d_num,d,age_num,age,year,pop_all,pop_male,pop_female
'00,전국,'00,계,1998,46991171,23594034,23397137
'00,전국,'05,0 - 4세,1998,3390678,1788561,1602117
'00,전국,'10,5 - 9세,1998,3428387,1820224,1608163
'00,전국,'15,10 - 14세,1998,3195174,1668531,1526643
'00,전국,'20,15 - 19세,1998,4094035,2102515,1991520
'00,전국,'25,20 - 24세,1998,3942827,2022535,1920292
'00,전국,'30,25 - 29세,1998,4637577,2371635,2265942
'00,전국,'35,30 - 34세,1998,4375695,2239107,2136588
'00,전국,'40,35 - 39세,1998,4502137,2308132,2194005
'00,전국,'45,40 - 44세,1998,3754895,1924704,1830191
'00,전국,'50,45 - 49세,1998,2633876,1338833,1295043
'00,전국,'55,50 - 54세,1998,2174068,1087746,1086322
'00,전국,'60,55 - 59세,1998,2129498,1026138,1103360
'00,전국,'65,60 - 64세,1998,1705802,780610,925192
'00,전국,'70,65 - 69세,1998,1185961,483132,702829
'00,전국,'75,70 - 74세,1998,811653,305709,505944
'00,전국,'80,75 - 79세,1998,559420,197624,361796
'00,전국,'85,80 - 84세,1998,291837,87587,204250
'00,전국,'90,85+ ,1998,177651,40711,136940
'11,서울특별시,'00,계,1998,10270506,5146825,5123681
'11,서울특별시,'05,0 - 4세,1998,667867,349146,318721
'11,서울특별시,'10,5 - 9세,1998,654908,346410,308498
'11,서울특별시,'15,10 - 14세,1998,651563,342747,308816
'11,서울특별시,'20,15 - 19세,1998,903472,469449,434023
'11,서울특별시,'25,20 - 24세,1998,922579,456451,466128
'11,서울특별시,'30,25 - 29세,1998,1179867,602277,577590
'11,서울특별시,'35,30 - 34세,1998,970210,506576,463634
'11,서울특별시,'40,35 - 39세,1998,945796,472140,473656
'11,서울특별시,'45,40 - 44세,1998,875842,424711,451131
'11,서울특별시,'50,45 - 49세,1998,652097,321861,330236
'11,서울특별시,'55,50 - 54세,1998,549316,273655,275661
'11,서울특별시,'60,55 - 59세,1998,473557,241495,232062
'11,서울특별시,'65,60 - 64세,1998,319421,155084,164337
'11,서울특별시,'70,65 - 69세,1998,197853,84073,113780
'11,서울특별시,'75,70 - 74세,1998,132112,48061,84051
'11,서울특별시,'80,75 - 79세,1998,93473,31936,61537
'11,서울특별시,'85,80 - 84세,1998,49847,13584,36263
'11,서울특별시,'90,85+ ,1998,30726,7169,23557
'11110, 종로구,'00,계,1998,188732,94646,94086
'11110, 종로구,'05,0 - 4세,1998,9776,5035,4741
'11110, 종로구,'10,5 - 9세,1998,10321,5472,4849
'11110, 종로구,'15,10 - 14세,1998,11101,5984,5117
'11110, 종로구,'20,15 - 19세,1998,15405,8230,7175
'11110, 종로구,'25,20 - 24세,1998,16775,8511,8264
'11110, 종로구,'30,25 - 29세,1998,22616,12261,10355
'11110, 종로구,'35,30 - 34세,1998,16766,8986,7780
'11110, 종로구,'40,35 - 39세,1998,16067,7975,8092
'11110, 종로구,'45,40 - 44세,1998,15193,7326,7867
'11110, 종로구,'50,45 - 49세,1998,11392,5485,5907
'11110, 종로구,'55,50 - 54세,1998,10599,4907,5692
'11110, 종로구,'60,55 - 59세,1998,11098,5290,5808
'11110, 종로구,'65,60 - 64세,1998,8211,3941,4270
'11110, 종로구,'70,65 - 69세,1998,5185,2228,2957
'11110, 종로구,'75,70 - 74세,1998,3529,1395,2134
'11110, 종로구,'80,75 - 79세,1998,2509,991,1518
'11110, 종로구,'85,80 - 84세,1998,1311,407,904
'11110, 종로구,'90,85+ ,1998,878,222,656
'1111051000,  청운동,'00,계,1998,6413,3250,3163
'1111051000,  청운동,'05,0 - 4세,1998,244,124,120
'1111051000,  청운동,'10,5 - 9세,1998,326,171,155
'1111051000,  청운동,'15,10 - 14세,1998,502,349,153
'1111051000,  청운동,'20,15 - 19세,1998,679,431,248
'1111051000,  청운동,'25,20 - 24세,1998,534,291,243
'1111051000,  청운동,'30,25 - 29세,1998,624,301,323
'1111051000,  청운동,'35,30 - 34세,1998,410,211,199
'1111051000,  청운동,'40,35 - 39세,1998,519,223,296
'1111051000,  청운동,'45,40 - 44세,1998,665,281,384
'1111051000,  청운동,'50,45 - 49세,1998,454,222,232
'1111051000,  청운동,'55,50 - 54세,1998,365,170,195
'1111051000,  청운동,'60,55 - 59세,1998,348,166,182
'1111051000,  청운동,'65,60 - 64세,1998,283,145,138
'1111051000,  청운동,'70,65 - 69세,1998,169,66,103
'1111051000,  청운동,'75,70 - 74세,1998,123,50,73
'1111051000,  청운동,'80,75 - 79세,1998,94,38,56
'1111051000,  청운동,'85,80 - 84세,1998,42,9,33
'1111051000,  청운동,'90,85+ ,1998,32,2,30
'1111052000,  효자동,'00,계,1998,12135,6004,6131
'1111052000,  효자동,'05,0 - 4세,1998,649,349,300
'1111052000,  효자동,'10,5 - 9세,1998,593,305,288
'1111052000,  효자동,'15,10 - 14세,1998,729,396,333
'1111052000,  효자동,'20,15 - 19세,1998,1090,582,508
'1111052000,  효자동,'25,20 - 24세,1998,1054,517,537
'1111052000,  효자동,'30,25 - 29세,1998,1390,739,651
'1111052000,  효자동,'35,30 - 34세,1998,1076,553,523
'1111052000,  효자동,'40,35 - 39세,1998,939,457,482
'1111052000,  효자동,'45,40 - 44세,1998,982,459,523
'1111052000,  효자동,'50,45 - 49세,1998,759,363,396
'1111052000,  효자동,'55,50 - 54세,1998,688,326,362
'1111052000,  효자동,'60,55 - 59세,1998,744,341,403
'1111052000,  효자동,'65,60 - 64세,1998,550,277,273
'1111052000,  효자동,'70,65 - 69세,1998,350,148,202
'1111052000,  효자동,'75,70 - 74세,1998,223,88,135
'1111052000,  효자동,'80,75 - 79세,1998,159,58,101
'1111052000,  효자동,'85,80 - 84세,1998,90,29,61
'1111052000,  효자동,'90,85+ ,1998,70,17,53
'1111053000,  사직동,'00,계,1998,9544,4682,4862
'1111053000,  사직동,'05,0 - 4세,1998,379,188,191
'1111053000,  사직동,'10,5 - 9세,1998,443,246,197
'1111053000,  사직동,'15,10 - 14세,1998,447,224,223
'1111053000,  사직동,'20,15 - 19세,1998,761,403,358
'1111053000,  사직동,'25,20 - 24세,1998,882,438,444
'1111053000,  사직동,'30,25 - 29세,1998,1105,640,465
'1111053000,  사직동,'35,30 - 34세,1998,784,421,363
'1111053000,  사직동,'40,35 - 39세,1998,732,352,380
'1111053000,  사직동,'45,40 - 44세,1998,752,344,408
'1111053000,  사직동,'50,45 - 49세,1998,624,263,361
'1111053000,  사직동,'55,50 - 54세,1998,655,300,355
'1111053000,  사직동,'60,55 - 59세,1998,665,315,350
'1111053000,  사직동,'65,60 - 64세,1998,495,218,277
'1111053000,  사직동,'70,65 - 69세,1998,318,134,184
'1111053000,  사직동,'75,70 - 74세,1998,225,97,128
'1111053000,  사직동,'80,75 - 79세,1998,163,65,98
'1111053000,  사직동,'85,80 - 84세,1998,61,20,41
'1111053000,  사직동,'90,85+ ,1998,53,14,39
'1111054000,  삼청동,'00,계,1998,5698,2830,2868
'1111054000,  삼청동,'05,0 - 4세,1998,286,143,143
'1111054000,  삼청동,'10,5 - 9세,1998,280,146,134
'1111054000,  삼청동,'15,10 - 14세,1998,279,130,149
'1111054000,  삼청동,'20,15 - 19세,1998,434,239,195
'1111054000,  삼청동,'25,20 - 24세,1998,435,235,200
'1111054000,  삼청동,'30,25 - 29세,1998,649,358,291
'1111054000,  삼청동,'35,30 - 34세,1998,518,268,250
'1111054000,  삼청동,'40,35 - 39세,1998,495,264,231
'1111054000,  삼청동,'45,40 - 44세,1998,433,198,235
'1111054000,  삼청동,'50,45 - 49세,1998,357,184,173
'1111054000,  삼청동,'55,50 - 54세,1998,334,146,188
'1111054000,  삼청동,'60,55 - 59세,1998,360,163,197
'1111054000,  삼청동,'65,60 - 64세,1998,290,146,144
'1111054000,  삼청동,'70,65 - 69세,1998,202,87,115
'1111054000,  삼청동,'75,70 - 74세,1998,157,51,106
'1111054000,  삼청동,'80,75 - 79세,1998,99,43,56
'1111054000,  삼청동,'85,80 - 84세,1998,58,20,38
'1111054000,  삼청동,'90,85+ ,1998,32,9,23
'1111055000,  부암동,'00,계,1998,13139,6559,6580
'1111055000,  부암동,'05,0 - 4세,1998,562,274,288
'1111055000,  부암동,'10,5 - 9세,1998,718,365,353
'1111055000,  부암동,'15,10 - 14세,1998,972,566,406
'1111055000,  부암동,'20,15 - 19세,1998,1202,702,500
'1111055000,  부암동,'25,20 - 24세,1998,1042,535,507
'1111055000,  부암동,'30,25 - 29세,1998,1284,675,609
'1111055000,  부암동,'35,30 - 34세,1998,975,487,488
'1111055000,  부암동,'40,35 - 39세,1998,1093,516,577
'1111055000,  부암동,'45,40 - 44세,1998,1265,580,685
'1111055000,  부암동,'50,45 - 49세,1998,874,409,465
'1111055000,  부암동,'55,50 - 54세,1998,759,370,389
'1111055000,  부암동,'60,55 - 59세,1998,756,389,367
'1111055000,  부암동,'65,60 - 64세,1998,592,268,324
'1111055000,  부암동,'70,65 - 69세,1998,408,181,227
'1111055000,  부암동,'75,70 - 74세,1998,289,122,167
'1111055000,  부암동,'80,75 - 79세,1998,184,76,108
'1111055000,  부암동,'85,80 - 84세,1998,97,24,73
'1111055000,  부암동,'90,85+ ,1998,67,20,47
'1111056000,  평창동,'00,계,1998,19068,9242,9826
'1111056000,  평창동,'05,0 - 4세,1998,994,544,450
'1111056000,  평창동,'10,5 - 9세,1998,1065,582,483
'1111056000,  평창동,'15,10 - 14세,1998,1313,711,602
'1111056000,  평창동,'20,15 - 19세,1998,1746,901,845
'1111056000,  평창동,'25,20 - 24세,1998,1392,695,697
'1111056000,  평창동,'30,25 - 29세,1998,1900,927,973
'1111056000,  평창동,'35,30 - 34세,1998,1448,691,757
'1111056000,  평창동,'40,35 - 39세,1998,1642,724,918
'1111056000,  평창동,'45,40 - 44세,1998,1748,749,999
'1111056000,  평창동,'50,45 - 49세,1998,1284,639,645
'1111056000,  평창동,'55,50 - 54세,1998,1122,510,612
'1111056000,  평창동,'60,55 - 59세,1998,1075,567,508
'1111056000,  평창동,'65,60 - 64세,1998,802,397,405
'1111056000,  평창동,'70,65 - 69세,1998,530,251,279
'1111056000,  평창동,'75,70 - 74세,1998,363,166,197
'1111056000,  평창동,'80,75 - 79세,1998,309,111,198
'1111056000,  평창동,'85,80 - 84세,1998,175,48,127
'1111056000,  평창동,'90,85+ ,1998,160,29,131
'1111057000,  무악동,'00,계,1998,5075,2521,2554
'1111057000,  무악동,'05,0 - 4세,1998,213,111,102
'1111057000,  무악동,'10,5 - 9세,1998,247,128,119
'1111057000,  무악동,'15,10 - 14세,1998,305,153,152
'1111057000,  무악동,'20,15 - 19세,1998,426,214,212
'1111057000,  무악동,'25,20 - 24세,1998,468,240,228
'1111057000,  무악동,'30,25 - 29세,1998,576,322,254
'1111057000,  무악동,'35,30 - 34세,1998,400,219,181
'1111057000,  무악동,'40,35 - 39세,1998,384,197,187
'1111057000,  무악동,'45,40 - 44세,1998,416,192,224
'1111057000,  무악동,'50,45 - 49세,1998,322,161,161
'1111057000,  무악동,'55,50 - 54세,1998,325,138,187
'1111057000,  무악동,'60,55 - 59세,1998,344,162,182
'1111057000,  무악동,'65,60 - 64세,1998,279,140,139
'1111057000,  무악동,'70,65 - 69세,1998,157,73,84
'1111057000,  무악동,'75,70 - 74세,1998,104,41,63
'1111057000,  무악동,'80,75 - 79세,1998,64,18,46
'1111057000,  무악동,'85,80 - 84세,1998,28,5,23
'1111057000,  무악동,'90,85+ ,1998,17,7,10
'1111058000,  교남동,'00,계,1998,9330,4574,4756
'1111058000,  교남동,'05,0 - 4세,1998,443,229,214
'1111058000,  교남동,'10,5 - 9세,1998,415,239,176
'1111058000,  교남동,'15,10 - 14세,1998,479,243,236
'1111058000,  교남동,'20,15 - 19세,1998,737,376,361
'1111058000,  교남동,'25,20 - 24세,1998,901,437,464
'1111058000,  교남동,'30,25 - 29세,1998,1149,637,512
'1111058000,  교남동,'35,30 - 34세,1998,817,450,367
'1111058000,  교남동,'40,35 - 39세,1998,758,350,408
'1111058000,  교남동,'45,40 - 44세,1998,759,333,426
'1111058000,  교남동,'50,45 - 49세,1998,588,273,315
'1111058000,  교남동,'55,50 - 54세,1998,573,245,328
'1111058000,  교남동,'60,55 - 59세,1998,595,295,300
'1111058000,  교남동,'65,60 - 64세,1998,453,226,227
'1111058000,  교남동,'70,65 - 69세,1998,261,98,163
'1111058000,  교남동,'75,70 - 74세,1998,178,69,109
'1111058000,  교남동,'80,75 - 79세,1998,119,49,70
'1111058000,  교남동,'85,80 - 84세,1998,66,16,50
'1111058000,  교남동,'90,85+ ,1998,39,9,30
'1111060000,  가회동,'00,계,1998,7383,3655,3728
'1111060000,  가회동,'05,0 - 4세,1998,359,188,171
'1111060000,  가회동,'10,5 - 9세,1998,397,191,206
'1111060000,  가회동,'15,10 - 14세,1998,339,183,156
'1111060000,  가회동,'20,15 - 19세,1998,600,321,279
'1111060000,  가회동,'25,20 - 24세,1998,654,334,320
'1111060000,  가회동,'30,25 - 29세,1998,895,471,424
'1111060000,  가회동,'35,30 - 34세,1998,655,362,293
'1111060000,  가회동,'40,35 - 39세,1998,650,340,310
'1111060000,  가회동,'45,40 - 44세,1998,562,255,307
'1111060000,  가회동,'50,45 - 49세,1998,460,221,239
'1111060000,  가회동,'55,50 - 54세,1998,415,194,221
'1111060000,  가회동,'60,55 - 59세,1998,453,200,253
'1111060000,  가회동,'65,60 - 64세,1998,339,175,164
'1111060000,  가회동,'70,65 - 69세,1998,215,88,127
'1111060000,  가회동,'75,70 - 74세,1998,145,54,91
'1111060000,  가회동,'80,75 - 79세,1998,134,44,90
'1111060000,  가회동,'85,80 - 84세,1998,66,24,42
'1111060000,  가회동,'90,85+ ,1998,45,10,35
'1111061500,  종로1.2.3.4가동,'00,계,1998,8295,4254,4041
'1111061500,  종로1.2.3.4가동,'05,0 - 4세,1998,253,135,118
'1111061500,  종로1.2.3.4가동,'10,5 - 9세,1998,303,167,136
'1111061500,  종로1.2.3.4가동,'15,10 - 14세,1998,329,171,158
'1111061500,  종로1.2.3.4가동,'20,15 - 19세,1998,577,304,273
'1111061500,  종로1.2.3.4가동,'25,20 - 24세,1998,676,370,306
'1111061500,  종로1.2.3.4가동,'30,25 - 29세,1998,848,510,338
'1111061500,  종로1.2.3.4가동,'35,30 - 34세,1998,607,368,239
'1111061500,  종로1.2.3.4가동,'40,35 - 39세,1998,655,343,312
'1111061500,  종로1.2.3.4가동,'45,40 - 44세,1998,728,377,351
'1111061500,  종로1.2.3.4가동,'50,45 - 49세,1998,585,280,305
'1111061500,  종로1.2.3.4가동,'55,50 - 54세,1998,623,289,334
'1111061500,  종로1.2.3.4가동,'60,55 - 59세,1998,656,307,349
'1111061500,  종로1.2.3.4가동,'65,60 - 64세,1998,532,253,279
'1111061500,  종로1.2.3.4가동,'70,65 - 69세,1998,352,150,202
'1111061500,  종로1.2.3.4가동,'75,70 - 74세,1998,264,89,175
'1111061500,  종로1.2.3.4가동,'80,75 - 79세,1998,173,91,82
'1111061500,  종로1.2.3.4가동,'85,80 - 84세,1998,81,31,50
'1111061500,  종로1.2.3.4가동,'90,85+ ,1998,53,19,34
'1111063000,  종로5·6가동,'00,계,1998,8834,4532,4302
'1111063000,  종로5·6가동,'05,0 - 4세,1998,503,254,249
'1111063000,  종로5·6가동,'10,5 - 9세,1998,593,324,269
'1111063000,  종로5·6가동,'15,10 - 14세,1998,555,284,271
'1111063000,  종로5·6가동,'20,15 - 19세,1998,698,362,336
'1111063000,  종로5·6가동,'25,20 - 24세,1998,784,416,368
'1111063000,  종로5·6가동,'30,25 - 29세,1998,1043,573,470
'1111063000,  종로5·6가동,'35,30 - 34세,1998,850,455,395
'1111063000,  종로5·6가동,'40,35 - 39세,1998,787,431,356
'1111063000,  종로5·6가동,'45,40 - 44세,1998,661,346,315
'1111063000,  종로5·6가동,'50,45 - 49세,1998,491,241,250
'1111063000,  종로5·6가동,'55,50 - 54세,1998,476,215,261
'1111063000,  종로5·6가동,'60,55 - 59세,1998,454,226,228
'1111063000,  종로5·6가동,'65,60 - 64세,1998,336,158,178
'1111063000,  종로5·6가동,'70,65 - 69세,1998,224,95,129
'1111063000,  종로5·6가동,'75,70 - 74세,1998,164,60,104
'1111063000,  종로5·6가동,'80,75 - 79세,1998,116,52,64
'1111063000,  종로5·6가동,'85,80 - 84세,1998,61,26,35
'1111063000,  종로5·6가동,'90,85+ ,1998,38,14,24
'1111064000,  이화동,'00,계,1998,12254,6047,6207
'1111064000,  이화동,'05,0 - 4세,1998,667,345,322
'1111064000,  이화동,'10,5 - 9세,1998,668,366,302
'1111064000,  이화동,'15,10 - 14세,1998,831,420,411
'1111064000,  이화동,'20,15 - 19세,1998,969,500,469
'1111064000,  이화동,'25,20 - 24세,1998,1153,556,597
'1111064000,  이화동,'30,25 - 29세,1998,1705,873,832
'1111064000,  이화동,'35,30 - 34세,1998,1203,660,543
'1111064000,  이화동,'40,35 - 39세,1998,1088,527,561
'1111064000,  이화동,'45,40 - 44세,1998,899,424,475
'1111064000,  이화동,'50,45 - 49세,1998,647,321,326
'1111064000,  이화동,'55,50 - 54세,1998,582,264,318
'1111064000,  이화동,'60,55 - 59세,1998,641,294,347
'1111064000,  이화동,'65,60 - 64세,1998,452,212,240
'1111064000,  이화동,'70,65 - 69세,1998,295,133,162
'1111064000,  이화동,'75,70 - 74세,1998,191,68,123
'1111064000,  이화동,'80,75 - 79세,1998,144,46,98
'1111064000,  이화동,'85,80 - 84세,1998,73,27,46
'1111064000,  이화동,'90,85+ ,1998,46,11,35
'1111065000,  혜화동,'00,계,1998,12085,6027,6058
'1111065000,  혜화동,'05,0 - 4세,1998,731,390,341
'1111065000,  혜화동,'10,5 - 9세,1998,631,334,297
'1111065000,  혜화동,'15,10 - 14세,1998,651,354,297
'1111065000,  혜화동,'20,15 - 19세,1998,839,442,397
'1111065000,  혜화동,'25,20 - 24세,1998,1200,607,593
'1111065000,  혜화동,'30,25 - 29세,1998,1799,953,846
'1111065000,  혜화동,'35,30 - 34세,1998,1121,599,522
'1111065000,  혜화동,'40,35 - 39세,1998,1046,495,551
'1111065000,  혜화동,'45,40 - 44세,1998,882,434,448
'1111065000,  혜화동,'50,45 - 49세,1998,667,295,372
'1111065000,  혜화동,'55,50 - 54세,1998,656,317,339
'1111065000,  혜화동,'60,55 - 59세,1998,619,287,332
'1111065000,  혜화동,'65,60 - 64세,1998,441,214,227
'1111065000,  혜화동,'70,65 - 69세,1998,310,119,191
'1111065000,  혜화동,'75,70 - 74세,1998,203,77,126
'1111065000,  혜화동,'80,75 - 79세,1998,152,65,87
'1111065000,  혜화동,'85,80 - 84세,1998,87,33,54
'1111065000,  혜화동,'90,85+ ,1998,50,12,38
'1111066000,  명륜3가동,'00,계,1998,8145,4289,3856
'1111066000,  명륜3가동,'05,0 - 4세,1998,400,196,204
'1111066000,  명륜3가동,'10,5 - 9세,1998,364,193,171
'1111066000,  명륜3가동,'15,10 - 14세,1998,344,202,142
'1111066000,  명륜3가동,'20,15 - 19세,1998,534,299,235
'1111066000,  명륜3가동,'25,20 - 24세,1998,1004,496,508
'1111066000,  명륜3가동,'30,25 - 29세,1998,1507,955,552
'1111066000,  명륜3가동,'35,30 - 34세,1998,784,450,334
'1111066000,  명륜3가동,'40,35 - 39세,1998,623,309,314
'1111066000,  명륜3가동,'45,40 - 44세,1998,479,246,233
'1111066000,  명륜3가동,'50,45 - 49세,1998,361,161,200
'1111066000,  명륜3가동,'55,50 - 54세,1998,405,181,224
'1111066000,  명륜3가동,'60,55 - 59세,1998,456,197,259
'1111066000,  명륜3가동,'65,60 - 64세,1998,390,191,199
'1111066000,  명륜3가동,'70,65 - 69세,1998,227,104,123
'1111066000,  명륜3가동,'75,70 - 74세,1998,109,48,61
'1111066000,  명륜3가동,'80,75 - 79세,1998,82,38,44
'1111066000,  명륜3가동,'85,80 - 84세,1998,48,17,31
'1111066000,  명륜3가동,'90,85+ ,1998,28,6,22
'1111067000,  창신1동,'00,계,1998,7702,3999,3703
'1111067000,  창신1동,'05,0 - 4세,1998,389,202,187
'1111067000,  창신1동,'10,5 - 9세,1998,479,272,207
'1111067000,  창신1동,'15,10 - 14세,1998,468,252,216
'1111067000,  창신1동,'20,15 - 19세,1998,571,306,265
'1111067000,  창신1동,'25,20 - 24세,1998,676,353,323
'1111067000,  창신1동,'30,25 - 29세,1998,887,482,405
'1111067000,  창신1동,'35,30 - 34세,1998,810,452,358
'1111067000,  창신1동,'40,35 - 39세,1998,707,376,331
'1111067000,  창신1동,'45,40 - 44세,1998,647,345,302
'1111067000,  창신1동,'50,45 - 49세,1998,464,240,224
'1111067000,  창신1동,'55,50 - 54세,1998,402,186,216
'1111067000,  창신1동,'60,55 - 59세,1998,468,212,256
'1111067000,  창신1동,'65,60 - 64세,1998,291,138,153
'1111067000,  창신1동,'70,65 - 69세,1998,171,75,96
'1111067000,  창신1동,'75,70 - 74세,1998,111,44,67
'1111067000,  창신1동,'80,75 - 79세,1998,100,42,58
'1111067000,  창신1동,'85,80 - 84세,1998,41,14,27
'1111067000,  창신1동,'90,85+ ,1998,20,8,12
'1111068000,  창신2동,'00,계,1998,14685,7491,7194
'1111068000,  창신2동,'05,0 - 4세,1998,956,455,501
'1111068000,  창신2동,'10,5 - 9세,1998,1006,526,480
'1111068000,  창신2동,'15,10 - 14세,1998,835,442,393
'1111068000,  창신2동,'20,15 - 19세,1998,1214,640,574
'1111068000,  창신2동,'25,20 - 24세,1998,1389,698,691
'1111068000,  창신2동,'30,25 - 29세,1998,1861,997,864
'1111068000,  창신2동,'35,30 - 34세,1998,1606,884,722
'1111068000,  창신2동,'40,35 - 39세,1998,1305,726,579
'1111068000,  창신2동,'45,40 - 44세,1998,1029,549,480
'1111068000,  창신2동,'50,45 - 49세,1998,745,360,385
'1111068000,  창신2동,'55,50 - 54세,1998,720,342,378
'1111068000,  창신2동,'60,55 - 59세,1998,785,364,421
'1111068000,  창신2동,'65,60 - 64세,1998,540,254,286
'1111068000,  창신2동,'70,65 - 69세,1998,274,108,166
'1111068000,  창신2동,'75,70 - 74세,1998,209,75,134
'1111068000,  창신2동,'80,75 - 79세,1998,113,42,71
'1111068000,  창신2동,'85,80 - 84세,1998,66,20,46
'1111068000,  창신2동,'90,85+ ,1998,32,9,23
'1111069000,  창신3동,'00,계,1998,10835,5466,5369
'1111069000,  창신3동,'05,0 - 4세,1998,731,379,352
'1111069000,  창신3동,'10,5 - 9세,1998,836,430,406
'1111069000,  창신3동,'15,10 - 14세,1998,769,417,352
'1111069000,  창신3동,'20,15 - 19세,1998,881,437,444
'1111069000,  창신3동,'25,20 - 24세,1998,835,445,390
'1111069000,  창신3동,'30,25 - 29세,1998,1119,579,540
'1111069000,  창신3동,'35,30 - 34세,1998,1017,524,493
'1111069000,  창신3동,'40,35 - 39세,1998,1138,556,582
'1111069000,  창신3동,'45,40 - 44세,1998,942,498,444
'1111069000,  창신3동,'50,45 - 49세,1998,583,310,273
'1111069000,  창신3동,'55,50 - 54세,1998,508,251,257
'1111069000,  창신3동,'60,55 - 59세,1998,536,249,287
'1111069000,  창신3동,'65,60 - 64세,1998,387,179,208
'1111069000,  창신3동,'70,65 - 69세,1998,241,107,134
'1111069000,  창신3동,'75,70 - 74세,1998,139,51,88
'1111069000,  창신3동,'80,75 - 79세,1998,90,35,55
'1111069000,  창신3동,'85,80 - 84세,1998,55,10,45
'1111069000,  창신3동,'90,85+ ,1998,28,9,19
'1111070000,  숭인1동,'00,계,1998,8860,4553,4307
'1111070000,  숭인1동,'05,0 - 4세,1998,544,289,255
'1111070000,  숭인1동,'10,5 - 9세,1998,558,283,275
'1111070000,  숭인1동,'15,10 - 14세,1998,529,271,258
'1111070000,  숭인1동,'20,15 - 19세,1998,721,387,334
'1111070000,  숭인1동,'25,20 - 24세,1998,792,404,388
'1111070000,  숭인1동,'30,25 - 29세,1998,1115,617,498
'1111070000,  숭인1동,'35,30 - 34세,1998,882,467,415
'1111070000,  숭인1동,'40,35 - 39세,1998,785,417,368
'1111070000,  숭인1동,'45,40 - 44세,1998,653,354,299
'1111070000,  숭인1동,'50,45 - 49세,1998,521,256,265
'1111070000,  숭인1동,'55,50 - 54세,1998,415,195,220
'1111070000,  숭인1동,'60,55 - 59세,1998,491,239,252
'1111070000,  숭인1동,'65,60 - 64세,1998,349,160,189
'1111070000,  숭인1동,'70,65 - 69세,1998,195,90,105
'1111070000,  숭인1동,'75,70 - 74세,1998,144,69,75
'1111070000,  숭인1동,'80,75 - 79세,1998,86,29,57
'1111070000,  숭인1동,'85,80 - 84세,1998,49,15,34
'1111070000,  숭인1동,'90,85+ ,1998,31,11,20
'1111071000,  숭인2동,'00,계,1998,9252,4671,4581
'1111071000,  숭인2동,'05,0 - 4세,1998,473,240,233
'1111071000,  숭인2동,'10,5 - 9세,1998,399,204,195
'1111071000,  숭인2동,'15,10 - 14세,1998,425,216,209
'1111071000,  숭인2동,'20,15 - 19세,1998,726,384,342
'1111071000,  숭인2동,'25,20 - 24세,1998,904,444,460
'1111071000,  숭인2동,'30,25 - 29세,1998,1160,652,508
'1111071000,  숭인2동,'35,30 - 34세,1998,803,465,338
'1111071000,  숭인2동,'40,35 - 39세,1998,721,372,349
'1111071000,  숭인2동,'45,40 - 44세,1998,691,362,329
'1111071000,  숭인2동,'50,45 - 49세,1998,606,286,320
'1111071000,  숭인2동,'55,50 - 54세,1998,576,268,308
'1111071000,  숭인2동,'60,55 - 59세,1998,652,317,335
'1111071000,  숭인2동,'65,60 - 64세,1998,410,190,220
'1111071000,  숭인2동,'70,65 - 69세,1998,286,121,165
'1111071000,  숭인2동,'75,70 - 74세,1998,188,76,112
'1111071000,  숭인2동,'80,75 - 79세,1998,128,49,79
'1111071000,  숭인2동,'85,80 - 84세,1998,67,19,48
'1111071000,  숭인2동,'90,85+ ,1998,37,6,31
'11140, 중구,'00,계,1998,122500,61557,60943
'11140, 중구,'05,0 - 4세,1998,6523,3403,3120
'11140, 중구,'10,5 - 9세,1998,6756,3575,3181
'11140, 중구,'15,10 - 14세,1998,6422,3404,3018
'11140, 중구,'20,15 - 19세,1998,9529,4741,4788
'11140, 중구,'25,20 - 24세,1998,10945,5575,5370
'11140, 중구,'30,25 - 29세,1998,14411,7901,6510
'11140, 중구,'35,30 - 34세,1998,11226,6060,5166
'11140, 중구,'40,35 - 39세,1998,10654,5654,5000
'11140, 중구,'45,40 - 44세,1998,9688,4866,4822
'11140, 중구,'50,45 - 49세,1998,7459,3605,3854
'11140, 중구,'55,50 - 54세,1998,7156,3296,3860
'11140, 중구,'60,55 - 59세,1998,7435,3594,3841
'11140, 중구,'65,60 - 64세,1998,5399,2446,2953
'11140, 중구,'70,65 - 69세,1998,3516,1438,2078
'11140, 중구,'75,70 - 74세,1998,2422,929,1493
'11140, 중구,'80,75 - 79세,1998,1682,686,996
'11140, 중구,'85,80 - 84세,1998,781,232,549
'11140, 중구,'90,85+ ,1998,496,152,344
'1114052000,  소공동,'00,계,1998,1590,809,781
'1114052000,  소공동,'05,0 - 4세,1998,38,18,20
'1114052000,  소공동,'10,5 - 9세,1998,60,39,21
'1114052000,  소공동,'15,10 - 14세,1998,81,36,45
'1114052000,  소공동,'20,15 - 19세,1998,169,50,119
'1114052000,  소공동,'25,20 - 24세,1998,102,61,41
'1114052000,  소공동,'30,25 - 29세,1998,164,108,56
'1114052000,  소공동,'35,30 - 34세,1998,110,61,49
'1114052000,  소공동,'40,35 - 39세,1998,131,79,52
'1114052000,  소공동,'45,40 - 44세,1998,167,85,82
'1114052000,  소공동,'50,45 - 49세,1998,107,55,52
'1114052000,  소공동,'55,50 - 54세,1998,115,59,56
'1114052000,  소공동,'60,55 - 59세,1998,119,59,60
'1114052000,  소공동,'65,60 - 64세,1998,79,34,45
'1114052000,  소공동,'70,65 - 69세,1998,58,21,37
'1114052000,  소공동,'75,70 - 74세,1998,44,22,22
'1114052000,  소공동,'80,75 - 79세,1998,26,14,12
'1114052000,  소공동,'85,80 - 84세,1998,13,4,9
'1114052000,  소공동,'90,85+ ,1998,7,4,3
'1114054000,  회현동,'00,계,1998,7154,3665,3489
'1114054000,  회현동,'05,0 - 4세,1998,291,158,133
'1114054000,  회현동,'10,5 - 9세,1998,331,166,165
'1114054000,  회현동,'15,10 - 14세,1998,281,145,136
'1114054000,  회현동,'20,15 - 19세,1998,534,282,252
'1114054000,  회현동,'25,20 - 24세,1998,627,340,287
'1114054000,  회현동,'30,25 - 29세,1998,778,458,320
'1114054000,  회현동,'35,30 - 34세,1998,532,301,231
'1114054000,  회현동,'40,35 - 39세,1998,601,329,272
'1114054000,  회현동,'45,40 - 44세,1998,615,327,288
'1114054000,  회현동,'50,45 - 49세,1998,508,257,251
'1114054000,  회현동,'55,50 - 54세,1998,516,250,266
'1114054000,  회현동,'60,55 - 59세,1998,483,257,226
'1114054000,  회현동,'65,60 - 64세,1998,405,171,234
'1114054000,  회현동,'70,65 - 69세,1998,246,88,158
'1114054000,  회현동,'75,70 - 74세,1998,204,72,132
'1114054000,  회현동,'80,75 - 79세,1998,115,42,73
'1114054000,  회현동,'85,80 - 84세,1998,49,12,37
'1114054000,  회현동,'90,85+ ,1998,38,10,28
'1114055000,  명동,'00,계,1998,3091,1347,1744
'1114055000,  명동,'05,0 - 4세,1998,87,42,45
'1114055000,  명동,'10,5 - 9세,1998,86,43,43
'1114055000,  명동,'15,10 - 14세,1998,79,38,41
'1114055000,  명동,'20,15 - 19세,1998,170,83,87
'1114055000,  명동,'25,20 - 24세,1998,247,125,122
'1114055000,  명동,'30,25 - 29세,1998,363,187,176
'1114055000,  명동,'35,30 - 34세,1998,272,122,150
'1114055000,  명동,'40,35 - 39세,1998,276,122,154
'1114055000,  명동,'45,40 - 44세,1998,266,100,166
'1114055000,  명동,'50,45 - 49세,1998,235,92,143
'1114055000,  명동,'55,50 - 54세,1998,250,102,148
'1114055000,  명동,'60,55 - 59세,1998,251,118,133
'1114055000,  명동,'65,60 - 64세,1998,183,72,111
'1114055000,  명동,'70,65 - 69세,1998,96,35,61
'1114055000,  명동,'75,70 - 74세,1998,93,26,67
'1114055000,  명동,'80,75 - 79세,1998,71,22,49
'1114055000,  명동,'85,80 - 84세,1998,40,13,27
'1114055000,  명동,'90,85+ ,1998,26,5,21
'1114057000,  필동,'00,계,1998,4960,2561,2399
'1114057000,  필동,'05,0 - 4세,1998,207,101,106
'1114057000,  필동,'10,5 - 9세,1998,258,154,104
'1114057000,  필동,'15,10 - 14세,1998,298,167,131
'1114057000,  필동,'20,15 - 19세,1998,428,228,200
'1114057000,  필동,'25,20 - 24세,1998,411,222,189
'1114057000,  필동,'30,25 - 29세,1998,569,348,221
'1114057000,  필동,'35,30 - 34세,1998,413,204,209
'1114057000,  필동,'40,35 - 39세,1998,425,221,204
'1114057000,  필동,'45,40 - 44세,1998,417,199,218
'1114057000,  필동,'50,45 - 49세,1998,312,149,163
'1114057000,  필동,'55,50 - 54세,1998,277,127,150
'1114057000,  필동,'60,55 - 59세,1998,295,145,150
'1114057000,  필동,'65,60 - 64세,1998,200,104,96
'1114057000,  필동,'70,65 - 69세,1998,171,65,106
'1114057000,  필동,'75,70 - 74세,1998,122,57,65
'1114057000,  필동,'80,75 - 79세,1998,89,43,46
'1114057000,  필동,'85,80 - 84세,1998,37,13,24
'1114057000,  필동,'90,85+ ,1998,31,14,17
'1114058000,  장충동,'00,계,1998,6422,3193,3229
'1114058000,  장충동,'05,0 - 4세,1998,367,185,182
'1114058000,  장충동,'10,5 - 9세,1998,366,188,178
'1114058000,  장충동,'15,10 - 14세,1998,303,156,147
'1114058000,  장충동,'20,15 - 19세,1998,514,238,276
'1114058000,  장충동,'25,20 - 24세,1998,589,332,257
'1114058000,  장충동,'30,25 - 29세,1998,796,455,341
'1114058000,  장충동,'35,30 - 34세,1998,586,314,272
'1114058000,  장충동,'40,35 - 39세,1998,539,279,260
'1114058000,  장충동,'45,40 - 44세,1998,512,247,265
'1114058000,  장충동,'50,45 - 49세,1998,379,179,200
'1114058000,  장충동,'55,50 - 54세,1998,347,147,200
'1114058000,  장충동,'60,55 - 59세,1998,344,168,176
'1114058000,  장충동,'65,60 - 64세,1998,275,119,156
'1114058000,  장충동,'70,65 - 69세,1998,190,78,112
'1114058000,  장충동,'75,70 - 74세,1998,134,45,89
'1114058000,  장충동,'80,75 - 79세,1998,101,37,64
'1114058000,  장충동,'85,80 - 84세,1998,53,19,34
'1114058000,  장충동,'90,85+ ,1998,27,7,20
'1114059000,  광희동,'00,계,1998,6981,3562,3419
'1114059000,  광희동,'05,0 - 4세,1998,316,165,151
'1114059000,  광희동,'10,5 - 9세,1998,319,172,147
'1114059000,  광희동,'15,10 - 14세,1998,380,197,183
'1114059000,  광희동,'20,15 - 19세,1998,526,262,264
'1114059000,  광희동,'25,20 - 24세,1998,600,319,281
'1114059000,  광희동,'30,25 - 29세,1998,744,421,323
'1114059000,  광희동,'35,30 - 34세,1998,563,325,238
'1114059000,  광희동,'40,35 - 39세,1998,640,332,308
'1114059000,  광희동,'45,40 - 44세,1998,599,322,277
'1114059000,  광희동,'50,45 - 49세,1998,480,248,232
'1114059000,  광희동,'55,50 - 54세,1998,444,221,223
'1114059000,  광희동,'60,55 - 59세,1998,427,207,220
'1114059000,  광희동,'65,60 - 64세,1998,334,139,195
'1114059000,  광희동,'70,65 - 69세,1998,220,94,126
'1114059000,  광희동,'75,70 - 74세,1998,169,56,113
'1114059000,  광희동,'80,75 - 79세,1998,128,48,80
'1114059000,  광희동,'85,80 - 84세,1998,51,15,36
'1114059000,  광희동,'90,85+ ,1998,41,19,22
'1114060000,  을지로3·4·5가동,'00,계,1998,2216,1172,1044
'1114060000,  을지로3·4·5가동,'05,0 - 4세,1998,79,46,33
'1114060000,  을지로3·4·5가동,'10,5 - 9세,1998,65,35,30
'1114060000,  을지로3·4·5가동,'15,10 - 14세,1998,91,53,38
'1114060000,  을지로3·4·5가동,'20,15 - 19세,1998,170,86,84
'1114060000,  을지로3·4·5가동,'25,20 - 24세,1998,165,94,71
'1114060000,  을지로3·4·5가동,'30,25 - 29세,1998,211,128,83
'1114060000,  을지로3·4·5가동,'35,30 - 34세,1998,147,95,52
'1114060000,  을지로3·4·5가동,'40,35 - 39세,1998,171,94,77
'1114060000,  을지로3·4·5가동,'45,40 - 44세,1998,174,98,76
'1114060000,  을지로3·4·5가동,'50,45 - 49세,1998,161,79,82
'1114060000,  을지로3·4·5가동,'55,50 - 54세,1998,160,83,77
'1114060000,  을지로3·4·5가동,'60,55 - 59세,1998,185,93,92
'1114060000,  을지로3·4·5가동,'65,60 - 64세,1998,131,56,75
'1114060000,  을지로3·4·5가동,'70,65 - 69세,1998,105,45,60
'1114060000,  을지로3·4·5가동,'75,70 - 74세,1998,96,38,58
'1114060000,  을지로3·4·5가동,'80,75 - 79세,1998,59,30,29
'1114060000,  을지로3·4·5가동,'85,80 - 84세,1998,32,13,19
'1114060000,  을지로3·4·5가동,'90,85+ ,1998,14,6,8
'1114061000,  신당1동,'00,계,1998,10913,5547,5366
'1114061000,  신당1동,'05,0 - 4세,1998,682,357,325
'1114061000,  신당1동,'10,5 - 9세,1998,715,371,344
'1114061000,  신당1동,'15,10 - 14세,1998,599,325,274
'1114061000,  신당1동,'20,15 - 19세,1998,819,431,388
'1114061000,  신당1동,'25,20 - 24세,1998,1006,496,510
'1114061000,  신당1동,'30,25 - 29세,1998,1398,737,661
'1114061000,  신당1동,'35,30 - 34세,1998,1085,594,491
'1114061000,  신당1동,'40,35 - 39세,1998,1024,555,469
'1114061000,  신당1동,'45,40 - 44세,1998,808,407,401
'1114061000,  신당1동,'50,45 - 49세,1998,584,277,307
'1114061000,  신당1동,'55,50 - 54세,1998,596,295,301
'1114061000,  신당1동,'60,55 - 59세,1998,582,268,314
'1114061000,  신당1동,'65,60 - 64세,1998,381,191,190
'1114061000,  신당1동,'70,65 - 69세,1998,263,108,155
'1114061000,  신당1동,'75,70 - 74세,1998,165,58,107
'1114061000,  신당1동,'80,75 - 79세,1998,113,43,70
'1114061000,  신당1동,'85,80 - 84세,1998,60,24,36
'1114061000,  신당1동,'90,85+ ,1998,33,10,23
'1114062000,  신당2동,'00,계,1998,16627,8270,8357
'1114062000,  신당2동,'05,0 - 4세,1998,927,480,447
'1114062000,  신당2동,'10,5 - 9세,1998,935,501,434
'1114062000,  신당2동,'15,10 - 14세,1998,880,468,412
'1114062000,  신당2동,'20,15 - 19세,1998,1317,649,668
'1114062000,  신당2동,'25,20 - 24세,1998,1499,757,742
'1114062000,  신당2동,'30,25 - 29세,1998,2035,1095,940
'1114062000,  신당2동,'35,30 - 34세,1998,1623,853,770
'1114062000,  신당2동,'40,35 - 39세,1998,1428,742,686
'1114062000,  신당2동,'45,40 - 44세,1998,1312,622,690
'1114062000,  신당2동,'50,45 - 49세,1998,983,464,519
'1114062000,  신당2동,'55,50 - 54세,1998,882,397,485
'1114062000,  신당2동,'60,55 - 59세,1998,1015,473,542
'1114062000,  신당2동,'65,60 - 64세,1998,713,340,373
'1114062000,  신당2동,'70,65 - 69세,1998,441,186,255
'1114062000,  신당2동,'75,70 - 74세,1998,289,121,168
'1114062000,  신당2동,'80,75 - 79세,1998,198,82,116
'1114062000,  신당2동,'85,80 - 84세,1998,95,22,73
'1114062000,  신당2동,'90,85+ ,1998,55,18,37
'1114063000,  신당3동,'00,계,1998,7050,3494,3556
'1114063000,  신당3동,'05,0 - 4세,1998,348,170,178
'1114063000,  신당3동,'10,5 - 9세,1998,353,201,152
'1114063000,  신당3동,'15,10 - 14세,1998,369,204,165
'1114063000,  신당3동,'20,15 - 19세,1998,550,258,292
'1114063000,  신당3동,'25,20 - 24세,1998,607,310,297
'1114063000,  신당3동,'30,25 - 29세,1998,830,447,383
'1114063000,  신당3동,'35,30 - 34세,1998,676,354,322
'1114063000,  신당3동,'40,35 - 39세,1998,552,303,249
'1114063000,  신당3동,'45,40 - 44세,1998,557,279,278
'1114063000,  신당3동,'50,45 - 49세,1998,405,194,211
'1114063000,  신당3동,'55,50 - 54세,1998,415,178,237
'1114063000,  신당3동,'60,55 - 59세,1998,463,221,242
'1114063000,  신당3동,'65,60 - 64세,1998,372,174,198
'1114063000,  신당3동,'70,65 - 69세,1998,205,85,120
'1114063000,  신당3동,'75,70 - 74세,1998,158,62,96
'1114063000,  신당3동,'80,75 - 79세,1998,110,40,70
'1114063000,  신당3동,'85,80 - 84세,1998,47,6,41
'1114063000,  신당3동,'90,85+ ,1998,33,8,25
'1114064000,  신당4동,'00,계,1998,6258,3139,3119
'1114064000,  신당4동,'05,0 - 4세,1998,343,193,150
'1114064000,  신당4동,'10,5 - 9세,1998,340,185,155
'1114064000,  신당4동,'15,10 - 14세,1998,387,199,188
'1114064000,  신당4동,'20,15 - 19세,1998,470,228,242
'1114064000,  신당4동,'25,20 - 24세,1998,562,288,274
'1114064000,  신당4동,'30,25 - 29세,1998,742,400,342
'1114064000,  신당4동,'35,30 - 34세,1998,553,304,249
'1114064000,  신당4동,'40,35 - 39세,1998,530,251,279
'1114064000,  신당4동,'45,40 - 44세,1998,460,239,221
'1114064000,  신당4동,'50,45 - 49세,1998,378,183,195
'1114064000,  신당4동,'55,50 - 54세,1998,358,149,209
'1114064000,  신당4동,'60,55 - 59세,1998,393,203,190
'1114064000,  신당4동,'65,60 - 64세,1998,268,119,149
'1114064000,  신당4동,'70,65 - 69세,1998,211,91,120
'1114064000,  신당4동,'75,70 - 74세,1998,120,53,67
'1114064000,  신당4동,'80,75 - 79세,1998,78,33,45
'1114064000,  신당4동,'85,80 - 84세,1998,39,12,27
'1114064000,  신당4동,'90,85+ ,1998,26,9,17
'1114065000,  신당5동,'00,계,1998,13045,6585,6460
'1114065000,  신당5동,'05,0 - 4세,1998,834,437,397
'1114065000,  신당5동,'10,5 - 9세,1998,771,403,368
'1114065000,  신당5동,'15,10 - 14세,1998,671,356,315
'1114065000,  신당5동,'20,15 - 19세,1998,991,505,486
'1114065000,  신당5동,'25,20 - 24세,1998,1262,622,640
'1114065000,  신당5동,'30,25 - 29세,1998,1689,902,787
'1114065000,  신당5동,'35,30 - 34세,1998,1304,731,573
'1114065000,  신당5동,'40,35 - 39세,1998,1165,632,533
'1114065000,  신당5동,'45,40 - 44세,1998,958,498,460
'1114065000,  신당5동,'50,45 - 49세,1998,720,327,393
'1114065000,  신당5동,'55,50 - 54세,1998,743,351,392
'1114065000,  신당5동,'60,55 - 59세,1998,690,335,355
'1114065000,  신당5동,'65,60 - 64세,1998,505,216,289
'1114065000,  신당5동,'70,65 - 69세,1998,311,119,192
'1114065000,  신당5동,'75,70 - 74세,1998,192,72,120
'1114065000,  신당5동,'80,75 - 79세,1998,145,52,93
'1114065000,  신당5동,'85,80 - 84세,1998,58,19,39
'1114065000,  신당5동,'90,85+ ,1998,36,8,28
'1114066000,  신당6동,'00,계,1998,13158,6542,6616
'1114066000,  신당6동,'05,0 - 4세,1998,816,442,374
'1114066000,  신당6동,'10,5 - 9세,1998,903,443,460
'1114066000,  신당6동,'15,10 - 14세,1998,727,379,348
'1114066000,  신당6동,'20,15 - 19세,1998,975,460,515
'1114066000,  신당6동,'25,20 - 24세,1998,1088,516,572
'1114066000,  신당6동,'30,25 - 29세,1998,1540,801,739
'1114066000,  신당6동,'35,30 - 34세,1998,1336,706,630
'1114066000,  신당6동,'40,35 - 39세,1998,1222,652,570
'1114066000,  신당6동,'45,40 - 44세,1998,993,521,472
'1114066000,  신당6동,'50,45 - 49세,1998,730,374,356
'1114066000,  신당6동,'55,50 - 54세,1998,656,291,365
'1114066000,  신당6동,'60,55 - 59세,1998,740,344,396
'1114066000,  신당6동,'65,60 - 64세,1998,576,261,315
'1114066000,  신당6동,'70,65 - 69세,1998,327,138,189
'1114066000,  신당6동,'75,70 - 74세,1998,241,97,144
'1114066000,  신당6동,'80,75 - 79세,1998,159,76,83
'1114066000,  신당6동,'85,80 - 84세,1998,81,26,55
'1114066000,  신당6동,'90,85+ ,1998,48,15,33
'1114067000,  황학동,'00,계,1998,11336,5801,5535
'1114067000,  황학동,'05,0 - 4세,1998,538,285,253
'1114067000,  황학동,'10,5 - 9세,1998,611,324,287
'1114067000,  황학동,'15,10 - 14세,1998,655,350,305
'1114067000,  황학동,'20,15 - 19세,1998,984,512,472
'1114067000,  황학동,'25,20 - 24세,1998,1080,565,515
'1114067000,  황학동,'30,25 - 29세,1998,1197,683,514
'1114067000,  황학동,'35,30 - 34세,1998,951,521,430
'1114067000,  황학동,'40,35 - 39세,1998,949,511,438
'1114067000,  황학동,'45,40 - 44세,1998,938,465,473
'1114067000,  황학동,'50,45 - 49세,1998,786,396,390
'1114067000,  황학동,'55,50 - 54세,1998,705,323,382
'1114067000,  황학동,'60,55 - 59세,1998,712,352,360
'1114067000,  황학동,'65,60 - 64세,1998,476,214,262
'1114067000,  황학동,'70,65 - 69세,1998,316,137,179
'1114067000,  황학동,'75,70 - 74세,1998,198,79,119
'1114067000,  황학동,'80,75 - 79세,1998,129,54,75
'1114067000,  황학동,'85,80 - 84세,1998,62,19,43
'1114067000,  황학동,'90,85+ ,1998,49,11,38
'1114068000,  중림동,'00,계,1998,11699,5870,5829
'1114068000,  중림동,'05,0 - 4세,1998,650,324,326
'1114068000,  중림동,'10,5 - 9세,1998,643,350,293
'1114068000,  중림동,'15,10 - 14세,1998,621,331,290
'1114068000,  중림동,'20,15 - 19세,1998,912,469,443
'1114068000,  중림동,'25,20 - 24세,1998,1100,528,572
'1114068000,  중림동,'30,25 - 29세,1998,1355,731,624
'1114068000,  중림동,'35,30 - 34세,1998,1075,575,500
'1114068000,  중림동,'40,35 - 39세,1998,1001,552,449
'1114068000,  중림동,'45,40 - 44세,1998,912,457,455
'1114068000,  중림동,'50,45 - 49세,1998,691,331,360
'1114068000,  중림동,'55,50 - 54세,1998,692,323,369
'1114068000,  중림동,'60,55 - 59세,1998,736,351,385
'1114068000,  중림동,'65,60 - 64세,1998,501,236,265
'1114068000,  중림동,'70,65 - 69세,1998,356,148,208
'1114068000,  중림동,'75,70 - 74세,1998,197,71,126
'1114068000,  중림동,'80,75 - 79세,1998,161,70,91
'1114068000,  중림동,'85,80 - 84세,1998,64,15,49
'1114068000,  중림동,'90,85+ ,1998,32,8,24
'11170, 용산구,'00,계,1998,239282,118709,120573
'11170, 용산구,'05,0 - 4세,1998,14032,7309,6723
'11170, 용산구,'10,5 - 9세,1998,12951,6872,6079
'11170, 용산구,'15,10 - 14세,1998,12304,6516,5788
'11170, 용산구,'20,15 - 19세,1998,18248,9676,8572
'11170, 용산구,'25,20 - 24세,1998,21045,10508,10537
'11170, 용산구,'30,25 - 29세,1998,29670,15337,14333
'11170, 용산구,'35,30 - 34세,1998,22907,12038,10869
'11170, 용산구,'40,35 - 39세,1998,20687,10386,10301
'11170, 용산구,'45,40 - 44세,1998,18725,9049,9676
'11170, 용산구,'50,45 - 49세,1998,14159,6654,7505
'11170, 용산구,'55,50 - 54세,1998,13451,6177,7274
'11170, 용산구,'60,55 - 59세,1998,13928,6582,7346
'11170, 용산구,'65,60 - 64세,1998,10717,4949,5768
'11170, 용산구,'70,65 - 69세,1998,6751,3038,3713
'11170, 용산구,'75,70 - 74세,1998,4339,1700,2639
'11170, 용산구,'80,75 - 79세,1998,2945,1185,1760
'11170, 용산구,'85,80 - 84세,1998,1499,496,1003
'11170, 용산구,'90,85+ ,1998,924,237,687
'1117051000,  후암동,'00,계,1998,20059,10022,10037
'1117051000,  후암동,'05,0 - 4세,1998,1268,661,607
'1117051000,  후암동,'10,5 - 9세,1998,1176,630,546
'1117051000,  후암동,'15,10 - 14세,1998,1105,615,490
'1117051000,  후암동,'20,15 - 19세,1998,1664,891,773
'1117051000,  후암동,'25,20 - 24세,1998,1756,906,850
'1117051000,  후암동,'30,25 - 29세,1998,2425,1230,1195
'1117051000,  후암동,'35,30 - 34세,1998,1907,1028,879
'1117051000,  후암동,'40,35 - 39세,1998,1711,842,869
'1117051000,  후암동,'45,40 - 44세,1998,1603,769,834
'1117051000,  후암동,'50,45 - 49세,1998,1196,570,626
'1117051000,  후암동,'55,50 - 54세,1998,1134,533,601
'1117051000,  후암동,'60,55 - 59세,1998,1012,502,510
'1117051000,  후암동,'65,60 - 64세,1998,725,314,411
'1117051000,  후암동,'70,65 - 69세,1998,485,191,294
'1117051000,  후암동,'75,70 - 74세,1998,374,137,237
'1117051000,  후암동,'80,75 - 79세,1998,315,124,191
'1117051000,  후암동,'85,80 - 84세,1998,127,51,76
'1117051000,  후암동,'90,85+ ,1998,76,28,48
'1117052000,  용산2가동,'00,계,1998,15827,7806,8021
'1117052000,  용산2가동,'05,0 - 4세,1998,903,480,423
'1117052000,  용산2가동,'10,5 - 9세,1998,861,470,391
'1117052000,  용산2가동,'15,10 - 14세,1998,851,449,402
'1117052000,  용산2가동,'20,15 - 19세,1998,1467,774,693
'1117052000,  용산2가동,'25,20 - 24세,1998,1396,706,690
'1117052000,  용산2가동,'30,25 - 29세,1998,1697,852,845
'1117052000,  용산2가동,'35,30 - 34세,1998,1381,691,690
'1117052000,  용산2가동,'40,35 - 39세,1998,1409,672,737
'1117052000,  용산2가동,'45,40 - 44세,1998,1398,674,724
'1117052000,  용산2가동,'50,45 - 49세,1998,1089,568,521
'1117052000,  용산2가동,'55,50 - 54세,1998,860,402,458
'1117052000,  용산2가동,'60,55 - 59세,1998,844,404,440
'1117052000,  용산2가동,'65,60 - 64세,1998,580,231,349
'1117052000,  용산2가동,'70,65 - 69세,1998,424,175,249
'1117052000,  용산2가동,'75,70 - 74세,1998,310,111,199
'1117052000,  용산2가동,'80,75 - 79세,1998,201,94,107
'1117052000,  용산2가동,'85,80 - 84세,1998,103,37,66
'1117052000,  용산2가동,'90,85+ ,1998,53,16,37
'1117053000,  남영동,'00,계,1998,7241,3819,3422
'1117053000,  남영동,'05,0 - 4세,1998,329,151,178
'1117053000,  남영동,'10,5 - 9세,1998,279,141,138
'1117053000,  남영동,'15,10 - 14세,1998,272,126,146
'1117053000,  남영동,'20,15 - 19세,1998,510,268,242
'1117053000,  남영동,'25,20 - 24세,1998,738,377,361
'1117053000,  남영동,'30,25 - 29세,1998,909,557,352
'1117053000,  남영동,'35,30 - 34세,1998,663,407,256
'1117053000,  남영동,'40,35 - 39세,1998,592,357,235
'1117053000,  남영동,'45,40 - 44세,1998,544,281,263
'1117053000,  남영동,'50,45 - 49세,1998,495,244,251
'1117053000,  남영동,'55,50 - 54세,1998,476,250,226
'1117053000,  남영동,'60,55 - 59세,1998,492,248,244
'1117053000,  남영동,'65,60 - 64세,1998,371,172,199
'1117053000,  남영동,'70,65 - 69세,1998,219,99,120
'1117053000,  남영동,'75,70 - 74세,1998,173,69,104
'1117053000,  남영동,'80,75 - 79세,1998,97,41,56
'1117053000,  남영동,'85,80 - 84세,1998,56,22,34
'1117053000,  남영동,'90,85+ ,1998,26,9,17
'1117054000,  청파1동,'00,계,1998,19312,9819,9493
'1117054000,  청파1동,'05,0 - 4세,1998,1367,719,648
'1117054000,  청파1동,'10,5 - 9세,1998,1185,616,569
'1117054000,  청파1동,'15,10 - 14세,1998,1180,688,492
'1117054000,  청파1동,'20,15 - 19세,1998,1509,865,644
'1117054000,  청파1동,'25,20 - 24세,1998,1713,822,891
'1117054000,  청파1동,'30,25 - 29세,1998,2507,1305,1202
'1117054000,  청파1동,'35,30 - 34세,1998,2024,1097,927
'1117054000,  청파1동,'40,35 - 39세,1998,1690,868,822
'1117054000,  청파1동,'45,40 - 44세,1998,1496,720,776
'1117054000,  청파1동,'50,45 - 49세,1998,1040,495,545
'1117054000,  청파1동,'55,50 - 54세,1998,962,461,501
'1117054000,  청파1동,'60,55 - 59세,1998,926,440,486
'1117054000,  청파1동,'65,60 - 64세,1998,676,333,343
'1117054000,  청파1동,'70,65 - 69세,1998,421,167,254
'1117054000,  청파1동,'75,70 - 74세,1998,276,103,173
'1117054000,  청파1동,'80,75 - 79세,1998,198,73,125
'1117054000,  청파1동,'85,80 - 84세,1998,96,31,65
'1117054000,  청파1동,'90,85+ ,1998,46,16,30
'1117055000,  청파2동,'00,계,1998,8521,4118,4403
'1117055000,  청파2동,'05,0 - 4세,1998,409,215,194
'1117055000,  청파2동,'10,5 - 9세,1998,346,171,175
'1117055000,  청파2동,'15,10 - 14세,1998,365,165,200
'1117055000,  청파2동,'20,15 - 19세,1998,623,331,292
'1117055000,  청파2동,'25,20 - 24세,1998,926,377,549
'1117055000,  청파2동,'30,25 - 29세,1998,1426,799,627
'1117055000,  청파2동,'35,30 - 34세,1998,886,523,363
'1117055000,  청파2동,'40,35 - 39세,1998,648,308,340
'1117055000,  청파2동,'45,40 - 44세,1998,610,256,354
'1117055000,  청파2동,'50,45 - 49세,1998,490,224,266
'1117055000,  청파2동,'55,50 - 54세,1998,481,205,276
'1117055000,  청파2동,'60,55 - 59세,1998,457,200,257
'1117055000,  청파2동,'65,60 - 64세,1998,307,155,152
'1117055000,  청파2동,'70,65 - 69세,1998,214,81,133
'1117055000,  청파2동,'75,70 - 74세,1998,137,49,88
'1117055000,  청파2동,'80,75 - 79세,1998,105,35,70
'1117055000,  청파2동,'85,80 - 84세,1998,63,18,45
'1117055000,  청파2동,'90,85+ ,1998,28,6,22
'1117056000,  원효로1동,'00,계,1998,7783,3910,3873
'1117056000,  원효로1동,'05,0 - 4세,1998,408,205,203
'1117056000,  원효로1동,'10,5 - 9세,1998,388,180,208
'1117056000,  원효로1동,'15,10 - 14세,1998,357,182,175
'1117056000,  원효로1동,'20,15 - 19세,1998,579,288,291
'1117056000,  원효로1동,'25,20 - 24세,1998,782,412,370
'1117056000,  원효로1동,'30,25 - 29세,1998,1051,570,481
'1117056000,  원효로1동,'35,30 - 34세,1998,722,402,320
'1117056000,  원효로1동,'40,35 - 39세,1998,622,333,289
'1117056000,  원효로1동,'45,40 - 44세,1998,531,259,272
'1117056000,  원효로1동,'50,45 - 49세,1998,481,214,267
'1117056000,  원효로1동,'55,50 - 54세,1998,476,232,244
'1117056000,  원효로1동,'60,55 - 59세,1998,528,252,276
'1117056000,  원효로1동,'65,60 - 64세,1998,328,166,162
'1117056000,  원효로1동,'70,65 - 69세,1998,209,91,118
'1117056000,  원효로1동,'75,70 - 74세,1998,144,62,82
'1117056000,  원효로1동,'80,75 - 79세,1998,99,38,61
'1117056000,  원효로1동,'85,80 - 84세,1998,41,14,27
'1117056000,  원효로1동,'90,85+ ,1998,37,10,27
'1117057000,  원효로2동,'00,계,1998,11040,5496,5544
'1117057000,  원효로2동,'05,0 - 4세,1998,637,324,313
'1117057000,  원효로2동,'10,5 - 9세,1998,555,288,267
'1117057000,  원효로2동,'15,10 - 14세,1998,567,293,274
'1117057000,  원효로2동,'20,15 - 19세,1998,891,455,436
'1117057000,  원효로2동,'25,20 - 24세,1998,957,480,477
'1117057000,  원효로2동,'30,25 - 29세,1998,1292,698,594
'1117057000,  원효로2동,'35,30 - 34세,1998,980,520,460
'1117057000,  원효로2동,'40,35 - 39세,1998,910,476,434
'1117057000,  원효로2동,'45,40 - 44세,1998,892,421,471
'1117057000,  원효로2동,'50,45 - 49세,1998,687,333,354
'1117057000,  원효로2동,'55,50 - 54세,1998,663,329,334
'1117057000,  원효로2동,'60,55 - 59세,1998,659,296,363
'1117057000,  원효로2동,'65,60 - 64세,1998,535,253,282
'1117057000,  원효로2동,'70,65 - 69세,1998,344,167,177
'1117057000,  원효로2동,'75,70 - 74세,1998,197,77,120
'1117057000,  원효로2동,'80,75 - 79세,1998,140,58,82
'1117057000,  원효로2동,'85,80 - 84세,1998,78,18,60
'1117057000,  원효로2동,'90,85+ ,1998,56,10,46
'1117058000,  효창동,'00,계,1998,11770,5936,5834
'1117058000,  효창동,'05,0 - 4세,1998,739,391,348
'1117058000,  효창동,'10,5 - 9세,1998,683,366,317
'1117058000,  효창동,'15,10 - 14세,1998,671,379,292
'1117058000,  효창동,'20,15 - 19세,1998,1011,547,464
'1117058000,  효창동,'25,20 - 24세,1998,996,490,506
'1117058000,  효창동,'30,25 - 29세,1998,1320,707,613
'1117058000,  효창동,'35,30 - 34세,1998,1107,571,536
'1117058000,  효창동,'40,35 - 39세,1998,1090,564,526
'1117058000,  효창동,'45,40 - 44세,1998,974,468,506
'1117058000,  효창동,'50,45 - 49세,1998,686,343,343
'1117058000,  효창동,'55,50 - 54세,1998,659,292,367
'1117058000,  효창동,'60,55 - 59세,1998,632,301,331
'1117058000,  효창동,'65,60 - 64세,1998,450,206,244
'1117058000,  효창동,'70,65 - 69세,1998,284,131,153
'1117058000,  효창동,'75,70 - 74세,1998,180,70,110
'1117058000,  효창동,'80,75 - 79세,1998,161,67,94
'1117058000,  효창동,'85,80 - 84세,1998,74,29,45
'1117058000,  효창동,'90,85+ ,1998,53,14,39
'1117059000,  용문동,'00,계,1998,8354,4210,4144
'1117059000,  용문동,'05,0 - 4세,1998,399,202,197
'1117059000,  용문동,'10,5 - 9세,1998,417,245,172
'1117059000,  용문동,'15,10 - 14세,1998,484,248,236
'1117059000,  용문동,'20,15 - 19세,1998,757,402,355
'1117059000,  용문동,'25,20 - 24세,1998,733,403,330
'1117059000,  용문동,'30,25 - 29세,1998,892,472,420
'1117059000,  용문동,'35,30 - 34세,1998,670,360,310
'1117059000,  용문동,'40,35 - 39세,1998,731,386,345
'1117059000,  용문동,'45,40 - 44세,1998,695,327,368
'1117059000,  용문동,'50,45 - 49세,1998,513,252,261
'1117059000,  용문동,'55,50 - 54세,1998,540,247,293
'1117059000,  용문동,'60,55 - 59세,1998,502,242,260
'1117059000,  용문동,'65,60 - 64세,1998,417,203,214
'1117059000,  용문동,'70,65 - 69세,1998,238,95,143
'1117059000,  용문동,'75,70 - 74세,1998,131,43,88
'1117059000,  용문동,'80,75 - 79세,1998,130,47,83
'1117059000,  용문동,'85,80 - 84세,1998,71,27,44
'1117059000,  용문동,'90,85+ ,1998,34,9,25
'1117060000,  한강로1동,'00,계,1998,4960,2474,2486
'1117060000,  한강로1동,'05,0 - 4세,1998,196,95,101
'1117060000,  한강로1동,'10,5 - 9세,1998,194,98,96
'1117060000,  한강로1동,'15,10 - 14세,1998,229,115,114
'1117060000,  한강로1동,'20,15 - 19세,1998,397,218,179
'1117060000,  한강로1동,'25,20 - 24세,1998,495,246,249
'1117060000,  한강로1동,'30,25 - 29세,1998,593,322,271
'1117060000,  한강로1동,'35,30 - 34세,1998,371,206,165
'1117060000,  한강로1동,'40,35 - 39세,1998,396,192,204
'1117060000,  한강로1동,'45,40 - 44세,1998,399,210,189
'1117060000,  한강로1동,'50,45 - 49세,1998,342,152,190
'1117060000,  한강로1동,'55,50 - 54세,1998,339,163,176
'1117060000,  한강로1동,'60,55 - 59세,1998,354,181,173
'1117060000,  한강로1동,'65,60 - 64세,1998,267,134,133
'1117060000,  한강로1동,'70,65 - 69세,1998,142,63,79
'1117060000,  한강로1동,'75,70 - 74세,1998,112,31,81
'1117060000,  한강로1동,'80,75 - 79세,1998,73,33,40
'1117060000,  한강로1동,'85,80 - 84세,1998,32,8,24
'1117060000,  한강로1동,'90,85+ ,1998,29,7,22
'1117061000,  한강로2동,'00,계,1998,6546,3319,3227
'1117061000,  한강로2동,'05,0 - 4세,1998,270,147,123
'1117061000,  한강로2동,'10,5 - 9세,1998,267,139,128
'1117061000,  한강로2동,'15,10 - 14세,1998,303,145,158
'1117061000,  한강로2동,'20,15 - 19세,1998,515,262,253
'1117061000,  한강로2동,'25,20 - 24세,1998,585,310,275
'1117061000,  한강로2동,'30,25 - 29세,1998,746,416,330
'1117061000,  한강로2동,'35,30 - 34세,1998,526,304,222
'1117061000,  한강로2동,'40,35 - 39세,1998,567,299,268
'1117061000,  한강로2동,'45,40 - 44세,1998,490,248,242
'1117061000,  한강로2동,'50,45 - 49세,1998,440,218,222
'1117061000,  한강로2동,'55,50 - 54세,1998,423,193,230
'1117061000,  한강로2동,'60,55 - 59세,1998,473,231,242
'1117061000,  한강로2동,'65,60 - 64세,1998,399,182,217
'1117061000,  한강로2동,'70,65 - 69세,1998,219,101,118
'1117061000,  한강로2동,'75,70 - 74세,1998,153,62,91
'1117061000,  한강로2동,'80,75 - 79세,1998,101,39,62
'1117061000,  한강로2동,'85,80 - 84세,1998,42,13,29
'1117061000,  한강로2동,'90,85+ ,1998,27,10,17
'1117062000,  한강로3동,'00,계,1998,6427,3321,3106
'1117062000,  한강로3동,'05,0 - 4세,1998,335,184,151
'1117062000,  한강로3동,'10,5 - 9세,1998,243,132,111
'1117062000,  한강로3동,'15,10 - 14세,1998,259,151,108
'1117062000,  한강로3동,'20,15 - 19세,1998,484,259,225
'1117062000,  한강로3동,'25,20 - 24세,1998,656,339,317
'1117062000,  한강로3동,'30,25 - 29세,1998,787,422,365
'1117062000,  한강로3동,'35,30 - 34세,1998,549,322,227
'1117062000,  한강로3동,'40,35 - 39세,1998,482,266,216
'1117062000,  한강로3동,'45,40 - 44세,1998,462,230,232
'1117062000,  한강로3동,'50,45 - 49세,1998,406,177,229
'1117062000,  한강로3동,'55,50 - 54세,1998,455,218,237
'1117062000,  한강로3동,'60,55 - 59세,1998,467,231,236
'1117062000,  한강로3동,'65,60 - 64세,1998,361,171,190
'1117062000,  한강로3동,'70,65 - 69세,1998,215,99,116
'1117062000,  한강로3동,'75,70 - 74세,1998,123,57,66
'1117062000,  한강로3동,'80,75 - 79세,1998,71,34,37
'1117062000,  한강로3동,'85,80 - 84세,1998,48,21,27
'1117062000,  한강로3동,'90,85+ ,1998,24,8,16
'1117063000,  이촌1동,'00,계,1998,20490,9901,10589
'1117063000,  이촌1동,'05,0 - 4세,1998,1469,800,669
'1117063000,  이촌1동,'10,5 - 9세,1998,1527,843,684
'1117063000,  이촌1동,'15,10 - 14세,1998,1324,687,637
'1117063000,  이촌1동,'20,15 - 19세,1998,1238,622,616
'1117063000,  이촌1동,'25,20 - 24세,1998,1210,591,619
'1117063000,  이촌1동,'30,25 - 29세,1998,2284,1023,1261
'1117063000,  이촌1동,'35,30 - 34세,1998,2152,1057,1095
'1117063000,  이촌1동,'40,35 - 39세,1998,2059,959,1100
'1117063000,  이촌1동,'45,40 - 44세,1998,1768,889,879
'1117063000,  이촌1동,'50,45 - 49세,1998,1060,492,568
'1117063000,  이촌1동,'55,50 - 54세,1998,973,429,544
'1117063000,  이촌1동,'60,55 - 59세,1998,1032,480,552
'1117063000,  이촌1동,'65,60 - 64세,1998,871,387,484
'1117063000,  이촌1동,'70,65 - 69세,1998,644,322,322
'1117063000,  이촌1동,'75,70 - 74세,1998,399,159,240
'1117063000,  이촌1동,'80,75 - 79세,1998,232,98,134
'1117063000,  이촌1동,'85,80 - 84세,1998,144,40,104
'1117063000,  이촌1동,'90,85+ ,1998,104,23,81
'1117064000,  이촌2동,'00,계,1998,9647,4785,4862
'1117064000,  이촌2동,'05,0 - 4세,1998,606,337,269
'1117064000,  이촌2동,'10,5 - 9세,1998,481,240,241
'1117064000,  이촌2동,'15,10 - 14세,1998,509,259,250
'1117064000,  이촌2동,'20,15 - 19세,1998,761,401,360
'1117064000,  이촌2동,'25,20 - 24세,1998,834,410,424
'1117064000,  이촌2동,'30,25 - 29세,1998,1153,594,559
'1117064000,  이촌2동,'35,30 - 34세,1998,919,497,422
'1117064000,  이촌2동,'40,35 - 39세,1998,780,376,404
'1117064000,  이촌2동,'45,40 - 44세,1998,767,369,398
'1117064000,  이촌2동,'50,45 - 49세,1998,630,301,329
'1117064000,  이촌2동,'55,50 - 54세,1998,582,273,309
'1117064000,  이촌2동,'60,55 - 59세,1998,558,268,290
'1117064000,  이촌2동,'65,60 - 64세,1998,414,185,229
'1117064000,  이촌2동,'70,65 - 69세,1998,306,148,158
'1117064000,  이촌2동,'75,70 - 74세,1998,174,73,101
'1117064000,  이촌2동,'80,75 - 79세,1998,97,34,63
'1117064000,  이촌2동,'85,80 - 84세,1998,44,15,29
'1117064000,  이촌2동,'90,85+ ,1998,32,5,27
'1117065000,  이태원1동,'00,계,1998,9296,4439,4857
'1117065000,  이태원1동,'05,0 - 4세,1998,528,275,253
'1117065000,  이태원1동,'10,5 - 9세,1998,553,286,267
'1117065000,  이태원1동,'15,10 - 14세,1998,431,219,212
'1117065000,  이태원1동,'20,15 - 19세,1998,598,326,272
'1117065000,  이태원1동,'25,20 - 24세,1998,777,364,413
'1117065000,  이태원1동,'30,25 - 29세,1998,1087,561,526
'1117065000,  이태원1동,'35,30 - 34세,1998,961,457,504
'1117065000,  이태원1동,'40,35 - 39세,1998,854,423,431
'1117065000,  이태원1동,'45,40 - 44세,1998,663,316,347
'1117065000,  이태원1동,'50,45 - 49세,1998,511,215,296
'1117065000,  이태원1동,'55,50 - 54세,1998,508,225,283
'1117065000,  이태원1동,'60,55 - 59세,1998,558,236,322
'1117065000,  이태원1동,'65,60 - 64세,1998,505,221,284
'1117065000,  이태원1동,'70,65 - 69세,1998,337,149,188
'1117065000,  이태원1동,'75,70 - 74세,1998,205,84,121
'1117065000,  이태원1동,'80,75 - 79세,1998,126,52,74
'1117065000,  이태원1동,'85,80 - 84세,1998,55,22,33
'1117065000,  이태원1동,'90,85+ ,1998,39,8,31
'1117066000,  이태원2동,'00,계,1998,14103,6827,7276
'1117066000,  이태원2동,'05,0 - 4세,1998,779,390,389
'1117066000,  이태원2동,'10,5 - 9세,1998,701,375,326
'1117066000,  이태원2동,'15,10 - 14세,1998,692,360,332
'1117066000,  이태원2동,'20,15 - 19세,1998,1049,529,520
'1117066000,  이태원2동,'25,20 - 24세,1998,1196,600,596
'1117066000,  이태원2동,'30,25 - 29세,1998,1799,881,918
'1117066000,  이태원2동,'35,30 - 34세,1998,1366,666,700
'1117066000,  이태원2동,'40,35 - 39세,1998,1190,594,596
'1117066000,  이태원2동,'45,40 - 44세,1998,1109,553,556
'1117066000,  이태원2동,'50,45 - 49세,1998,786,377,409
'1117066000,  이태원2동,'55,50 - 54세,1998,801,356,445
'1117066000,  이태원2동,'60,55 - 59세,1998,912,424,488
'1117066000,  이태원2동,'65,60 - 64세,1998,708,313,395
'1117066000,  이태원2동,'70,65 - 69세,1998,411,190,221
'1117066000,  이태원2동,'75,70 - 74세,1998,286,109,177
'1117066000,  이태원2동,'80,75 - 79세,1998,176,68,108
'1117066000,  이태원2동,'85,80 - 84세,1998,85,27,58
'1117066000,  이태원2동,'90,85+ ,1998,57,15,42
'1117067000,  한남1동,'00,계,1998,13346,6647,6699
'1117067000,  한남1동,'05,0 - 4세,1998,733,382,351
'1117067000,  한남1동,'10,5 - 9세,1998,593,303,290
'1117067000,  한남1동,'15,10 - 14세,1998,537,292,245
'1117067000,  한남1동,'20,15 - 19세,1998,992,517,475
'1117067000,  한남1동,'25,20 - 24세,1998,1366,693,673
'1117067000,  한남1동,'30,25 - 29세,1998,1936,1023,913
'1117067000,  한남1동,'35,30 - 34세,1998,1291,733,558
'1117067000,  한남1동,'40,35 - 39세,1998,1060,531,529
'1117067000,  한남1동,'45,40 - 44세,1998,955,450,505
'1117067000,  한남1동,'50,45 - 49세,1998,772,349,423
'1117067000,  한남1동,'55,50 - 54세,1998,733,310,423
'1117067000,  한남1동,'60,55 - 59세,1998,874,413,461
'1117067000,  한남1동,'65,60 - 64세,1998,613,293,320
'1117067000,  한남1동,'70,65 - 69세,1998,396,185,211
'1117067000,  한남1동,'75,70 - 74세,1998,229,84,145
'1117067000,  한남1동,'80,75 - 79세,1998,137,53,84
'1117067000,  한남1동,'85,80 - 84세,1998,89,27,62
'1117067000,  한남1동,'90,85+ ,1998,40,9,31
'1117068000,  한남2동,'00,계,1998,9674,4697,4977
'1117068000,  한남2동,'05,0 - 4세,1998,496,237,259
'1117068000,  한남2동,'10,5 - 9세,1998,450,250,200
'1117068000,  한남2동,'15,10 - 14세,1998,374,211,163
'1117068000,  한남2동,'20,15 - 19세,1998,694,356,338
'1117068000,  한남2동,'25,20 - 24세,1998,980,484,496
'1117068000,  한남2동,'30,25 - 29세,1998,1451,743,708
'1117068000,  한남2동,'35,30 - 34세,1998,949,468,481
'1117068000,  한남2동,'40,35 - 39세,1998,825,412,413
'1117068000,  한남2동,'45,40 - 44세,1998,708,329,379
'1117068000,  한남2동,'50,45 - 49세,1998,576,249,327
'1117068000,  한남2동,'55,50 - 54세,1998,530,231,299
'1117068000,  한남2동,'60,55 - 59세,1998,555,262,293
'1117068000,  한남2동,'65,60 - 64세,1998,451,211,240
'1117068000,  한남2동,'70,65 - 69세,1998,252,105,147
'1117068000,  한남2동,'75,70 - 74세,1998,181,70,111
'1117068000,  한남2동,'80,75 - 79세,1998,113,52,61
'1117068000,  한남2동,'85,80 - 84세,1998,51,18,33
'1117068000,  한남2동,'90,85+ ,1998,38,9,29
'1117069000,  서빙고동,'00,계,1998,13122,6519,6603
'1117069000,  서빙고동,'05,0 - 4세,1998,902,472,430
'1117069000,  서빙고동,'10,5 - 9세,1998,958,525,433
'1117069000,  서빙고동,'15,10 - 14세,1998,755,374,381
'1117069000,  서빙고동,'20,15 - 19세,1998,859,460,399
'1117069000,  서빙고동,'25,20 - 24세,1998,875,459,416
'1117069000,  서빙고동,'30,25 - 29세,1998,1394,671,723
'1117069000,  서빙고동,'35,30 - 34세,1998,1355,677,678
'1117069000,  서빙고동,'40,35 - 39세,1998,1266,635,631
'1117069000,  서빙고동,'45,40 - 44세,1998,1041,548,493
'1117069000,  서빙고동,'50,45 - 49세,1998,683,338,345
'1117069000,  서빙고동,'55,50 - 54세,1998,575,254,321
'1117069000,  서빙고동,'60,55 - 59세,1998,752,316,436
'1117069000,  서빙고동,'65,60 - 64세,1998,742,360,382
'1117069000,  서빙고동,'70,65 - 69세,1998,428,218,210
'1117069000,  서빙고동,'75,70 - 74세,1998,225,103,122
'1117069000,  서빙고동,'80,75 - 79세,1998,150,64,86
'1117069000,  서빙고동,'85,80 - 84세,1998,98,34,64
'1117069000,  서빙고동,'90,85+ ,1998,64,11,53
'1117070000,  보광동,'00,계,1998,21764,10644,11120
'1117070000,  보광동,'05,0 - 4세,1998,1259,642,617
'1117070000,  보광동,'10,5 - 9세,1998,1094,574,520
'1117070000,  보광동,'15,10 - 14세,1998,1039,558,481
'1117070000,  보광동,'20,15 - 19세,1998,1650,905,745
'1117070000,  보광동,'25,20 - 24세,1998,2074,1039,1035
'1117070000,  보광동,'30,25 - 29세,1998,2921,1491,1430
'1117070000,  보광동,'35,30 - 34세,1998,2128,1052,1076
'1117070000,  보광동,'40,35 - 39세,1998,1805,893,912
'1117070000,  보광동,'45,40 - 44세,1998,1620,732,888
'1117070000,  보광동,'50,45 - 49세,1998,1276,543,733
'1117070000,  보광동,'55,50 - 54세,1998,1281,574,707
'1117070000,  보광동,'60,55 - 59세,1998,1341,655,686
'1117070000,  보광동,'65,60 - 64세,1998,997,459,538
'1117070000,  보광동,'70,65 - 69세,1998,563,261,302
'1117070000,  보광동,'75,70 - 74세,1998,330,147,183
'1117070000,  보광동,'80,75 - 79세,1998,223,81,142
'1117070000,  보광동,'85,80 - 84세,1998,102,24,78
'1117070000,  보광동,'90,85+ ,1998,61,14,47
'11200, 성동구,'00,계,1998,321945,162866,159079
'11200, 성동구,'05,0 - 4세,1998,21885,11430,10455
'11200, 성동구,'10,5 - 9세,1998,20723,10877,9846
'11200, 성동구,'15,10 - 14세,1998,18454,9368,9086
'11200, 성동구,'20,15 - 19세,1998,24772,12652,12120
'11200, 성동구,'25,20 - 24세,1998,28840,14136,14704
'11200, 성동구,'30,25 - 29세,1998,40149,21055,19094
'11200, 성동구,'35,30 - 34세,1998,33171,17978,15193
'11200, 성동구,'40,35 - 39세,1998,30475,16170,14305
'11200, 성동구,'45,40 - 44세,1998,24674,12608,12066
'11200, 성동구,'50,45 - 49세,1998,17793,8832,8961
'11200, 성동구,'55,50 - 54세,1998,16449,7850,8599
'11200, 성동구,'60,55 - 59세,1998,16447,8022,8425
'11200, 성동구,'65,60 - 64세,1998,11694,5509,6185
'11200, 성동구,'70,65 - 69세,1998,6904,3042,3862
'11200, 성동구,'75,70 - 74세,1998,4240,1662,2578
'11200, 성동구,'80,75 - 79세,1998,2833,1043,1790
'11200, 성동구,'85,80 - 84세,1998,1499,409,1090
'11200, 성동구,'90,85+ ,1998,943,223,720
'1120051000,  왕십리1동,'00,계,1998,15633,7912,7721
'1120051000,  왕십리1동,'05,0 - 4세,1998,1104,559,545
'1120051000,  왕십리1동,'10,5 - 9세,1998,1027,533,494
'1120051000,  왕십리1동,'15,10 - 14세,1998,827,434,393
'1120051000,  왕십리1동,'20,15 - 19세,1998,1173,607,566
'1120051000,  왕십리1동,'25,20 - 24세,1998,1483,728,755
'1120051000,  왕십리1동,'30,25 - 29세,1998,1946,1037,909
'1120051000,  왕십리1동,'35,30 - 34세,1998,1599,887,712
'1120051000,  왕십리1동,'40,35 - 39세,1998,1396,784,612
'1120051000,  왕십리1동,'45,40 - 44세,1998,1149,551,598
'1120051000,  왕십리1동,'50,45 - 49세,1998,886,431,455
'1120051000,  왕십리1동,'55,50 - 54세,1998,833,389,444
'1120051000,  왕십리1동,'60,55 - 59세,1998,851,416,435
'1120051000,  왕십리1동,'65,60 - 64세,1998,558,280,278
'1120051000,  왕십리1동,'70,65 - 69세,1998,332,131,201
'1120051000,  왕십리1동,'75,70 - 74세,1998,208,70,138
'1120051000,  왕십리1동,'80,75 - 79세,1998,131,46,85
'1120051000,  왕십리1동,'85,80 - 84세,1998,85,18,67
'1120051000,  왕십리1동,'90,85+ ,1998,45,11,34
'1120052000,  왕십리2동,'00,계,1998,17845,9013,8832
'1120052000,  왕십리2동,'05,0 - 4세,1998,1102,573,529
'1120052000,  왕십리2동,'10,5 - 9세,1998,1134,590,544
'1120052000,  왕십리2동,'15,10 - 14세,1998,1040,511,529
'1120052000,  왕십리2동,'20,15 - 19세,1998,1558,794,764
'1120052000,  왕십리2동,'25,20 - 24세,1998,1633,792,841
'1120052000,  왕십리2동,'30,25 - 29세,1998,2039,1115,924
'1120052000,  왕십리2동,'35,30 - 34세,1998,1654,905,749
'1120052000,  왕십리2동,'40,35 - 39세,1998,1645,858,787
'1120052000,  왕십리2동,'45,40 - 44세,1998,1449,728,721
'1120052000,  왕십리2동,'50,45 - 49세,1998,1069,532,537
'1120052000,  왕십리2동,'55,50 - 54세,1998,934,447,487
'1120052000,  왕십리2동,'60,55 - 59세,1998,877,433,444
'1120052000,  왕십리2동,'65,60 - 64세,1998,705,313,392
'1120052000,  왕십리2동,'70,65 - 69세,1998,409,196,213
'1120052000,  왕십리2동,'75,70 - 74세,1998,269,114,155
'1120052000,  왕십리2동,'80,75 - 79세,1998,194,67,127
'1120052000,  왕십리2동,'85,80 - 84세,1998,84,27,57
'1120052000,  왕십리2동,'90,85+ ,1998,50,18,32
'1120053000,  도선동,'00,계,1998,11050,5539,5511
'1120053000,  도선동,'05,0 - 4세,1998,684,343,341
'1120053000,  도선동,'10,5 - 9세,1998,643,349,294
'1120053000,  도선동,'15,10 - 14세,1998,605,311,294
'1120053000,  도선동,'20,15 - 19세,1998,819,433,386
'1120053000,  도선동,'25,20 - 24세,1998,1013,491,522
'1120053000,  도선동,'30,25 - 29세,1998,1415,728,687
'1120053000,  도선동,'35,30 - 34세,1998,1140,608,532
'1120053000,  도선동,'40,35 - 39세,1998,997,550,447
'1120053000,  도선동,'45,40 - 44세,1998,806,395,411
'1120053000,  도선동,'50,45 - 49세,1998,610,289,321
'1120053000,  도선동,'55,50 - 54세,1998,581,264,317
'1120053000,  도선동,'60,55 - 59세,1998,651,305,346
'1120053000,  도선동,'65,60 - 64세,1998,453,213,240
'1120053000,  도선동,'70,65 - 69세,1998,255,114,141
'1120053000,  도선동,'75,70 - 74세,1998,160,65,95
'1120053000,  도선동,'80,75 - 79세,1998,118,56,62
'1120053000,  도선동,'85,80 - 84세,1998,62,15,47
'1120053000,  도선동,'90,85+ ,1998,38,10,28
'1120054000,  마장동,'00,계,1998,26466,13357,13109
'1120054000,  마장동,'05,0 - 4세,1998,1774,944,830
'1120054000,  마장동,'10,5 - 9세,1998,1781,916,865
'1120054000,  마장동,'15,10 - 14세,1998,1627,823,804
'1120054000,  마장동,'20,15 - 19세,1998,2162,1051,1111
'1120054000,  마장동,'25,20 - 24세,1998,2228,1108,1120
'1120054000,  마장동,'30,25 - 29세,1998,3079,1589,1490
'1120054000,  마장동,'35,30 - 34세,1998,2705,1445,1260
'1120054000,  마장동,'40,35 - 39세,1998,2562,1351,1211
'1120054000,  마장동,'45,40 - 44세,1998,2135,1074,1061
'1120054000,  마장동,'50,45 - 49세,1998,1544,811,733
'1120054000,  마장동,'55,50 - 54세,1998,1372,682,690
'1120054000,  마장동,'60,55 - 59세,1998,1288,627,661
'1120054000,  마장동,'65,60 - 64세,1998,924,435,489
'1120054000,  마장동,'70,65 - 69세,1998,547,257,290
'1120054000,  마장동,'75,70 - 74세,1998,320,116,204
'1120054000,  마장동,'80,75 - 79세,1998,231,78,153
'1120054000,  마장동,'85,80 - 84세,1998,120,37,83
'1120054000,  마장동,'90,85+ ,1998,67,13,54
'1120055000,  사근동,'00,계,1998,13569,6988,6581
'1120055000,  사근동,'05,0 - 4세,1998,812,424,388
'1120055000,  사근동,'10,5 - 9세,1998,759,409,350
'1120055000,  사근동,'15,10 - 14세,1998,774,381,393
'1120055000,  사근동,'20,15 - 19세,1998,1055,530,525
'1120055000,  사근동,'25,20 - 24세,1998,1474,770,704
'1120055000,  사근동,'30,25 - 29세,1998,1949,1124,825
'1120055000,  사근동,'35,30 - 34세,1998,1314,726,588
'1120055000,  사근동,'40,35 - 39세,1998,1103,583,520
'1120055000,  사근동,'45,40 - 44세,1998,941,475,466
'1120055000,  사근동,'50,45 - 49세,1998,729,360,369
'1120055000,  사근동,'55,50 - 54세,1998,734,327,407
'1120055000,  사근동,'60,55 - 59세,1998,785,389,396
'1120055000,  사근동,'65,60 - 64세,1998,500,259,241
'1120055000,  사근동,'70,65 - 69세,1998,275,116,159
'1120055000,  사근동,'75,70 - 74세,1998,155,56,99
'1120055000,  사근동,'80,75 - 79세,1998,112,32,80
'1120055000,  사근동,'85,80 - 84세,1998,60,16,44
'1120055000,  사근동,'90,85+ ,1998,38,11,27
'1120056000,  행당1동,'00,계,1998,16931,8447,8484
'1120056000,  행당1동,'05,0 - 4세,1998,976,503,473
'1120056000,  행당1동,'10,5 - 9세,1998,1027,555,472
'1120056000,  행당1동,'15,10 - 14세,1998,942,469,473
'1120056000,  행당1동,'20,15 - 19세,1998,1373,690,683
'1120056000,  행당1동,'25,20 - 24세,1998,1655,790,865
'1120056000,  행당1동,'30,25 - 29세,1998,2037,1097,940
'1120056000,  행당1동,'35,30 - 34세,1998,1558,827,731
'1120056000,  행당1동,'40,35 - 39세,1998,1552,818,734
'1120056000,  행당1동,'45,40 - 44세,1998,1305,646,659
'1120056000,  행당1동,'50,45 - 49세,1998,983,471,512
'1120056000,  행당1동,'55,50 - 54세,1998,938,456,482
'1120056000,  행당1동,'60,55 - 59세,1998,957,451,506
'1120056000,  행당1동,'65,60 - 64세,1998,665,316,349
'1120056000,  행당1동,'70,65 - 69세,1998,370,143,227
'1120056000,  행당1동,'75,70 - 74세,1998,259,97,162
'1120056000,  행당1동,'80,75 - 79세,1998,184,76,108
'1120056000,  행당1동,'85,80 - 84세,1998,91,28,63
'1120056000,  행당1동,'90,85+ ,1998,59,14,45
'1120057000,  행당2동,'00,계,1998,9150,4585,4565
'1120057000,  행당2동,'05,0 - 4세,1998,604,328,276
'1120057000,  행당2동,'10,5 - 9세,1998,582,306,276
'1120057000,  행당2동,'15,10 - 14세,1998,624,324,300
'1120057000,  행당2동,'20,15 - 19세,1998,740,377,363
'1120057000,  행당2동,'25,20 - 24세,1998,782,384,398
'1120057000,  행당2동,'30,25 - 29세,1998,970,491,479
'1120057000,  행당2동,'35,30 - 34세,1998,876,474,402
'1120057000,  행당2동,'40,35 - 39세,1998,892,448,444
'1120057000,  행당2동,'45,40 - 44세,1998,763,389,374
'1120057000,  행당2동,'50,45 - 49세,1998,532,265,267
'1120057000,  행당2동,'55,50 - 54세,1998,477,232,245
'1120057000,  행당2동,'60,55 - 59세,1998,475,235,240
'1120057000,  행당2동,'65,60 - 64세,1998,351,164,187
'1120057000,  행당2동,'70,65 - 69세,1998,197,82,115
'1120057000,  행당2동,'75,70 - 74세,1998,117,42,75
'1120057000,  행당2동,'80,75 - 79세,1998,100,28,72
'1120057000,  행당2동,'85,80 - 84세,1998,47,12,35
'1120057000,  행당2동,'90,85+ ,1998,21,4,17
'1120058000,  응봉동,'00,계,1998,14227,7025,7202
'1120058000,  응봉동,'05,0 - 4세,1998,1004,508,496
'1120058000,  응봉동,'10,5 - 9세,1998,936,492,444
'1120058000,  응봉동,'15,10 - 14세,1998,849,430,419
'1120058000,  응봉동,'20,15 - 19세,1998,1048,529,519
'1120058000,  응봉동,'25,20 - 24세,1998,987,510,477
'1120058000,  응봉동,'30,25 - 29세,1998,1634,803,831
'1120058000,  응봉동,'35,30 - 34세,1998,1395,710,685
'1120058000,  응봉동,'40,35 - 39세,1998,1384,698,686
'1120058000,  응봉동,'45,40 - 44세,1998,1139,582,557
'1120058000,  응봉동,'50,45 - 49세,1998,833,410,423
'1120058000,  응봉동,'55,50 - 54세,1998,739,350,389
'1120058000,  응봉동,'60,55 - 59세,1998,784,369,415
'1120058000,  응봉동,'65,60 - 64세,1998,610,292,318
'1120058000,  응봉동,'70,65 - 69세,1998,401,177,224
'1120058000,  응봉동,'75,70 - 74세,1998,213,86,127
'1120058000,  응봉동,'80,75 - 79세,1998,128,44,84
'1120058000,  응봉동,'85,80 - 84세,1998,90,28,62
'1120058000,  응봉동,'90,85+ ,1998,53,7,46
'1120059000,  금호1가동,'00,계,1998,11310,5697,5613
'1120059000,  금호1가동,'05,0 - 4세,1998,613,322,291
'1120059000,  금호1가동,'10,5 - 9세,1998,631,344,287
'1120059000,  금호1가동,'15,10 - 14세,1998,708,358,350
'1120059000,  금호1가동,'20,15 - 19세,1998,993,507,486
'1120059000,  금호1가동,'25,20 - 24세,1998,997,504,493
'1120059000,  금호1가동,'30,25 - 29세,1998,1265,666,599
'1120059000,  금호1가동,'35,30 - 34세,1998,970,505,465
'1120059000,  금호1가동,'40,35 - 39세,1998,1038,531,507
'1120059000,  금호1가동,'45,40 - 44세,1998,891,470,421
'1120059000,  금호1가동,'50,45 - 49세,1998,700,340,360
'1120059000,  금호1가동,'55,50 - 54세,1998,662,314,348
'1120059000,  금호1가동,'60,55 - 59세,1998,644,320,324
'1120059000,  금호1가동,'65,60 - 64세,1998,478,226,252
'1120059000,  금호1가동,'70,65 - 69세,1998,282,124,158
'1120059000,  금호1가동,'75,70 - 74세,1998,206,74,132
'1120059000,  금호1가동,'80,75 - 79세,1998,121,56,65
'1120059000,  금호1가동,'85,80 - 84세,1998,66,22,44
'1120059000,  금호1가동,'90,85+ ,1998,45,14,31
'1120060000,  금호2가동,'00,계,1998,14388,7208,7180
'1120060000,  금호2가동,'05,0 - 4세,1998,931,485,446
'1120060000,  금호2가동,'10,5 - 9세,1998,940,481,459
'1120060000,  금호2가동,'15,10 - 14세,1998,817,427,390
'1120060000,  금호2가동,'20,15 - 19세,1998,1138,579,559
'1120060000,  금호2가동,'25,20 - 24세,1998,1231,610,621
'1120060000,  금호2가동,'30,25 - 29세,1998,1726,874,852
'1120060000,  금호2가동,'35,30 - 34세,1998,1483,792,691
'1120060000,  금호2가동,'40,35 - 39세,1998,1356,718,638
'1120060000,  금호2가동,'45,40 - 44세,1998,1079,541,538
'1120060000,  금호2가동,'50,45 - 49세,1998,832,422,410
'1120060000,  금호2가동,'55,50 - 54세,1998,747,362,385
'1120060000,  금호2가동,'60,55 - 59세,1998,786,366,420
'1120060000,  금호2가동,'65,60 - 64세,1998,566,245,321
'1120060000,  금호2가동,'70,65 - 69세,1998,328,150,178
'1120060000,  금호2가동,'75,70 - 74세,1998,193,76,117
'1120060000,  금호2가동,'80,75 - 79세,1998,140,50,90
'1120060000,  금호2가동,'85,80 - 84세,1998,60,22,38
'1120060000,  금호2가동,'90,85+ ,1998,35,8,27
'1120061000,  금호3가동,'00,계,1998,18963,9497,9466
'1120061000,  금호3가동,'05,0 - 4세,1998,1259,654,605
'1120061000,  금호3가동,'10,5 - 9세,1998,1097,597,500
'1120061000,  금호3가동,'15,10 - 14세,1998,1086,545,541
'1120061000,  금호3가동,'20,15 - 19세,1998,1463,742,721
'1120061000,  금호3가동,'25,20 - 24세,1998,1607,782,825
'1120061000,  금호3가동,'30,25 - 29세,1998,2362,1247,1115
'1120061000,  금호3가동,'35,30 - 34세,1998,1858,995,863
'1120061000,  금호3가동,'40,35 - 39세,1998,1730,904,826
'1120061000,  금호3가동,'45,40 - 44세,1998,1476,740,736
'1120061000,  금호3가동,'50,45 - 49세,1998,1029,507,522
'1120061000,  금호3가동,'55,50 - 54세,1998,1040,488,552
'1120061000,  금호3가동,'60,55 - 59세,1998,1065,521,544
'1120061000,  금호3가동,'65,60 - 64세,1998,753,333,420
'1120061000,  금호3가동,'70,65 - 69세,1998,475,202,273
'1120061000,  금호3가동,'75,70 - 74세,1998,316,126,190
'1120061000,  금호3가동,'80,75 - 79세,1998,170,69,101
'1120061000,  금호3가동,'85,80 - 84세,1998,93,28,65
'1120061000,  금호3가동,'90,85+ ,1998,84,17,67
'1120062000,  금호4가동,'00,계,1998,12928,6504,6424
'1120062000,  금호4가동,'05,0 - 4세,1998,695,363,332
'1120062000,  금호4가동,'10,5 - 9세,1998,729,387,342
'1120062000,  금호4가동,'15,10 - 14세,1998,726,351,375
'1120062000,  금호4가동,'20,15 - 19세,1998,1058,565,493
'1120062000,  금호4가동,'25,20 - 24세,1998,1186,621,565
'1120062000,  금호4가동,'30,25 - 29세,1998,1581,844,737
'1120062000,  금호4가동,'35,30 - 34세,1998,1197,653,544
'1120062000,  금호4가동,'40,35 - 39세,1998,1156,565,591
'1120062000,  금호4가동,'45,40 - 44세,1998,959,504,455
'1120062000,  금호4가동,'50,45 - 49세,1998,732,345,387
'1120062000,  금호4가동,'55,50 - 54세,1998,776,350,426
'1120062000,  금호4가동,'60,55 - 59세,1998,787,393,394
'1120062000,  금호4가동,'65,60 - 64세,1998,579,249,330
'1120062000,  금호4가동,'70,65 - 69세,1998,334,157,177
'1120062000,  금호4가동,'75,70 - 74세,1998,187,79,108
'1120062000,  금호4가동,'80,75 - 79세,1998,139,47,92
'1120062000,  금호4가동,'85,80 - 84세,1998,65,23,42
'1120062000,  금호4가동,'90,85+ ,1998,42,8,34
'1120063000,  옥수1동,'00,계,1998,14717,7425,7292
'1120063000,  옥수1동,'05,0 - 4세,1998,861,455,406
'1120063000,  옥수1동,'10,5 - 9세,1998,864,450,414
'1120063000,  옥수1동,'15,10 - 14세,1998,777,380,397
'1120063000,  옥수1동,'20,15 - 19세,1998,1160,602,558
'1120063000,  옥수1동,'25,20 - 24세,1998,1463,708,755
'1120063000,  옥수1동,'30,25 - 29세,1998,2009,1086,923
'1120063000,  옥수1동,'35,30 - 34세,1998,1412,811,601
'1120063000,  옥수1동,'40,35 - 39세,1998,1241,623,618
'1120063000,  옥수1동,'45,40 - 44세,1998,1081,549,532
'1120063000,  옥수1동,'50,45 - 49세,1998,805,396,409
'1120063000,  옥수1동,'55,50 - 54세,1998,785,363,422
'1120063000,  옥수1동,'60,55 - 59세,1998,830,392,438
'1120063000,  옥수1동,'65,60 - 64세,1998,619,282,337
'1120063000,  옥수1동,'70,65 - 69세,1998,368,155,213
'1120063000,  옥수1동,'75,70 - 74세,1998,211,95,116
'1120063000,  옥수1동,'80,75 - 79세,1998,127,55,72
'1120063000,  옥수1동,'85,80 - 84세,1998,72,15,57
'1120063000,  옥수1동,'90,85+ ,1998,32,8,24
'1120064000,  옥수2동,'00,계,1998,14770,7091,7679
'1120064000,  옥수2동,'05,0 - 4세,1998,1057,531,526
'1120064000,  옥수2동,'10,5 - 9세,1998,985,479,506
'1120064000,  옥수2동,'15,10 - 14세,1998,790,404,386
'1120064000,  옥수2동,'20,15 - 19세,1998,950,462,488
'1120064000,  옥수2동,'25,20 - 24세,1998,1122,536,586
'1120064000,  옥수2동,'30,25 - 29세,1998,1696,798,898
'1120064000,  옥수2동,'35,30 - 34세,1998,1517,761,756
'1120064000,  옥수2동,'40,35 - 39세,1998,1469,705,764
'1120064000,  옥수2동,'45,40 - 44세,1998,1127,567,560
'1120064000,  옥수2동,'50,45 - 49세,1998,836,418,418
'1120064000,  옥수2동,'55,50 - 54세,1998,782,339,443
'1120064000,  옥수2동,'60,55 - 59세,1998,826,380,446
'1120064000,  옥수2동,'65,60 - 64세,1998,632,305,327
'1120064000,  옥수2동,'70,65 - 69세,1998,419,195,224
'1120064000,  옥수2동,'75,70 - 74세,1998,256,108,148
'1120064000,  옥수2동,'80,75 - 79세,1998,172,77,95
'1120064000,  옥수2동,'85,80 - 84세,1998,83,14,69
'1120064000,  옥수2동,'90,85+ ,1998,51,12,39
'1120065000,  성수1가1동,'00,계,1998,19465,10000,9465
'1120065000,  성수1가1동,'05,0 - 4세,1998,1522,784,738
'1120065000,  성수1가1동,'10,5 - 9세,1998,1546,841,705
'1120065000,  성수1가1동,'15,10 - 14세,1998,1197,607,590
'1120065000,  성수1가1동,'20,15 - 19세,1998,1455,735,720
'1120065000,  성수1가1동,'25,20 - 24세,1998,1612,789,823
'1120065000,  성수1가1동,'30,25 - 29세,1998,2295,1220,1075
'1120065000,  성수1가1동,'35,30 - 34세,1998,2172,1138,1034
'1120065000,  성수1가1동,'40,35 - 39세,1998,2162,1187,975
'1120065000,  성수1가1동,'45,40 - 44세,1998,1548,851,697
'1120065000,  성수1가1동,'50,45 - 49세,1998,971,491,480
'1120065000,  성수1가1동,'55,50 - 54세,1998,838,406,432
'1120065000,  성수1가1동,'60,55 - 59세,1998,778,394,384
'1120065000,  성수1가1동,'65,60 - 64세,1998,545,263,282
'1120065000,  성수1가1동,'70,65 - 69세,1998,336,146,190
'1120065000,  성수1가1동,'75,70 - 74세,1998,216,78,138
'1120065000,  성수1가1동,'80,75 - 79세,1998,129,35,94
'1120065000,  성수1가1동,'85,80 - 84세,1998,92,22,70
'1120065000,  성수1가1동,'90,85+ ,1998,51,13,38
'1120066000,  성수1가2동,'00,계,1998,20270,10348,9922
'1120066000,  성수1가2동,'05,0 - 4세,1998,1629,859,770
'1120066000,  성수1가2동,'10,5 - 9세,1998,1296,662,634
'1120066000,  성수1가2동,'15,10 - 14세,1998,1104,554,550
'1120066000,  성수1가2동,'20,15 - 19세,1998,1415,749,666
'1120066000,  성수1가2동,'25,20 - 24세,1998,1778,869,909
'1120066000,  성수1가2동,'30,25 - 29세,1998,2929,1460,1469
'1120066000,  성수1가2동,'35,30 - 34세,1998,2348,1336,1012
'1120066000,  성수1가2동,'40,35 - 39세,1998,1924,1028,896
'1120066000,  성수1가2동,'45,40 - 44세,1998,1514,793,721
'1120066000,  성수1가2동,'50,45 - 49세,1998,1021,513,508
'1120066000,  성수1가2동,'55,50 - 54세,1998,944,448,496
'1120066000,  성수1가2동,'60,55 - 59세,1998,935,477,458
'1120066000,  성수1가2동,'65,60 - 64세,1998,584,279,305
'1120066000,  성수1가2동,'70,65 - 69세,1998,346,147,199
'1120066000,  성수1가2동,'75,70 - 74세,1998,209,86,123
'1120066000,  성수1가2동,'80,75 - 79세,1998,142,54,88
'1120066000,  성수1가2동,'85,80 - 84세,1998,81,16,65
'1120066000,  성수1가2동,'90,85+ ,1998,71,18,53
'1120067000,  성수2가1동,'00,계,1998,23109,11939,11170
'1120067000,  성수2가1동,'05,0 - 4세,1998,1634,827,807
'1120067000,  성수2가1동,'10,5 - 9세,1998,1627,863,764
'1120067000,  성수2가1동,'15,10 - 14세,1998,1515,757,758
'1120067000,  성수2가1동,'20,15 - 19세,1998,1775,924,851
'1120067000,  성수2가1동,'25,20 - 24세,1998,2056,1019,1037
'1120067000,  성수2가1동,'30,25 - 29세,1998,2751,1496,1255
'1120067000,  성수2가1동,'35,30 - 34세,1998,2501,1359,1142
'1120067000,  성수2가1동,'40,35 - 39세,1998,2439,1352,1087
'1120067000,  성수2가1동,'45,40 - 44세,1998,1838,953,885
'1120067000,  성수2가1동,'50,45 - 49세,1998,1283,670,613
'1120067000,  성수2가1동,'55,50 - 54세,1998,1057,528,529
'1120067000,  성수2가1동,'60,55 - 59세,1998,1003,499,504
'1120067000,  성수2가1동,'65,60 - 64세,1998,691,338,353
'1120067000,  성수2가1동,'70,65 - 69세,1998,387,181,206
'1120067000,  성수2가1동,'75,70 - 74세,1998,227,81,146
'1120067000,  성수2가1동,'80,75 - 79세,1998,178,56,122
'1120067000,  성수2가1동,'85,80 - 84세,1998,98,29,69
'1120067000,  성수2가1동,'90,85+ ,1998,49,7,42
'1120069000,  성수2가3동,'00,계,1998,10800,5657,5143
'1120069000,  성수2가3동,'05,0 - 4세,1998,670,381,289
'1120069000,  성수2가3동,'10,5 - 9세,1998,640,332,308
'1120069000,  성수2가3동,'15,10 - 14세,1998,564,295,269
'1120069000,  성수2가3동,'20,15 - 19세,1998,824,438,386
'1120069000,  성수2가3동,'25,20 - 24세,1998,1038,494,544
'1120069000,  성수2가3동,'30,25 - 29세,1998,1444,816,628
'1120069000,  성수2가3동,'35,30 - 34세,1998,1121,636,485
'1120069000,  성수2가3동,'40,35 - 39세,1998,1064,591,473
'1120069000,  성수2가3동,'45,40 - 44세,1998,808,408,400
'1120069000,  성수2가3동,'50,45 - 49세,1998,620,300,320
'1120069000,  성수2가3동,'55,50 - 54세,1998,551,289,262
'1120069000,  성수2가3동,'60,55 - 59세,1998,553,271,282
'1120069000,  성수2가3동,'65,60 - 64세,1998,369,186,183
'1120069000,  성수2가3동,'70,65 - 69세,1998,231,105,126
'1120069000,  성수2가3동,'75,70 - 74세,1998,136,58,78
'1120069000,  성수2가3동,'80,75 - 79세,1998,94,32,62
'1120069000,  성수2가3동,'85,80 - 84세,1998,40,14,26
'1120069000,  성수2가3동,'90,85+ ,1998,33,11,22
'1120072000,  송정동,'00,계,1998,14698,7563,7135
'1120072000,  송정동,'05,0 - 4세,1998,1237,650,587
'1120072000,  송정동,'10,5 - 9세,1998,1019,522,497
'1120072000,  송정동,'15,10 - 14세,1998,745,408,337
'1120072000,  송정동,'20,15 - 19세,1998,1014,536,478
'1120072000,  송정동,'25,20 - 24세,1998,1433,659,774
'1120072000,  송정동,'30,25 - 29세,1998,2086,1059,1027
'1120072000,  송정동,'35,30 - 34세,1998,1810,998,812
'1120072000,  송정동,'40,35 - 39세,1998,1425,822,603
'1120072000,  송정동,'45,40 - 44세,1998,1071,550,521
'1120072000,  송정동,'50,45 - 49세,1998,714,351,363
'1120072000,  송정동,'55,50 - 54세,1998,629,315,314
'1120072000,  송정동,'60,55 - 59세,1998,549,275,274
'1120072000,  송정동,'65,60 - 64세,1998,409,198,211
'1120072000,  송정동,'70,65 - 69세,1998,228,92,136
'1120072000,  송정동,'75,70 - 74세,1998,171,73,98
'1120072000,  송정동,'80,75 - 79세,1998,87,36,51
'1120072000,  송정동,'85,80 - 84세,1998,40,9,31
'1120072000,  송정동,'90,85+ ,1998,31,10,21
'1120079000,  용답동,'00,계,1998,21656,11071,10585
'1120079000,  용답동,'05,0 - 4세,1998,1717,937,780
'1120079000,  용답동,'10,5 - 9세,1998,1460,769,691
'1120079000,  용답동,'15,10 - 14세,1998,1137,599,538
'1120079000,  용답동,'20,15 - 19세,1998,1599,802,797
'1120079000,  용답동,'25,20 - 24세,1998,2062,972,1090
'1120079000,  용답동,'30,25 - 29세,1998,2936,1505,1431
'1120079000,  용답동,'35,30 - 34세,1998,2541,1412,1129
'1120079000,  용답동,'40,35 - 39세,1998,1940,1054,886
'1120079000,  용답동,'45,40 - 44세,1998,1595,842,753
'1120079000,  용답동,'50,45 - 49세,1998,1064,510,554
'1120079000,  용답동,'55,50 - 54세,1998,1030,501,529
'1120079000,  용답동,'60,55 - 59세,1998,1023,509,514
'1120079000,  용답동,'65,60 - 64세,1998,703,333,370
'1120079000,  용답동,'70,65 - 69세,1998,384,172,212
'1120079000,  용답동,'75,70 - 74세,1998,211,82,129
'1120079000,  용답동,'80,75 - 79세,1998,136,49,87
'1120079000,  용답동,'85,80 - 84세,1998,70,14,56
'1120079000,  용답동,'90,85+ ,1998,48,9,39
'11215, 광진구,'00,계,1998,395921,199432,196489
'11215, 광진구,'05,0 - 4세,1998,28922,15008,13914
'11215, 광진구,'10,5 - 9세,1998,26114,13773,12341
'11215, 광진구,'15,10 - 14세,1998,24494,12996,11498
'11215, 광진구,'20,15 - 19세,1998,32211,16802,15409
'11215, 광진구,'25,20 - 24세,1998,35591,16857,18734
'11215, 광진구,'30,25 - 29세,1998,51430,25977,25453
'11215, 광진구,'35,30 - 34세,1998,41428,22122,19306
'11215, 광진구,'40,35 - 39세,1998,37368,19064,18304
'11215, 광진구,'45,40 - 44세,1998,32352,16004,16348
'11215, 광진구,'50,45 - 49세,1998,22865,11489,11376
'11215, 광진구,'55,50 - 54세,1998,18983,9315,9668
'11215, 광진구,'60,55 - 59세,1998,16596,8550,8046
'11215, 광진구,'65,60 - 64세,1998,10860,5360,5500
'11215, 광진구,'70,65 - 69세,1998,6561,2779,3782
'11215, 광진구,'75,70 - 74세,1998,4366,1574,2792
'11215, 광진구,'80,75 - 79세,1998,3076,1067,2009
'11215, 광진구,'85,80 - 84세,1998,1660,454,1206
'11215, 광진구,'90,85+ ,1998,1044,241,803
'1121571000,  화양동,'00,계,1998,26605,13338,13267
'1121571000,  화양동,'05,0 - 4세,1998,1837,929,908
'1121571000,  화양동,'10,5 - 9세,1998,1499,778,721
'1121571000,  화양동,'15,10 - 14세,1998,1186,650,536
'1121571000,  화양동,'20,15 - 19세,1998,1734,907,827
'1121571000,  화양동,'25,20 - 24세,1998,3062,1318,1744
'1121571000,  화양동,'30,25 - 29세,1998,4855,2585,2270
'1121571000,  화양동,'35,30 - 34세,1998,2968,1648,1320
'1121571000,  화양동,'40,35 - 39세,1998,2293,1235,1058
'1121571000,  화양동,'45,40 - 44세,1998,1774,842,932
'1121571000,  화양동,'50,45 - 49세,1998,1303,599,704
'1121571000,  화양동,'55,50 - 54세,1998,1172,559,613
'1121571000,  화양동,'60,55 - 59세,1998,1094,507,587
'1121571000,  화양동,'65,60 - 64세,1998,811,386,425
'1121571000,  화양동,'70,65 - 69세,1998,424,204,220
'1121571000,  화양동,'75,70 - 74세,1998,268,96,172
'1121571000,  화양동,'80,75 - 79세,1998,158,55,103
'1121571000,  화양동,'85,80 - 84세,1998,111,25,86
'1121571000,  화양동,'90,85+ ,1998,56,15,41
'1121573000,  군자동,'00,계,1998,25762,13102,12660
'1121573000,  군자동,'05,0 - 4세,1998,1945,1023,922
'1121573000,  군자동,'10,5 - 9세,1998,1623,891,732
'1121573000,  군자동,'15,10 - 14세,1998,1489,793,696
'1121573000,  군자동,'20,15 - 19세,1998,1979,1066,913
'1121573000,  군자동,'25,20 - 24세,1998,2442,1111,1331
'1121573000,  군자동,'30,25 - 29세,1998,3564,1821,1743
'1121573000,  군자동,'35,30 - 34세,1998,2823,1548,1275
'1121573000,  군자동,'40,35 - 39세,1998,2368,1249,1119
'1121573000,  군자동,'45,40 - 44세,1998,1961,951,1010
'1121573000,  군자동,'50,45 - 49세,1998,1380,689,691
'1121573000,  군자동,'55,50 - 54세,1998,1216,577,639
'1121573000,  군자동,'60,55 - 59세,1998,1212,605,607
'1121573000,  군자동,'65,60 - 64세,1998,730,378,352
'1121573000,  군자동,'70,65 - 69세,1998,418,196,222
'1121573000,  군자동,'75,70 - 74세,1998,251,83,168
'1121573000,  군자동,'80,75 - 79세,1998,183,74,109
'1121573000,  군자동,'85,80 - 84세,1998,116,33,83
'1121573000,  군자동,'90,85+ ,1998,62,14,48
'1121574000,  중곡1동,'00,계,1998,18833,9600,9233
'1121574000,  중곡1동,'05,0 - 4세,1998,1568,802,766
'1121574000,  중곡1동,'10,5 - 9세,1998,1295,693,602
'1121574000,  중곡1동,'15,10 - 14세,1998,1078,582,496
'1121574000,  중곡1동,'20,15 - 19세,1998,1291,698,593
'1121574000,  중곡1동,'25,20 - 24세,1998,1701,812,889
'1121574000,  중곡1동,'30,25 - 29세,1998,2585,1299,1286
'1121574000,  중곡1동,'35,30 - 34세,1998,2184,1206,978
'1121574000,  중곡1동,'40,35 - 39세,1998,1750,928,822
'1121574000,  중곡1동,'45,40 - 44세,1998,1366,715,651
'1121574000,  중곡1동,'50,45 - 49세,1998,972,453,519
'1121574000,  중곡1동,'55,50 - 54세,1998,876,441,435
'1121574000,  중곡1동,'60,55 - 59세,1998,801,392,409
'1121574000,  중곡1동,'65,60 - 64세,1998,529,277,252
'1121574000,  중곡1동,'70,65 - 69세,1998,341,142,199
'1121574000,  중곡1동,'75,70 - 74세,1998,230,84,146
'1121574000,  중곡1동,'80,75 - 79세,1998,147,48,99
'1121574000,  중곡1동,'85,80 - 84세,1998,63,15,48
'1121574000,  중곡1동,'90,85+ ,1998,56,13,43
'1121575000,  중곡2동,'00,계,1998,23867,12028,11839
'1121575000,  중곡2동,'05,0 - 4세,1998,1719,910,809
'1121575000,  중곡2동,'10,5 - 9세,1998,1639,852,787
'1121575000,  중곡2동,'15,10 - 14세,1998,1467,806,661
'1121575000,  중곡2동,'20,15 - 19세,1998,1976,1032,944
'1121575000,  중곡2동,'25,20 - 24세,1998,2195,1077,1118
'1121575000,  중곡2동,'30,25 - 29세,1998,3006,1497,1509
'1121575000,  중곡2동,'35,30 - 34세,1998,2442,1269,1173
'1121575000,  중곡2동,'40,35 - 39세,1998,2212,1131,1081
'1121575000,  중곡2동,'45,40 - 44세,1998,1770,855,915
'1121575000,  중곡2동,'50,45 - 49세,1998,1395,686,709
'1121575000,  중곡2동,'55,50 - 54세,1998,1256,580,676
'1121575000,  중곡2동,'60,55 - 59세,1998,1106,605,501
'1121575000,  중곡2동,'65,60 - 64세,1998,686,345,341
'1121575000,  중곡2동,'70,65 - 69세,1998,382,178,204
'1121575000,  중곡2동,'75,70 - 74세,1998,234,81,153
'1121575000,  중곡2동,'80,75 - 79세,1998,211,80,131
'1121575000,  중곡2동,'85,80 - 84세,1998,99,27,72
'1121575000,  중곡2동,'90,85+ ,1998,72,17,55
'1121576000,  중곡3동,'00,계,1998,23066,11671,11395
'1121576000,  중곡3동,'05,0 - 4세,1998,1679,842,837
'1121576000,  중곡3동,'10,5 - 9세,1998,1567,848,719
'1121576000,  중곡3동,'15,10 - 14세,1998,1358,711,647
'1121576000,  중곡3동,'20,15 - 19세,1998,2034,1045,989
'1121576000,  중곡3동,'25,20 - 24세,1998,2186,1088,1098
'1121576000,  중곡3동,'30,25 - 29세,1998,2827,1454,1373
'1121576000,  중곡3동,'35,30 - 34세,1998,2412,1282,1130
'1121576000,  중곡3동,'40,35 - 39세,1998,2145,1114,1031
'1121576000,  중곡3동,'45,40 - 44세,1998,1792,877,915
'1121576000,  중곡3동,'50,45 - 49세,1998,1343,648,695
'1121576000,  중곡3동,'55,50 - 54세,1998,1192,582,610
'1121576000,  중곡3동,'60,55 - 59세,1998,1016,561,455
'1121576000,  중곡3동,'65,60 - 64세,1998,592,295,297
'1121576000,  중곡3동,'70,65 - 69세,1998,354,146,208
'1121576000,  중곡3동,'75,70 - 74세,1998,237,89,148
'1121576000,  중곡3동,'80,75 - 79세,1998,164,51,113
'1121576000,  중곡3동,'85,80 - 84세,1998,101,23,78
'1121576000,  중곡3동,'90,85+ ,1998,67,15,52
'1121577000,  중곡4동,'00,계,1998,33025,16558,16467
'1121577000,  중곡4동,'05,0 - 4세,1998,2125,1107,1018
'1121577000,  중곡4동,'10,5 - 9세,1998,1925,1016,909
'1121577000,  중곡4동,'15,10 - 14세,1998,2303,1174,1129
'1121577000,  중곡4동,'20,15 - 19세,1998,3293,1716,1577
'1121577000,  중곡4동,'25,20 - 24세,1998,3033,1536,1497
'1121577000,  중곡4동,'30,25 - 29세,1998,3771,1936,1835
'1121577000,  중곡4동,'35,30 - 34세,1998,2996,1578,1418
'1121577000,  중곡4동,'40,35 - 39세,1998,2848,1434,1414
'1121577000,  중곡4동,'45,40 - 44세,1998,2948,1332,1616
'1121577000,  중곡4동,'50,45 - 49세,1998,2225,1114,1111
'1121577000,  중곡4동,'55,50 - 54세,1998,1814,914,900
'1121577000,  중곡4동,'60,55 - 59세,1998,1492,818,674
'1121577000,  중곡4동,'65,60 - 64세,1998,820,402,418
'1121577000,  중곡4동,'70,65 - 69세,1998,517,207,310
'1121577000,  중곡4동,'75,70 - 74세,1998,364,126,238
'1121577000,  중곡4동,'80,75 - 79세,1998,296,87,209
'1121577000,  중곡4동,'85,80 - 84세,1998,156,39,117
'1121577000,  중곡4동,'90,85+ ,1998,99,22,77
'1121578000,  능동,'00,계,1998,11728,5866,5862
'1121578000,  능동,'05,0 - 4세,1998,934,456,478
'1121578000,  능동,'10,5 - 9세,1998,632,319,313
'1121578000,  능동,'15,10 - 14세,1998,547,297,250
'1121578000,  능동,'20,15 - 19세,1998,853,471,382
'1121578000,  능동,'25,20 - 24세,1998,1113,521,592
'1121578000,  능동,'30,25 - 29세,1998,1849,925,924
'1121578000,  능동,'35,30 - 34세,1998,1317,716,601
'1121578000,  능동,'40,35 - 39세,1998,951,517,434
'1121578000,  능동,'45,40 - 44세,1998,796,382,414
'1121578000,  능동,'50,45 - 49세,1998,612,287,325
'1121578000,  능동,'55,50 - 54세,1998,606,269,337
'1121578000,  능동,'60,55 - 59세,1998,589,307,282
'1121578000,  능동,'65,60 - 64세,1998,381,195,186
'1121578000,  능동,'70,65 - 69세,1998,197,81,116
'1121578000,  능동,'75,70 - 74세,1998,141,55,86
'1121578000,  능동,'80,75 - 79세,1998,117,45,72
'1121578000,  능동,'85,80 - 84세,1998,56,12,44
'1121578000,  능동,'90,85+ ,1998,37,11,26
'1121581000,  광장동,'00,계,1998,30579,15171,15408
'1121581000,  광장동,'05,0 - 4세,1998,2165,1161,1004
'1121581000,  광장동,'10,5 - 9세,1998,2548,1334,1214
'1121581000,  광장동,'15,10 - 14세,1998,2855,1527,1328
'1121581000,  광장동,'20,15 - 19세,1998,2715,1397,1318
'1121581000,  광장동,'25,20 - 24세,1998,1638,791,847
'1121581000,  광장동,'30,25 - 29세,1998,2558,1151,1407
'1121581000,  광장동,'35,30 - 34세,1998,2933,1404,1529
'1121581000,  광장동,'40,35 - 39세,1998,3369,1559,1810
'1121581000,  광장동,'45,40 - 44세,1998,3414,1691,1723
'1121581000,  광장동,'50,45 - 49세,1998,2027,1157,870
'1121581000,  광장동,'55,50 - 54세,1998,1142,617,525
'1121581000,  광장동,'60,55 - 59세,1998,954,478,476
'1121581000,  광장동,'65,60 - 64세,1998,740,362,378
'1121581000,  광장동,'70,65 - 69세,1998,527,202,325
'1121581000,  광장동,'75,70 - 74세,1998,448,170,278
'1121581000,  광장동,'80,75 - 79세,1998,284,105,179
'1121581000,  광장동,'85,80 - 84세,1998,163,41,122
'1121581000,  광장동,'90,85+ ,1998,99,24,75
'1121582000,  자양1동,'00,계,1998,28050,14268,13782
'1121582000,  자양1동,'05,0 - 4세,1998,2190,1131,1059
'1121582000,  자양1동,'10,5 - 9세,1998,1707,906,801
'1121582000,  자양1동,'15,10 - 14세,1998,1487,824,663
'1121582000,  자양1동,'20,15 - 19세,1998,2204,1141,1063
'1121582000,  자양1동,'25,20 - 24세,1998,2697,1267,1430
'1121582000,  자양1동,'30,25 - 29세,1998,4035,2047,1988
'1121582000,  자양1동,'35,30 - 34세,1998,3079,1698,1381
'1121582000,  자양1동,'40,35 - 39세,1998,2533,1328,1205
'1121582000,  자양1동,'45,40 - 44세,1998,2080,1047,1033
'1121582000,  자양1동,'50,45 - 49세,1998,1507,759,748
'1121582000,  자양1동,'55,50 - 54세,1998,1377,663,714
'1121582000,  자양1동,'60,55 - 59세,1998,1243,652,591
'1121582000,  자양1동,'65,60 - 64세,1998,777,369,408
'1121582000,  자양1동,'70,65 - 69세,1998,460,211,249
'1121582000,  자양1동,'75,70 - 74세,1998,284,109,175
'1121582000,  자양1동,'80,75 - 79세,1998,199,67,132
'1121582000,  자양1동,'85,80 - 84세,1998,122,36,86
'1121582000,  자양1동,'90,85+ ,1998,69,13,56
'1121583000,  자양2동,'00,계,1998,30677,15392,15285
'1121583000,  자양2동,'05,0 - 4세,1998,2171,1125,1046
'1121583000,  자양2동,'10,5 - 9세,1998,2112,1060,1052
'1121583000,  자양2동,'15,10 - 14세,1998,2057,1085,972
'1121583000,  자양2동,'20,15 - 19세,1998,2749,1405,1344
'1121583000,  자양2동,'25,20 - 24세,1998,2682,1299,1383
'1121583000,  자양2동,'30,25 - 29세,1998,3457,1762,1695
'1121583000,  자양2동,'35,30 - 34세,1998,2960,1565,1395
'1121583000,  자양2동,'40,35 - 39세,1998,2979,1459,1520
'1121583000,  자양2동,'45,40 - 44세,1998,2729,1341,1388
'1121583000,  자양2동,'50,45 - 49세,1998,1861,970,891
'1121583000,  자양2동,'55,50 - 54세,1998,1537,767,770
'1121583000,  자양2동,'60,55 - 59세,1998,1241,669,572
'1121583000,  자양2동,'65,60 - 64세,1998,780,377,403
'1121583000,  자양2동,'70,65 - 69세,1998,520,216,304
'1121583000,  자양2동,'75,70 - 74세,1998,389,143,246
'1121583000,  자양2동,'80,75 - 79세,1998,245,96,149
'1121583000,  자양2동,'85,80 - 84세,1998,127,39,88
'1121583000,  자양2동,'90,85+ ,1998,81,14,67
'1121584000,  자양3동,'00,계,1998,30853,15611,15242
'1121584000,  자양3동,'05,0 - 4세,1998,2043,1081,962
'1121584000,  자양3동,'10,5 - 9세,1998,2371,1258,1113
'1121584000,  자양3동,'15,10 - 14세,1998,2383,1249,1134
'1121584000,  자양3동,'20,15 - 19세,1998,2658,1369,1289
'1121584000,  자양3동,'25,20 - 24세,1998,2415,1193,1222
'1121584000,  자양3동,'30,25 - 29세,1998,3389,1740,1649
'1121584000,  자양3동,'35,30 - 34세,1998,3075,1547,1528
'1121584000,  자양3동,'40,35 - 39세,1998,3439,1664,1775
'1121584000,  자양3동,'45,40 - 44세,1998,2984,1582,1402
'1121584000,  자양3동,'50,45 - 49세,1998,1782,956,826
'1121584000,  자양3동,'55,50 - 54세,1998,1329,681,648
'1121584000,  자양3동,'60,55 - 59세,1998,1027,540,487
'1121584000,  자양3동,'65,60 - 64세,1998,729,338,391
'1121584000,  자양3동,'70,65 - 69세,1998,507,187,320
'1121584000,  자양3동,'75,70 - 74세,1998,309,114,195
'1121584000,  자양3동,'80,75 - 79세,1998,234,67,167
'1121584000,  자양3동,'85,80 - 84세,1998,116,32,84
'1121584000,  자양3동,'90,85+ ,1998,63,13,50
'1121584500,  노유1동,'00,계,1998,14819,7580,7239
'1121584500,  노유1동,'05,0 - 4세,1998,1081,567,514
'1121584500,  노유1동,'10,5 - 9세,1998,859,458,401
'1121584500,  노유1동,'15,10 - 14세,1998,725,388,337
'1121584500,  노유1동,'20,15 - 19세,1998,1112,582,530
'1121584500,  노유1동,'25,20 - 24세,1998,1560,676,884
'1121584500,  노유1동,'30,25 - 29세,1998,2327,1236,1091
'1121584500,  노유1동,'35,30 - 34세,1998,1671,956,715
'1121584500,  노유1동,'40,35 - 39세,1998,1318,729,589
'1121584500,  노유1동,'45,40 - 44세,1998,1100,556,544
'1121584500,  노유1동,'50,45 - 49세,1998,728,369,359
'1121584500,  노유1동,'55,50 - 54세,1998,682,332,350
'1121584500,  노유1동,'60,55 - 59세,1998,637,295,342
'1121584500,  노유1동,'65,60 - 64세,1998,470,227,243
'1121584500,  노유1동,'70,65 - 69세,1998,264,113,151
'1121584500,  노유1동,'75,70 - 74세,1998,125,45,80
'1121584500,  노유1동,'80,75 - 79세,1998,90,22,68
'1121584500,  노유1동,'85,80 - 84세,1998,49,20,29
'1121584500,  노유1동,'90,85+ ,1998,21,9,12
'1121584600,  노유2동,'00,계,1998,18384,9491,8893
'1121584600,  노유2동,'05,0 - 4세,1998,1217,620,597
'1121584600,  노유2동,'10,5 - 9세,1998,1266,675,591
'1121584600,  노유2동,'15,10 - 14세,1998,1136,604,532
'1121584600,  노유2동,'20,15 - 19세,1998,1580,822,758
'1121584600,  노유2동,'25,20 - 24세,1998,1688,855,833
'1121584600,  노유2동,'30,25 - 29세,1998,2242,1211,1031
'1121584600,  노유2동,'35,30 - 34세,1998,1873,1016,857
'1121584600,  노유2동,'40,35 - 39세,1998,1893,1007,886
'1121584600,  노유2동,'45,40 - 44세,1998,1501,788,713
'1121584600,  노유2동,'50,45 - 49세,1998,1110,565,545
'1121584600,  노유2동,'55,50 - 54세,1998,889,447,442
'1121584600,  노유2동,'60,55 - 59세,1998,770,385,385
'1121584600,  노유2동,'65,60 - 64세,1998,502,251,251
'1121584600,  노유2동,'70,65 - 69세,1998,279,103,176
'1121584600,  노유2동,'75,70 - 74세,1998,214,77,137
'1121584600,  노유2동,'80,75 - 79세,1998,119,35,84
'1121584600,  노유2동,'85,80 - 84세,1998,71,19,52
'1121584600,  노유2동,'90,85+ ,1998,34,11,23
'1121585000,  구의1동,'00,계,1998,24964,12352,12612
'1121585000,  구의1동,'05,0 - 4세,1998,2135,1140,995
'1121585000,  구의1동,'10,5 - 9세,1998,1436,774,662
'1121585000,  구의1동,'15,10 - 14세,1998,1144,569,575
'1121585000,  구의1동,'20,15 - 19세,1998,1713,901,812
'1121585000,  구의1동,'25,20 - 24세,1998,2435,1022,1413
'1121585000,  구의1동,'30,25 - 29세,1998,4147,1961,2186
'1121585000,  구의1동,'35,30 - 34세,1998,3048,1694,1354
'1121585000,  구의1동,'40,35 - 39세,1998,2139,1116,1023
'1121585000,  구의1동,'45,40 - 44세,1998,1663,806,857
'1121585000,  구의1동,'50,45 - 49세,1998,1255,588,667
'1121585000,  구의1동,'55,50 - 54세,1998,1079,478,601
'1121585000,  구의1동,'60,55 - 59세,1998,1086,563,523
'1121585000,  구의1동,'65,60 - 64세,1998,706,367,339
'1121585000,  구의1동,'70,65 - 69세,1998,422,189,233
'1121585000,  구의1동,'75,70 - 74세,1998,224,74,150
'1121585000,  구의1동,'80,75 - 79세,1998,176,67,109
'1121585000,  구의1동,'85,80 - 84세,1998,86,27,59
'1121585000,  구의1동,'90,85+ ,1998,70,16,54
'1121586000,  구의2동,'00,계,1998,25965,13054,12911
'1121586000,  구의2동,'05,0 - 4세,1998,1965,1018,947
'1121586000,  구의2동,'10,5 - 9세,1998,1600,868,732
'1121586000,  구의2동,'15,10 - 14세,1998,1467,765,702
'1121586000,  구의2동,'20,15 - 19세,1998,2077,1077,1000
'1121586000,  구의2동,'25,20 - 24세,1998,2288,1130,1158
'1121586000,  구의2동,'30,25 - 29세,1998,3331,1636,1695
'1121586000,  구의2동,'35,30 - 34세,1998,2745,1503,1242
'1121586000,  구의2동,'40,35 - 39세,1998,2382,1239,1143
'1121586000,  구의2동,'45,40 - 44세,1998,1953,956,997
'1121586000,  구의2동,'50,45 - 49세,1998,1571,757,814
'1121586000,  구의2동,'55,50 - 54세,1998,1359,660,699
'1121586000,  구의2동,'60,55 - 59세,1998,1147,570,577
'1121586000,  구의2동,'65,60 - 64세,1998,832,402,430
'1121586000,  구의2동,'70,65 - 69세,1998,487,208,279
'1121586000,  구의2동,'75,70 - 74세,1998,337,115,222
'1121586000,  구의2동,'80,75 - 79세,1998,224,92,132
'1121586000,  구의2동,'85,80 - 84세,1998,122,45,77
'1121586000,  구의2동,'90,85+ ,1998,78,13,65
'1121587000,  구의3동,'00,계,1998,28744,14350,14394
'1121587000,  구의3동,'05,0 - 4세,1998,2148,1096,1052
'1121587000,  구의3동,'10,5 - 9세,1998,2035,1043,992
'1121587000,  구의3동,'15,10 - 14세,1998,1812,972,840
'1121587000,  구의3동,'20,15 - 19세,1998,2243,1173,1070
'1121587000,  구의3동,'25,20 - 24세,1998,2456,1161,1295
'1121587000,  구의3동,'30,25 - 29세,1998,3487,1716,1771
'1121587000,  구의3동,'35,30 - 34세,1998,2902,1492,1410
'1121587000,  구의3동,'40,35 - 39세,1998,2749,1355,1394
'1121587000,  구의3동,'45,40 - 44세,1998,2521,1283,1238
'1121587000,  구의3동,'50,45 - 49세,1998,1794,892,902
'1121587000,  구의3동,'55,50 - 54세,1998,1457,748,709
'1121587000,  구의3동,'60,55 - 59세,1998,1181,603,578
'1121587000,  구의3동,'65,60 - 64세,1998,775,389,386
'1121587000,  구의3동,'70,65 - 69세,1998,462,196,266
'1121587000,  구의3동,'75,70 - 74세,1998,311,113,198
'1121587000,  구의3동,'80,75 - 79세,1998,229,76,153
'1121587000,  구의3동,'85,80 - 84세,1998,102,21,81
'1121587000,  구의3동,'90,85+ ,1998,80,21,59
'11230, 동대문구,'00,계,1998,377724,191437,186287
'11230, 동대문구,'05,0 - 4세,1998,22210,11564,10646
'11230, 동대문구,'10,5 - 9세,1998,21825,11646,10179
'11230, 동대문구,'15,10 - 14세,1998,21563,11351,10212
'11230, 동대문구,'20,15 - 19세,1998,31159,16059,15100
'11230, 동대문구,'25,20 - 24세,1998,36376,18162,18214
'11230, 동대문구,'30,25 - 29세,1998,46712,25406,21306
'11230, 동대문구,'35,30 - 34세,1998,34909,18849,16060
'11230, 동대문구,'40,35 - 39세,1998,32795,16913,15882
'11230, 동대문구,'45,40 - 44세,1998,29617,14728,14889
'11230, 동대문구,'50,45 - 49세,1998,22756,11118,11638
'11230, 동대문구,'55,50 - 54세,1998,21331,10117,11214
'11230, 동대문구,'60,55 - 59세,1998,21011,10315,10696
'11230, 동대문구,'65,60 - 64세,1998,14607,7116,7491
'11230, 동대문구,'70,65 - 69세,1998,8660,3837,4823
'11230, 동대문구,'75,70 - 74세,1998,5438,2088,3350
'11230, 동대문구,'80,75 - 79세,1998,3763,1341,2422
'11230, 동대문구,'85,80 - 84세,1998,1896,562,1334
'11230, 동대문구,'90,85+ ,1998,1096,265,831
'1123051000,  신설동,'00,계,1998,9673,4920,4753
'1123051000,  신설동,'05,0 - 4세,1998,606,304,302
'1123051000,  신설동,'10,5 - 9세,1998,576,305,271
'1123051000,  신설동,'15,10 - 14세,1998,595,318,277
'1123051000,  신설동,'20,15 - 19세,1998,781,411,370
'1123051000,  신설동,'25,20 - 24세,1998,824,432,392
'1123051000,  신설동,'30,25 - 29세,1998,1096,573,523
'1123051000,  신설동,'35,30 - 34세,1998,917,498,419
'1123051000,  신설동,'40,35 - 39세,1998,959,476,483
'1123051000,  신설동,'45,40 - 44세,1998,742,404,338
'1123051000,  신설동,'50,45 - 49세,1998,591,286,305
'1123051000,  신설동,'55,50 - 54세,1998,509,248,261
'1123051000,  신설동,'60,55 - 59세,1998,507,260,247
'1123051000,  신설동,'65,60 - 64세,1998,398,191,207
'1123051000,  신설동,'70,65 - 69세,1998,238,94,144
'1123051000,  신설동,'75,70 - 74세,1998,145,55,90
'1123051000,  신설동,'80,75 - 79세,1998,121,46,75
'1123051000,  신설동,'85,80 - 84세,1998,42,11,31
'1123051000,  신설동,'90,85+ ,1998,26,8,18
'1123052000,  용두1동,'00,계,1998,15356,7833,7523
'1123052000,  용두1동,'05,0 - 4세,1998,720,373,347
'1123052000,  용두1동,'10,5 - 9세,1998,831,426,405
'1123052000,  용두1동,'15,10 - 14세,1998,737,369,368
'1123052000,  용두1동,'20,15 - 19세,1998,1207,609,598
'1123052000,  용두1동,'25,20 - 24세,1998,1431,780,651
'1123052000,  용두1동,'30,25 - 29세,1998,1706,970,736
'1123052000,  용두1동,'35,30 - 34세,1998,1332,761,571
'1123052000,  용두1동,'40,35 - 39세,1998,1285,674,611
'1123052000,  용두1동,'45,40 - 44세,1998,1220,633,587
'1123052000,  용두1동,'50,45 - 49세,1998,994,497,497
'1123052000,  용두1동,'55,50 - 54세,1998,1029,493,536
'1123052000,  용두1동,'60,55 - 59세,1998,1048,483,565
'1123052000,  용두1동,'65,60 - 64세,1998,807,386,421
'1123052000,  용두1동,'70,65 - 69세,1998,447,191,256
'1123052000,  용두1동,'75,70 - 74세,1998,259,98,161
'1123052000,  용두1동,'80,75 - 79세,1998,177,62,115
'1123052000,  용두1동,'85,80 - 84세,1998,75,18,57
'1123052000,  용두1동,'90,85+ ,1998,51,10,41
'1123053000,  용두2동,'00,계,1998,11438,5892,5546
'1123053000,  용두2동,'05,0 - 4세,1998,616,323,293
'1123053000,  용두2동,'10,5 - 9세,1998,618,337,281
'1123053000,  용두2동,'15,10 - 14세,1998,639,370,269
'1123053000,  용두2동,'20,15 - 19세,1998,931,512,419
'1123053000,  용두2동,'25,20 - 24세,1998,1097,537,560
'1123053000,  용두2동,'30,25 - 29세,1998,1405,779,626
'1123053000,  용두2동,'35,30 - 34세,1998,1074,602,472
'1123053000,  용두2동,'40,35 - 39세,1998,943,489,454
'1123053000,  용두2동,'45,40 - 44세,1998,869,445,424
'1123053000,  용두2동,'50,45 - 49세,1998,660,326,334
'1123053000,  용두2동,'55,50 - 54세,1998,712,336,376
'1123053000,  용두2동,'60,55 - 59세,1998,660,316,344
'1123053000,  용두2동,'65,60 - 64세,1998,501,241,260
'1123053000,  용두2동,'70,65 - 69세,1998,286,128,158
'1123053000,  용두2동,'75,70 - 74세,1998,187,75,112
'1123053000,  용두2동,'80,75 - 79세,1998,141,49,92
'1123053000,  용두2동,'85,80 - 84세,1998,55,17,38
'1123053000,  용두2동,'90,85+ ,1998,44,10,34
'1123054000,  제기1동,'00,계,1998,12532,6375,6157
'1123054000,  제기1동,'05,0 - 4세,1998,561,280,281
'1123054000,  제기1동,'10,5 - 9세,1998,671,373,298
'1123054000,  제기1동,'15,10 - 14세,1998,640,332,308
'1123054000,  제기1동,'20,15 - 19세,1998,1089,538,551
'1123054000,  제기1동,'25,20 - 24세,1998,1265,677,588
'1123054000,  제기1동,'30,25 - 29세,1998,1325,774,551
'1123054000,  제기1동,'35,30 - 34세,1998,961,522,439
'1123054000,  제기1동,'40,35 - 39세,1998,983,530,453
'1123054000,  제기1동,'45,40 - 44세,1998,1003,476,527
'1123054000,  제기1동,'50,45 - 49세,1998,824,397,427
'1123054000,  제기1동,'55,50 - 54세,1998,862,413,449
'1123054000,  제기1동,'60,55 - 59세,1998,899,429,470
'1123054000,  제기1동,'65,60 - 64세,1998,603,301,302
'1123054000,  제기1동,'70,65 - 69세,1998,351,152,199
'1123054000,  제기1동,'75,70 - 74세,1998,224,91,133
'1123054000,  제기1동,'80,75 - 79세,1998,153,56,97
'1123054000,  제기1동,'85,80 - 84세,1998,76,24,52
'1123054000,  제기1동,'90,85+ ,1998,42,10,32
'1123055000,  제기2동,'00,계,1998,13925,7167,6758
'1123055000,  제기2동,'05,0 - 4세,1998,692,364,328
'1123055000,  제기2동,'10,5 - 9세,1998,694,353,341
'1123055000,  제기2동,'15,10 - 14세,1998,687,388,299
'1123055000,  제기2동,'20,15 - 19세,1998,1022,561,461
'1123055000,  제기2동,'25,20 - 24세,1998,1439,745,694
'1123055000,  제기2동,'30,25 - 29세,1998,1851,1120,731
'1123055000,  제기2동,'35,30 - 34세,1998,1193,676,517
'1123055000,  제기2동,'40,35 - 39세,1998,1097,573,524
'1123055000,  제기2동,'45,40 - 44세,1998,1025,487,538
'1123055000,  제기2동,'50,45 - 49세,1998,795,366,429
'1123055000,  제기2동,'55,50 - 54세,1998,840,370,470
'1123055000,  제기2동,'60,55 - 59세,1998,899,445,454
'1123055000,  제기2동,'65,60 - 64세,1998,619,297,322
'1123055000,  제기2동,'70,65 - 69세,1998,466,190,276
'1123055000,  제기2동,'75,70 - 74세,1998,292,122,170
'1123055000,  제기2동,'80,75 - 79세,1998,168,68,100
'1123055000,  제기2동,'85,80 - 84세,1998,94,26,68
'1123055000,  제기2동,'90,85+ ,1998,52,16,36
'1123056000,  전농1동,'00,계,1998,17111,8809,8302
'1123056000,  전농1동,'05,0 - 4세,1998,1163,612,551
'1123056000,  전농1동,'10,5 - 9세,1998,1008,526,482
'1123056000,  전농1동,'15,10 - 14세,1998,887,485,402
'1123056000,  전농1동,'20,15 - 19세,1998,1362,692,670
'1123056000,  전농1동,'25,20 - 24세,1998,1520,784,736
'1123056000,  전농1동,'30,25 - 29세,1998,2018,1119,899
'1123056000,  전농1동,'35,30 - 34세,1998,1623,885,738
'1123056000,  전농1동,'40,35 - 39세,1998,1504,829,675
'1123056000,  전농1동,'45,40 - 44세,1998,1295,693,602
'1123056000,  전농1동,'50,45 - 49세,1998,1038,508,530
'1123056000,  전농1동,'55,50 - 54세,1998,952,456,496
'1123056000,  전농1동,'60,55 - 59세,1998,1003,484,519
'1123056000,  전농1동,'65,60 - 64세,1998,720,348,372
'1123056000,  전농1동,'70,65 - 69세,1998,410,180,230
'1123056000,  전농1동,'75,70 - 74세,1998,259,96,163
'1123056000,  전농1동,'80,75 - 79세,1998,190,71,119
'1123056000,  전농1동,'85,80 - 84세,1998,100,30,70
'1123056000,  전농1동,'90,85+ ,1998,59,11,48
'1123057000,  전농2동,'00,계,1998,7981,4077,3904
'1123057000,  전농2동,'05,0 - 4세,1998,465,232,233
'1123057000,  전농2동,'10,5 - 9세,1998,348,181,167
'1123057000,  전농2동,'15,10 - 14세,1998,333,191,142
'1123057000,  전농2동,'20,15 - 19세,1998,689,372,317
'1123057000,  전농2동,'25,20 - 24세,1998,828,412,416
'1123057000,  전농2동,'30,25 - 29세,1998,987,566,421
'1123057000,  전농2동,'35,30 - 34세,1998,683,378,305
'1123057000,  전농2동,'40,35 - 39세,1998,608,342,266
'1123057000,  전농2동,'45,40 - 44세,1998,579,275,304
'1123057000,  전농2동,'50,45 - 49세,1998,497,235,262
'1123057000,  전농2동,'55,50 - 54세,1998,514,243,271
'1123057000,  전농2동,'60,55 - 59세,1998,532,268,264
'1123057000,  전농2동,'65,60 - 64세,1998,376,169,207
'1123057000,  전농2동,'70,65 - 69세,1998,232,111,121
'1123057000,  전농2동,'75,70 - 74세,1998,139,52,87
'1123057000,  전농2동,'80,75 - 79세,1998,108,37,71
'1123057000,  전농2동,'85,80 - 84세,1998,41,10,31
'1123057000,  전농2동,'90,85+ ,1998,22,3,19
'1123058000,  전농3동,'00,계,1998,14053,6999,7054
'1123058000,  전농3동,'05,0 - 4세,1998,787,424,363
'1123058000,  전농3동,'10,5 - 9세,1998,874,445,429
'1123058000,  전농3동,'15,10 - 14세,1998,964,508,456
'1123058000,  전농3동,'20,15 - 19세,1998,1275,655,620
'1123058000,  전농3동,'25,20 - 24세,1998,1254,620,634
'1123058000,  전농3동,'30,25 - 29세,1998,1322,688,634
'1123058000,  전농3동,'35,30 - 34세,1998,1124,563,561
'1123058000,  전농3동,'40,35 - 39세,1998,1310,632,678
'1123058000,  전농3동,'45,40 - 44세,1998,1234,625,609
'1123058000,  전농3동,'50,45 - 49세,1998,927,449,478
'1123058000,  전농3동,'55,50 - 54세,1998,837,417,420
'1123058000,  전농3동,'60,55 - 59세,1998,788,393,395
'1123058000,  전농3동,'65,60 - 64세,1998,558,269,289
'1123058000,  전농3동,'70,65 - 69세,1998,328,157,171
'1123058000,  전농3동,'75,70 - 74세,1998,199,77,122
'1123058000,  전농3동,'80,75 - 79세,1998,153,47,106
'1123058000,  전농3동,'85,80 - 84세,1998,77,19,58
'1123058000,  전농3동,'90,85+ ,1998,42,11,31
'1123059000,  전농4동,'00,계,1998,16500,8302,8198
'1123059000,  전농4동,'05,0 - 4세,1998,939,487,452
'1123059000,  전농4동,'10,5 - 9세,1998,960,476,484
'1123059000,  전농4동,'15,10 - 14세,1998,978,533,445
'1123059000,  전농4동,'20,15 - 19세,1998,1415,686,729
'1123059000,  전농4동,'25,20 - 24세,1998,1586,810,776
'1123059000,  전농4동,'30,25 - 29세,1998,1957,1058,899
'1123059000,  전농4동,'35,30 - 34세,1998,1494,782,712
'1123059000,  전농4동,'40,35 - 39세,1998,1428,737,691
'1123059000,  전농4동,'45,40 - 44세,1998,1322,658,664
'1123059000,  전농4동,'50,45 - 49세,1998,1011,500,511
'1123059000,  전농4동,'55,50 - 54세,1998,935,441,494
'1123059000,  전농4동,'60,55 - 59세,1998,917,448,469
'1123059000,  전농4동,'65,60 - 64세,1998,648,315,333
'1123059000,  전농4동,'70,65 - 69세,1998,361,165,196
'1123059000,  전농4동,'75,70 - 74세,1998,231,89,142
'1123059000,  전농4동,'80,75 - 79세,1998,176,58,118
'1123059000,  전농4동,'85,80 - 84세,1998,94,42,52
'1123059000,  전농4동,'90,85+ ,1998,48,17,31
'1123060000,  답십리1동,'00,계,1998,12153,6172,5981
'1123060000,  답십리1동,'05,0 - 4세,1998,801,401,400
'1123060000,  답십리1동,'10,5 - 9세,1998,776,413,363
'1123060000,  답십리1동,'15,10 - 14세,1998,683,350,333
'1123060000,  답십리1동,'20,15 - 19세,1998,1025,535,490
'1123060000,  답십리1동,'25,20 - 24세,1998,1095,572,523
'1123060000,  답십리1동,'30,25 - 29세,1998,1507,799,708
'1123060000,  답십리1동,'35,30 - 34세,1998,1269,685,584
'1123060000,  답십리1동,'40,35 - 39세,1998,1081,580,501
'1123060000,  답십리1동,'45,40 - 44세,1998,908,458,450
'1123060000,  답십리1동,'50,45 - 49세,1998,706,339,367
'1123060000,  답십리1동,'55,50 - 54세,1998,653,306,347
'1123060000,  답십리1동,'60,55 - 59세,1998,624,303,321
'1123060000,  답십리1동,'65,60 - 64세,1998,443,213,230
'1123060000,  답십리1동,'70,65 - 69세,1998,222,97,125
'1123060000,  답십리1동,'75,70 - 74세,1998,160,62,98
'1123060000,  답십리1동,'80,75 - 79세,1998,106,36,70
'1123060000,  답십리1동,'85,80 - 84세,1998,56,14,42
'1123060000,  답십리1동,'90,85+ ,1998,38,9,29
'1123061000,  답십리2동,'00,계,1998,8659,4403,4256
'1123061000,  답십리2동,'05,0 - 4세,1998,509,269,240
'1123061000,  답십리2동,'10,5 - 9세,1998,558,318,240
'1123061000,  답십리2동,'15,10 - 14세,1998,569,312,257
'1123061000,  답십리2동,'20,15 - 19세,1998,750,365,385
'1123061000,  답십리2동,'25,20 - 24세,1998,710,371,339
'1123061000,  답십리2동,'30,25 - 29세,1998,937,487,450
'1123061000,  답십리2동,'35,30 - 34세,1998,835,454,381
'1123061000,  답십리2동,'40,35 - 39세,1998,792,407,385
'1123061000,  답십리2동,'45,40 - 44세,1998,722,364,358
'1123061000,  답십리2동,'50,45 - 49세,1998,536,272,264
'1123061000,  답십리2동,'55,50 - 54세,1998,463,217,246
'1123061000,  답십리2동,'60,55 - 59세,1998,466,225,241
'1123061000,  답십리2동,'65,60 - 64세,1998,332,159,173
'1123061000,  답십리2동,'70,65 - 69세,1998,221,93,128
'1123061000,  답십리2동,'75,70 - 74세,1998,128,45,83
'1123061000,  답십리2동,'80,75 - 79세,1998,68,27,41
'1123061000,  답십리2동,'85,80 - 84세,1998,40,10,30
'1123061000,  답십리2동,'90,85+ ,1998,23,8,15
'1123062000,  답십리3동,'00,계,1998,8550,4313,4237
'1123062000,  답십리3동,'05,0 - 4세,1998,543,295,248
'1123062000,  답십리3동,'10,5 - 9세,1998,529,284,245
'1123062000,  답십리3동,'15,10 - 14세,1998,444,242,202
'1123062000,  답십리3동,'20,15 - 19세,1998,658,327,331
'1123062000,  답십리3동,'25,20 - 24세,1998,738,375,363
'1123062000,  답십리3동,'30,25 - 29세,1998,1033,555,478
'1123062000,  답십리3동,'35,30 - 34세,1998,837,444,393
'1123062000,  답십리3동,'40,35 - 39세,1998,735,384,351
'1123062000,  답십리3동,'45,40 - 44세,1998,583,288,295
'1123062000,  답십리3동,'50,45 - 49세,1998,501,237,264
'1123062000,  답십리3동,'55,50 - 54세,1998,529,234,295
'1123062000,  답십리3동,'60,55 - 59세,1998,515,257,258
'1123062000,  답십리3동,'65,60 - 64세,1998,387,180,207
'1123062000,  답십리3동,'70,65 - 69세,1998,225,104,121
'1123062000,  답십리3동,'75,70 - 74세,1998,119,47,72
'1123062000,  답십리3동,'80,75 - 79세,1998,101,37,64
'1123062000,  답십리3동,'85,80 - 84세,1998,50,18,32
'1123062000,  답십리3동,'90,85+ ,1998,23,5,18
'1123063000,  답십리4동,'00,계,1998,14124,7239,6885
'1123063000,  답십리4동,'05,0 - 4세,1998,877,462,415
'1123063000,  답십리4동,'10,5 - 9세,1998,900,486,414
'1123063000,  답십리4동,'15,10 - 14세,1998,910,475,435
'1123063000,  답십리4동,'20,15 - 19세,1998,1207,607,600
'1123063000,  답십리4동,'25,20 - 24세,1998,1180,611,569
'1123063000,  답십리4동,'30,25 - 29세,1998,1503,823,680
'1123063000,  답십리4동,'35,30 - 34세,1998,1302,699,603
'1123063000,  답십리4동,'40,35 - 39세,1998,1419,717,702
'1123063000,  답십리4동,'45,40 - 44세,1998,1200,637,563
'1123063000,  답십리4동,'50,45 - 49세,1998,815,419,396
'1123063000,  답십리4동,'55,50 - 54세,1998,747,358,389
'1123063000,  답십리4동,'60,55 - 59세,1998,780,393,387
'1123063000,  답십리4동,'65,60 - 64세,1998,544,255,289
'1123063000,  답십리4동,'70,65 - 69세,1998,322,152,170
'1123063000,  답십리4동,'75,70 - 74세,1998,186,72,114
'1123063000,  답십리4동,'80,75 - 79세,1998,116,39,77
'1123063000,  답십리4동,'85,80 - 84세,1998,68,21,47
'1123063000,  답십리4동,'90,85+ ,1998,48,13,35
'1123064000,  답십리5동,'00,계,1998,11831,6040,5791
'1123064000,  답십리5동,'05,0 - 4세,1998,739,410,329
'1123064000,  답십리5동,'10,5 - 9세,1998,748,375,373
'1123064000,  답십리5동,'15,10 - 14세,1998,631,342,289
'1123064000,  답십리5동,'20,15 - 19세,1998,889,470,419
'1123064000,  답십리5동,'25,20 - 24세,1998,1135,542,593
'1123064000,  답십리5동,'30,25 - 29세,1998,1563,830,733
'1123064000,  답십리5동,'35,30 - 34세,1998,1201,645,556
'1123064000,  답십리5동,'40,35 - 39세,1998,1071,584,487
'1123064000,  답십리5동,'45,40 - 44세,1998,813,419,394
'1123064000,  답십리5동,'50,45 - 49세,1998,654,309,345
'1123064000,  답십리5동,'55,50 - 54세,1998,637,307,330
'1123064000,  답십리5동,'60,55 - 59세,1998,670,313,357
'1123064000,  답십리5동,'65,60 - 64세,1998,468,251,217
'1123064000,  답십리5동,'70,65 - 69세,1998,255,116,139
'1123064000,  답십리5동,'75,70 - 74세,1998,163,59,104
'1123064000,  답십리5동,'80,75 - 79세,1998,122,45,77
'1123064000,  답십리5동,'85,80 - 84세,1998,54,17,37
'1123064000,  답십리5동,'90,85+ ,1998,18,6,12
'1123065000,  장안1동,'00,계,1998,20448,10310,10138
'1123065000,  장안1동,'05,0 - 4세,1998,1158,595,563
'1123065000,  장안1동,'10,5 - 9세,1998,1359,723,636
'1123065000,  장안1동,'15,10 - 14세,1998,1344,705,639
'1123065000,  장안1동,'20,15 - 19세,1998,1777,883,894
'1123065000,  장안1동,'25,20 - 24세,1998,1962,939,1023
'1123065000,  장안1동,'30,25 - 29세,1998,2290,1218,1072
'1123065000,  장안1동,'35,30 - 34세,1998,1968,1046,922
'1123065000,  장안1동,'40,35 - 39세,1998,1956,1006,950
'1123065000,  장안1동,'45,40 - 44세,1998,1697,834,863
'1123065000,  장안1동,'50,45 - 49세,1998,1251,638,613
'1123065000,  장안1동,'55,50 - 54세,1998,1070,517,553
'1123065000,  장안1동,'60,55 - 59세,1998,1022,530,492
'1123065000,  장안1동,'65,60 - 64세,1998,659,319,340
'1123065000,  장안1동,'70,65 - 69세,1998,404,178,226
'1123065000,  장안1동,'75,70 - 74세,1998,253,93,160
'1123065000,  장안1동,'80,75 - 79세,1998,151,48,103
'1123065000,  장안1동,'85,80 - 84세,1998,78,25,53
'1123065000,  장안1동,'90,85+ ,1998,49,13,36
'1123066000,  장안2동,'00,계,1998,17097,8728,8369
'1123066000,  장안2동,'05,0 - 4세,1998,1043,571,472
'1123066000,  장안2동,'10,5 - 9세,1998,1111,603,508
'1123066000,  장안2동,'15,10 - 14세,1998,1210,643,567
'1123066000,  장안2동,'20,15 - 19세,1998,1652,881,771
'1123066000,  장안2동,'25,20 - 24세,1998,1517,794,723
'1123066000,  장안2동,'30,25 - 29세,1998,1750,946,804
'1123066000,  장안2동,'35,30 - 34세,1998,1553,762,791
'1123066000,  장안2동,'40,35 - 39세,1998,1694,853,841
'1123066000,  장안2동,'45,40 - 44세,1998,1585,772,813
'1123066000,  장안2동,'50,45 - 49세,1998,1178,599,579
'1123066000,  장안2동,'55,50 - 54세,1998,907,458,449
'1123066000,  장안2동,'60,55 - 59세,1998,732,400,332
'1123066000,  장안2동,'65,60 - 64세,1998,462,211,251
'1123066000,  장안2동,'70,65 - 69세,1998,279,118,161
'1123066000,  장안2동,'75,70 - 74세,1998,178,51,127
'1123066000,  장안2동,'80,75 - 79세,1998,129,35,94
'1123066000,  장안2동,'85,80 - 84세,1998,84,21,63
'1123066000,  장안2동,'90,85+ ,1998,33,10,23
'1123067000,  장안3동,'00,계,1998,18550,9465,9085
'1123067000,  장안3동,'05,0 - 4세,1998,1117,572,545
'1123067000,  장안3동,'10,5 - 9세,1998,1220,654,566
'1123067000,  장안3동,'15,10 - 14세,1998,1270,667,603
'1123067000,  장안3동,'20,15 - 19세,1998,1681,878,803
'1123067000,  장안3동,'25,20 - 24세,1998,1611,846,765
'1123067000,  장안3동,'30,25 - 29세,1998,1926,1025,901
'1123067000,  장안3동,'35,30 - 34세,1998,1697,874,823
'1123067000,  장안3동,'40,35 - 39세,1998,1890,946,944
'1123067000,  장안3동,'45,40 - 44세,1998,1693,847,846
'1123067000,  장안3동,'50,45 - 49세,1998,1182,620,562
'1123067000,  장안3동,'55,50 - 54세,1998,1035,528,507
'1123067000,  장안3동,'60,55 - 59세,1998,834,441,393
'1123067000,  장안3동,'65,60 - 64세,1998,550,280,270
'1123067000,  장안3동,'70,65 - 69세,1998,342,129,213
'1123067000,  장안3동,'75,70 - 74세,1998,243,81,162
'1123067000,  장안3동,'80,75 - 79세,1998,138,49,89
'1123067000,  장안3동,'85,80 - 84세,1998,74,19,55
'1123067000,  장안3동,'90,85+ ,1998,47,9,38
'1123068000,  장안4동,'00,계,1998,18157,9169,8988
'1123068000,  장안4동,'05,0 - 4세,1998,910,508,402
'1123068000,  장안4동,'10,5 - 9세,1998,1093,609,484
'1123068000,  장안4동,'15,10 - 14세,1998,1173,566,607
'1123068000,  장안4동,'20,15 - 19세,1998,1831,928,903
'1123068000,  장안4동,'25,20 - 24세,1998,1802,915,887
'1123068000,  장안4동,'30,25 - 29세,1998,1922,1011,911
'1123068000,  장안4동,'35,30 - 34세,1998,1452,739,713
'1123068000,  장안4동,'40,35 - 39세,1998,1586,783,803
'1123068000,  장안4동,'45,40 - 44세,1998,1673,818,855
'1123068000,  장안4동,'50,45 - 49세,1998,1260,621,639
'1123068000,  장안4동,'55,50 - 54세,1998,1063,533,530
'1123068000,  장안4동,'60,55 - 59세,1998,957,499,458
'1123068000,  장안4동,'65,60 - 64세,1998,618,321,297
'1123068000,  장안4동,'70,65 - 69세,1998,328,163,165
'1123068000,  장안4동,'75,70 - 74세,1998,200,67,133
'1123068000,  장안4동,'80,75 - 79세,1998,166,57,109
'1123068000,  장안4동,'85,80 - 84세,1998,81,21,60
'1123068000,  장안4동,'90,85+ ,1998,42,10,32
'1123069000,  청량리1동,'00,계,1998,16880,8512,8368
'1123069000,  청량리1동,'05,0 - 4세,1998,984,518,466
'1123069000,  청량리1동,'10,5 - 9세,1998,984,537,447
'1123069000,  청량리1동,'15,10 - 14세,1998,1014,551,463
'1123069000,  청량리1동,'20,15 - 19세,1998,1260,671,589
'1123069000,  청량리1동,'25,20 - 24세,1998,1444,750,694
'1123069000,  청량리1동,'30,25 - 29세,1998,1857,971,886
'1123069000,  청량리1동,'35,30 - 34세,1998,1496,788,708
'1123069000,  청량리1동,'40,35 - 39세,1998,1490,747,743
'1123069000,  청량리1동,'45,40 - 44세,1998,1290,658,632
'1123069000,  청량리1동,'50,45 - 49세,1998,1021,486,535
'1123069000,  청량리1동,'55,50 - 54세,1998,997,440,557
'1123069000,  청량리1동,'60,55 - 59세,1998,1021,475,546
'1123069000,  청량리1동,'65,60 - 64세,1998,804,398,406
'1123069000,  청량리1동,'70,65 - 69세,1998,529,251,278
'1123069000,  청량리1동,'75,70 - 74세,1998,314,125,189
'1123069000,  청량리1동,'80,75 - 79세,1998,211,94,117
'1123069000,  청량리1동,'85,80 - 84세,1998,96,33,63
'1123069000,  청량리1동,'90,85+ ,1998,68,19,49
'1123070000,  청량리2동,'00,계,1998,10208,5176,5032
'1123070000,  청량리2동,'05,0 - 4세,1998,514,273,241
'1123070000,  청량리2동,'10,5 - 9세,1998,512,277,235
'1123070000,  청량리2동,'15,10 - 14세,1998,523,285,238
'1123070000,  청량리2동,'20,15 - 19세,1998,801,405,396
'1123070000,  청량리2동,'25,20 - 24세,1998,989,517,472
'1123070000,  청량리2동,'30,25 - 29세,1998,1245,706,539
'1123070000,  청량리2동,'35,30 - 34세,1998,809,450,359
'1123070000,  청량리2동,'40,35 - 39세,1998,836,437,399
'1123070000,  청량리2동,'45,40 - 44세,1998,832,406,426
'1123070000,  청량리2동,'50,45 - 49세,1998,632,276,356
'1123070000,  청량리2동,'55,50 - 54세,1998,665,319,346
'1123070000,  청량리2동,'60,55 - 59세,1998,656,323,333
'1123070000,  청량리2동,'65,60 - 64세,1998,453,206,247
'1123070000,  청량리2동,'70,65 - 69세,1998,294,136,158
'1123070000,  청량리2동,'75,70 - 74세,1998,217,71,146
'1123070000,  청량리2동,'80,75 - 79세,1998,132,53,79
'1123070000,  청량리2동,'85,80 - 84세,1998,60,26,34
'1123070000,  청량리2동,'90,85+ ,1998,38,10,28
'1123071000,  회기동,'00,계,1998,12804,6356,6448
'1123071000,  회기동,'05,0 - 4세,1998,756,400,356
'1123071000,  회기동,'10,5 - 9세,1998,646,349,297
'1123071000,  회기동,'15,10 - 14세,1998,717,354,363
'1123071000,  회기동,'20,15 - 19세,1998,988,498,490
'1123071000,  회기동,'25,20 - 24세,1998,1387,643,744
'1123071000,  회기동,'30,25 - 29세,1998,1916,1087,829
'1123071000,  회기동,'35,30 - 34세,1998,1195,674,521
'1123071000,  회기동,'40,35 - 39세,1998,959,451,508
'1123071000,  회기동,'45,40 - 44세,1998,996,469,527
'1123071000,  회기동,'50,45 - 49세,1998,680,310,370
'1123071000,  회기동,'55,50 - 54세,1998,643,304,339
'1123071000,  회기동,'60,55 - 59세,1998,674,319,355
'1123071000,  회기동,'65,60 - 64세,1998,490,216,274
'1123071000,  회기동,'70,65 - 69세,1998,298,118,180
'1123071000,  회기동,'75,70 - 74세,1998,208,88,120
'1123071000,  회기동,'80,75 - 79세,1998,132,50,82
'1123071000,  회기동,'85,80 - 84세,1998,69,15,54
'1123071000,  회기동,'90,85+ ,1998,50,11,39
'1123072000,  휘경1동,'00,계,1998,17182,8686,8496
'1123072000,  휘경1동,'05,0 - 4세,1998,1168,588,580
'1123072000,  휘경1동,'10,5 - 9세,1998,749,404,345
'1123072000,  휘경1동,'15,10 - 14세,1998,680,337,343
'1123072000,  휘경1동,'20,15 - 19세,1998,1267,649,618
'1123072000,  휘경1동,'25,20 - 24세,1998,1960,919,1041
'1123072000,  휘경1동,'30,25 - 29세,1998,2945,1574,1371
'1123072000,  휘경1동,'35,30 - 34세,1998,1771,1031,740
'1123072000,  휘경1동,'40,35 - 39세,1998,1228,692,536
'1123072000,  휘경1동,'45,40 - 44세,1998,1144,539,605
'1123072000,  휘경1동,'50,45 - 49세,1998,911,426,485
'1123072000,  휘경1동,'55,50 - 54세,1998,925,418,507
'1123072000,  휘경1동,'60,55 - 59세,1998,941,447,494
'1123072000,  휘경1동,'65,60 - 64세,1998,633,315,318
'1123072000,  휘경1동,'70,65 - 69세,1998,349,158,191
'1123072000,  휘경1동,'75,70 - 74세,1998,242,100,142
'1123072000,  휘경1동,'80,75 - 79세,1998,163,61,102
'1123072000,  휘경1동,'85,80 - 84세,1998,71,20,51
'1123072000,  휘경1동,'90,85+ ,1998,35,8,27
'1123073000,  휘경2동,'00,계,1998,19454,9652,9802
'1123073000,  휘경2동,'05,0 - 4세,1998,1229,625,604
'1123073000,  휘경2동,'10,5 - 9세,1998,1163,609,554
'1123073000,  휘경2동,'15,10 - 14세,1998,1047,515,532
'1123073000,  휘경2동,'20,15 - 19세,1998,1524,774,750
'1123073000,  휘경2동,'25,20 - 24세,1998,2001,941,1060
'1123073000,  휘경2동,'30,25 - 29세,1998,2683,1392,1291
'1123073000,  휘경2동,'35,30 - 34세,1998,1843,976,867
'1123073000,  휘경2동,'40,35 - 39세,1998,1613,813,800
'1123073000,  휘경2동,'45,40 - 44세,1998,1455,701,754
'1123073000,  휘경2동,'50,45 - 49세,1998,1143,565,578
'1123073000,  휘경2동,'55,50 - 54세,1998,1079,504,575
'1123073000,  휘경2동,'60,55 - 59세,1998,1031,499,532
'1123073000,  휘경2동,'65,60 - 64세,1998,646,336,310
'1123073000,  휘경2동,'70,65 - 69세,1998,423,187,236
'1123073000,  휘경2동,'75,70 - 74세,1998,238,111,127
'1123073000,  휘경2동,'80,75 - 79세,1998,181,63,118
'1123073000,  휘경2동,'85,80 - 84세,1998,100,31,69
'1123073000,  휘경2동,'90,85+ ,1998,55,10,45
'1123074000,  이문1동,'00,계,1998,16454,8253,8201
'1123074000,  이문1동,'05,0 - 4세,1998,1151,587,564
'1123074000,  이문1동,'10,5 - 9세,1998,832,444,388
'1123074000,  이문1동,'15,10 - 14세,1998,792,411,381
'1123074000,  이문1동,'20,15 - 19세,1998,1230,652,578
'1123074000,  이문1동,'25,20 - 24세,1998,1739,795,944
'1123074000,  이문1동,'30,25 - 29세,1998,2688,1380,1308
'1123074000,  이문1동,'35,30 - 34세,1998,1733,970,763
'1123074000,  이문1동,'40,35 - 39세,1998,1277,658,619
'1123074000,  이문1동,'45,40 - 44세,1998,1087,541,546
'1123074000,  이문1동,'50,45 - 49세,1998,921,458,463
'1123074000,  이문1동,'55,50 - 54세,1998,851,407,444
'1123074000,  이문1동,'60,55 - 59세,1998,786,369,417
'1123074000,  이문1동,'65,60 - 64세,1998,583,276,307
'1123074000,  이문1동,'70,65 - 69세,1998,328,149,179
'1123074000,  이문1동,'75,70 - 74세,1998,214,79,135
'1123074000,  이문1동,'80,75 - 79세,1998,144,50,94
'1123074000,  이문1동,'85,80 - 84세,1998,63,20,43
'1123074000,  이문1동,'90,85+ ,1998,35,7,28
'1123075000,  이문2동,'00,계,1998,21129,10692,10437
'1123075000,  이문2동,'05,0 - 4세,1998,1214,607,607
'1123075000,  이문2동,'10,5 - 9세,1998,1125,623,502
'1123075000,  이문2동,'15,10 - 14세,1998,1193,617,576
'1123075000,  이문2동,'20,15 - 19세,1998,1641,862,779
'1123075000,  이문2동,'25,20 - 24세,1998,2315,1081,1234
'1123075000,  이문2동,'30,25 - 29세,1998,3258,1855,1403
'1123075000,  이문2동,'35,30 - 34세,1998,2038,1134,904
'1123075000,  이문2동,'40,35 - 39세,1998,1662,839,823
'1123075000,  이문2동,'45,40 - 44세,1998,1513,717,796
'1123075000,  이문2동,'50,45 - 49세,1998,1149,558,591
'1123075000,  이문2동,'55,50 - 54세,1998,1060,477,583
'1123075000,  이문2동,'60,55 - 59세,1998,1172,545,627
'1123075000,  이문2동,'65,60 - 64세,1998,743,380,363
'1123075000,  이문2동,'70,65 - 69세,1998,425,192,233
'1123075000,  이문2동,'75,70 - 74세,1998,256,103,153
'1123075000,  이문2동,'80,75 - 79세,1998,186,55,131
'1123075000,  이문2동,'85,80 - 84세,1998,113,34,79
'1123075000,  이문2동,'90,85+ ,1998,66,13,53
'1123076000,  이문3동,'00,계,1998,15475,7897,7578
'1123076000,  이문3동,'05,0 - 4세,1998,948,484,464
'1123076000,  이문3동,'10,5 - 9세,1998,940,516,424
'1123076000,  이문3동,'15,10 - 14세,1998,903,485,418
'1123076000,  이문3동,'20,15 - 19세,1998,1207,638,569
'1123076000,  이문3동,'25,20 - 24세,1998,1547,754,793
'1123076000,  이문3동,'30,25 - 29세,1998,2022,1100,922
'1123076000,  이문3동,'35,30 - 34세,1998,1509,811,698
'1123076000,  이문3동,'40,35 - 39세,1998,1389,734,655
'1123076000,  이문3동,'45,40 - 44세,1998,1137,564,573
'1123076000,  이문3동,'50,45 - 49세,1998,879,421,458
'1123076000,  이문3동,'55,50 - 54세,1998,817,373,444
'1123076000,  이문3동,'60,55 - 59세,1998,877,451,426
'1123076000,  이문3동,'65,60 - 64세,1998,562,283,279
'1123076000,  이문3동,'70,65 - 69세,1998,297,128,169
'1123076000,  이문3동,'75,70 - 74세,1998,184,79,105
'1123076000,  이문3동,'80,75 - 79세,1998,130,48,82
'1123076000,  이문3동,'85,80 - 84세,1998,85,20,65
'1123076000,  이문3동,'90,85+ ,1998,42,8,34
'11260, 중랑구,'00,계,1998,467001,234583,232418
'11260, 중랑구,'05,0 - 4세,1998,33037,17316,15721
'11260, 중랑구,'10,5 - 9세,1998,34029,17927,16102
'11260, 중랑구,'15,10 - 14세,1998,31252,16139,15113
'11260, 중랑구,'20,15 - 19세,1998,39871,20390,19481
'11260, 중랑구,'25,20 - 24세,1998,39863,19634,20229
'11260, 중랑구,'30,25 - 29세,1998,51066,25726,25340
'11260, 중랑구,'35,30 - 34세,1998,46359,23680,22679
'11260, 중랑구,'40,35 - 39세,1998,46973,24091,22882
'11260, 중랑구,'45,40 - 44세,1998,39274,19962,19312
'11260, 중랑구,'50,45 - 49세,1998,27337,13645,13692
'11260, 중랑구,'55,50 - 54세,1998,23239,11527,11712
'11260, 중랑구,'60,55 - 59세,1998,20703,10578,10125
'11260, 중랑구,'65,60 - 64세,1998,13664,6654,7010
'11260, 중랑구,'70,65 - 69세,1998,8200,3438,4762
'11260, 중랑구,'75,70 - 74세,1998,5347,1937,3410
'11260, 중랑구,'80,75 - 79세,1998,3647,1169,2478
'11260, 중랑구,'85,80 - 84세,1998,1971,500,1471
'11260, 중랑구,'90,85+ ,1998,1169,270,899
'1126051000,  면목1동,'00,계,1998,25526,12862,12664
'1126051000,  면목1동,'05,0 - 4세,1998,1785,930,855
'1126051000,  면목1동,'10,5 - 9세,1998,1813,973,840
'1126051000,  면목1동,'15,10 - 14세,1998,1679,831,848
'1126051000,  면목1동,'20,15 - 19세,1998,2098,1084,1014
'1126051000,  면목1동,'25,20 - 24세,1998,2311,1131,1180
'1126051000,  면목1동,'30,25 - 29세,1998,3098,1566,1532
'1126051000,  면목1동,'35,30 - 34세,1998,2606,1359,1247
'1126051000,  면목1동,'40,35 - 39세,1998,2451,1283,1168
'1126051000,  면목1동,'45,40 - 44세,1998,2020,1020,1000
'1126051000,  면목1동,'50,45 - 49세,1998,1497,736,761
'1126051000,  면목1동,'55,50 - 54세,1998,1196,598,598
'1126051000,  면목1동,'60,55 - 59세,1998,1134,582,552
'1126051000,  면목1동,'65,60 - 64세,1998,759,375,384
'1126051000,  면목1동,'70,65 - 69세,1998,434,175,259
'1126051000,  면목1동,'75,70 - 74세,1998,265,106,159
'1126051000,  면목1동,'80,75 - 79세,1998,201,75,126
'1126051000,  면목1동,'85,80 - 84세,1998,108,25,83
'1126051000,  면목1동,'90,85+ ,1998,71,13,58
'1126052000,  면목2동,'00,계,1998,32902,16669,16233
'1126052000,  면목2동,'05,0 - 4세,1998,2623,1420,1203
'1126052000,  면목2동,'10,5 - 9세,1998,2523,1304,1219
'1126052000,  면목2동,'15,10 - 14세,1998,2108,1121,987
'1126052000,  면목2동,'20,15 - 19세,1998,2476,1307,1169
'1126052000,  면목2동,'25,20 - 24세,1998,2686,1317,1369
'1126052000,  면목2동,'30,25 - 29세,1998,3876,1894,1982
'1126052000,  면목2동,'35,30 - 34세,1998,3848,2015,1833
'1126052000,  면목2동,'40,35 - 39세,1998,3325,1759,1566
'1126052000,  면목2동,'45,40 - 44세,1998,2621,1345,1276
'1126052000,  면목2동,'50,45 - 49세,1998,1765,880,885
'1126052000,  면목2동,'55,50 - 54세,1998,1530,743,787
'1126052000,  면목2동,'60,55 - 59세,1998,1367,693,674
'1126052000,  면목2동,'65,60 - 64세,1998,836,403,433
'1126052000,  면목2동,'70,65 - 69세,1998,568,238,330
'1126052000,  면목2동,'75,70 - 74세,1998,360,112,248
'1126052000,  면목2동,'80,75 - 79세,1998,211,65,146
'1126052000,  면목2동,'85,80 - 84세,1998,106,36,70
'1126052000,  면목2동,'90,85+ ,1998,73,17,56
'1126053000,  면목3동,'00,계,1998,21455,10784,10671
'1126053000,  면목3동,'05,0 - 4세,1998,1631,849,782
'1126053000,  면목3동,'10,5 - 9세,1998,1447,757,690
'1126053000,  면목3동,'15,10 - 14세,1998,1235,656,579
'1126053000,  면목3동,'20,15 - 19세,1998,1773,920,853
'1126053000,  면목3동,'25,20 - 24세,1998,1872,944,928
'1126053000,  면목3동,'30,25 - 29세,1998,2709,1338,1371
'1126053000,  면목3동,'35,30 - 34세,1998,2304,1209,1095
'1126053000,  면목3동,'40,35 - 39세,1998,2019,1074,945
'1126053000,  면목3동,'45,40 - 44세,1998,1685,812,873
'1126053000,  면목3동,'50,45 - 49세,1998,1203,591,612
'1126053000,  면목3동,'55,50 - 54세,1998,1072,550,522
'1126053000,  면목3동,'60,55 - 59세,1998,965,452,513
'1126053000,  면목3동,'65,60 - 64세,1998,643,317,326
'1126053000,  면목3동,'70,65 - 69세,1998,358,159,199
'1126053000,  면목3동,'75,70 - 74세,1998,233,72,161
'1126053000,  면목3동,'80,75 - 79세,1998,165,54,111
'1126053000,  면목3동,'85,80 - 84세,1998,103,23,80
'1126053000,  면목3동,'90,85+ ,1998,38,7,31
'1126054000,  면목4동,'00,계,1998,26016,12972,13044
'1126054000,  면목4동,'05,0 - 4세,1998,1725,901,824
'1126054000,  면목4동,'10,5 - 9세,1998,1635,843,792
'1126054000,  면목4동,'15,10 - 14세,1998,1568,826,742
'1126054000,  면목4동,'20,15 - 19세,1998,2183,1096,1087
'1126054000,  면목4동,'25,20 - 24세,1998,2910,1408,1502
'1126054000,  면목4동,'30,25 - 29세,1998,3142,1574,1568
'1126054000,  면목4동,'35,30 - 34세,1998,2495,1321,1174
'1126054000,  면목4동,'40,35 - 39세,1998,2299,1243,1056
'1126054000,  면목4동,'45,40 - 44세,1998,1897,951,946
'1126054000,  면목4동,'50,45 - 49세,1998,1583,702,881
'1126054000,  면목4동,'55,50 - 54세,1998,1481,686,795
'1126054000,  면목4동,'60,55 - 59세,1998,1299,671,628
'1126054000,  면목4동,'65,60 - 64세,1998,727,361,366
'1126054000,  면목4동,'70,65 - 69세,1998,430,164,266
'1126054000,  면목4동,'75,70 - 74세,1998,282,117,165
'1126054000,  면목4동,'80,75 - 79세,1998,186,68,118
'1126054000,  면목4동,'85,80 - 84세,1998,116,27,89
'1126054000,  면목4동,'90,85+ ,1998,58,13,45
'1126055000,  면목5동,'00,계,1998,17448,8801,8647
'1126055000,  면목5동,'05,0 - 4세,1998,1311,682,629
'1126055000,  면목5동,'10,5 - 9세,1998,1305,678,627
'1126055000,  면목5동,'15,10 - 14세,1998,1019,514,505
'1126055000,  면목5동,'20,15 - 19세,1998,1404,719,685
'1126055000,  면목5동,'25,20 - 24세,1998,1511,723,788
'1126055000,  면목5동,'30,25 - 29세,1998,2083,1059,1024
'1126055000,  면목5동,'35,30 - 34세,1998,1878,995,883
'1126055000,  면목5동,'40,35 - 39세,1998,1732,931,801
'1126055000,  면목5동,'45,40 - 44세,1998,1256,651,605
'1126055000,  면목5동,'50,45 - 49세,1998,977,479,498
'1126055000,  면목5동,'55,50 - 54세,1998,818,395,423
'1126055000,  면목5동,'60,55 - 59세,1998,806,410,396
'1126055000,  면목5동,'65,60 - 64세,1998,580,303,277
'1126055000,  면목5동,'70,65 - 69세,1998,326,129,197
'1126055000,  면목5동,'75,70 - 74세,1998,205,79,126
'1126055000,  면목5동,'80,75 - 79세,1998,138,31,107
'1126055000,  면목5동,'85,80 - 84세,1998,67,18,49
'1126055000,  면목5동,'90,85+ ,1998,32,5,27
'1126056000,  면목6동,'00,계,1998,18276,9241,9035
'1126056000,  면목6동,'05,0 - 4세,1998,1363,706,657
'1126056000,  면목6동,'10,5 - 9세,1998,1222,665,557
'1126056000,  면목6동,'15,10 - 14세,1998,1069,553,516
'1126056000,  면목6동,'20,15 - 19세,1998,1521,777,744
'1126056000,  면목6동,'25,20 - 24세,1998,1702,848,854
'1126056000,  면목6동,'30,25 - 29세,1998,2238,1147,1091
'1126056000,  면목6동,'35,30 - 34세,1998,1864,988,876
'1126056000,  면목6동,'40,35 - 39세,1998,1729,918,811
'1126056000,  면목6동,'45,40 - 44세,1998,1406,691,715
'1126056000,  면목6동,'50,45 - 49세,1998,1038,498,540
'1126056000,  면목6동,'55,50 - 54세,1998,936,457,479
'1126056000,  면목6동,'60,55 - 59세,1998,880,451,429
'1126056000,  면목6동,'65,60 - 64세,1998,564,265,299
'1126056000,  면목6동,'70,65 - 69세,1998,302,134,168
'1126056000,  면목6동,'75,70 - 74세,1998,198,72,126
'1126056000,  면목6동,'80,75 - 79세,1998,134,38,96
'1126056000,  면목6동,'85,80 - 84세,1998,67,20,47
'1126056000,  면목6동,'90,85+ ,1998,43,13,30
'1126057000,  면목7동,'00,계,1998,29057,14664,14393
'1126057000,  면목7동,'05,0 - 4세,1998,2056,1046,1010
'1126057000,  면목7동,'10,5 - 9세,1998,2061,1089,972
'1126057000,  면목7동,'15,10 - 14세,1998,1872,1000,872
'1126057000,  면목7동,'20,15 - 19세,1998,2397,1238,1159
'1126057000,  면목7동,'25,20 - 24세,1998,2580,1295,1285
'1126057000,  면목7동,'30,25 - 29세,1998,3220,1642,1578
'1126057000,  면목7동,'35,30 - 34세,1998,2833,1438,1395
'1126057000,  면목7동,'40,35 - 39세,1998,2887,1500,1387
'1126057000,  면목7동,'45,40 - 44세,1998,2480,1277,1203
'1126057000,  면목7동,'50,45 - 49세,1998,1744,853,891
'1126057000,  면목7동,'55,50 - 54세,1998,1484,752,732
'1126057000,  면목7동,'60,55 - 59세,1998,1305,674,631
'1126057000,  면목7동,'65,60 - 64세,1998,905,417,488
'1126057000,  면목7동,'70,65 - 69세,1998,498,208,290
'1126057000,  면목7동,'75,70 - 74세,1998,326,114,212
'1126057000,  면목7동,'80,75 - 79세,1998,204,71,133
'1126057000,  면목7동,'85,80 - 84세,1998,124,25,99
'1126057000,  면목7동,'90,85+ ,1998,81,25,56
'1126057100,  면목8동,'00,계,1998,15411,7776,7635
'1126057100,  면목8동,'05,0 - 4세,1998,995,524,471
'1126057100,  면목8동,'10,5 - 9세,1998,1039,546,493
'1126057100,  면목8동,'15,10 - 14세,1998,1000,498,502
'1126057100,  면목8동,'20,15 - 19세,1998,1426,740,686
'1126057100,  면목8동,'25,20 - 24세,1998,1321,656,665
'1126057100,  면목8동,'30,25 - 29세,1998,1660,879,781
'1126057100,  면목8동,'35,30 - 34세,1998,1386,719,667
'1126057100,  면목8동,'40,35 - 39세,1998,1448,722,726
'1126057100,  면목8동,'45,40 - 44세,1998,1371,681,690
'1126057100,  면목8동,'50,45 - 49세,1998,955,503,452
'1126057100,  면목8동,'55,50 - 54세,1998,858,410,448
'1126057100,  면목8동,'60,55 - 59세,1998,766,415,351
'1126057100,  면목8동,'65,60 - 64세,1998,476,228,248
'1126057100,  면목8동,'70,65 - 69세,1998,272,112,160
'1126057100,  면목8동,'75,70 - 74세,1998,174,67,107
'1126057100,  면목8동,'80,75 - 79세,1998,148,46,102
'1126057100,  면목8동,'85,80 - 84세,1998,75,19,56
'1126057100,  면목8동,'90,85+ ,1998,41,11,30
'1126058000,  상봉1동,'00,계,1998,22819,11355,11464
'1126058000,  상봉1동,'05,0 - 4세,1998,1355,718,637
'1126058000,  상봉1동,'10,5 - 9세,1998,1933,1044,889
'1126058000,  상봉1동,'15,10 - 14세,1998,1885,991,894
'1126058000,  상봉1동,'20,15 - 19세,1998,2120,1092,1028
'1126058000,  상봉1동,'25,20 - 24세,1998,1778,878,900
'1126058000,  상봉1동,'30,25 - 29세,1998,1852,974,878
'1126058000,  상봉1동,'35,30 - 34세,1998,2008,949,1059
'1126058000,  상봉1동,'40,35 - 39세,1998,2662,1287,1375
'1126058000,  상봉1동,'45,40 - 44세,1998,2154,1120,1034
'1126058000,  상봉1동,'50,45 - 49세,1998,1305,654,651
'1126058000,  상봉1동,'55,50 - 54세,1998,993,478,515
'1126058000,  상봉1동,'60,55 - 59세,1998,929,449,480
'1126058000,  상봉1동,'65,60 - 64세,1998,707,324,383
'1126058000,  상봉1동,'70,65 - 69세,1998,447,186,261
'1126058000,  상봉1동,'75,70 - 74세,1998,329,116,213
'1126058000,  상봉1동,'80,75 - 79세,1998,203,59,144
'1126058000,  상봉1동,'85,80 - 84세,1998,96,25,71
'1126058000,  상봉1동,'90,85+ ,1998,63,11,52
'1126059000,  상봉2동,'00,계,1998,19608,9883,9725
'1126059000,  상봉2동,'05,0 - 4세,1998,1383,740,643
'1126059000,  상봉2동,'10,5 - 9세,1998,1166,591,575
'1126059000,  상봉2동,'15,10 - 14세,1998,974,512,462
'1126059000,  상봉2동,'20,15 - 19세,1998,1559,816,743
'1126059000,  상봉2동,'25,20 - 24세,1998,1881,939,942
'1126059000,  상봉2동,'30,25 - 29세,1998,2503,1283,1220
'1126059000,  상봉2동,'35,30 - 34세,1998,1952,1024,928
'1126059000,  상봉2동,'40,35 - 39세,1998,1806,977,829
'1126059000,  상봉2동,'45,40 - 44세,1998,1411,688,723
'1126059000,  상봉2동,'50,45 - 49세,1998,1207,576,631
'1126059000,  상봉2동,'55,50 - 54세,1998,1098,520,578
'1126059000,  상봉2동,'60,55 - 59세,1998,1065,543,522
'1126059000,  상봉2동,'65,60 - 64세,1998,682,333,349
'1126059000,  상봉2동,'70,65 - 69세,1998,372,159,213
'1126059000,  상봉2동,'75,70 - 74세,1998,229,93,136
'1126059000,  상봉2동,'80,75 - 79세,1998,169,53,116
'1126059000,  상봉2동,'85,80 - 84세,1998,89,24,65
'1126059000,  상봉2동,'90,85+ ,1998,62,12,50
'1126060000,  중화1동,'00,계,1998,23725,11943,11782
'1126060000,  중화1동,'05,0 - 4세,1998,1571,827,744
'1126060000,  중화1동,'10,5 - 9세,1998,1810,947,863
'1126060000,  중화1동,'15,10 - 14세,1998,1755,876,879
'1126060000,  중화1동,'20,15 - 19세,1998,1990,1080,910
'1126060000,  중화1동,'25,20 - 24세,1998,1921,946,975
'1126060000,  중화1동,'30,25 - 29세,1998,2453,1243,1210
'1126060000,  중화1동,'35,30 - 34세,1998,2172,1043,1129
'1126060000,  중화1동,'40,35 - 39세,1998,2560,1277,1283
'1126060000,  중화1동,'45,40 - 44세,1998,2213,1149,1064
'1126060000,  중화1동,'50,45 - 49세,1998,1385,706,679
'1126060000,  중화1동,'55,50 - 54세,1998,1216,637,579
'1126060000,  중화1동,'60,55 - 59세,1998,984,514,470
'1126060000,  중화1동,'65,60 - 64세,1998,668,326,342
'1126060000,  중화1동,'70,65 - 69세,1998,389,171,218
'1126060000,  중화1동,'75,70 - 74세,1998,286,98,188
'1126060000,  중화1동,'80,75 - 79세,1998,188,61,127
'1126060000,  중화1동,'85,80 - 84세,1998,104,26,78
'1126060000,  중화1동,'90,85+ ,1998,60,16,44
'1126061000,  중화2동,'00,계,1998,23407,11881,11526
'1126061000,  중화2동,'05,0 - 4세,1998,1916,970,946
'1126061000,  중화2동,'10,5 - 9세,1998,1680,894,786
'1126061000,  중화2동,'15,10 - 14세,1998,1265,666,599
'1126061000,  중화2동,'20,15 - 19세,1998,1713,901,812
'1126061000,  중화2동,'25,20 - 24세,1998,2084,972,1112
'1126061000,  중화2동,'30,25 - 29세,1998,3072,1541,1531
'1126061000,  중화2동,'35,30 - 34세,1998,2706,1495,1211
'1126061000,  중화2동,'40,35 - 39세,1998,2326,1290,1036
'1126061000,  중화2동,'45,40 - 44세,1998,1687,889,798
'1126061000,  중화2동,'50,45 - 49세,1998,1192,574,618
'1126061000,  중화2동,'55,50 - 54세,1998,1033,485,548
'1126061000,  중화2동,'60,55 - 59세,1998,1023,490,533
'1126061000,  중화2동,'65,60 - 64세,1998,736,349,387
'1126061000,  중화2동,'70,65 - 69세,1998,435,194,241
'1126061000,  중화2동,'75,70 - 74세,1998,244,86,158
'1126061000,  중화2동,'80,75 - 79세,1998,156,48,108
'1126061000,  중화2동,'85,80 - 84세,1998,88,27,61
'1126061000,  중화2동,'90,85+ ,1998,51,10,41
'1126061100,  중화3동,'00,계,1998,16979,8624,8355
'1126061100,  중화3동,'05,0 - 4세,1998,1252,662,590
'1126061100,  중화3동,'10,5 - 9세,1998,1155,592,563
'1126061100,  중화3동,'15,10 - 14세,1998,1026,520,506
'1126061100,  중화3동,'20,15 - 19세,1998,1380,740,640
'1126061100,  중화3동,'25,20 - 24세,1998,1542,735,807
'1126061100,  중화3동,'30,25 - 29세,1998,2139,1121,1018
'1126061100,  중화3동,'35,30 - 34세,1998,1759,942,817
'1126061100,  중화3동,'40,35 - 39세,1998,1610,838,772
'1126061100,  중화3동,'45,40 - 44세,1998,1332,681,651
'1126061100,  중화3동,'50,45 - 49세,1998,977,477,500
'1126061100,  중화3동,'55,50 - 54세,1998,811,393,418
'1126061100,  중화3동,'60,55 - 59세,1998,818,430,388
'1126061100,  중화3동,'65,60 - 64세,1998,464,236,228
'1126061100,  중화3동,'70,65 - 69세,1998,312,127,185
'1126061100,  중화3동,'75,70 - 74세,1998,181,71,110
'1126061100,  중화3동,'80,75 - 79세,1998,111,38,73
'1126061100,  중화3동,'85,80 - 84세,1998,67,13,54
'1126061100,  중화3동,'90,85+ ,1998,43,8,35
'1126062000,  묵1동,'00,계,1998,32074,15999,16075
'1126062000,  묵1동,'05,0 - 4세,1998,1955,1030,925
'1126062000,  묵1동,'10,5 - 9세,1998,2231,1168,1063
'1126062000,  묵1동,'15,10 - 14세,1998,2242,1160,1082
'1126062000,  묵1동,'20,15 - 19세,1998,2925,1490,1435
'1126062000,  묵1동,'25,20 - 24세,1998,2755,1383,1372
'1126062000,  묵1동,'30,25 - 29세,1998,3191,1622,1569
'1126062000,  묵1동,'35,30 - 34세,1998,2780,1409,1371
'1126062000,  묵1동,'40,35 - 39세,1998,2986,1436,1550
'1126062000,  묵1동,'45,40 - 44세,1998,2915,1445,1470
'1126062000,  묵1동,'50,45 - 49세,1998,2113,1042,1071
'1126062000,  묵1동,'55,50 - 54세,1998,1842,945,897
'1126062000,  묵1동,'60,55 - 59세,1998,1492,768,724
'1126062000,  묵1동,'65,60 - 64세,1998,1051,526,525
'1126062000,  묵1동,'70,65 - 69세,1998,653,283,370
'1126062000,  묵1동,'75,70 - 74세,1998,380,145,235
'1126062000,  묵1동,'80,75 - 79세,1998,279,76,203
'1126062000,  묵1동,'85,80 - 84세,1998,174,47,127
'1126062000,  묵1동,'90,85+ ,1998,110,24,86
'1126063000,  묵2동,'00,계,1998,21205,10588,10617
'1126063000,  묵2동,'05,0 - 4세,1998,1469,756,713
'1126063000,  묵2동,'10,5 - 9세,1998,1527,813,714
'1126063000,  묵2동,'15,10 - 14세,1998,1292,683,609
'1126063000,  묵2동,'20,15 - 19세,1998,1920,938,982
'1126063000,  묵2동,'25,20 - 24세,1998,1901,926,975
'1126063000,  묵2동,'30,25 - 29세,1998,2408,1221,1187
'1126063000,  묵2동,'35,30 - 34세,1998,2115,1075,1040
'1126063000,  묵2동,'40,35 - 39세,1998,2015,1009,1006
'1126063000,  묵2동,'45,40 - 44세,1998,1714,841,873
'1126063000,  묵2동,'50,45 - 49세,1998,1297,678,619
'1126063000,  묵2동,'55,50 - 54세,1998,1115,557,558
'1126063000,  묵2동,'60,55 - 59세,1998,956,496,460
'1126063000,  묵2동,'65,60 - 64세,1998,581,293,288
'1126063000,  묵2동,'70,65 - 69세,1998,372,146,226
'1126063000,  묵2동,'75,70 - 74세,1998,239,86,153
'1126063000,  묵2동,'80,75 - 79세,1998,159,52,107
'1126063000,  묵2동,'85,80 - 84세,1998,89,12,77
'1126063000,  묵2동,'90,85+ ,1998,36,6,30
'1126064000,  망우1동,'00,계,1998,27811,13908,13903
'1126064000,  망우1동,'05,0 - 4세,1998,1713,901,812
'1126064000,  망우1동,'10,5 - 9세,1998,1838,972,866
'1126064000,  망우1동,'15,10 - 14세,1998,2051,1080,971
'1126064000,  망우1동,'20,15 - 19세,1998,2852,1376,1476
'1126064000,  망우1동,'25,20 - 24세,1998,2358,1164,1194
'1126064000,  망우1동,'30,25 - 29세,1998,2767,1413,1354
'1126064000,  망우1동,'35,30 - 34세,1998,2419,1245,1174
'1126064000,  망우1동,'40,35 - 39세,1998,2732,1359,1373
'1126064000,  망우1동,'45,40 - 44세,1998,2531,1209,1322
'1126064000,  망우1동,'50,45 - 49세,1998,1769,925,844
'1126064000,  망우1동,'55,50 - 54세,1998,1478,760,718
'1126064000,  망우1동,'60,55 - 59세,1998,1252,644,608
'1126064000,  망우1동,'65,60 - 64세,1998,824,403,421
'1126064000,  망우1동,'70,65 - 69세,1998,481,202,279
'1126064000,  망우1동,'75,70 - 74세,1998,320,130,190
'1126064000,  망우1동,'80,75 - 79세,1998,233,78,155
'1126064000,  망우1동,'85,80 - 84세,1998,122,34,88
'1126064000,  망우1동,'90,85+ ,1998,71,13,58
'1126065000,  망우2동,'00,계,1998,11228,5618,5610
'1126065000,  망우2동,'05,0 - 4세,1998,771,401,370
'1126065000,  망우2동,'10,5 - 9세,1998,744,359,385
'1126065000,  망우2동,'15,10 - 14세,1998,646,331,315
'1126065000,  망우2동,'20,15 - 19세,1998,977,515,462
'1126065000,  망우2동,'25,20 - 24세,1998,974,464,510
'1126065000,  망우2동,'30,25 - 29세,1998,1290,675,615
'1126065000,  망우2동,'35,30 - 34세,1998,1148,600,548
'1126065000,  망우2동,'40,35 - 39세,1998,1073,563,510
'1126065000,  망우2동,'45,40 - 44세,1998,841,417,424
'1126065000,  망우2동,'50,45 - 49세,1998,662,311,351
'1126065000,  망우2동,'55,50 - 54세,1998,603,280,323
'1126065000,  망우2동,'60,55 - 59세,1998,584,294,290
'1126065000,  망우2동,'65,60 - 64세,1998,378,198,180
'1126065000,  망우2동,'70,65 - 69세,1998,220,100,120
'1126065000,  망우2동,'75,70 - 74세,1998,147,50,97
'1126065000,  망우2동,'80,75 - 79세,1998,90,36,54
'1126065000,  망우2동,'85,80 - 84세,1998,52,16,36
'1126065000,  망우2동,'90,85+ ,1998,28,8,20
'1126066000,  망우3동,'00,계,1998,23576,11752,11824
'1126066000,  망우3동,'05,0 - 4세,1998,1756,889,867
'1126066000,  망우3동,'10,5 - 9세,1998,1857,978,879
'1126066000,  망우3동,'15,10 - 14세,1998,1677,819,858
'1126066000,  망우3동,'20,15 - 19세,1998,2007,962,1045
'1126066000,  망우3동,'25,20 - 24세,1998,1887,954,933
'1126066000,  망우3동,'30,25 - 29세,1998,2470,1192,1278
'1126066000,  망우3동,'35,30 - 34세,1998,2495,1245,1250
'1126066000,  망우3동,'40,35 - 39세,1998,2495,1332,1163
'1126066000,  망우3동,'45,40 - 44세,1998,1950,984,966
'1126066000,  망우3동,'50,45 - 49세,1998,1284,659,625
'1126066000,  망우3동,'55,50 - 54세,1998,1126,563,563
'1126066000,  망우3동,'60,55 - 59세,1998,951,493,458
'1126066000,  망우3동,'65,60 - 64세,1998,582,293,289
'1126066000,  망우3동,'70,65 - 69세,1998,400,172,228
'1126066000,  망우3동,'75,70 - 74세,1998,296,101,195
'1126066000,  망우3동,'80,75 - 79세,1998,187,65,122
'1126066000,  망우3동,'85,80 - 84세,1998,93,30,63
'1126066000,  망우3동,'90,85+ ,1998,63,21,42
'1126068000,  신내1동,'00,계,1998,28176,14161,14015
'1126068000,  신내1동,'05,0 - 4세,1998,1880,1004,876
'1126068000,  신내1동,'10,5 - 9세,1998,2283,1239,1044
'1126068000,  신내1동,'15,10 - 14세,1998,2379,1222,1157
'1126068000,  신내1동,'20,15 - 19세,1998,2496,1231,1265
'1126068000,  신내1동,'25,20 - 24세,1998,2037,1016,1021
'1126068000,  신내1동,'30,25 - 29세,1998,2390,1213,1177
'1126068000,  신내1동,'35,30 - 34세,1998,2465,1157,1308
'1126068000,  신내1동,'40,35 - 39세,1998,3140,1492,1648
'1126068000,  신내1동,'45,40 - 44세,1998,2782,1511,1271
'1126068000,  신내1동,'50,45 - 49세,1998,1756,941,815
'1126068000,  신내1동,'55,50 - 54세,1998,1382,692,690
'1126068000,  신내1동,'60,55 - 59세,1998,1167,623,544
'1126068000,  신내1동,'65,60 - 64세,1998,819,404,415
'1126068000,  신내1동,'70,65 - 69세,1998,463,190,273
'1126068000,  신내1동,'75,70 - 74세,1998,305,112,193
'1126068000,  신내1동,'80,75 - 79세,1998,248,74,174
'1126068000,  신내1동,'85,80 - 84세,1998,108,22,86
'1126068000,  신내1동,'90,85+ ,1998,76,18,58
'1126069000,  신내2동,'00,계,1998,30302,15102,15200
'1126069000,  신내2동,'05,0 - 4세,1998,2527,1360,1167
'1126069000,  신내2동,'10,5 - 9세,1998,2760,1475,1285
'1126069000,  신내2동,'15,10 - 14세,1998,2510,1280,1230
'1126069000,  신내2동,'20,15 - 19세,1998,2654,1368,1286
'1126069000,  신내2동,'25,20 - 24세,1998,1852,935,917
'1126069000,  신내2동,'30,25 - 29세,1998,2505,1129,1376
'1126069000,  신내2동,'35,30 - 34세,1998,3126,1452,1674
'1126069000,  신내2동,'40,35 - 39세,1998,3678,1801,1877
'1126069000,  신내2동,'45,40 - 44세,1998,3008,1600,1408
'1126069000,  신내2동,'50,45 - 49세,1998,1628,860,768
'1126069000,  신내2동,'55,50 - 54세,1998,1167,626,541
'1126069000,  신내2동,'60,55 - 59세,1998,960,486,474
'1126069000,  신내2동,'65,60 - 64세,1998,682,300,382
'1126069000,  신내2동,'70,65 - 69세,1998,468,189,279
'1126069000,  신내2동,'75,70 - 74세,1998,348,110,238
'1126069000,  신내2동,'80,75 - 79세,1998,237,81,156
'1126069000,  신내2동,'85,80 - 84세,1998,123,31,92
'1126069000,  신내2동,'90,85+ ,1998,69,19,50
'11290, 성북구,'00,계,1998,478830,240933,237897
'11290, 성북구,'05,0 - 4세,1998,29690,15476,14214
'11290, 성북구,'10,5 - 9세,1998,28293,14841,13452
'11290, 성북구,'15,10 - 14세,1998,26775,13960,12815
'11290, 성북구,'20,15 - 19세,1998,38988,20519,18469
'11290, 성북구,'25,20 - 24세,1998,44482,22583,21899
'11290, 성북구,'30,25 - 29세,1998,57523,30511,27012
'11290, 성북구,'35,30 - 34세,1998,44840,23657,21183
'11290, 성북구,'40,35 - 39세,1998,42299,21747,20552
'11290, 성북구,'45,40 - 44세,1998,37307,18351,18956
'11290, 성북구,'50,45 - 49세,1998,28764,13864,14900
'11290, 성북구,'55,50 - 54세,1998,27450,12922,14528
'11290, 성북구,'60,55 - 59세,1998,26666,13177,13489
'11290, 성북구,'65,60 - 64세,1998,18640,8997,9643
'11290, 성북구,'70,65 - 69세,1998,11057,4843,6214
'11290, 성북구,'75,70 - 74세,1998,7171,2684,4487
'11290, 성북구,'80,75 - 79세,1998,4803,1768,3035
'11290, 성북구,'85,80 - 84세,1998,2539,672,1867
'11290, 성북구,'90,85+ ,1998,1543,361,1182
'1129051000,  성북1동,'00,계,1998,7536,3740,3796
'1129051000,  성북1동,'05,0 - 4세,1998,442,220,222
'1129051000,  성북1동,'10,5 - 9세,1998,346,185,161
'1129051000,  성북1동,'15,10 - 14세,1998,383,203,180
'1129051000,  성북1동,'20,15 - 19세,1998,590,316,274
'1129051000,  성북1동,'25,20 - 24세,1998,675,341,334
'1129051000,  성북1동,'30,25 - 29세,1998,943,492,451
'1129051000,  성북1동,'35,30 - 34세,1998,734,384,350
'1129051000,  성북1동,'40,35 - 39세,1998,607,315,292
'1129051000,  성북1동,'45,40 - 44세,1998,563,277,286
'1129051000,  성북1동,'50,45 - 49세,1998,431,190,241
'1129051000,  성북1동,'55,50 - 54세,1998,465,217,248
'1129051000,  성북1동,'60,55 - 59세,1998,455,219,236
'1129051000,  성북1동,'65,60 - 64세,1998,302,149,153
'1129051000,  성북1동,'70,65 - 69세,1998,246,106,140
'1129051000,  성북1동,'75,70 - 74세,1998,142,47,95
'1129051000,  성북1동,'80,75 - 79세,1998,124,58,66
'1129051000,  성북1동,'85,80 - 84세,1998,59,14,45
'1129051000,  성북1동,'90,85+ ,1998,29,7,22
'1129052000,  성북2동,'00,계,1998,9359,4722,4637
'1129052000,  성북2동,'05,0 - 4세,1998,467,240,227
'1129052000,  성북2동,'10,5 - 9세,1998,500,258,242
'1129052000,  성북2동,'15,10 - 14세,1998,483,241,242
'1129052000,  성북2동,'20,15 - 19세,1998,658,359,299
'1129052000,  성북2동,'25,20 - 24세,1998,819,438,381
'1129052000,  성북2동,'30,25 - 29세,1998,1090,588,502
'1129052000,  성북2동,'35,30 - 34세,1998,809,438,371
'1129052000,  성북2동,'40,35 - 39세,1998,753,410,343
'1129052000,  성북2동,'45,40 - 44세,1998,659,319,340
'1129052000,  성북2동,'50,45 - 49세,1998,499,230,269
'1129052000,  성북2동,'55,50 - 54세,1998,565,251,314
'1129052000,  성북2동,'60,55 - 59세,1998,641,300,341
'1129052000,  성북2동,'65,60 - 64세,1998,522,242,280
'1129052000,  성북2동,'70,65 - 69세,1998,368,177,191
'1129052000,  성북2동,'75,70 - 74세,1998,259,123,136
'1129052000,  성북2동,'80,75 - 79세,1998,164,77,87
'1129052000,  성북2동,'85,80 - 84세,1998,71,24,47
'1129052000,  성북2동,'90,85+ ,1998,32,7,25
'1129053000,  동소문동,'00,계,1998,12444,6093,6351
'1129053000,  동소문동,'05,0 - 4세,1998,831,439,392
'1129053000,  동소문동,'10,5 - 9세,1998,875,437,438
'1129053000,  동소문동,'15,10 - 14세,1998,730,373,357
'1129053000,  동소문동,'20,15 - 19세,1998,882,464,418
'1129053000,  동소문동,'25,20 - 24세,1998,1018,508,510
'1129053000,  동소문동,'30,25 - 29세,1998,1402,689,713
'1129053000,  동소문동,'35,30 - 34세,1998,1176,581,595
'1129053000,  동소문동,'40,35 - 39세,1998,1158,572,586
'1129053000,  동소문동,'45,40 - 44세,1998,1009,491,518
'1129053000,  동소문동,'50,45 - 49세,1998,719,333,386
'1129053000,  동소문동,'55,50 - 54세,1998,723,330,393
'1129053000,  동소문동,'60,55 - 59세,1998,660,347,313
'1129053000,  동소문동,'65,60 - 64세,1998,486,232,254
'1129053000,  동소문동,'70,65 - 69세,1998,310,139,171
'1129053000,  동소문동,'75,70 - 74세,1998,200,79,121
'1129053000,  동소문동,'80,75 - 79세,1998,148,51,97
'1129053000,  동소문동,'85,80 - 84세,1998,69,17,52
'1129053000,  동소문동,'90,85+ ,1998,48,11,37
'1129054000,  삼선1동,'00,계,1998,13398,6688,6710
'1129054000,  삼선1동,'05,0 - 4세,1998,864,443,421
'1129054000,  삼선1동,'10,5 - 9세,1998,645,331,314
'1129054000,  삼선1동,'15,10 - 14세,1998,613,305,308
'1129054000,  삼선1동,'20,15 - 19세,1998,1085,583,502
'1129054000,  삼선1동,'25,20 - 24세,1998,1368,636,732
'1129054000,  삼선1동,'30,25 - 29세,1998,1967,1021,946
'1129054000,  삼선1동,'35,30 - 34세,1998,1297,728,569
'1129054000,  삼선1동,'40,35 - 39세,1998,1080,585,495
'1129054000,  삼선1동,'45,40 - 44세,1998,955,451,504
'1129054000,  삼선1동,'50,45 - 49세,1998,764,386,378
'1129054000,  삼선1동,'55,50 - 54세,1998,748,345,403
'1129054000,  삼선1동,'60,55 - 59세,1998,708,314,394
'1129054000,  삼선1동,'65,60 - 64세,1998,563,260,303
'1129054000,  삼선1동,'70,65 - 69세,1998,309,154,155
'1129054000,  삼선1동,'75,70 - 74세,1998,198,73,125
'1129054000,  삼선1동,'80,75 - 79세,1998,124,42,82
'1129054000,  삼선1동,'85,80 - 84세,1998,62,17,45
'1129054000,  삼선1동,'90,85+ ,1998,48,14,34
'1129055000,  삼선2동,'00,계,1998,16113,7990,8123
'1129055000,  삼선2동,'05,0 - 4세,1998,970,494,476
'1129055000,  삼선2동,'10,5 - 9세,1998,911,462,449
'1129055000,  삼선2동,'15,10 - 14세,1998,814,428,386
'1129055000,  삼선2동,'20,15 - 19세,1998,1307,672,635
'1129055000,  삼선2동,'25,20 - 24세,1998,1522,749,773
'1129055000,  삼선2동,'30,25 - 29세,1998,2025,1079,946
'1129055000,  삼선2동,'35,30 - 34세,1998,1481,792,689
'1129055000,  삼선2동,'40,35 - 39세,1998,1355,679,676
'1129055000,  삼선2동,'45,40 - 44세,1998,1220,594,626
'1129055000,  삼선2동,'50,45 - 49세,1998,965,433,532
'1129055000,  삼선2동,'55,50 - 54세,1998,957,463,494
'1129055000,  삼선2동,'60,55 - 59세,1998,924,450,474
'1129055000,  삼선2동,'65,60 - 64세,1998,629,290,339
'1129055000,  삼선2동,'70,65 - 69세,1998,412,184,228
'1129055000,  삼선2동,'75,70 - 74세,1998,268,92,176
'1129055000,  삼선2동,'80,75 - 79세,1998,188,78,110
'1129055000,  삼선2동,'85,80 - 84세,1998,116,38,78
'1129055000,  삼선2동,'90,85+ ,1998,49,13,36
'1129056000,  동선1동,'00,계,1998,7795,3695,4100
'1129056000,  동선1동,'05,0 - 4세,1998,441,208,233
'1129056000,  동선1동,'10,5 - 9세,1998,381,186,195
'1129056000,  동선1동,'15,10 - 14세,1998,333,165,168
'1129056000,  동선1동,'20,15 - 19세,1998,583,280,303
'1129056000,  동선1동,'25,20 - 24세,1998,877,406,471
'1129056000,  동선1동,'30,25 - 29세,1998,1106,544,562
'1129056000,  동선1동,'35,30 - 34세,1998,728,376,352
'1129056000,  동선1동,'40,35 - 39세,1998,603,292,311
'1129056000,  동선1동,'45,40 - 44세,1998,546,262,284
'1129056000,  동선1동,'50,45 - 49세,1998,461,213,248
'1129056000,  동선1동,'55,50 - 54세,1998,458,196,262
'1129056000,  동선1동,'60,55 - 59세,1998,456,220,236
'1129056000,  동선1동,'65,60 - 64세,1998,303,134,169
'1129056000,  동선1동,'70,65 - 69세,1998,228,100,128
'1129056000,  동선1동,'75,70 - 74세,1998,144,54,90
'1129056000,  동선1동,'80,75 - 79세,1998,87,44,43
'1129056000,  동선1동,'85,80 - 84세,1998,38,7,31
'1129056000,  동선1동,'90,85+ ,1998,22,8,14
'1129057000,  동선2동,'00,계,1998,8164,4011,4153
'1129057000,  동선2동,'05,0 - 4세,1998,401,213,188
'1129057000,  동선2동,'10,5 - 9세,1998,393,200,193
'1129057000,  동선2동,'15,10 - 14세,1998,364,163,201
'1129057000,  동선2동,'20,15 - 19세,1998,606,325,281
'1129057000,  동선2동,'25,20 - 24세,1998,792,401,391
'1129057000,  동선2동,'30,25 - 29세,1998,1143,596,547
'1129057000,  동선2동,'35,30 - 34세,1998,710,383,327
'1129057000,  동선2동,'40,35 - 39세,1998,612,311,301
'1129057000,  동선2동,'45,40 - 44세,1998,589,278,311
'1129057000,  동선2동,'50,45 - 49세,1998,494,237,257
'1129057000,  동선2동,'55,50 - 54세,1998,513,217,296
'1129057000,  동선2동,'60,55 - 59세,1998,558,269,289
'1129057000,  동선2동,'65,60 - 64세,1998,393,188,205
'1129057000,  동선2동,'70,65 - 69세,1998,240,99,141
'1129057000,  동선2동,'75,70 - 74세,1998,151,62,89
'1129057000,  동선2동,'80,75 - 79세,1998,110,40,70
'1129057000,  동선2동,'85,80 - 84세,1998,62,23,39
'1129057000,  동선2동,'90,85+ ,1998,33,6,27
'1129058000,  돈암1동,'00,계,1998,9854,4927,4927
'1129058000,  돈암1동,'05,0 - 4세,1998,676,355,321
'1129058000,  돈암1동,'10,5 - 9세,1998,577,319,258
'1129058000,  돈암1동,'15,10 - 14세,1998,488,242,246
'1129058000,  돈암1동,'20,15 - 19세,1998,790,427,363
'1129058000,  돈암1동,'25,20 - 24세,1998,849,430,419
'1129058000,  돈암1동,'30,25 - 29세,1998,1161,574,587
'1129058000,  돈암1동,'35,30 - 34세,1998,997,528,469
'1129058000,  돈암1동,'40,35 - 39세,1998,891,471,420
'1129058000,  돈암1동,'45,40 - 44세,1998,768,367,401
'1129058000,  돈암1동,'50,45 - 49세,1998,573,269,304
'1129058000,  돈암1동,'55,50 - 54세,1998,587,286,301
'1129058000,  돈암1동,'60,55 - 59세,1998,505,245,260
'1129058000,  돈암1동,'65,60 - 64세,1998,425,197,228
'1129058000,  돈암1동,'70,65 - 69세,1998,248,113,135
'1129058000,  돈암1동,'75,70 - 74세,1998,139,50,89
'1129058000,  돈암1동,'80,75 - 79세,1998,116,41,75
'1129058000,  돈암1동,'85,80 - 84세,1998,40,7,33
'1129058000,  돈암1동,'90,85+ ,1998,24,6,18
'1129059000,  돈암2동,'00,계,1998,13168,6536,6632
'1129059000,  돈암2동,'05,0 - 4세,1998,999,547,452
'1129059000,  돈암2동,'10,5 - 9세,1998,980,516,464
'1129059000,  돈암2동,'15,10 - 14세,1998,866,419,447
'1129059000,  돈암2동,'20,15 - 19세,1998,937,480,457
'1129059000,  돈암2동,'25,20 - 24세,1998,906,468,438
'1129059000,  돈암2동,'30,25 - 29세,1998,1403,672,731
'1129059000,  돈암2동,'35,30 - 34세,1998,1424,702,722
'1129059000,  돈암2동,'40,35 - 39세,1998,1432,710,722
'1129059000,  돈암2동,'45,40 - 44세,1998,1139,615,524
'1129059000,  돈암2동,'50,45 - 49세,1998,700,342,358
'1129059000,  돈암2동,'55,50 - 54세,1998,648,304,344
'1129059000,  돈암2동,'60,55 - 59세,1998,608,295,313
'1129059000,  돈암2동,'65,60 - 64세,1998,447,218,229
'1129059000,  돈암2동,'70,65 - 69세,1998,274,110,164
'1129059000,  돈암2동,'75,70 - 74세,1998,196,78,118
'1129059000,  돈암2동,'80,75 - 79세,1998,108,42,66
'1129059000,  돈암2동,'85,80 - 84세,1998,59,6,53
'1129059000,  돈암2동,'90,85+ ,1998,42,12,30
'1129060000,  안암동,'00,계,1998,19056,9742,9314
'1129060000,  안암동,'05,0 - 4세,1998,1073,573,500
'1129060000,  안암동,'10,5 - 9세,1998,899,476,423
'1129060000,  안암동,'15,10 - 14세,1998,1025,588,437
'1129060000,  안암동,'20,15 - 19세,1998,1438,788,650
'1129060000,  안암동,'25,20 - 24세,1998,2163,1084,1079
'1129060000,  안암동,'30,25 - 29세,1998,2811,1606,1205
'1129060000,  안암동,'35,30 - 34세,1998,1727,963,764
'1129060000,  안암동,'40,35 - 39세,1998,1536,757,779
'1129060000,  안암동,'45,40 - 44세,1998,1329,632,697
'1129060000,  안암동,'50,45 - 49세,1998,1050,476,574
'1129060000,  안암동,'55,50 - 54세,1998,1028,481,547
'1129060000,  안암동,'60,55 - 59세,1998,1037,494,543
'1129060000,  안암동,'65,60 - 64세,1998,782,370,412
'1129060000,  안암동,'70,65 - 69세,1998,459,203,256
'1129060000,  안암동,'75,70 - 74세,1998,312,121,191
'1129060000,  안암동,'80,75 - 79세,1998,210,75,135
'1129060000,  안암동,'85,80 - 84세,1998,125,39,86
'1129060000,  안암동,'90,85+ ,1998,52,16,36
'1129061000,  보문동,'00,계,1998,19446,9681,9765
'1129061000,  보문동,'05,0 - 4세,1998,1310,699,611
'1129061000,  보문동,'10,5 - 9세,1998,1162,612,550
'1129061000,  보문동,'15,10 - 14세,1998,1093,563,530
'1129061000,  보문동,'20,15 - 19세,1998,1430,786,644
'1129061000,  보문동,'25,20 - 24세,1998,1701,832,869
'1129061000,  보문동,'30,25 - 29세,1998,2459,1218,1241
'1129061000,  보문동,'35,30 - 34세,1998,2037,1096,941
'1129061000,  보문동,'40,35 - 39세,1998,1748,896,852
'1129061000,  보문동,'45,40 - 44세,1998,1499,746,753
'1129061000,  보문동,'50,45 - 49세,1998,1113,522,591
'1129061000,  보문동,'55,50 - 54세,1998,1058,484,574
'1129061000,  보문동,'60,55 - 59세,1998,957,467,490
'1129061000,  보문동,'65,60 - 64세,1998,768,351,417
'1129061000,  보문동,'70,65 - 69세,1998,479,185,294
'1129061000,  보문동,'75,70 - 74세,1998,300,117,183
'1129061000,  보문동,'80,75 - 79세,1998,194,70,124
'1129061000,  보문동,'85,80 - 84세,1998,77,23,54
'1129061000,  보문동,'90,85+ ,1998,61,14,47
'1129062000,  정릉1동,'00,계,1998,18113,8888,9225
'1129062000,  정릉1동,'05,0 - 4세,1998,988,542,446
'1129062000,  정릉1동,'10,5 - 9세,1998,1104,595,509
'1129062000,  정릉1동,'15,10 - 14세,1998,1119,589,530
'1129062000,  정릉1동,'20,15 - 19세,1998,1456,769,687
'1129062000,  정릉1동,'25,20 - 24세,1998,1521,777,744
'1129062000,  정릉1동,'30,25 - 29세,1998,1996,1004,992
'1129062000,  정릉1동,'35,30 - 34세,1998,1619,815,804
'1129062000,  정릉1동,'40,35 - 39세,1998,1681,792,889
'1129062000,  정릉1동,'45,40 - 44세,1998,1523,708,815
'1129062000,  정릉1동,'50,45 - 49세,1998,1142,549,593
'1129062000,  정릉1동,'55,50 - 54세,1998,1038,471,567
'1129062000,  정릉1동,'60,55 - 59세,1998,1077,517,560
'1129062000,  정릉1동,'65,60 - 64세,1998,790,384,406
'1129062000,  정릉1동,'70,65 - 69세,1998,420,178,242
'1129062000,  정릉1동,'75,70 - 74세,1998,272,87,185
'1129062000,  정릉1동,'80,75 - 79세,1998,195,67,128
'1129062000,  정릉1동,'85,80 - 84세,1998,99,26,73
'1129062000,  정릉1동,'90,85+ ,1998,73,18,55
'1129063000,  정릉2동,'00,계,1998,19866,10089,9777
'1129063000,  정릉2동,'05,0 - 4세,1998,1154,627,527
'1129063000,  정릉2동,'10,5 - 9세,1998,1163,616,547
'1129063000,  정릉2동,'15,10 - 14세,1998,1078,583,495
'1129063000,  정릉2동,'20,15 - 19세,1998,1604,842,762
'1129063000,  정릉2동,'25,20 - 24세,1998,1817,984,833
'1129063000,  정릉2동,'30,25 - 29세,1998,2265,1215,1050
'1129063000,  정릉2동,'35,30 - 34세,1998,1751,925,826
'1129063000,  정릉2동,'40,35 - 39세,1998,1669,847,822
'1129063000,  정릉2동,'45,40 - 44세,1998,1597,772,825
'1129063000,  정릉2동,'50,45 - 49세,1998,1226,601,625
'1129063000,  정릉2동,'55,50 - 54세,1998,1182,581,601
'1129063000,  정릉2동,'60,55 - 59세,1998,1153,571,582
'1129063000,  정릉2동,'65,60 - 64세,1998,896,417,479
'1129063000,  정릉2동,'70,65 - 69세,1998,488,222,266
'1129063000,  정릉2동,'75,70 - 74세,1998,356,138,218
'1129063000,  정릉2동,'80,75 - 79세,1998,235,85,150
'1129063000,  정릉2동,'85,80 - 84세,1998,141,37,104
'1129063000,  정릉2동,'90,85+ ,1998,91,26,65
'1129064000,  정릉3동,'00,계,1998,21114,10577,10537
'1129064000,  정릉3동,'05,0 - 4세,1998,1248,623,625
'1129064000,  정릉3동,'10,5 - 9세,1998,1164,612,552
'1129064000,  정릉3동,'15,10 - 14세,1998,1246,630,616
'1129064000,  정릉3동,'20,15 - 19세,1998,1664,890,774
'1129064000,  정릉3동,'25,20 - 24세,1998,1869,1000,869
'1129064000,  정릉3동,'30,25 - 29세,1998,2614,1529,1085
'1129064000,  정릉3동,'35,30 - 34세,1998,1812,940,872
'1129064000,  정릉3동,'40,35 - 39세,1998,1800,867,933
'1129064000,  정릉3동,'45,40 - 44세,1998,1737,804,933
'1129064000,  정릉3동,'50,45 - 49세,1998,1270,595,675
'1129064000,  정릉3동,'55,50 - 54세,1998,1243,575,668
'1129064000,  정릉3동,'60,55 - 59세,1998,1239,570,669
'1129064000,  정릉3동,'65,60 - 64세,1998,873,428,445
'1129064000,  정릉3동,'70,65 - 69세,1998,514,221,293
'1129064000,  정릉3동,'75,70 - 74세,1998,385,142,243
'1129064000,  정릉3동,'80,75 - 79세,1998,260,99,161
'1129064000,  정릉3동,'85,80 - 84세,1998,116,37,79
'1129064000,  정릉3동,'90,85+ ,1998,60,15,45
'1129065000,  정릉4동,'00,계,1998,18550,9325,9225
'1129065000,  정릉4동,'05,0 - 4세,1998,1137,605,532
'1129065000,  정릉4동,'10,5 - 9세,1998,958,487,471
'1129065000,  정릉4동,'15,10 - 14세,1998,948,455,493
'1129065000,  정릉4동,'20,15 - 19세,1998,1572,819,753
'1129065000,  정릉4동,'25,20 - 24세,1998,1627,842,785
'1129065000,  정릉4동,'30,25 - 29세,1998,2110,1130,980
'1129065000,  정릉4동,'35,30 - 34세,1998,1614,897,717
'1129065000,  정릉4동,'40,35 - 39세,1998,1565,797,768
'1129065000,  정릉4동,'45,40 - 44세,1998,1432,681,751
'1129065000,  정릉4동,'50,45 - 49세,1998,1192,617,575
'1129065000,  정릉4동,'55,50 - 54세,1998,1174,540,634
'1129065000,  정릉4동,'60,55 - 59세,1998,1158,562,596
'1129065000,  정릉4동,'65,60 - 64세,1998,797,401,396
'1129065000,  정릉4동,'70,65 - 69세,1998,492,217,275
'1129065000,  정릉4동,'75,70 - 74세,1998,334,131,203
'1129065000,  정릉4동,'80,75 - 79세,1998,241,96,145
'1129065000,  정릉4동,'85,80 - 84세,1998,120,34,86
'1129065000,  정릉4동,'90,85+ ,1998,79,14,65
'1129066000,  길음1동,'00,계,1998,13170,6599,6571
'1129066000,  길음1동,'05,0 - 4세,1998,669,329,340
'1129066000,  길음1동,'10,5 - 9세,1998,611,330,281
'1129066000,  길음1동,'15,10 - 14세,1998,695,366,329
'1129066000,  길음1동,'20,15 - 19세,1998,1120,595,525
'1129066000,  길음1동,'25,20 - 24세,1998,1381,711,670
'1129066000,  길음1동,'30,25 - 29세,1998,1527,851,676
'1129066000,  길음1동,'35,30 - 34세,1998,1052,562,490
'1129066000,  길음1동,'40,35 - 39세,1998,1098,557,541
'1129066000,  길음1동,'45,40 - 44세,1998,1023,491,532
'1129066000,  길음1동,'50,45 - 49세,1998,880,419,461
'1129066000,  길음1동,'55,50 - 54세,1998,856,413,443
'1129066000,  길음1동,'60,55 - 59세,1998,848,414,434
'1129066000,  길음1동,'65,60 - 64세,1998,553,262,291
'1129066000,  길음1동,'70,65 - 69세,1998,328,139,189
'1129066000,  길음1동,'75,70 - 74세,1998,226,76,150
'1129066000,  길음1동,'80,75 - 79세,1998,149,51,98
'1129066000,  길음1동,'85,80 - 84세,1998,92,23,69
'1129066000,  길음1동,'90,85+ ,1998,62,10,52
'1129067000,  길음2동,'00,계,1998,19653,9999,9654
'1129067000,  길음2동,'05,0 - 4세,1998,980,502,478
'1129067000,  길음2동,'10,5 - 9세,1998,1138,619,519
'1129067000,  길음2동,'15,10 - 14세,1998,1192,620,572
'1129067000,  길음2동,'20,15 - 19세,1998,1827,933,894
'1129067000,  길음2동,'25,20 - 24세,1998,1989,1028,961
'1129067000,  길음2동,'30,25 - 29세,1998,2094,1173,921
'1129067000,  길음2동,'35,30 - 34세,1998,1650,867,783
'1129067000,  길음2동,'40,35 - 39세,1998,1645,869,776
'1129067000,  길음2동,'45,40 - 44세,1998,1580,787,793
'1129067000,  길음2동,'50,45 - 49세,1998,1260,631,629
'1129067000,  길음2동,'55,50 - 54세,1998,1174,574,600
'1129067000,  길음2동,'60,55 - 59세,1998,1144,575,569
'1129067000,  길음2동,'65,60 - 64세,1998,816,372,444
'1129067000,  길음2동,'70,65 - 69세,1998,490,205,285
'1129067000,  길음2동,'75,70 - 74세,1998,303,112,191
'1129067000,  길음2동,'80,75 - 79세,1998,219,84,135
'1129067000,  길음2동,'85,80 - 84세,1998,93,31,62
'1129067000,  길음2동,'90,85+ ,1998,59,17,42
'1129068000,  길음3동,'00,계,1998,15309,7709,7600
'1129068000,  길음3동,'05,0 - 4세,1998,889,448,441
'1129068000,  길음3동,'10,5 - 9세,1998,819,452,367
'1129068000,  길음3동,'15,10 - 14세,1998,759,418,341
'1129068000,  길음3동,'20,15 - 19세,1998,1250,646,604
'1129068000,  길음3동,'25,20 - 24세,1998,1545,783,762
'1129068000,  길음3동,'30,25 - 29세,1998,2020,1068,952
'1129068000,  길음3동,'35,30 - 34세,1998,1402,789,613
'1129068000,  길음3동,'40,35 - 39세,1998,1256,646,610
'1129068000,  길음3동,'45,40 - 44세,1998,1148,534,614
'1129068000,  길음3동,'50,45 - 49세,1998,970,438,532
'1129068000,  길음3동,'55,50 - 54세,1998,929,435,494
'1129068000,  길음3동,'60,55 - 59세,1998,920,452,468
'1129068000,  길음3동,'65,60 - 64세,1998,587,294,293
'1129068000,  길음3동,'70,65 - 69세,1998,350,143,207
'1129068000,  길음3동,'75,70 - 74세,1998,201,81,120
'1129068000,  길음3동,'80,75 - 79세,1998,140,56,84
'1129068000,  길음3동,'85,80 - 84세,1998,80,18,62
'1129068000,  길음3동,'90,85+ ,1998,44,8,36
'1129068500,  길음2동,'00,계,1998,,,
'1129068500,  길음2동,'05,0 - 4세,1998,,,
'1129068500,  길음2동,'10,5 - 9세,1998,,,
'1129068500,  길음2동,'15,10 - 14세,1998,,,
'1129068500,  길음2동,'20,15 - 19세,1998,,,
'1129068500,  길음2동,'25,20 - 24세,1998,,,
'1129068500,  길음2동,'30,25 - 29세,1998,,,
'1129068500,  길음2동,'35,30 - 34세,1998,,,
'1129068500,  길음2동,'40,35 - 39세,1998,,,
'1129068500,  길음2동,'45,40 - 44세,1998,,,
'1129068500,  길음2동,'50,45 - 49세,1998,,,
'1129068500,  길음2동,'55,50 - 54세,1998,,,
'1129068500,  길음2동,'60,55 - 59세,1998,,,
'1129068500,  길음2동,'65,60 - 64세,1998,,,
'1129068500,  길음2동,'70,65 - 69세,1998,,,
'1129068500,  길음2동,'75,70 - 74세,1998,,,
'1129068500,  길음2동,'80,75 - 79세,1998,,,
'1129068500,  길음2동,'85,80 - 84세,1998,,,
'1129068500,  길음2동,'90,85+ ,1998,,,
'1129069000,  종암1동,'00,계,1998,21340,10794,10546
'1129069000,  종암1동,'05,0 - 4세,1998,1261,661,600
'1129069000,  종암1동,'10,5 - 9세,1998,1204,637,567
'1129069000,  종암1동,'15,10 - 14세,1998,1205,620,585
'1129069000,  종암1동,'20,15 - 19세,1998,1765,942,823
'1129069000,  종암1동,'25,20 - 24세,1998,2112,1081,1031
'1129069000,  종암1동,'30,25 - 29세,1998,2557,1395,1162
'1129069000,  종암1동,'35,30 - 34세,1998,1890,1013,877
'1129069000,  종암1동,'40,35 - 39세,1998,1851,941,910
'1129069000,  종암1동,'45,40 - 44세,1998,1665,821,844
'1129069000,  종암1동,'50,45 - 49세,1998,1306,602,704
'1129069000,  종암1동,'55,50 - 54세,1998,1260,593,667
'1129069000,  종암1동,'60,55 - 59세,1998,1234,606,628
'1129069000,  종암1동,'65,60 - 64세,1998,821,416,405
'1129069000,  종암1동,'70,65 - 69세,1998,511,242,269
'1129069000,  종암1동,'75,70 - 74세,1998,302,98,204
'1129069000,  종암1동,'80,75 - 79세,1998,211,79,132
'1129069000,  종암1동,'85,80 - 84세,1998,122,38,84
'1129069000,  종암1동,'90,85+ ,1998,63,9,54
'1129070000,  종암2동,'00,계,1998,19480,9915,9565
'1129070000,  종암2동,'05,0 - 4세,1998,1184,620,564
'1129070000,  종암2동,'10,5 - 9세,1998,1217,633,584
'1129070000,  종암2동,'15,10 - 14세,1998,1236,677,559
'1129070000,  종암2동,'20,15 - 19세,1998,1720,896,824
'1129070000,  종암2동,'25,20 - 24세,1998,1621,847,774
'1129070000,  종암2동,'30,25 - 29세,1998,2259,1269,990
'1129070000,  종암2동,'35,30 - 34세,1998,1787,943,844
'1129070000,  종암2동,'40,35 - 39세,1998,1926,966,960
'1129070000,  종암2동,'45,40 - 44세,1998,1610,818,792
'1129070000,  종암2동,'50,45 - 49세,1998,1183,572,611
'1129070000,  종암2동,'55,50 - 54세,1998,1014,479,535
'1129070000,  종암2동,'60,55 - 59세,1998,1009,502,507
'1129070000,  종암2동,'65,60 - 64세,1998,690,311,379
'1129070000,  종암2동,'70,65 - 69세,1998,412,187,225
'1129070000,  종암2동,'75,70 - 74세,1998,260,89,171
'1129070000,  종암2동,'80,75 - 79세,1998,206,74,132
'1129070000,  종암2동,'85,80 - 84세,1998,85,20,65
'1129070000,  종암2동,'90,85+ ,1998,61,12,49
'1129071000,  하월곡1동,'00,계,1998,17716,8898,8818
'1129071000,  하월곡1동,'05,0 - 4세,1998,1021,495,526
'1129071000,  하월곡1동,'10,5 - 9세,1998,1181,609,572
'1129071000,  하월곡1동,'15,10 - 14세,1998,1074,549,525
'1129071000,  하월곡1동,'20,15 - 19세,1998,1521,817,704
'1129071000,  하월곡1동,'25,20 - 24세,1998,1604,816,788
'1129071000,  하월곡1동,'30,25 - 29세,1998,1955,1040,915
'1129071000,  하월곡1동,'35,30 - 34세,1998,1624,816,808
'1129071000,  하월곡1동,'40,35 - 39세,1998,1721,869,852
'1129071000,  하월곡1동,'45,40 - 44세,1998,1415,739,676
'1129071000,  하월곡1동,'50,45 - 49세,1998,1122,537,585
'1129071000,  하월곡1동,'55,50 - 54세,1998,1021,486,535
'1129071000,  하월곡1동,'60,55 - 59세,1998,933,496,437
'1129071000,  하월곡1동,'65,60 - 64세,1998,665,316,349
'1129071000,  하월곡1동,'70,65 - 69세,1998,357,156,201
'1129071000,  하월곡1동,'75,70 - 74세,1998,233,83,150
'1129071000,  하월곡1동,'80,75 - 79세,1998,127,37,90
'1129071000,  하월곡1동,'85,80 - 84세,1998,86,25,61
'1129071000,  하월곡1동,'90,85+ ,1998,56,12,44
'1129072000,  하월곡2동,'00,계,1998,11149,5696,5453
'1129072000,  하월곡2동,'05,0 - 4세,1998,741,374,367
'1129072000,  하월곡2동,'10,5 - 9세,1998,699,373,326
'1129072000,  하월곡2동,'15,10 - 14세,1998,577,293,284
'1129072000,  하월곡2동,'20,15 - 19세,1998,897,496,401
'1129072000,  하월곡2동,'25,20 - 24세,1998,1059,483,576
'1129072000,  하월곡2동,'30,25 - 29세,1998,1323,730,593
'1129072000,  하월곡2동,'35,30 - 34세,1998,1148,604,544
'1129072000,  하월곡2동,'40,35 - 39세,1998,997,553,444
'1129072000,  하월곡2동,'45,40 - 44세,1998,803,423,380
'1129072000,  하월곡2동,'50,45 - 49세,1998,654,323,331
'1129072000,  하월곡2동,'55,50 - 54세,1998,579,264,315
'1129072000,  하월곡2동,'60,55 - 59세,1998,659,335,324
'1129072000,  하월곡2동,'65,60 - 64세,1998,421,214,207
'1129072000,  하월곡2동,'70,65 - 69세,1998,257,103,154
'1129072000,  하월곡2동,'75,70 - 74세,1998,173,71,102
'1129072000,  하월곡2동,'80,75 - 79세,1998,80,32,48
'1129072000,  하월곡2동,'85,80 - 84세,1998,50,15,35
'1129072000,  하월곡2동,'90,85+ ,1998,32,10,22
'1129073000,  하월곡3동,'00,계,1998,7510,3905,3605
'1129073000,  하월곡3동,'05,0 - 4세,1998,355,189,166
'1129073000,  하월곡3동,'10,5 - 9세,1998,344,169,175
'1129073000,  하월곡3동,'15,10 - 14세,1998,405,219,186
'1129073000,  하월곡3동,'20,15 - 19세,1998,736,380,356
'1129073000,  하월곡3동,'25,20 - 24세,1998,805,459,346
'1129073000,  하월곡3동,'30,25 - 29세,1998,796,467,329
'1129073000,  하월곡3동,'35,30 - 34세,1998,603,342,261
'1129073000,  하월곡3동,'40,35 - 39세,1998,609,341,268
'1129073000,  하월곡3동,'45,40 - 44세,1998,633,290,343
'1129073000,  하월곡3동,'50,45 - 49세,1998,549,272,277
'1129073000,  하월곡3동,'55,50 - 54세,1998,480,244,236
'1129073000,  하월곡3동,'60,55 - 59세,1998,451,218,233
'1129073000,  하월곡3동,'65,60 - 64세,1998,326,160,166
'1129073000,  하월곡3동,'70,65 - 69세,1998,192,88,104
'1129073000,  하월곡3동,'75,70 - 74세,1998,98,34,64
'1129073000,  하월곡3동,'80,75 - 79세,1998,69,22,47
'1129073000,  하월곡3동,'85,80 - 84세,1998,40,6,34
'1129073000,  하월곡3동,'90,85+ ,1998,19,5,14
'1129074000,  하월곡4동,'00,계,1998,7424,3878,3546
'1129074000,  하월곡4동,'05,0 - 4세,1998,372,199,173
'1129074000,  하월곡4동,'10,5 - 9세,1998,457,243,214
'1129074000,  하월곡4동,'15,10 - 14세,1998,430,242,188
'1129074000,  하월곡4동,'20,15 - 19세,1998,758,377,381
'1129074000,  하월곡4동,'25,20 - 24세,1998,705,361,344
'1129074000,  하월곡4동,'30,25 - 29세,1998,749,445,304
'1129074000,  하월곡4동,'35,30 - 34세,1998,635,349,286
'1129074000,  하월곡4동,'40,35 - 39세,1998,654,358,296
'1129074000,  하월곡4동,'45,40 - 44세,1998,642,341,301
'1129074000,  하월곡4동,'50,45 - 49세,1998,467,253,214
'1129074000,  하월곡4동,'55,50 - 54세,1998,403,178,225
'1129074000,  하월곡4동,'60,55 - 59세,1998,432,220,212
'1129074000,  하월곡4동,'65,60 - 64세,1998,332,164,168
'1129074000,  하월곡4동,'70,65 - 69세,1998,158,67,91
'1129074000,  하월곡4동,'75,70 - 74세,1998,104,41,63
'1129074000,  하월곡4동,'80,75 - 79세,1998,70,27,43
'1129074000,  하월곡4동,'85,80 - 84세,1998,39,10,29
'1129074000,  하월곡4동,'90,85+ ,1998,17,3,14
'1129075000,  상월곡동,'00,계,1998,7934,3995,3939
'1129075000,  상월곡동,'05,0 - 4세,1998,522,277,245
'1129075000,  상월곡동,'10,5 - 9세,1998,495,274,221
'1129075000,  상월곡동,'15,10 - 14세,1998,514,259,255
'1129075000,  상월곡동,'20,15 - 19세,1998,664,344,320
'1129075000,  상월곡동,'25,20 - 24세,1998,733,360,373
'1129075000,  상월곡동,'30,25 - 29세,1998,860,433,427
'1129075000,  상월곡동,'35,30 - 34세,1998,750,388,362
'1129075000,  상월곡동,'40,35 - 39세,1998,730,376,354
'1129075000,  상월곡동,'45,40 - 44세,1998,646,320,326
'1129075000,  상월곡동,'50,45 - 49세,1998,435,227,208
'1129075000,  상월곡동,'55,50 - 54세,1998,460,220,240
'1129075000,  상월곡동,'60,55 - 59세,1998,415,218,197
'1129075000,  상월곡동,'65,60 - 64세,1998,292,132,160
'1129075000,  상월곡동,'70,65 - 69세,1998,182,85,97
'1129075000,  상월곡동,'75,70 - 74세,1998,93,39,54
'1129075000,  상월곡동,'80,75 - 79세,1998,79,24,55
'1129075000,  상월곡동,'85,80 - 84세,1998,34,9,25
'1129075000,  상월곡동,'90,85+ ,1998,30,10,20
'1129076000,  장위1동,'00,계,1998,28614,14278,14336
'1129076000,  장위1동,'05,0 - 4세,1998,2014,1028,986
'1129076000,  장위1동,'10,5 - 9세,1998,1897,989,908
'1129076000,  장위1동,'15,10 - 14세,1998,1648,850,798
'1129076000,  장위1동,'20,15 - 19세,1998,2387,1210,1177
'1129076000,  장위1동,'25,20 - 24세,1998,2573,1288,1285
'1129076000,  장위1동,'30,25 - 29세,1998,3307,1661,1646
'1129076000,  장위1동,'35,30 - 34세,1998,2872,1473,1399
'1129076000,  장위1동,'40,35 - 39세,1998,2618,1380,1238
'1129076000,  장위1동,'45,40 - 44세,1998,2204,1074,1130
'1129076000,  장위1동,'50,45 - 49세,1998,1719,833,886
'1129076000,  장위1동,'55,50 - 54세,1998,1556,761,795
'1129076000,  장위1동,'60,55 - 59세,1998,1495,748,747
'1129076000,  장위1동,'65,60 - 64세,1998,963,468,495
'1129076000,  장위1동,'70,65 - 69세,1998,550,240,310
'1129076000,  장위1동,'75,70 - 74세,1998,380,138,242
'1129076000,  장위1동,'80,75 - 79세,1998,225,80,145
'1129076000,  장위1동,'85,80 - 84세,1998,128,37,91
'1129076000,  장위1동,'90,85+ ,1998,78,20,58
'1129077000,  장위2동,'00,계,1998,25913,13052,12861
'1129077000,  장위2동,'05,0 - 4세,1998,1763,918,845
'1129077000,  장위2동,'10,5 - 9세,1998,1589,801,788
'1129077000,  장위2동,'15,10 - 14세,1998,1559,820,739
'1129077000,  장위2동,'20,15 - 19세,1998,2177,1158,1019
'1129077000,  장위2동,'25,20 - 24세,1998,2419,1196,1223
'1129077000,  장위2동,'30,25 - 29세,1998,3048,1581,1467
'1129077000,  장위2동,'35,30 - 34세,1998,2426,1253,1173
'1129077000,  장위2동,'40,35 - 39세,1998,2317,1231,1086
'1129077000,  장위2동,'45,40 - 44세,1998,2041,1001,1040
'1129077000,  장위2동,'50,45 - 49세,1998,1558,790,768
'1129077000,  장위2동,'55,50 - 54세,1998,1496,687,809
'1129077000,  장위2동,'60,55 - 59세,1998,1391,726,665
'1129077000,  장위2동,'65,60 - 64세,1998,868,431,437
'1129077000,  장위2동,'70,65 - 69세,1998,514,215,299
'1129077000,  장위2동,'75,70 - 74세,1998,333,135,198
'1129077000,  장위2동,'80,75 - 79세,1998,203,70,133
'1129077000,  장위2동,'85,80 - 84세,1998,124,22,102
'1129077000,  장위2동,'90,85+ ,1998,87,17,70
'1129078000,  장위3동,'00,계,1998,22425,11513,10912
'1129078000,  장위3동,'05,0 - 4세,1998,1330,710,620
'1129078000,  장위3동,'10,5 - 9세,1998,1341,700,641
'1129078000,  장위3동,'15,10 - 14세,1998,1232,685,547
'1129078000,  장위3동,'20,15 - 19세,1998,1914,995,919
'1129078000,  장위3동,'25,20 - 24세,1998,2197,1132,1065
'1129078000,  장위3동,'30,25 - 29세,1998,2663,1475,1188
'1129078000,  장위3동,'35,30 - 34세,1998,2078,1090,988
'1129078000,  장위3동,'40,35 - 39세,1998,1904,982,922
'1129078000,  장위3동,'45,40 - 44세,1998,1738,855,883
'1129078000,  장위3동,'50,45 - 49세,1998,1419,704,715
'1129078000,  장위3동,'55,50 - 54세,1998,1345,655,690
'1129078000,  장위3동,'60,55 - 59세,1998,1299,660,639
'1129078000,  장위3동,'65,60 - 64세,1998,852,442,410
'1129078000,  장위3동,'70,65 - 69세,1998,466,220,246
'1129078000,  장위3동,'75,70 - 74세,1998,289,115,174
'1129078000,  장위3동,'80,75 - 79세,1998,186,51,135
'1129078000,  장위3동,'85,80 - 84세,1998,107,26,81
'1129078000,  장위3동,'90,85+ ,1998,65,16,49
'1129079000,  석관1동,'00,계,1998,32229,16409,15820
'1129079000,  석관1동,'05,0 - 4세,1998,2432,1282,1150
'1129079000,  석관1동,'10,5 - 9세,1998,2217,1179,1038
'1129079000,  석관1동,'15,10 - 14세,1998,1914,1006,908
'1129079000,  석관1동,'20,15 - 19세,1998,2512,1315,1197
'1129079000,  석관1동,'25,20 - 24세,1998,2877,1464,1413
'1129079000,  석관1동,'30,25 - 29세,1998,3992,2003,1989
'1129079000,  석관1동,'35,30 - 34세,1998,3433,1789,1644
'1129079000,  석관1동,'40,35 - 39세,1998,3154,1661,1493
'1129079000,  석관1동,'45,40 - 44세,1998,2508,1291,1217
'1129079000,  석관1동,'50,45 - 49세,1998,1786,866,920
'1129079000,  석관1동,'55,50 - 54세,1998,1692,816,876
'1129079000,  석관1동,'60,55 - 59세,1998,1518,807,711
'1129079000,  석관1동,'65,60 - 64세,1998,937,490,447
'1129079000,  석관1동,'70,65 - 69세,1998,489,198,291
'1129079000,  석관1동,'75,70 - 74세,1998,336,120,216
'1129079000,  석관1동,'80,75 - 79세,1998,211,78,133
'1129079000,  석관1동,'85,80 - 84세,1998,143,32,111
'1129079000,  석관1동,'90,85+ ,1998,78,12,66
'1129080000,  석관2동,'00,계,1998,14988,7589,7399
'1129080000,  석관2동,'05,0 - 4세,1998,1156,616,540
'1129080000,  석관2동,'10,5 - 9세,1998,1026,541,485
'1129080000,  석관2동,'15,10 - 14세,1998,752,389,363
'1129080000,  석관2동,'20,15 - 19세,1998,1138,615,523
'1129080000,  석관2동,'25,20 - 24세,1998,1338,678,660
'1129080000,  석관2동,'30,25 - 29세,1998,1878,963,915
'1129080000,  석관2동,'35,30 - 34세,1998,1574,831,743
'1129080000,  석관2동,'40,35 - 39세,1998,1329,716,613
'1129080000,  석관2동,'45,40 - 44세,1998,1086,569,517
'1129080000,  석관2동,'50,45 - 49세,1998,857,404,453
'1129080000,  석관2동,'55,50 - 54세,1998,798,376,422
'1129080000,  석관2동,'60,55 - 59세,1998,782,360,422
'1129080000,  석관2동,'65,60 - 64세,1998,541,264,277
'1129080000,  석관2동,'70,65 - 69세,1998,314,147,167
'1129080000,  석관2동,'75,70 - 74세,1998,184,58,126
'1129080000,  석관2동,'80,75 - 79세,1998,124,38,86
'1129080000,  석관2동,'85,80 - 84세,1998,62,11,51
'1129080000,  석관2동,'90,85+ ,1998,49,13,36
'11305, 강북구,'00,계,1998,360814,180184,180630
'11305, 강북구,'05,0 - 4세,1998,22579,11813,10766
'11305, 강북구,'10,5 - 9세,1998,21554,11191,10363
'11305, 강북구,'15,10 - 14세,1998,20357,10707,9650
'11305, 강북구,'20,15 - 19세,1998,30218,15660,14558
'11305, 강북구,'25,20 - 24세,1998,35038,17333,17705
'11305, 강북구,'30,25 - 29세,1998,43094,22139,20955
'11305, 강북구,'35,30 - 34세,1998,33237,17321,15916
'11305, 강북구,'40,35 - 39세,1998,31482,16094,15388
'11305, 강북구,'45,40 - 44세,1998,27621,13543,14078
'11305, 강북구,'50,45 - 49세,1998,22094,10383,11711
'11305, 강북구,'55,50 - 54세,1998,21368,9968,11400
'11305, 강북구,'60,55 - 59세,1998,20677,10344,10333
'11305, 강북구,'65,60 - 64세,1998,13330,6735,6595
'11305, 강북구,'70,65 - 69세,1998,7278,3370,3908
'11305, 강북구,'75,70 - 74세,1998,4574,1694,2880
'11305, 강북구,'80,75 - 79세,1998,3343,1159,2184
'11305, 강북구,'85,80 - 84세,1998,1824,490,1334
'11305, 강북구,'90,85+ ,1998,1146,240,906
'1130553100,  미아1동,'00,계,1998,11730,6021,5709
'1130553100,  미아1동,'05,0 - 4세,1998,635,346,289
'1130553100,  미아1동,'10,5 - 9세,1998,728,386,342
'1130553100,  미아1동,'15,10 - 14세,1998,743,403,340
'1130553100,  미아1동,'20,15 - 19세,1998,1032,506,526
'1130553100,  미아1동,'25,20 - 24세,1998,1130,599,531
'1130553100,  미아1동,'30,25 - 29세,1998,1218,665,553
'1130553100,  미아1동,'35,30 - 34세,1998,986,514,472
'1130553100,  미아1동,'40,35 - 39세,1998,1097,598,499
'1130553100,  미아1동,'45,40 - 44세,1998,881,440,441
'1130553100,  미아1동,'50,45 - 49세,1998,773,393,380
'1130553100,  미아1동,'55,50 - 54세,1998,717,332,385
'1130553100,  미아1동,'60,55 - 59세,1998,709,361,348
'1130553100,  미아1동,'65,60 - 64세,1998,473,250,223
'1130553100,  미아1동,'70,65 - 69세,1998,261,115,146
'1130553100,  미아1동,'75,70 - 74세,1998,154,56,98
'1130553100,  미아1동,'80,75 - 79세,1998,116,43,73
'1130553100,  미아1동,'85,80 - 84세,1998,52,10,42
'1130553100,  미아1동,'90,85+ ,1998,25,4,21
'1130553200,  미아2동,'00,계,1998,19332,9839,9493
'1130553200,  미아2동,'05,0 - 4세,1998,1206,623,583
'1130553200,  미아2동,'10,5 - 9세,1998,1204,623,581
'1130553200,  미아2동,'15,10 - 14세,1998,1164,602,562
'1130553200,  미아2동,'20,15 - 19세,1998,1640,850,790
'1130553200,  미아2동,'25,20 - 24세,1998,1815,914,901
'1130553200,  미아2동,'30,25 - 29세,1998,2172,1171,1001
'1130553200,  미아2동,'35,30 - 34세,1998,1856,990,866
'1130553200,  미아2동,'40,35 - 39세,1998,1785,934,851
'1130553200,  미아2동,'45,40 - 44세,1998,1519,802,717
'1130553200,  미아2동,'50,45 - 49세,1998,1096,535,561
'1130553200,  미아2동,'55,50 - 54세,1998,1096,544,552
'1130553200,  미아2동,'60,55 - 59세,1998,1022,506,516
'1130553200,  미아2동,'65,60 - 64세,1998,744,355,389
'1130553200,  미아2동,'70,65 - 69세,1998,410,186,224
'1130553200,  미아2동,'75,70 - 74세,1998,262,91,171
'1130553200,  미아2동,'80,75 - 79세,1998,209,77,132
'1130553200,  미아2동,'85,80 - 84세,1998,76,21,55
'1130553200,  미아2동,'90,85+ ,1998,56,15,41
'1130553300,  미아3동,'00,계,1998,27622,13969,13653
'1130553300,  미아3동,'05,0 - 4세,1998,1702,875,827
'1130553300,  미아3동,'10,5 - 9세,1998,1631,872,759
'1130553300,  미아3동,'15,10 - 14세,1998,1665,950,715
'1130553300,  미아3동,'20,15 - 19세,1998,2327,1277,1050
'1130553300,  미아3동,'25,20 - 24세,1998,2601,1298,1303
'1130553300,  미아3동,'30,25 - 29세,1998,3480,1772,1708
'1130553300,  미아3동,'35,30 - 34세,1998,2637,1389,1248
'1130553300,  미아3동,'40,35 - 39세,1998,2431,1214,1217
'1130553300,  미아3동,'45,40 - 44세,1998,2258,1098,1160
'1130553300,  미아3동,'50,45 - 49세,1998,1669,769,900
'1130553300,  미아3동,'55,50 - 54세,1998,1595,776,819
'1130553300,  미아3동,'60,55 - 59세,1998,1507,740,767
'1130553300,  미아3동,'65,60 - 64세,1998,940,489,451
'1130553300,  미아3동,'70,65 - 69세,1998,475,228,247
'1130553300,  미아3동,'75,70 - 74세,1998,304,108,196
'1130553300,  미아3동,'80,75 - 79세,1998,201,66,135
'1130553300,  미아3동,'85,80 - 84세,1998,119,31,88
'1130553300,  미아3동,'90,85+ ,1998,80,17,63
'1130554000,  미아4동,'00,계,1998,20340,9987,10353
'1130554000,  미아4동,'05,0 - 4세,1998,1345,708,637
'1130554000,  미아4동,'10,5 - 9세,1998,1175,595,580
'1130554000,  미아4동,'15,10 - 14세,1998,1102,536,566
'1130554000,  미아4동,'20,15 - 19세,1998,1671,847,824
'1130554000,  미아4동,'25,20 - 24세,1998,2054,962,1092
'1130554000,  미아4동,'30,25 - 29세,1998,2650,1344,1306
'1130554000,  미아4동,'35,30 - 34세,1998,1958,1020,938
'1130554000,  미아4동,'40,35 - 39세,1998,1741,890,851
'1130554000,  미아4동,'45,40 - 44세,1998,1565,746,819
'1130554000,  미아4동,'50,45 - 49세,1998,1223,570,653
'1130554000,  미아4동,'55,50 - 54세,1998,1069,493,576
'1130554000,  미아4동,'60,55 - 59세,1998,1118,554,564
'1130554000,  미아4동,'65,60 - 64세,1998,729,356,373
'1130554000,  미아4동,'70,65 - 69세,1998,389,190,199
'1130554000,  미아4동,'75,70 - 74세,1998,234,76,158
'1130554000,  미아4동,'80,75 - 79세,1998,187,67,120
'1130554000,  미아4동,'85,80 - 84세,1998,80,22,58
'1130554000,  미아4동,'90,85+ ,1998,50,11,39
'1130555000,  미아5동,'00,계,1998,20454,10342,10112
'1130555000,  미아5동,'05,0 - 4세,1998,1289,700,589
'1130555000,  미아5동,'10,5 - 9세,1998,1309,683,626
'1130555000,  미아5동,'15,10 - 14세,1998,1285,706,579
'1130555000,  미아5동,'20,15 - 19세,1998,1703,900,803
'1130555000,  미아5동,'25,20 - 24세,1998,1888,909,979
'1130555000,  미아5동,'30,25 - 29세,1998,2511,1297,1214
'1130555000,  미아5동,'35,30 - 34세,1998,1951,1014,937
'1130555000,  미아5동,'40,35 - 39세,1998,1859,951,908
'1130555000,  미아5동,'45,40 - 44세,1998,1542,807,735
'1130555000,  미아5동,'50,45 - 49세,1998,1165,550,615
'1130555000,  미아5동,'55,50 - 54세,1998,1170,540,630
'1130555000,  미아5동,'60,55 - 59세,1998,1113,577,536
'1130555000,  미아5동,'65,60 - 64세,1998,721,347,374
'1130555000,  미아5동,'70,65 - 69세,1998,386,181,205
'1130555000,  미아5동,'75,70 - 74세,1998,243,83,160
'1130555000,  미아5동,'80,75 - 79세,1998,179,68,111
'1130555000,  미아5동,'85,80 - 84세,1998,88,25,63
'1130555000,  미아5동,'90,85+ ,1998,52,4,48
'1130556500,  미아6.7동,'00,계,1998,13339,6727,6612
'1130556500,  미아6.7동,'05,0 - 4세,1998,586,308,278
'1130556500,  미아6.7동,'10,5 - 9세,1998,768,408,360
'1130556500,  미아6.7동,'15,10 - 14세,1998,855,432,423
'1130556500,  미아6.7동,'20,15 - 19세,1998,1244,650,594
'1130556500,  미아6.7동,'25,20 - 24세,1998,1259,630,629
'1130556500,  미아6.7동,'30,25 - 29세,1998,1336,743,593
'1130556500,  미아6.7동,'35,30 - 34세,1998,1074,564,510
'1130556500,  미아6.7동,'40,35 - 39세,1998,1154,591,563
'1130556500,  미아6.7동,'45,40 - 44세,1998,1156,580,576
'1130556500,  미아6.7동,'50,45 - 49세,1998,886,465,421
'1130556500,  미아6.7동,'55,50 - 54세,1998,758,363,395
'1130556500,  미아6.7동,'60,55 - 59세,1998,878,410,468
'1130556500,  미아6.7동,'65,60 - 64세,1998,578,272,306
'1130556500,  미아6.7동,'70,65 - 69세,1998,338,141,197
'1130556500,  미아6.7동,'75,70 - 74세,1998,213,84,129
'1130556500,  미아6.7동,'80,75 - 79세,1998,135,53,82
'1130556500,  미아6.7동,'85,80 - 84세,1998,76,23,53
'1130556500,  미아6.7동,'90,85+ ,1998,45,10,35
'1130558000,  미아8동,'00,계,1998,19603,9768,9835
'1130558000,  미아8동,'05,0 - 4세,1998,1194,608,586
'1130558000,  미아8동,'10,5 - 9세,1998,1134,574,560
'1130558000,  미아8동,'15,10 - 14세,1998,1136,592,544
'1130558000,  미아8동,'20,15 - 19세,1998,1719,829,890
'1130558000,  미아8동,'25,20 - 24세,1998,1877,899,978
'1130558000,  미아8동,'30,25 - 29세,1998,2329,1255,1074
'1130558000,  미아8동,'35,30 - 34세,1998,1823,966,857
'1130558000,  미아8동,'40,35 - 39세,1998,1721,887,834
'1130558000,  미아8동,'45,40 - 44세,1998,1507,721,786
'1130558000,  미아8동,'50,45 - 49세,1998,1264,643,621
'1130558000,  미아8동,'55,50 - 54세,1998,1073,488,585
'1130558000,  미아8동,'60,55 - 59세,1998,1159,564,595
'1130558000,  미아8동,'65,60 - 64세,1998,736,379,357
'1130558000,  미아8동,'70,65 - 69세,1998,387,199,188
'1130558000,  미아8동,'75,70 - 74세,1998,226,82,144
'1130558000,  미아8동,'80,75 - 79세,1998,141,43,98
'1130558000,  미아8동,'85,80 - 84세,1998,106,26,80
'1130558000,  미아8동,'90,85+ ,1998,71,13,58
'1130558100,  미아9동,'00,계,1998,20387,10082,10305
'1130558100,  미아9동,'05,0 - 4세,1998,1145,581,564
'1130558100,  미아9동,'10,5 - 9세,1998,1181,585,596
'1130558100,  미아9동,'15,10 - 14세,1998,1167,630,537
'1130558100,  미아9동,'20,15 - 19세,1998,1809,956,853
'1130558100,  미아9동,'25,20 - 24세,1998,1924,941,983
'1130558100,  미아9동,'30,25 - 29세,1998,2415,1252,1163
'1130558100,  미아9동,'35,30 - 34세,1998,1786,898,888
'1130558100,  미아9동,'40,35 - 39세,1998,1861,894,967
'1130558100,  미아9동,'45,40 - 44세,1998,1604,763,841
'1130558100,  미아9동,'50,45 - 49세,1998,1307,621,686
'1130558100,  미아9동,'55,50 - 54세,1998,1243,594,649
'1130558100,  미아9동,'60,55 - 59세,1998,1185,573,612
'1130558100,  미아9동,'65,60 - 64세,1998,801,433,368
'1130558100,  미아9동,'70,65 - 69세,1998,389,180,209
'1130558100,  미아9동,'75,70 - 74세,1998,242,100,142
'1130558100,  미아9동,'80,75 - 79세,1998,164,52,112
'1130558100,  미아9동,'85,80 - 84세,1998,97,20,77
'1130558100,  미아9동,'90,85+ ,1998,67,9,58
'1130559000,  번1동,'00,계,1998,23163,11542,11621
'1130559000,  번1동,'05,0 - 4세,1998,1877,957,920
'1130559000,  번1동,'10,5 - 9세,1998,1372,710,662
'1130559000,  번1동,'15,10 - 14세,1998,959,489,470
'1130559000,  번1동,'20,15 - 19세,1998,1680,868,812
'1130559000,  번1동,'25,20 - 24세,1998,2207,1057,1150
'1130559000,  번1동,'30,25 - 29세,1998,3392,1682,1710
'1130559000,  번1동,'35,30 - 34세,1998,2507,1373,1134
'1130559000,  번1동,'40,35 - 39세,1998,1947,1024,923
'1130559000,  번1동,'45,40 - 44세,1998,1550,759,791
'1130559000,  번1동,'50,45 - 49세,1998,1249,594,655
'1130559000,  번1동,'55,50 - 54세,1998,1280,592,688
'1130559000,  번1동,'60,55 - 59세,1998,1224,597,627
'1130559000,  번1동,'65,60 - 64세,1998,808,394,414
'1130559000,  번1동,'70,65 - 69세,1998,477,231,246
'1130559000,  번1동,'75,70 - 74세,1998,290,111,179
'1130559000,  번1동,'80,75 - 79세,1998,179,61,118
'1130559000,  번1동,'85,80 - 84세,1998,99,23,76
'1130559000,  번1동,'90,85+ ,1998,66,20,46
'1130560000,  번2동,'00,계,1998,25070,12563,12507
'1130560000,  번2동,'05,0 - 4세,1998,1718,913,805
'1130560000,  번2동,'10,5 - 9세,1998,1507,799,708
'1130560000,  번2동,'15,10 - 14세,1998,1400,744,656
'1130560000,  번2동,'20,15 - 19세,1998,2244,1140,1104
'1130560000,  번2동,'25,20 - 24세,1998,2579,1271,1308
'1130560000,  번2동,'30,25 - 29세,1998,2983,1538,1445
'1130560000,  번2동,'35,30 - 34세,1998,2343,1239,1104
'1130560000,  번2동,'40,35 - 39세,1998,2203,1181,1022
'1130560000,  번2동,'45,40 - 44세,1998,1861,903,958
'1130560000,  번2동,'50,45 - 49세,1998,1481,689,792
'1130560000,  번2동,'55,50 - 54세,1998,1525,659,866
'1130560000,  번2동,'60,55 - 59세,1998,1428,719,709
'1130560000,  번2동,'65,60 - 64세,1998,823,423,400
'1130560000,  번2동,'70,65 - 69세,1998,392,187,205
'1130560000,  번2동,'75,70 - 74세,1998,226,77,149
'1130560000,  번2동,'80,75 - 79세,1998,176,45,131
'1130560000,  번2동,'85,80 - 84세,1998,116,24,92
'1130560000,  번2동,'90,85+ ,1998,65,12,53
'1130560600,  번3동,'00,계,1998,22917,10849,12068
'1130560600,  번3동,'05,0 - 4세,1998,1119,560,559
'1130560600,  번3동,'10,5 - 9세,1998,1031,522,509
'1130560600,  번3동,'15,10 - 14세,1998,1074,546,528
'1130560600,  번3동,'20,15 - 19세,1998,2278,1099,1179
'1130560600,  번3동,'25,20 - 24세,1998,3491,1638,1853
'1130560600,  번3동,'30,25 - 29세,1998,2820,1463,1357
'1130560600,  번3동,'35,30 - 34세,1998,1604,811,793
'1130560600,  번3동,'40,35 - 39세,1998,1383,699,684
'1130560600,  번3동,'45,40 - 44세,1998,1381,623,758
'1130560600,  번3동,'50,45 - 49세,1998,1538,546,992
'1130560600,  번3동,'55,50 - 54세,1998,1819,764,1055
'1130560600,  번3동,'60,55 - 59세,1998,1594,847,747
'1130560600,  번3동,'65,60 - 64세,1998,745,406,339
'1130560600,  번3동,'70,65 - 69세,1998,358,174,184
'1130560600,  번3동,'75,70 - 74세,1998,236,77,159
'1130560600,  번3동,'80,75 - 79세,1998,220,52,168
'1130560600,  번3동,'85,80 - 84세,1998,137,15,122
'1130560600,  번3동,'90,85+ ,1998,89,7,82
'1130561000,  수유1동,'00,계,1998,26407,13357,13050
'1130561000,  수유1동,'05,0 - 4세,1998,1672,878,794
'1130561000,  수유1동,'10,5 - 9세,1998,1707,893,814
'1130561000,  수유1동,'15,10 - 14세,1998,1605,816,789
'1130561000,  수유1동,'20,15 - 19세,1998,2159,1134,1025
'1130561000,  수유1동,'25,20 - 24세,1998,2324,1214,1110
'1130561000,  수유1동,'30,25 - 29세,1998,2976,1545,1431
'1130561000,  수유1동,'35,30 - 34세,1998,2498,1301,1197
'1130561000,  수유1동,'40,35 - 39세,1998,2462,1248,1214
'1130561000,  수유1동,'45,40 - 44세,1998,2064,1048,1016
'1130561000,  수유1동,'50,45 - 49세,1998,1606,767,839
'1130561000,  수유1동,'55,50 - 54세,1998,1501,751,750
'1130561000,  수유1동,'60,55 - 59세,1998,1424,703,721
'1130561000,  수유1동,'65,60 - 64세,1998,1029,523,506
'1130561000,  수유1동,'70,65 - 69세,1998,568,247,321
'1130561000,  수유1동,'75,70 - 74세,1998,352,136,216
'1130561000,  수유1동,'80,75 - 79세,1998,242,86,156
'1130561000,  수유1동,'85,80 - 84세,1998,144,44,100
'1130561000,  수유1동,'90,85+ ,1998,74,23,51
'1130562000,  수유2동,'00,계,1998,24361,12198,12163
'1130562000,  수유2동,'05,0 - 4세,1998,1528,826,702
'1130562000,  수유2동,'10,5 - 9세,1998,1486,786,700
'1130562000,  수유2동,'15,10 - 14세,1998,1366,698,668
'1130562000,  수유2동,'20,15 - 19세,1998,2000,1066,934
'1130562000,  수유2동,'25,20 - 24세,1998,2192,1131,1061
'1130562000,  수유2동,'30,25 - 29세,1998,2751,1362,1389
'1130562000,  수유2동,'35,30 - 34세,1998,2188,1109,1079
'1130562000,  수유2동,'40,35 - 39세,1998,2104,1072,1032
'1130562000,  수유2동,'45,40 - 44세,1998,2011,962,1049
'1130562000,  수유2동,'50,45 - 49세,1998,1606,784,822
'1130562000,  수유2동,'55,50 - 54세,1998,1461,675,786
'1130562000,  수유2동,'60,55 - 59세,1998,1413,734,679
'1130562000,  수유2동,'65,60 - 64세,1998,906,453,453
'1130562000,  수유2동,'70,65 - 69세,1998,530,232,298
'1130562000,  수유2동,'75,70 - 74세,1998,338,130,208
'1130562000,  수유2동,'80,75 - 79세,1998,254,117,137
'1130562000,  수유2동,'85,80 - 84세,1998,139,43,96
'1130562000,  수유2동,'90,85+ ,1998,88,18,70
'1130563000,  수유3동,'00,계,1998,27227,13544,13683
'1130563000,  수유3동,'05,0 - 4세,1998,1959,1052,907
'1130563000,  수유3동,'10,5 - 9세,1998,1543,796,747
'1130563000,  수유3동,'15,10 - 14세,1998,1271,693,578
'1130563000,  수유3동,'20,15 - 19세,1998,2018,1058,960
'1130563000,  수유3동,'25,20 - 24세,1998,2646,1264,1382
'1130563000,  수유3동,'30,25 - 29세,1998,3739,1841,1898
'1130563000,  수유3동,'35,30 - 34세,1998,2733,1417,1316
'1130563000,  수유3동,'40,35 - 39세,1998,2271,1214,1057
'1130563000,  수유3동,'45,40 - 44세,1998,1943,921,1022
'1130563000,  수유3동,'50,45 - 49세,1998,1527,687,840
'1130563000,  수유3동,'55,50 - 54세,1998,1556,722,834
'1130563000,  수유3동,'60,55 - 59세,1998,1604,784,820
'1130563000,  수유3동,'65,60 - 64세,1998,1058,527,531
'1130563000,  수유3동,'70,65 - 69세,1998,581,298,283
'1130563000,  수유3동,'75,70 - 74세,1998,345,142,203
'1130563000,  수유3동,'80,75 - 79세,1998,237,78,159
'1130563000,  수유3동,'85,80 - 84세,1998,118,38,80
'1130563000,  수유3동,'90,85+ ,1998,78,12,66
'1130564000,  수유4동,'00,계,1998,21799,10865,10934
'1130564000,  수유4동,'05,0 - 4세,1998,1289,678,611
'1130564000,  수유4동,'10,5 - 9세,1998,1322,670,652
'1130564000,  수유4동,'15,10 - 14세,1998,1193,647,546
'1130564000,  수유4동,'20,15 - 19세,1998,1679,872,807
'1130564000,  수유4동,'25,20 - 24세,1998,1912,1029,883
'1130564000,  수유4동,'30,25 - 29세,1998,2409,1222,1187
'1130564000,  수유4동,'35,30 - 34세,1998,1923,978,945
'1130564000,  수유4동,'40,35 - 39세,1998,1995,979,1016
'1130564000,  수유4동,'45,40 - 44세,1998,1698,864,834
'1130564000,  수유4동,'50,45 - 49세,1998,1385,648,737
'1130564000,  수유4동,'55,50 - 54세,1998,1367,630,737
'1130564000,  수유4동,'60,55 - 59세,1998,1290,662,628
'1130564000,  수유4동,'65,60 - 64세,1998,862,428,434
'1130564000,  수유4동,'70,65 - 69세,1998,552,242,310
'1130564000,  수유4동,'75,70 - 74세,1998,371,140,231
'1130564000,  수유4동,'80,75 - 79세,1998,282,100,182
'1130564000,  수유4동,'85,80 - 84세,1998,168,49,119
'1130564000,  수유4동,'90,85+ ,1998,102,27,75
'1130565000,  수유5동,'00,계,1998,19517,9787,9730
'1130565000,  수유5동,'05,0 - 4세,1998,1230,648,582
'1130565000,  수유5동,'10,5 - 9세,1998,1219,648,571
'1130565000,  수유5동,'15,10 - 14세,1998,1065,556,509
'1130565000,  수유5동,'20,15 - 19세,1998,1574,814,760
'1130565000,  수유5동,'25,20 - 24세,1998,1762,869,893
'1130565000,  수유5동,'30,25 - 29세,1998,2239,1166,1073
'1130565000,  수유5동,'35,30 - 34세,1998,1805,947,858
'1130565000,  수유5동,'40,35 - 39세,1998,1735,867,868
'1130565000,  수유5동,'45,40 - 44세,1998,1496,718,778
'1130565000,  수유5동,'50,45 - 49세,1998,1252,594,658
'1130565000,  수유5동,'55,50 - 54세,1998,1218,592,626
'1130565000,  수유5동,'60,55 - 59세,1998,1119,582,537
'1130565000,  수유5동,'65,60 - 64세,1998,741,376,365
'1130565000,  수유5동,'70,65 - 69세,1998,410,180,230
'1130565000,  수유5동,'75,70 - 74세,1998,268,95,173
'1130565000,  수유5동,'80,75 - 79세,1998,211,74,137
'1130565000,  수유5동,'85,80 - 84세,1998,112,42,70
'1130565000,  수유5동,'90,85+ ,1998,61,19,42
'1130565100,  수유6동,'00,계,1998,17546,8744,8802
'1130565100,  수유6동,'05,0 - 4세,1998,1085,552,533
'1130565100,  수유6동,'10,5 - 9세,1998,1237,641,596
'1130565100,  수유6동,'15,10 - 14세,1998,1307,667,640
'1130565100,  수유6동,'20,15 - 19세,1998,1441,794,647
'1130565100,  수유6동,'25,20 - 24세,1998,1377,708,669
'1130565100,  수유6동,'30,25 - 29세,1998,1674,821,853
'1130565100,  수유6동,'35,30 - 34세,1998,1565,791,774
'1130565100,  수유6동,'40,35 - 39세,1998,1733,851,882
'1130565100,  수유6동,'45,40 - 44세,1998,1585,788,797
'1130565100,  수유6동,'50,45 - 49세,1998,1067,528,539
'1130565100,  수유6동,'55,50 - 54세,1998,920,453,467
'1130565100,  수유6동,'60,55 - 59세,1998,890,431,459
'1130565100,  수유6동,'65,60 - 64세,1998,636,324,312
'1130565100,  수유6동,'70,65 - 69세,1998,375,159,216
'1130565100,  수유6동,'75,70 - 74세,1998,270,106,164
'1130565100,  수유6동,'80,75 - 79세,1998,210,77,133
'1130565100,  수유6동,'85,80 - 84세,1998,97,34,63
'1130565100,  수유6동,'90,85+ ,1998,77,19,58
'11320, 도봉구,'00,계,1998,380844,190969,189875
'11320, 도봉구,'05,0 - 4세,1998,26865,14068,12797
'11320, 도봉구,'10,5 - 9세,1998,28328,14966,13362
'11320, 도봉구,'15,10 - 14세,1998,28609,15151,13458
'11320, 도봉구,'20,15 - 19세,1998,33202,17324,15878
'11320, 도봉구,'25,20 - 24세,1998,28299,14331,13968
'11320, 도봉구,'30,25 - 29세,1998,37696,18510,19186
'11320, 도봉구,'35,30 - 34세,1998,36154,18077,18077
'11320, 도봉구,'40,35 - 39세,1998,39529,19091,20438
'11320, 도봉구,'45,40 - 44세,1998,36411,18433,17978
'11320, 도봉구,'50,45 - 49세,1998,23035,12102,10933
'11320, 도봉구,'55,50 - 54세,1998,17868,9069,8799
'11320, 도봉구,'60,55 - 59세,1998,15853,8099,7754
'11320, 도봉구,'65,60 - 64세,1998,11009,5212,5797
'11320, 도봉구,'70,65 - 69세,1998,7257,3037,4220
'11320, 도봉구,'75,70 - 74세,1998,4757,1752,3005
'11320, 도봉구,'80,75 - 79세,1998,3205,1060,2145
'11320, 도봉구,'85,80 - 84세,1998,1761,485,1276
'11320, 도봉구,'90,85+ ,1998,1006,202,804
'1132051100,  창1동,'00,계,1998,32122,15994,16128
'1132051100,  창1동,'05,0 - 4세,1998,2375,1214,1161
'1132051100,  창1동,'10,5 - 9세,1998,2399,1235,1164
'1132051100,  창1동,'15,10 - 14세,1998,2518,1384,1134
'1132051100,  창1동,'20,15 - 19세,1998,2733,1407,1326
'1132051100,  창1동,'25,20 - 24세,1998,2182,1092,1090
'1132051100,  창1동,'30,25 - 29세,1998,3290,1510,1780
'1132051100,  창1동,'35,30 - 34세,1998,3219,1612,1607
'1132051100,  창1동,'40,35 - 39세,1998,3338,1556,1782
'1132051100,  창1동,'45,40 - 44세,1998,3175,1655,1520
'1132051100,  창1동,'50,45 - 49세,1998,1973,1053,920
'1132051100,  창1동,'55,50 - 54세,1998,1383,713,670
'1132051100,  창1동,'60,55 - 59세,1998,1207,605,602
'1132051100,  창1동,'65,60 - 64세,1998,889,420,469
'1132051100,  창1동,'70,65 - 69세,1998,597,256,341
'1132051100,  창1동,'75,70 - 74세,1998,413,160,253
'1132051100,  창1동,'80,75 - 79세,1998,222,75,147
'1132051100,  창1동,'85,80 - 84세,1998,132,34,98
'1132051100,  창1동,'90,85+ ,1998,77,13,64
'1132051200,  창2동,'00,계,1998,27743,13936,13807
'1132051200,  창2동,'05,0 - 4세,1998,2362,1193,1169
'1132051200,  창2동,'10,5 - 9세,1998,2027,1068,959
'1132051200,  창2동,'15,10 - 14세,1998,1513,825,688
'1132051200,  창2동,'20,15 - 19세,1998,2112,1044,1068
'1132051200,  창2동,'25,20 - 24세,1998,2307,1155,1152
'1132051200,  창2동,'30,25 - 29세,1998,3382,1645,1737
'1132051200,  창2동,'35,30 - 34세,1998,3113,1583,1530
'1132051200,  창2동,'40,35 - 39세,1998,2774,1506,1268
'1132051200,  창2동,'45,40 - 44세,1998,2055,1045,1010
'1132051200,  창2동,'50,45 - 49세,1998,1545,781,764
'1132051200,  창2동,'55,50 - 54세,1998,1312,623,689
'1132051200,  창2동,'60,55 - 59세,1998,1282,638,644
'1132051200,  창2동,'65,60 - 64세,1998,822,414,408
'1132051200,  창2동,'70,65 - 69세,1998,479,202,277
'1132051200,  창2동,'75,70 - 74세,1998,290,116,174
'1132051200,  창2동,'80,75 - 79세,1998,202,60,142
'1132051200,  창2동,'85,80 - 84세,1998,110,29,81
'1132051200,  창2동,'90,85+ ,1998,56,9,47
'1132051300,  창3동,'00,계,1998,19999,10138,9861
'1132051300,  창3동,'05,0 - 4세,1998,1545,823,722
'1132051300,  창3동,'10,5 - 9세,1998,1479,777,702
'1132051300,  창3동,'15,10 - 14세,1998,1271,637,634
'1132051300,  창3동,'20,15 - 19세,1998,1671,845,826
'1132051300,  창3동,'25,20 - 24세,1998,1649,843,806
'1132051300,  창3동,'30,25 - 29세,1998,2326,1161,1165
'1132051300,  창3동,'35,30 - 34세,1998,2105,1091,1014
'1132051300,  창3동,'40,35 - 39세,1998,1945,993,952
'1132051300,  창3동,'45,40 - 44세,1998,1636,875,761
'1132051300,  창3동,'50,45 - 49세,1998,1145,580,565
'1132051300,  창3동,'55,50 - 54세,1998,964,498,466
'1132051300,  창3동,'60,55 - 59세,1998,887,468,419
'1132051300,  창3동,'65,60 - 64세,1998,558,275,283
'1132051300,  창3동,'70,65 - 69세,1998,333,127,206
'1132051300,  창3동,'75,70 - 74세,1998,202,74,128
'1132051300,  창3동,'80,75 - 79세,1998,146,40,106
'1132051300,  창3동,'85,80 - 84세,1998,88,25,63
'1132051300,  창3동,'90,85+ ,1998,49,6,43
'1132051400,  창4동,'00,계,1998,31280,15466,15814
'1132051400,  창4동,'05,0 - 4세,1998,2509,1319,1190
'1132051400,  창4동,'10,5 - 9세,1998,2678,1445,1233
'1132051400,  창4동,'15,10 - 14세,1998,2548,1327,1221
'1132051400,  창4동,'20,15 - 19세,1998,2561,1324,1237
'1132051400,  창4동,'25,20 - 24세,1998,1766,847,919
'1132051400,  창4동,'30,25 - 29세,1998,2801,1236,1565
'1132051400,  창4동,'35,30 - 34세,1998,3264,1591,1673
'1132051400,  창4동,'40,35 - 39세,1998,3635,1711,1924
'1132051400,  창4동,'45,40 - 44세,1998,3201,1661,1540
'1132051400,  창4동,'50,45 - 49세,1998,1880,1032,848
'1132051400,  창4동,'55,50 - 54세,1998,1216,640,576
'1132051400,  창4동,'60,55 - 59세,1998,960,486,474
'1132051400,  창4동,'65,60 - 64세,1998,739,325,414
'1132051400,  창4동,'70,65 - 69세,1998,561,210,351
'1132051400,  창4동,'75,70 - 74세,1998,432,157,275
'1132051400,  창4동,'80,75 - 79세,1998,285,89,196
'1132051400,  창4동,'85,80 - 84세,1998,153,48,105
'1132051400,  창4동,'90,85+ ,1998,91,18,73
'1132051500,  창5동,'00,계,1998,20985,10511,10474
'1132051500,  창5동,'05,0 - 4세,1998,1517,769,748
'1132051500,  창5동,'10,5 - 9세,1998,1512,776,736
'1132051500,  창5동,'15,10 - 14세,1998,1315,715,600
'1132051500,  창5동,'20,15 - 19세,1998,1849,981,868
'1132051500,  창5동,'25,20 - 24세,1998,1618,825,793
'1132051500,  창5동,'30,25 - 29세,1998,2356,1148,1208
'1132051500,  창5동,'35,30 - 34세,1998,2087,1073,1014
'1132051500,  창5동,'40,35 - 39세,1998,2085,1055,1030
'1132051500,  창5동,'45,40 - 44세,1998,1769,847,922
'1132051500,  창5동,'50,45 - 49세,1998,1252,652,600
'1132051500,  창5동,'55,50 - 54세,1998,1043,501,542
'1132051500,  창5동,'60,55 - 59세,1998,965,475,490
'1132051500,  창5동,'65,60 - 64세,1998,661,318,343
'1132051500,  창5동,'70,65 - 69세,1998,425,197,228
'1132051500,  창5동,'75,70 - 74세,1998,230,76,154
'1132051500,  창5동,'80,75 - 79세,1998,172,64,108
'1132051500,  창5동,'85,80 - 84세,1998,88,31,57
'1132051500,  창5동,'90,85+ ,1998,41,8,33
'1132052100,  도봉1동,'00,계,1998,30231,15370,14861
'1132052100,  도봉1동,'05,0 - 4세,1998,1900,995,905
'1132052100,  도봉1동,'10,5 - 9세,1998,1765,940,825
'1132052100,  도봉1동,'15,10 - 14세,1998,1728,888,840
'1132052100,  도봉1동,'20,15 - 19세,1998,2696,1454,1242
'1132052100,  도봉1동,'25,20 - 24세,1998,2872,1447,1425
'1132052100,  도봉1동,'30,25 - 29세,1998,3282,1716,1566
'1132052100,  도봉1동,'35,30 - 34세,1998,2673,1411,1262
'1132052100,  도봉1동,'40,35 - 39세,1998,2722,1398,1324
'1132052100,  도봉1동,'45,40 - 44세,1998,2326,1169,1157
'1132052100,  도봉1동,'50,45 - 49세,1998,1871,870,1001
'1132052100,  도봉1동,'55,50 - 54세,1998,1949,972,977
'1132052100,  도봉1동,'60,55 - 59세,1998,1674,895,779
'1132052100,  도봉1동,'65,60 - 64세,1998,1086,535,551
'1132052100,  도봉1동,'70,65 - 69세,1998,677,315,362
'1132052100,  도봉1동,'75,70 - 74세,1998,427,171,256
'1132052100,  도봉1동,'80,75 - 79세,1998,309,113,196
'1132052100,  도봉1동,'85,80 - 84세,1998,177,58,119
'1132052100,  도봉1동,'90,85+ ,1998,97,23,74
'1132052200,  도봉2동,'00,계,1998,32494,16436,16058
'1132052200,  도봉2동,'05,0 - 4세,1998,1982,1059,923
'1132052200,  도봉2동,'10,5 - 9세,1998,2166,1162,1004
'1132052200,  도봉2동,'15,10 - 14세,1998,2178,1120,1058
'1132052200,  도봉2동,'20,15 - 19세,1998,2846,1483,1363
'1132052200,  도봉2동,'25,20 - 24세,1998,2704,1462,1242
'1132052200,  도봉2동,'30,25 - 29세,1998,3176,1689,1487
'1132052200,  도봉2동,'35,30 - 34세,1998,2773,1395,1378
'1132052200,  도봉2동,'40,35 - 39세,1998,3085,1525,1560
'1132052200,  도봉2동,'45,40 - 44세,1998,3006,1506,1500
'1132052200,  도봉2동,'50,45 - 49세,1998,2107,1088,1019
'1132052200,  도봉2동,'55,50 - 54세,1998,1771,883,888
'1132052200,  도봉2동,'60,55 - 59세,1998,1670,829,841
'1132052200,  도봉2동,'65,60 - 64세,1998,1222,572,650
'1132052200,  도봉2동,'70,65 - 69세,1998,769,322,447
'1132052200,  도봉2동,'75,70 - 74세,1998,459,162,297
'1132052200,  도봉2동,'80,75 - 79세,1998,312,117,195
'1132052200,  도봉2동,'85,80 - 84세,1998,166,46,120
'1132052200,  도봉2동,'90,85+ ,1998,102,16,86
'1132066000,  쌍문1동,'00,계,1998,26281,13249,13032
'1132066000,  쌍문1동,'05,0 - 4세,1998,1813,969,844
'1132066000,  쌍문1동,'10,5 - 9세,1998,1741,928,813
'1132066000,  쌍문1동,'15,10 - 14세,1998,1753,935,818
'1132066000,  쌍문1동,'20,15 - 19세,1998,2179,1154,1025
'1132066000,  쌍문1동,'25,20 - 24세,1998,2220,1091,1129
'1132066000,  쌍문1동,'30,25 - 29세,1998,2737,1431,1306
'1132066000,  쌍문1동,'35,30 - 34세,1998,2407,1234,1173
'1132066000,  쌍문1동,'40,35 - 39세,1998,2448,1193,1255
'1132066000,  쌍문1동,'45,40 - 44세,1998,2234,1139,1095
'1132066000,  쌍문1동,'50,45 - 49세,1998,1581,779,802
'1132066000,  쌍문1동,'55,50 - 54세,1998,1465,709,756
'1132066000,  쌍문1동,'60,55 - 59세,1998,1385,709,676
'1132066000,  쌍문1동,'65,60 - 64세,1998,926,461,465
'1132066000,  쌍문1동,'70,65 - 69세,1998,552,261,291
'1132066000,  쌍문1동,'75,70 - 74세,1998,351,126,225
'1132066000,  쌍문1동,'80,75 - 79세,1998,254,78,176
'1132066000,  쌍문1동,'85,80 - 84세,1998,134,36,98
'1132066000,  쌍문1동,'90,85+ ,1998,101,16,85
'1132067000,  쌍문2동,'00,계,1998,22852,11429,11423
'1132067000,  쌍문2동,'05,0 - 4세,1998,1597,839,758
'1132067000,  쌍문2동,'10,5 - 9세,1998,1554,820,734
'1132067000,  쌍문2동,'15,10 - 14세,1998,1766,925,841
'1132067000,  쌍문2동,'20,15 - 19세,1998,2110,1104,1006
'1132067000,  쌍문2동,'25,20 - 24세,1998,1654,837,817
'1132067000,  쌍문2동,'30,25 - 29세,1998,2322,1130,1192
'1132067000,  쌍문2동,'35,30 - 34세,1998,2127,1085,1042
'1132067000,  쌍문2동,'40,35 - 39세,1998,2310,1109,1201
'1132067000,  쌍문2동,'45,40 - 44세,1998,2202,1072,1130
'1132067000,  쌍문2동,'50,45 - 49세,1998,1429,754,675
'1132067000,  쌍문2동,'55,50 - 54세,1998,1048,527,521
'1132067000,  쌍문2동,'60,55 - 59세,1998,960,485,475
'1132067000,  쌍문2동,'65,60 - 64세,1998,691,342,349
'1132067000,  쌍문2동,'70,65 - 69세,1998,442,189,253
'1132067000,  쌍문2동,'75,70 - 74세,1998,296,116,180
'1132067000,  쌍문2동,'80,75 - 79세,1998,181,53,128
'1132067000,  쌍문2동,'85,80 - 84세,1998,107,30,77
'1132067000,  쌍문2동,'90,85+ ,1998,56,12,44
'1132068000,  쌍문3동,'00,계,1998,19762,9811,9951
'1132068000,  쌍문3동,'05,0 - 4세,1998,1434,741,693
'1132068000,  쌍문3동,'10,5 - 9세,1998,1228,665,563
'1132068000,  쌍문3동,'15,10 - 14세,1998,1165,580,585
'1132068000,  쌍문3동,'20,15 - 19세,1998,1653,850,803
'1132068000,  쌍문3동,'25,20 - 24세,1998,1807,891,916
'1132068000,  쌍문3동,'30,25 - 29세,1998,2436,1204,1232
'1132068000,  쌍문3동,'35,30 - 34세,1998,1945,1006,939
'1132068000,  쌍문3동,'40,35 - 39세,1998,1763,903,860
'1132068000,  쌍문3동,'45,40 - 44세,1998,1585,769,816
'1132068000,  쌍문3동,'50,45 - 49세,1998,1141,549,592
'1132068000,  쌍문3동,'55,50 - 54세,1998,1033,485,548
'1132068000,  쌍문3동,'60,55 - 59세,1998,986,489,497
'1132068000,  쌍문3동,'65,60 - 64세,1998,642,311,331
'1132068000,  쌍문3동,'70,65 - 69세,1998,395,168,227
'1132068000,  쌍문3동,'75,70 - 74세,1998,238,96,142
'1132068000,  쌍문3동,'80,75 - 79세,1998,159,59,100
'1132068000,  쌍문3동,'85,80 - 84세,1998,97,24,73
'1132068000,  쌍문3동,'90,85+ ,1998,55,21,34
'1132068100,  쌍문4동,'00,계,1998,24631,12146,12485
'1132068100,  쌍문4동,'05,0 - 4세,1998,1402,753,649
'1132068100,  쌍문4동,'10,5 - 9세,1998,2222,1157,1065
'1132068100,  쌍문4동,'15,10 - 14세,1998,3075,1673,1402
'1132068100,  쌍문4동,'20,15 - 19세,1998,2433,1291,1142
'1132068100,  쌍문4동,'25,20 - 24세,1998,1015,512,503
'1132068100,  쌍문4동,'30,25 - 29세,1998,1459,651,808
'1132068100,  쌍문4동,'35,30 - 34세,1998,1843,818,1025
'1132068100,  쌍문4동,'40,35 - 39세,1998,3189,1302,1887
'1132068100,  쌍문4동,'45,40 - 44세,1998,3513,1781,1732
'1132068100,  쌍문4동,'50,45 - 49세,1998,1594,965,629
'1132068100,  쌍문4동,'55,50 - 54세,1998,746,439,307
'1132068100,  쌍문4동,'60,55 - 59세,1998,540,264,276
'1132068100,  쌍문4동,'65,60 - 64세,1998,481,189,292
'1132068100,  쌍문4동,'70,65 - 69세,1998,407,136,271
'1132068100,  쌍문4동,'75,70 - 74세,1998,326,112,214
'1132068100,  쌍문4동,'80,75 - 79세,1998,218,57,161
'1132068100,  쌍문4동,'85,80 - 84세,1998,116,27,89
'1132068100,  쌍문4동,'90,85+ ,1998,52,19,33
'1132069000,  방학1동,'00,계,1998,26533,13528,13005
'1132069000,  방학1동,'05,0 - 4세,1998,2019,1085,934
'1132069000,  방학1동,'10,5 - 9세,1998,1685,923,762
'1132069000,  방학1동,'15,10 - 14세,1998,1511,800,711
'1132069000,  방학1동,'20,15 - 19세,1998,2371,1243,1128
'1132069000,  방학1동,'25,20 - 24세,1998,2512,1270,1242
'1132069000,  방학1동,'30,25 - 29세,1998,3152,1537,1615
'1132069000,  방학1동,'35,30 - 34세,1998,2744,1497,1247
'1132069000,  방학1동,'40,35 - 39세,1998,2438,1259,1179
'1132069000,  방학1동,'45,40 - 44세,1998,2205,1049,1156
'1132069000,  방학1동,'50,45 - 49세,1998,1618,800,818
'1132069000,  방학1동,'55,50 - 54세,1998,1354,676,678
'1132069000,  방학1동,'60,55 - 59세,1998,1186,637,549
'1132069000,  방학1동,'65,60 - 64세,1998,689,360,329
'1132069000,  방학1동,'70,65 - 69세,1998,430,196,234
'1132069000,  방학1동,'75,70 - 74세,1998,272,100,172
'1132069000,  방학1동,'80,75 - 79세,1998,177,56,121
'1132069000,  방학1동,'85,80 - 84세,1998,102,26,76
'1132069000,  방학1동,'90,85+ ,1998,68,14,54
'1132070000,  방학2동,'00,계,1998,29433,14833,14600
'1132070000,  방학2동,'05,0 - 4세,1998,2138,1098,1040
'1132070000,  방학2동,'10,5 - 9세,1998,2209,1132,1077
'1132070000,  방학2동,'15,10 - 14세,1998,2183,1149,1034
'1132070000,  방학2동,'20,15 - 19세,1998,2580,1328,1252
'1132070000,  방학2동,'25,20 - 24세,1998,2433,1233,1200
'1132070000,  방학2동,'30,25 - 29세,1998,2977,1530,1447
'1132070000,  방학2동,'35,30 - 34세,1998,2880,1435,1445
'1132070000,  방학2동,'40,35 - 39세,1998,3057,1515,1542
'1132070000,  방학2동,'45,40 - 44세,1998,2617,1319,1298
'1132070000,  방학2동,'50,45 - 49세,1998,1739,889,850
'1132070000,  방학2동,'55,50 - 54세,1998,1442,765,677
'1132070000,  방학2동,'60,55 - 59세,1998,1225,664,561
'1132070000,  방학2동,'65,60 - 64세,1998,771,368,403
'1132070000,  방학2동,'70,65 - 69세,1998,471,194,277
'1132070000,  방학2동,'75,70 - 74세,1998,312,112,200
'1132070000,  방학2동,'80,75 - 79세,1998,215,69,146
'1132070000,  방학2동,'85,80 - 84세,1998,115,23,92
'1132070000,  방학2동,'90,85+ ,1998,69,10,59
'1132071000,  방학3동,'00,계,1998,21852,10758,11094
'1132071000,  방학3동,'05,0 - 4세,1998,1543,805,738
'1132071000,  방학3동,'10,5 - 9세,1998,2022,1038,984
'1132071000,  방학3동,'15,10 - 14세,1998,2094,1126,968
'1132071000,  방학3동,'20,15 - 19세,1998,1980,1044,936
'1132071000,  방학3동,'25,20 - 24세,1998,1018,528,490
'1132071000,  방학3동,'30,25 - 29세,1998,1489,684,805
'1132071000,  방학3동,'35,30 - 34세,1998,1996,899,1097
'1132071000,  방학3동,'40,35 - 39세,1998,2671,1222,1449
'1132071000,  방학3동,'45,40 - 44세,1998,2664,1334,1330
'1132071000,  방학3동,'50,45 - 49세,1998,1254,737,517
'1132071000,  방학3동,'55,50 - 54세,1998,735,399,336
'1132071000,  방학3동,'60,55 - 59세,1998,625,301,324
'1132071000,  방학3동,'65,60 - 64세,1998,550,218,332
'1132071000,  방학3동,'70,65 - 69세,1998,472,169,303
'1132071000,  방학3동,'75,70 - 74세,1998,338,124,214
'1132071000,  방학3동,'80,75 - 79세,1998,229,85,144
'1132071000,  방학3동,'85,80 - 84세,1998,114,32,82
'1132071000,  방학3동,'90,85+ ,1998,58,13,45
'1132072000,  방학4동,'00,계,1998,14646,7364,7282
'1132072000,  방학4동,'05,0 - 4세,1998,729,406,323
'1132072000,  방학4동,'10,5 - 9세,1998,1641,900,741
'1132072000,  방학4동,'15,10 - 14세,1998,1991,1067,924
'1132072000,  방학4동,'20,15 - 19세,1998,1428,772,656
'1132072000,  방학4동,'25,20 - 24세,1998,542,298,244
'1132072000,  방학4동,'30,25 - 29세,1998,511,238,273
'1132072000,  방학4동,'35,30 - 34세,1998,978,347,631
'1132072000,  방학4동,'40,35 - 39세,1998,2069,844,1225
'1132072000,  방학4동,'45,40 - 44세,1998,2223,1212,1011
'1132072000,  방학4동,'50,45 - 49세,1998,906,573,333
'1132072000,  방학4동,'55,50 - 54세,1998,407,239,168
'1132072000,  방학4동,'60,55 - 59세,1998,301,154,147
'1132072000,  방학4동,'65,60 - 64세,1998,282,104,178
'1132072000,  방학4동,'70,65 - 69세,1998,247,95,152
'1132072000,  방학4동,'75,70 - 74세,1998,171,50,121
'1132072000,  방학4동,'80,75 - 79세,1998,124,45,79
'1132072000,  방학4동,'85,80 - 84세,1998,62,16,46
'1132072000,  방학4동,'90,85+ ,1998,34,4,30
'11350, 노원구,'00,계,1998,594851,294485,300366
'11350, 노원구,'05,0 - 4세,1998,41323,21768,19555
'11350, 노원구,'10,5 - 9세,1998,45010,23722,21288
'11350, 노원구,'15,10 - 14세,1998,45343,23578,21765
'11350, 노원구,'20,15 - 19세,1998,56063,28657,27406
'11350, 노원구,'25,20 - 24세,1998,44240,22364,21876
'11350, 노원구,'30,25 - 29세,1998,53417,25987,27430
'11350, 노원구,'35,30 - 34세,1998,55281,27102,28179
'11350, 노원구,'40,35 - 39세,1998,62232,29868,32364
'11350, 노원구,'45,40 - 44세,1998,58886,29035,29851
'11350, 노원구,'50,45 - 49세,1998,37281,19663,17618
'11350, 노원구,'55,50 - 54세,1998,26702,13787,12915
'11350, 노원구,'60,55 - 59세,1998,22454,11104,11350
'11350, 노원구,'65,60 - 64세,1998,16413,7364,9049
'11350, 노원구,'70,65 - 69세,1998,11547,4532,7015
'11350, 노원구,'75,70 - 74세,1998,8257,2837,5420
'11350, 노원구,'80,75 - 79세,1998,5773,1926,3847
'11350, 노원구,'85,80 - 84세,1998,2952,799,2153
'11350, 노원구,'90,85+ ,1998,1677,392,1285
'1135056000,  월계1동,'00,계,1998,13987,7033,6954
'1135056000,  월계1동,'05,0 - 4세,1998,806,426,380
'1135056000,  월계1동,'10,5 - 9세,1998,833,429,404
'1135056000,  월계1동,'15,10 - 14세,1998,814,413,401
'1135056000,  월계1동,'20,15 - 19세,1998,1172,630,542
'1135056000,  월계1동,'25,20 - 24세,1998,1317,667,650
'1135056000,  월계1동,'30,25 - 29세,1998,1624,883,741
'1135056000,  월계1동,'35,30 - 34세,1998,1146,593,553
'1135056000,  월계1동,'40,35 - 39세,1998,1190,607,583
'1135056000,  월계1동,'45,40 - 44세,1998,1092,543,549
'1135056000,  월계1동,'50,45 - 49세,1998,923,425,498
'1135056000,  월계1동,'55,50 - 54세,1998,921,416,505
'1135056000,  월계1동,'60,55 - 59세,1998,779,416,363
'1135056000,  월계1동,'65,60 - 64세,1998,537,267,270
'1135056000,  월계1동,'70,65 - 69세,1998,360,171,189
'1135056000,  월계1동,'75,70 - 74세,1998,208,73,135
'1135056000,  월계1동,'80,75 - 79세,1998,146,44,102
'1135056000,  월계1동,'85,80 - 84세,1998,77,22,55
'1135056000,  월계1동,'90,85+ ,1998,42,8,34
'1135057000,  월계2동,'00,계,1998,28671,14014,14657
'1135057000,  월계2동,'05,0 - 4세,1998,2009,1070,939
'1135057000,  월계2동,'10,5 - 9세,1998,1815,967,848
'1135057000,  월계2동,'15,10 - 14세,1998,1902,962,940
'1135057000,  월계2동,'20,15 - 19세,1998,2895,1434,1461
'1135057000,  월계2동,'25,20 - 24세,1998,2660,1362,1298
'1135057000,  월계2동,'30,25 - 29세,1998,2714,1335,1379
'1135057000,  월계2동,'35,30 - 34세,1998,2622,1362,1260
'1135057000,  월계2동,'40,35 - 39세,1998,2704,1291,1413
'1135057000,  월계2동,'45,40 - 44세,1998,2636,1265,1371
'1135057000,  월계2동,'50,45 - 49세,1998,1840,883,957
'1135057000,  월계2동,'55,50 - 54세,1998,1257,673,584
'1135057000,  월계2동,'60,55 - 59세,1998,971,462,509
'1135057000,  월계2동,'65,60 - 64세,1998,750,277,473
'1135057000,  월계2동,'70,65 - 69세,1998,671,241,430
'1135057000,  월계2동,'75,70 - 74세,1998,563,175,388
'1135057000,  월계2동,'80,75 - 79세,1998,397,157,240
'1135057000,  월계2동,'85,80 - 84세,1998,184,75,109
'1135057000,  월계2동,'90,85+ ,1998,81,23,58
'1135058000,  월계3동,'00,계,1998,20745,10346,10399
'1135058000,  월계3동,'05,0 - 4세,1998,1889,980,909
'1135058000,  월계3동,'10,5 - 9세,1998,1875,987,888
'1135058000,  월계3동,'15,10 - 14세,1998,1477,778,699
'1135058000,  월계3동,'20,15 - 19세,1998,1469,780,689
'1135058000,  월계3동,'25,20 - 24세,1998,1185,591,594
'1135058000,  월계3동,'30,25 - 29세,1998,1924,853,1071
'1135058000,  월계3동,'35,30 - 34세,1998,2506,1228,1278
'1135058000,  월계3동,'40,35 - 39세,1998,2511,1264,1247
'1135058000,  월계3동,'45,40 - 44세,1998,1795,950,845
'1135058000,  월계3동,'50,45 - 49세,1998,1079,592,487
'1135058000,  월계3동,'55,50 - 54세,1998,857,435,422
'1135058000,  월계3동,'60,55 - 59세,1998,709,344,365
'1135058000,  월계3동,'65,60 - 64세,1998,539,247,292
'1135058000,  월계3동,'70,65 - 69세,1998,375,131,244
'1135058000,  월계3동,'75,70 - 74세,1998,270,101,169
'1135058000,  월계3동,'80,75 - 79세,1998,166,54,112
'1135058000,  월계3동,'85,80 - 84세,1998,69,18,51
'1135058000,  월계3동,'90,85+ ,1998,50,13,37
'1135058100,  월계4동,'00,계,1998,24939,12300,12639
'1135058100,  월계4동,'05,0 - 4세,1998,1385,727,658
'1135058100,  월계4동,'10,5 - 9세,1998,1401,722,679
'1135058100,  월계4동,'15,10 - 14세,1998,1483,767,716
'1135058100,  월계4동,'20,15 - 19세,1998,2722,1363,1359
'1135058100,  월계4동,'25,20 - 24세,1998,2591,1327,1264
'1135058100,  월계4동,'30,25 - 29세,1998,2558,1357,1201
'1135058100,  월계4동,'35,30 - 34세,1998,2039,1034,1005
'1135058100,  월계4동,'40,35 - 39세,1998,2178,1118,1060
'1135058100,  월계4동,'45,40 - 44세,1998,2026,896,1130
'1135058100,  월계4동,'50,45 - 49세,1998,1644,757,887
'1135058100,  월계4동,'55,50 - 54세,1998,1423,696,727
'1135058100,  월계4동,'60,55 - 59세,1998,1215,638,577
'1135058100,  월계4동,'65,60 - 64세,1998,847,408,439
'1135058100,  월계4동,'70,65 - 69세,1998,540,205,335
'1135058100,  월계4동,'75,70 - 74세,1998,389,137,252
'1135058100,  월계4동,'80,75 - 79세,1998,277,88,189
'1135058100,  월계4동,'85,80 - 84세,1998,144,36,108
'1135058100,  월계4동,'90,85+ ,1998,77,24,53
'1135059000,  공릉1동,'00,계,1998,19698,10040,9658
'1135059000,  공릉1동,'05,0 - 4세,1998,1077,572,505
'1135059000,  공릉1동,'10,5 - 9세,1998,1330,697,633
'1135059000,  공릉1동,'15,10 - 14세,1998,1396,750,646
'1135059000,  공릉1동,'20,15 - 19세,1998,1992,1044,948
'1135059000,  공릉1동,'25,20 - 24세,1998,1692,861,831
'1135059000,  공릉1동,'30,25 - 29세,1998,2004,1088,916
'1135059000,  공릉1동,'35,30 - 34세,1998,1658,852,806
'1135059000,  공릉1동,'40,35 - 39세,1998,1895,907,988
'1135059000,  공릉1동,'45,40 - 44세,1998,1876,941,935
'1135059000,  공릉1동,'50,45 - 49세,1998,1310,696,614
'1135059000,  공릉1동,'55,50 - 54세,1998,1059,550,509
'1135059000,  공릉1동,'60,55 - 59세,1998,833,425,408
'1135059000,  공릉1동,'65,60 - 64세,1998,648,312,336
'1135059000,  공릉1동,'70,65 - 69세,1998,385,184,201
'1135059000,  공릉1동,'75,70 - 74세,1998,214,82,132
'1135059000,  공릉1동,'80,75 - 79세,1998,177,51,126
'1135059000,  공릉1동,'85,80 - 84세,1998,84,17,67
'1135059000,  공릉1동,'90,85+ ,1998,68,11,57
'1135060000,  공릉2동,'00,계,1998,26285,13214,13071
'1135060000,  공릉2동,'05,0 - 4세,1998,1495,755,740
'1135060000,  공릉2동,'10,5 - 9세,1998,1954,1029,925
'1135060000,  공릉2동,'15,10 - 14세,1998,2277,1214,1063
'1135060000,  공릉2동,'20,15 - 19세,1998,2794,1439,1355
'1135060000,  공릉2동,'25,20 - 24세,1998,1958,1002,956
'1135060000,  공릉2동,'30,25 - 29세,1998,2128,1150,978
'1135060000,  공릉2동,'35,30 - 34세,1998,2122,1028,1094
'1135060000,  공릉2동,'40,35 - 39세,1998,2759,1233,1526
'1135060000,  공릉2동,'45,40 - 44세,1998,2921,1481,1440
'1135060000,  공릉2동,'50,45 - 49세,1998,1798,1000,798
'1135060000,  공릉2동,'55,50 - 54세,1998,1228,681,547
'1135060000,  공릉2동,'60,55 - 59세,1998,954,480,474
'1135060000,  공릉2동,'65,60 - 64세,1998,659,299,360
'1135060000,  공릉2동,'70,65 - 69세,1998,449,175,274
'1135060000,  공릉2동,'75,70 - 74세,1998,343,113,230
'1135060000,  공릉2동,'80,75 - 79세,1998,243,88,155
'1135060000,  공릉2동,'85,80 - 84세,1998,127,26,101
'1135060000,  공릉2동,'90,85+ ,1998,76,21,55
'1135060100,  공릉3동,'00,계,1998,18474,9082,9392
'1135060100,  공릉3동,'05,0 - 4세,1998,1136,620,516
'1135060100,  공릉3동,'10,5 - 9세,1998,1330,695,635
'1135060100,  공릉3동,'15,10 - 14세,1998,1343,686,657
'1135060100,  공릉3동,'20,15 - 19세,1998,2180,1115,1065
'1135060100,  공릉3동,'25,20 - 24세,1998,1571,839,732
'1135060100,  공릉3동,'30,25 - 29세,1998,1454,717,737
'1135060100,  공릉3동,'35,30 - 34세,1998,1598,753,845
'1135060100,  공릉3동,'40,35 - 39세,1998,1927,925,1002
'1135060100,  공릉3동,'45,40 - 44세,1998,1819,851,968
'1135060100,  공릉3동,'50,45 - 49세,1998,1181,573,608
'1135060100,  공릉3동,'55,50 - 54세,1998,830,427,403
'1135060100,  공릉3동,'60,55 - 59세,1998,717,369,348
'1135060100,  공릉3동,'65,60 - 64세,1998,469,204,265
'1135060100,  공릉3동,'70,65 - 69세,1998,358,134,224
'1135060100,  공릉3동,'75,70 - 74세,1998,268,86,182
'1135060100,  공릉3동,'80,75 - 79세,1998,171,50,121
'1135060100,  공릉3동,'85,80 - 84세,1998,80,27,53
'1135060100,  공릉3동,'90,85+ ,1998,42,11,31
'1135061100,  하계1동,'00,계,1998,33593,16018,17575
'1135061100,  하계1동,'05,0 - 4세,1998,1808,950,858
'1135061100,  하계1동,'10,5 - 9세,1998,2455,1278,1177
'1135061100,  하계1동,'15,10 - 14세,1998,2652,1361,1291
'1135061100,  하계1동,'20,15 - 19세,1998,3655,1888,1767
'1135061100,  하계1동,'25,20 - 24세,1998,2960,1518,1442
'1135061100,  하계1동,'30,25 - 29세,1998,2362,1152,1210
'1135061100,  하계1동,'35,30 - 34세,1998,2516,1136,1380
'1135061100,  하계1동,'40,35 - 39세,1998,3397,1487,1910
'1135061100,  하계1동,'45,40 - 44세,1998,3621,1671,1950
'1135061100,  하계1동,'50,45 - 49세,1998,2350,1145,1205
'1135061100,  하계1동,'55,50 - 54세,1998,1524,748,776
'1135061100,  하계1동,'60,55 - 59세,1998,1192,544,648
'1135061100,  하계1동,'65,60 - 64세,1998,1032,413,619
'1135061100,  하계1동,'70,65 - 69세,1998,731,265,466
'1135061100,  하계1동,'75,70 - 74세,1998,596,186,410
'1135061100,  하계1동,'80,75 - 79세,1998,412,158,254
'1135061100,  하계1동,'85,80 - 84세,1998,221,78,143
'1135061100,  하계1동,'90,85+ ,1998,109,40,69
'1135061200,  하계2동,'00,계,1998,29369,14415,14954
'1135061200,  하계2동,'05,0 - 4세,1998,2052,1076,976
'1135061200,  하계2동,'10,5 - 9세,1998,2381,1197,1184
'1135061200,  하계2동,'15,10 - 14세,1998,2642,1385,1257
'1135061200,  하계2동,'20,15 - 19세,1998,2747,1406,1341
'1135061200,  하계2동,'25,20 - 24세,1998,1899,933,966
'1135061200,  하계2동,'30,25 - 29세,1998,2336,1105,1231
'1135061200,  하계2동,'35,30 - 34세,1998,2623,1220,1403
'1135061200,  하계2동,'40,35 - 39세,1998,3340,1568,1772
'1135061200,  하계2동,'45,40 - 44세,1998,3202,1583,1619
'1135061200,  하계2동,'50,45 - 49세,1998,1822,967,855
'1135061200,  하계2동,'55,50 - 54세,1998,1197,650,547
'1135061200,  하계2동,'60,55 - 59세,1998,1027,537,490
'1135061200,  하계2동,'65,60 - 64세,1998,707,312,395
'1135061200,  하계2동,'70,65 - 69세,1998,567,219,348
'1135061200,  하계2동,'75,70 - 74세,1998,338,120,218
'1135061200,  하계2동,'80,75 - 79세,1998,262,83,179
'1135061200,  하계2동,'85,80 - 84세,1998,149,34,115
'1135061200,  하계2동,'90,85+ ,1998,78,20,58
'1135061900,  중계본동,'00,계,1998,28139,14080,14059
'1135061900,  중계본동,'05,0 - 4세,1998,1423,747,676
'1135061900,  중계본동,'10,5 - 9세,1998,2460,1301,1159
'1135061900,  중계본동,'15,10 - 14세,1998,2873,1509,1364
'1135061900,  중계본동,'20,15 - 19세,1998,2826,1385,1441
'1135061900,  중계본동,'25,20 - 24세,1998,1734,896,838
'1135061900,  중계본동,'30,25 - 29세,1998,1816,969,847
'1135061900,  중계본동,'35,30 - 34세,1998,1990,856,1134
'1135061900,  중계본동,'40,35 - 39세,1998,3360,1544,1816
'1135061900,  중계본동,'45,40 - 44세,1998,3360,1776,1584
'1135061900,  중계본동,'50,45 - 49세,1998,1841,1055,786
'1135061900,  중계본동,'55,50 - 54세,1998,1179,641,538
'1135061900,  중계본동,'60,55 - 59세,1998,1040,530,510
'1135061900,  중계본동,'65,60 - 64세,1998,823,370,453
'1135061900,  중계본동,'70,65 - 69세,1998,570,233,337
'1135061900,  중계본동,'75,70 - 74세,1998,366,121,245
'1135061900,  중계본동,'80,75 - 79세,1998,251,96,155
'1135061900,  중계본동,'85,80 - 84세,1998,136,31,105
'1135061900,  중계본동,'90,85+ ,1998,91,20,71
'1135062100,  중계1동,'00,계,1998,25740,12858,12882
'1135062100,  중계1동,'05,0 - 4세,1998,1661,919,742
'1135062100,  중계1동,'10,5 - 9세,1998,2583,1390,1193
'1135062100,  중계1동,'15,10 - 14세,1998,2853,1510,1343
'1135062100,  중계1동,'20,15 - 19세,1998,2441,1214,1227
'1135062100,  중계1동,'25,20 - 24세,1998,1251,639,612
'1135062100,  중계1동,'30,25 - 29세,1998,1481,703,778
'1135062100,  중계1동,'35,30 - 34세,1998,2035,884,1151
'1135062100,  중계1동,'40,35 - 39세,1998,3366,1438,1928
'1135062100,  중계1동,'45,40 - 44세,1998,3323,1766,1557
'1135062100,  중계1동,'50,45 - 49세,1998,1600,955,645
'1135062100,  중계1동,'55,50 - 54세,1998,895,506,389
'1135062100,  중계1동,'60,55 - 59세,1998,688,359,329
'1135062100,  중계1동,'65,60 - 64세,1998,515,230,285
'1135062100,  중계1동,'70,65 - 69세,1998,358,124,234
'1135062100,  중계1동,'75,70 - 74세,1998,306,98,208
'1135062100,  중계1동,'80,75 - 79세,1998,224,75,149
'1135062100,  중계1동,'85,80 - 84세,1998,116,40,76
'1135062100,  중계1동,'90,85+ ,1998,44,8,36
'1135062200,  중계2동,'00,계,1998,19785,9620,10165
'1135062200,  중계2동,'05,0 - 4세,1998,1775,929,846
'1135062200,  중계2동,'10,5 - 9세,1998,1795,966,829
'1135062200,  중계2동,'15,10 - 14세,1998,1606,814,792
'1135062200,  중계2동,'20,15 - 19세,1998,1463,728,735
'1135062200,  중계2동,'25,20 - 24세,1998,972,457,515
'1135062200,  중계2동,'30,25 - 29세,1998,1807,795,1012
'1135062200,  중계2동,'35,30 - 34세,1998,2251,1115,1136
'1135062200,  중계2동,'40,35 - 39세,1998,2376,1160,1216
'1135062200,  중계2동,'45,40 - 44세,1998,1905,955,950
'1135062200,  중계2동,'50,45 - 49세,1998,1040,571,469
'1135062200,  중계2동,'55,50 - 54세,1998,581,317,264
'1135062200,  중계2동,'60,55 - 59세,1998,571,264,307
'1135062200,  중계2동,'65,60 - 64세,1998,476,194,282
'1135062200,  중계2동,'70,65 - 69세,1998,403,153,250
'1135062200,  중계2동,'75,70 - 74세,1998,319,101,218
'1135062200,  중계2동,'80,75 - 79세,1998,221,57,164
'1135062200,  중계2동,'85,80 - 84세,1998,121,22,99
'1135062200,  중계2동,'90,85+ ,1998,103,22,81
'1135062300,  중계3동,'00,계,1998,29791,14356,15435
'1135062300,  중계3동,'05,0 - 4세,1998,1338,716,622
'1135062300,  중계3동,'10,5 - 9세,1998,1531,827,704
'1135062300,  중계3동,'15,10 - 14세,1998,1963,969,994
'1135062300,  중계3동,'20,15 - 19세,1998,3265,1579,1686
'1135062300,  중계3동,'25,20 - 24세,1998,3668,1917,1751
'1135062300,  중계3동,'30,25 - 29세,1998,2811,1495,1316
'1135062300,  중계3동,'35,30 - 34세,1998,1842,945,897
'1135062300,  중계3동,'40,35 - 39세,1998,2229,1020,1209
'1135062300,  중계3동,'45,40 - 44세,1998,2624,1193,1431
'1135062300,  중계3동,'50,45 - 49세,1998,2096,930,1166
'1135062300,  중계3동,'55,50 - 54세,1998,1927,852,1075
'1135062300,  중계3동,'60,55 - 59세,1998,1742,826,916
'1135062300,  중계3동,'65,60 - 64세,1998,1149,513,636
'1135062300,  중계3동,'70,65 - 69세,1998,661,286,375
'1135062300,  중계3동,'75,70 - 74세,1998,408,166,242
'1135062300,  중계3동,'80,75 - 79세,1998,282,79,203
'1135062300,  중계3동,'85,80 - 84세,1998,158,26,132
'1135062300,  중계3동,'90,85+ ,1998,97,17,80
'1135062400,  중계4동,'00,계,1998,25549,12643,12906
'1135062400,  중계4동,'05,0 - 4세,1998,1354,753,601
'1135062400,  중계4동,'10,5 - 9세,1998,1655,873,782
'1135062400,  중계4동,'15,10 - 14세,1998,1766,892,874
'1135062400,  중계4동,'20,15 - 19세,1998,2471,1252,1219
'1135062400,  중계4동,'25,20 - 24세,1998,2735,1412,1323
'1135062400,  중계4동,'30,25 - 29세,1998,2467,1309,1158
'1135062400,  중계4동,'35,30 - 34세,1998,1942,973,969
'1135062400,  중계4동,'40,35 - 39세,1998,2327,1096,1231
'1135062400,  중계4동,'45,40 - 44세,1998,2289,1145,1144
'1135062400,  중계4동,'50,45 - 49세,1998,1727,803,924
'1135062400,  중계4동,'55,50 - 54세,1998,1481,662,819
'1135062400,  중계4동,'60,55 - 59세,1998,1257,640,617
'1135062400,  중계4동,'65,60 - 64세,1998,835,421,414
'1135062400,  중계4동,'70,65 - 69세,1998,469,193,276
'1135062400,  중계4동,'75,70 - 74세,1998,343,117,226
'1135062400,  중계4동,'80,75 - 79세,1998,252,75,177
'1135062400,  중계4동,'85,80 - 84세,1998,113,22,91
'1135062400,  중계4동,'90,85+ ,1998,66,5,61
'1135063000,  상계1동,'00,계,1998,32953,16556,16397
'1135063000,  상계1동,'05,0 - 4세,1998,2091,1088,1003
'1135063000,  상계1동,'10,5 - 9세,1998,2517,1334,1183
'1135063000,  상계1동,'15,10 - 14세,1998,2786,1478,1308
'1135063000,  상계1동,'20,15 - 19세,1998,3204,1622,1582
'1135063000,  상계1동,'25,20 - 24세,1998,2292,1155,1137
'1135063000,  상계1동,'30,25 - 29세,1998,2787,1408,1379
'1135063000,  상계1동,'35,30 - 34세,1998,2784,1372,1412
'1135063000,  상계1동,'40,35 - 39세,1998,3588,1697,1891
'1135063000,  상계1동,'45,40 - 44세,1998,3432,1776,1656
'1135063000,  상계1동,'50,45 - 49세,1998,2013,1124,889
'1135063000,  상계1동,'55,50 - 54세,1998,1533,828,705
'1135063000,  상계1동,'60,55 - 59세,1998,1317,649,668
'1135063000,  상계1동,'65,60 - 64세,1998,919,435,484
'1135063000,  상계1동,'70,65 - 69세,1998,610,252,358
'1135063000,  상계1동,'75,70 - 74세,1998,451,153,298
'1135063000,  상계1동,'80,75 - 79세,1998,352,112,240
'1135063000,  상계1동,'85,80 - 84세,1998,178,53,125
'1135063000,  상계1동,'90,85+ ,1998,99,20,79
'1135064000,  상계2동,'00,계,1998,20590,10379,10211
'1135064000,  상계2동,'05,0 - 4세,1998,1353,716,637
'1135064000,  상계2동,'10,5 - 9세,1998,1373,703,670
'1135064000,  상계2동,'15,10 - 14세,1998,1271,650,621
'1135064000,  상계2동,'20,15 - 19세,1998,1889,973,916
'1135064000,  상계2동,'25,20 - 24세,1998,1851,950,901
'1135064000,  상계2동,'30,25 - 29세,1998,2192,1125,1067
'1135064000,  상계2동,'35,30 - 34세,1998,1935,958,977
'1135064000,  상계2동,'40,35 - 39세,1998,1974,1033,941
'1135064000,  상계2동,'45,40 - 44세,1998,1796,861,935
'1135064000,  상계2동,'50,45 - 49세,1998,1348,700,648
'1135064000,  상계2동,'55,50 - 54세,1998,1110,580,530
'1135064000,  상계2동,'60,55 - 59세,1998,936,469,467
'1135064000,  상계2동,'65,60 - 64세,1998,629,325,304
'1135064000,  상계2동,'70,65 - 69세,1998,389,165,224
'1135064000,  상계2동,'75,70 - 74세,1998,240,86,154
'1135064000,  상계2동,'80,75 - 79세,1998,165,51,114
'1135064000,  상계2동,'85,80 - 84세,1998,86,24,62
'1135064000,  상계2동,'90,85+ ,1998,53,10,43
'1135065000,  상계3동,'00,계,1998,16924,8554,8370
'1135065000,  상계3동,'05,0 - 4세,1998,1059,569,490
'1135065000,  상계3동,'10,5 - 9세,1998,976,519,457
'1135065000,  상계3동,'15,10 - 14세,1998,886,452,434
'1135065000,  상계3동,'20,15 - 19세,1998,1453,770,683
'1135065000,  상계3동,'25,20 - 24세,1998,1532,737,795
'1135065000,  상계3동,'30,25 - 29세,1998,2057,1139,918
'1135065000,  상계3동,'35,30 - 34세,1998,1542,823,719
'1135065000,  상계3동,'40,35 - 39세,1998,1386,726,660
'1135065000,  상계3동,'45,40 - 44세,1998,1266,617,649
'1135065000,  상계3동,'50,45 - 49세,1998,1039,520,519
'1135065000,  상계3동,'55,50 - 54세,1998,1030,484,546
'1135065000,  상계3동,'60,55 - 59세,1998,1037,494,543
'1135065000,  상계3동,'65,60 - 64세,1998,690,347,343
'1135065000,  상계3동,'70,65 - 69세,1998,392,177,215
'1135065000,  상계3동,'75,70 - 74세,1998,247,91,156
'1135065000,  상계3동,'80,75 - 79세,1998,194,64,130
'1135065000,  상계3동,'85,80 - 84세,1998,87,16,71
'1135065000,  상계3동,'90,85+ ,1998,51,9,42
'1135066000,  상계4동,'00,계,1998,19207,9797,9410
'1135066000,  상계4동,'05,0 - 4세,1998,1216,645,571
'1135066000,  상계4동,'10,5 - 9세,1998,1090,560,530
'1135066000,  상계4동,'15,10 - 14세,1998,1004,500,504
'1135066000,  상계4동,'20,15 - 19세,1998,1670,870,800
'1135066000,  상계4동,'25,20 - 24세,1998,1837,948,889
'1135066000,  상계4동,'30,25 - 29세,1998,2334,1230,1104
'1135066000,  상계4동,'35,30 - 34세,1998,1833,1025,808
'1135066000,  상계4동,'40,35 - 39세,1998,1489,787,702
'1135066000,  상계4동,'45,40 - 44세,1998,1409,710,699
'1135066000,  상계4동,'50,45 - 49세,1998,1130,559,571
'1135066000,  상계4동,'55,50 - 54세,1998,1125,553,572
'1135066000,  상계4동,'60,55 - 59세,1998,1199,574,625
'1135066000,  상계4동,'65,60 - 64세,1998,763,389,374
'1135066000,  상계4동,'70,65 - 69세,1998,469,226,243
'1135066000,  상계4동,'75,70 - 74세,1998,279,105,174
'1135066000,  상계4동,'80,75 - 79세,1998,201,71,130
'1135066000,  상계4동,'85,80 - 84세,1998,104,39,65
'1135066000,  상계4동,'90,85+ ,1998,55,6,49
'1135067000,  상계5동,'00,계,1998,29066,14537,14529
'1135067000,  상계5동,'05,0 - 4세,1998,2204,1138,1066
'1135067000,  상계5동,'10,5 - 9세,1998,2107,1086,1021
'1135067000,  상계5동,'15,10 - 14세,1998,1996,1045,951
'1135067000,  상계5동,'20,15 - 19세,1998,2465,1315,1150
'1135067000,  상계5동,'25,20 - 24세,1998,2191,1094,1097
'1135067000,  상계5동,'30,25 - 29세,1998,3050,1476,1574
'1135067000,  상계5동,'35,30 - 34세,1998,2967,1519,1448
'1135067000,  상계5동,'40,35 - 39세,1998,2958,1458,1500
'1135067000,  상계5동,'45,40 - 44세,1998,2583,1295,1288
'1135067000,  상계5동,'50,45 - 49세,1998,1712,882,830
'1135067000,  상계5동,'55,50 - 54세,1998,1334,687,647
'1135067000,  상계5동,'60,55 - 59세,1998,1272,634,638
'1135067000,  상계5동,'65,60 - 64세,1998,812,380,432
'1135067000,  상계5동,'70,65 - 69세,1998,555,228,327
'1135067000,  상계5동,'75,70 - 74세,1998,389,158,231
'1135067000,  상계5동,'80,75 - 79세,1998,247,83,164
'1135067000,  상계5동,'85,80 - 84세,1998,146,39,107
'1135067000,  상계5동,'90,85+ ,1998,78,20,58
'1135068000,  상계6동,'00,계,1998,24607,12009,12598
'1135068000,  상계6동,'05,0 - 4세,1998,2041,1078,963
'1135068000,  상계6동,'10,5 - 9세,1998,2088,1101,987
'1135068000,  상계6동,'15,10 - 14세,1998,1928,1034,894
'1135068000,  상계6동,'20,15 - 19세,1998,2306,1156,1150
'1135068000,  상계6동,'25,20 - 24세,1998,1354,622,732
'1135068000,  상계6동,'30,25 - 29세,1998,2049,850,1199
'1135068000,  상계6동,'35,30 - 34세,1998,2506,1196,1310
'1135068000,  상계6동,'40,35 - 39세,1998,2807,1368,1439
'1135068000,  상계6동,'45,40 - 44세,1998,2602,1198,1404
'1135068000,  상계6동,'50,45 - 49세,1998,1643,944,699
'1135068000,  상계6동,'55,50 - 54세,1998,923,513,410
'1135068000,  상계6동,'60,55 - 59세,1998,645,343,302
'1135068000,  상계6동,'65,60 - 64세,1998,489,198,291
'1135068000,  상계6동,'70,65 - 69세,1998,489,168,321
'1135068000,  상계6동,'75,70 - 74세,1998,329,109,220
'1135068000,  상계6동,'80,75 - 79세,1998,222,77,145
'1135068000,  상계6동,'85,80 - 84세,1998,124,36,88
'1135068000,  상계6동,'90,85+ ,1998,62,18,44
'1135069000,  상계7동,'00,계,1998,19382,9398,9984
'1135069000,  상계7동,'05,0 - 4세,1998,1921,1038,883
'1135069000,  상계7동,'10,5 - 9세,1998,1659,914,745
'1135069000,  상계7동,'15,10 - 14세,1998,1275,638,637
'1135069000,  상계7동,'20,15 - 19세,1998,1462,727,735
'1135069000,  상계7동,'25,20 - 24세,1998,946,432,514
'1135069000,  상계7동,'30,25 - 29세,1998,2039,806,1233
'1135069000,  상계7동,'35,30 - 34세,1998,2580,1246,1334
'1135069000,  상계7동,'40,35 - 39세,1998,2246,1138,1108
'1135069000,  상계7동,'45,40 - 44세,1998,1814,866,948
'1135069000,  상계7동,'50,45 - 49세,1998,1078,585,493
'1135069000,  상계7동,'55,50 - 54세,1998,598,324,274
'1135069000,  상계7동,'60,55 - 59세,1998,428,194,234
'1135069000,  상계7동,'65,60 - 64세,1998,410,152,258
'1135069000,  상계7동,'70,65 - 69세,1998,339,122,217
'1135069000,  상계7동,'75,70 - 74세,1998,292,102,190
'1135069000,  상계7동,'80,75 - 79세,1998,167,74,93
'1135069000,  상계7동,'85,80 - 84세,1998,89,30,59
'1135069000,  상계7동,'90,85+ ,1998,39,10,29
'1135070000,  상계8동,'00,계,1998,32580,16151,16429
'1135070000,  상계8동,'05,0 - 4세,1998,3548,1836,1712
'1135070000,  상계8동,'10,5 - 9세,1998,3193,1682,1511
'1135070000,  상계8동,'15,10 - 14세,1998,2594,1365,1229
'1135070000,  상계8동,'20,15 - 19세,1998,2612,1383,1229
'1135070000,  상계8동,'25,20 - 24세,1998,1296,665,631
'1135070000,  상계8동,'30,25 - 29세,1998,2533,996,1537
'1135070000,  상계8동,'35,30 - 34세,1998,4064,1887,2177
'1135070000,  상계8동,'40,35 - 39세,1998,4108,2126,1982
'1135070000,  상계8동,'45,40 - 44세,1998,3362,1692,1670
'1135070000,  상계8동,'50,45 - 49세,1998,1735,1064,671
'1135070000,  상계8동,'55,50 - 54세,1998,913,542,371
'1135070000,  상계8동,'60,55 - 59세,1998,641,290,351
'1135070000,  상계8동,'65,60 - 64세,1998,621,231,390
'1135070000,  상계8동,'70,65 - 69세,1998,493,161,332
'1135070000,  상계8동,'75,70 - 74세,1998,388,114,274
'1135070000,  상계8동,'80,75 - 79세,1998,277,77,200
'1135070000,  상계8동,'85,80 - 84세,1998,129,26,103
'1135070000,  상계8동,'90,85+ ,1998,73,14,59
'1135071000,  상계9동,'00,계,1998,30017,14973,15044
'1135071000,  상계9동,'05,0 - 4세,1998,2429,1248,1181
'1135071000,  상계9동,'10,5 - 9세,1998,2676,1445,1231
'1135071000,  상계9동,'15,10 - 14세,1998,2713,1445,1268
'1135071000,  상계9동,'20,15 - 19세,1998,2829,1565,1264
'1135071000,  상계9동,'25,20 - 24세,1998,1458,723,735
'1135071000,  상계9동,'30,25 - 29세,1998,2243,937,1306
'1135071000,  상계9동,'35,30 - 34세,1998,3194,1545,1649
'1135071000,  상계9동,'40,35 - 39세,1998,3554,1657,1897
'1135071000,  상계9동,'45,40 - 44세,1998,3608,1778,1830
'1135071000,  상계9동,'50,45 - 49세,1998,1881,1119,762
'1135071000,  상계9동,'55,50 - 54세,1998,963,571,392
'1135071000,  상계9동,'60,55 - 59세,1998,646,335,311
'1135071000,  상계9동,'65,60 - 64세,1998,540,198,342
'1135071000,  상계9동,'70,65 - 69세,1998,477,160,317
'1135071000,  상계9동,'75,70 - 74세,1998,353,105,248
'1135071000,  상계9동,'80,75 - 79세,1998,244,82,162
'1135071000,  상계9동,'85,80 - 84세,1998,129,37,92
'1135071000,  상계9동,'90,85+ ,1998,80,23,57
'1135072000,  상계10동,'00,계,1998,24760,12112,12648
'1135072000,  상계10동,'05,0 - 4세,1998,2253,1172,1081
'1135072000,  상계10동,'10,5 - 9세,1998,1933,1020,913
'1135072000,  상계10동,'15,10 - 14세,1998,1843,961,882
'1135072000,  상계10동,'20,15 - 19세,1998,2081,1019,1062
'1135072000,  상계10동,'25,20 - 24세,1998,1290,617,673
'1135072000,  상계10동,'30,25 - 29세,1998,2647,1109,1538
'1135072000,  상계10동,'35,30 - 34세,1998,2986,1552,1434
'1135072000,  상계10동,'40,35 - 39세,1998,2563,1220,1343
'1135072000,  상계10동,'45,40 - 44세,1998,2525,1226,1299
'1135072000,  상계10동,'50,45 - 49세,1998,1451,814,637
'1135072000,  상계10동,'55,50 - 54세,1998,814,451,363
'1135072000,  상계10동,'60,55 - 59세,1998,638,288,350
'1135072000,  상계10동,'65,60 - 64세,1998,554,242,312
'1135072000,  상계10동,'70,65 - 69세,1998,437,159,278
'1135072000,  상계10동,'75,70 - 74세,1998,358,138,220
'1135072000,  상계10동,'80,75 - 79세,1998,223,80,143
'1135072000,  상계10동,'85,80 - 84세,1998,101,25,76
'1135072000,  상계10동,'90,85+ ,1998,63,19,44
'11380, 은평구,'00,계,1998,479841,238157,241684
'11380, 은평구,'05,0 - 4세,1998,32457,16933,15524
'11380, 은평구,'10,5 - 9세,1998,30943,16314,14629
'11380, 은평구,'15,10 - 14세,1998,30084,15515,14569
'11380, 은평구,'20,15 - 19세,1998,40473,20987,19486
'11380, 은평구,'25,20 - 24세,1998,40837,20042,20795
'11380, 은평구,'30,25 - 29세,1998,54880,27403,27477
'11380, 은평구,'35,30 - 34세,1998,46490,23992,22498
'11380, 은평구,'40,35 - 39세,1998,44054,21859,22195
'11380, 은평구,'45,40 - 44세,1998,39489,18997,20492
'11380, 은평구,'50,45 - 49세,1998,28879,13816,15063
'11380, 은평구,'55,50 - 54세,1998,25881,12538,13343
'11380, 은평구,'60,55 - 59세,1998,24102,12043,12059
'11380, 은평구,'65,60 - 64세,1998,16650,8266,8384
'11380, 은평구,'70,65 - 69세,1998,10037,4509,5528
'11380, 은평구,'75,70 - 74세,1998,6268,2408,3860
'11380, 은평구,'80,75 - 79세,1998,4296,1512,2784
'11380, 은평구,'85,80 - 84세,1998,2413,663,1750
'11380, 은평구,'90,85+ ,1998,1608,360,1248
'1138051000,  녹번동,'00,계,1998,36446,17969,18477
'1138051000,  녹번동,'05,0 - 4세,1998,2821,1448,1373
'1138051000,  녹번동,'10,5 - 9세,1998,2199,1112,1087
'1138051000,  녹번동,'15,10 - 14세,1998,1835,941,894
'1138051000,  녹번동,'20,15 - 19세,1998,2560,1334,1226
'1138051000,  녹번동,'25,20 - 24세,1998,3108,1441,1667
'1138051000,  녹번동,'30,25 - 29세,1998,5137,2520,2617
'1138051000,  녹번동,'35,30 - 34세,1998,4088,2195,1893
'1138051000,  녹번동,'40,35 - 39세,1998,3204,1669,1535
'1138051000,  녹번동,'45,40 - 44세,1998,2648,1269,1379
'1138051000,  녹번동,'50,45 - 49세,1998,1937,897,1040
'1138051000,  녹번동,'55,50 - 54세,1998,1881,845,1036
'1138051000,  녹번동,'60,55 - 59세,1998,1910,938,972
'1138051000,  녹번동,'65,60 - 64세,1998,1326,654,672
'1138051000,  녹번동,'70,65 - 69세,1998,756,346,410
'1138051000,  녹번동,'75,70 - 74세,1998,433,167,266
'1138051000,  녹번동,'80,75 - 79세,1998,324,118,206
'1138051000,  녹번동,'85,80 - 84세,1998,173,44,129
'1138051000,  녹번동,'90,85+ ,1998,106,31,75
'1138052000,  불광1동,'00,계,1998,33548,16681,16867
'1138052000,  불광1동,'05,0 - 4세,1998,2389,1289,1100
'1138052000,  불광1동,'10,5 - 9세,1998,2218,1159,1059
'1138052000,  불광1동,'15,10 - 14세,1998,1899,995,904
'1138052000,  불광1동,'20,15 - 19세,1998,2577,1322,1255
'1138052000,  불광1동,'25,20 - 24세,1998,2798,1359,1439
'1138052000,  불광1동,'30,25 - 29세,1998,3898,1982,1916
'1138052000,  불광1동,'35,30 - 34세,1998,3428,1761,1667
'1138052000,  불광1동,'40,35 - 39세,1998,3173,1626,1547
'1138052000,  불광1동,'45,40 - 44세,1998,2661,1267,1394
'1138052000,  불광1동,'50,45 - 49세,1998,1966,943,1023
'1138052000,  불광1동,'55,50 - 54세,1998,1731,820,911
'1138052000,  불광1동,'60,55 - 59세,1998,1741,831,910
'1138052000,  불광1동,'65,60 - 64세,1998,1260,604,656
'1138052000,  불광1동,'70,65 - 69세,1998,743,336,407
'1138052000,  불광1동,'75,70 - 74세,1998,465,198,267
'1138052000,  불광1동,'80,75 - 79세,1998,304,116,188
'1138052000,  불광1동,'85,80 - 84세,1998,177,50,127
'1138052000,  불광1동,'90,85+ ,1998,120,23,97
'1138053000,  불광2동,'00,계,1998,21966,10877,11089
'1138053000,  불광2동,'05,0 - 4세,1998,1572,812,760
'1138053000,  불광2동,'10,5 - 9세,1998,1354,707,647
'1138053000,  불광2동,'15,10 - 14세,1998,1365,707,658
'1138053000,  불광2동,'20,15 - 19세,1998,1857,992,865
'1138053000,  불광2동,'25,20 - 24세,1998,1828,876,952
'1138053000,  불광2동,'30,25 - 29세,1998,2763,1334,1429
'1138053000,  불광2동,'35,30 - 34세,1998,2223,1213,1010
'1138053000,  불광2동,'40,35 - 39세,1998,1964,957,1007
'1138053000,  불광2동,'45,40 - 44세,1998,1801,837,964
'1138053000,  불광2동,'50,45 - 49세,1998,1305,622,683
'1138053000,  불광2동,'55,50 - 54세,1998,1198,555,643
'1138053000,  불광2동,'60,55 - 59세,1998,1040,544,496
'1138053000,  불광2동,'65,60 - 64세,1998,693,355,338
'1138053000,  불광2동,'70,65 - 69세,1998,413,178,235
'1138053000,  불광2동,'75,70 - 74세,1998,252,85,167
'1138053000,  불광2동,'80,75 - 79세,1998,171,60,111
'1138053000,  불광2동,'85,80 - 84세,1998,99,29,70
'1138053000,  불광2동,'90,85+ ,1998,68,14,54
'1138054000,  불광3동,'00,계,1998,24498,12134,12364
'1138054000,  불광3동,'05,0 - 4세,1998,1944,1026,918
'1138054000,  불광3동,'10,5 - 9세,1998,1646,849,797
'1138054000,  불광3동,'15,10 - 14세,1998,1451,758,693
'1138054000,  불광3동,'20,15 - 19세,1998,1866,982,884
'1138054000,  불광3동,'25,20 - 24세,1998,2004,948,1056
'1138054000,  불광3동,'30,25 - 29세,1998,3171,1552,1619
'1138054000,  불광3동,'35,30 - 34세,1998,2663,1343,1320
'1138054000,  불광3동,'40,35 - 39세,1998,2252,1159,1093
'1138054000,  불광3동,'45,40 - 44세,1998,1832,883,949
'1138054000,  불광3동,'50,45 - 49세,1998,1386,659,727
'1138054000,  불광3동,'55,50 - 54세,1998,1229,585,644
'1138054000,  불광3동,'60,55 - 59세,1998,1128,583,545
'1138054000,  불광3동,'65,60 - 64세,1998,738,361,377
'1138054000,  불광3동,'70,65 - 69세,1998,471,209,262
'1138054000,  불광3동,'75,70 - 74세,1998,309,100,209
'1138054000,  불광3동,'80,75 - 79세,1998,208,80,128
'1138054000,  불광3동,'85,80 - 84세,1998,123,38,85
'1138054000,  불광3동,'90,85+ ,1998,77,19,58
'1138055100,  갈현1동,'00,계,1998,27590,13660,13930
'1138055100,  갈현1동,'05,0 - 4세,1998,1897,1009,888
'1138055100,  갈현1동,'10,5 - 9세,1998,1657,859,798
'1138055100,  갈현1동,'15,10 - 14세,1998,1897,1019,878
'1138055100,  갈현1동,'20,15 - 19세,1998,2550,1359,1191
'1138055100,  갈현1동,'25,20 - 24세,1998,2482,1220,1262
'1138055100,  갈현1동,'30,25 - 29세,1998,3214,1590,1624
'1138055100,  갈현1동,'35,30 - 34세,1998,2580,1321,1259
'1138055100,  갈현1동,'40,35 - 39세,1998,2421,1151,1270
'1138055100,  갈현1동,'45,40 - 44세,1998,2325,1083,1242
'1138055100,  갈현1동,'50,45 - 49세,1998,1702,789,913
'1138055100,  갈현1동,'55,50 - 54세,1998,1515,735,780
'1138055100,  갈현1동,'60,55 - 59세,1998,1273,656,617
'1138055100,  갈현1동,'65,60 - 64세,1998,820,428,392
'1138055100,  갈현1동,'70,65 - 69세,1998,490,206,284
'1138055100,  갈현1동,'75,70 - 74세,1998,337,114,223
'1138055100,  갈현1동,'80,75 - 79세,1998,219,74,145
'1138055100,  갈현1동,'85,80 - 84세,1998,125,31,94
'1138055100,  갈현1동,'90,85+ ,1998,86,16,70
'1138055200,  갈현2동,'00,계,1998,25293,12288,13005
'1138055200,  갈현2동,'05,0 - 4세,1998,1537,785,752
'1138055200,  갈현2동,'10,5 - 9세,1998,1554,785,769
'1138055200,  갈현2동,'15,10 - 14세,1998,1784,913,871
'1138055200,  갈현2동,'20,15 - 19세,1998,2486,1258,1228
'1138055200,  갈현2동,'25,20 - 24세,1998,2134,1050,1084
'1138055200,  갈현2동,'30,25 - 29세,1998,2618,1263,1355
'1138055200,  갈현2동,'35,30 - 34세,1998,2295,1172,1123
'1138055200,  갈현2동,'40,35 - 39세,1998,2180,985,1195
'1138055200,  갈현2동,'45,40 - 44세,1998,2366,1077,1289
'1138055200,  갈현2동,'50,45 - 49세,1998,1637,803,834
'1138055200,  갈현2동,'55,50 - 54세,1998,1409,695,714
'1138055200,  갈현2동,'60,55 - 59세,1998,1254,641,613
'1138055200,  갈현2동,'65,60 - 64세,1998,790,415,375
'1138055200,  갈현2동,'70,65 - 69세,1998,452,208,244
'1138055200,  갈현2동,'75,70 - 74세,1998,302,100,202
'1138055200,  갈현2동,'80,75 - 79세,1998,231,84,147
'1138055200,  갈현2동,'85,80 - 84세,1998,153,32,121
'1138055200,  갈현2동,'90,85+ ,1998,111,22,89
'1138056000,  구산동,'00,계,1998,28249,13906,14343
'1138056000,  구산동,'05,0 - 4세,1998,1615,855,760
'1138056000,  구산동,'10,5 - 9세,1998,1775,954,821
'1138056000,  구산동,'15,10 - 14세,1998,2130,1082,1048
'1138056000,  구산동,'20,15 - 19세,1998,2668,1320,1348
'1138056000,  구산동,'25,20 - 24세,1998,2367,1159,1208
'1138056000,  구산동,'30,25 - 29세,1998,2718,1357,1361
'1138056000,  구산동,'35,30 - 34세,1998,2379,1181,1198
'1138056000,  구산동,'40,35 - 39세,1998,2600,1200,1400
'1138056000,  구산동,'45,40 - 44세,1998,2610,1222,1388
'1138056000,  구산동,'50,45 - 49세,1998,1898,959,939
'1138056000,  구산동,'55,50 - 54세,1998,1627,829,798
'1138056000,  구산동,'60,55 - 59세,1998,1381,713,668
'1138056000,  구산동,'65,60 - 64세,1998,956,489,467
'1138056000,  구산동,'70,65 - 69세,1998,575,273,302
'1138056000,  구산동,'75,70 - 74세,1998,390,149,241
'1138056000,  구산동,'80,75 - 79세,1998,303,99,204
'1138056000,  구산동,'85,80 - 84세,1998,151,48,103
'1138056000,  구산동,'90,85+ ,1998,106,17,89
'1138057000,  대조동,'00,계,1998,32484,15824,16660
'1138057000,  대조동,'05,0 - 4세,1998,2404,1248,1156
'1138057000,  대조동,'10,5 - 9세,1998,1953,1034,919
'1138057000,  대조동,'15,10 - 14세,1998,1971,991,980
'1138057000,  대조동,'20,15 - 19세,1998,2599,1267,1332
'1138057000,  대조동,'25,20 - 24세,1998,2744,1291,1453
'1138057000,  대조동,'30,25 - 29세,1998,4130,1967,2163
'1138057000,  대조동,'35,30 - 34세,1998,3387,1762,1625
'1138057000,  대조동,'40,35 - 39세,1998,3008,1503,1505
'1138057000,  대조동,'45,40 - 44세,1998,2464,1158,1306
'1138057000,  대조동,'50,45 - 49세,1998,1830,843,987
'1138057000,  대조동,'55,50 - 54세,1998,1654,790,864
'1138057000,  대조동,'60,55 - 59세,1998,1649,800,849
'1138057000,  대조동,'65,60 - 64세,1998,1113,554,559
'1138057000,  대조동,'70,65 - 69세,1998,649,298,351
'1138057000,  대조동,'75,70 - 74세,1998,376,144,232
'1138057000,  대조동,'80,75 - 79세,1998,266,86,180
'1138057000,  대조동,'85,80 - 84세,1998,160,53,107
'1138057000,  대조동,'90,85+ ,1998,127,35,92
'1138058000,  응암1동,'00,계,1998,29861,14759,15102
'1138058000,  응암1동,'05,0 - 4세,1998,2331,1178,1153
'1138058000,  응암1동,'10,5 - 9세,1998,2106,1095,1011
'1138058000,  응암1동,'15,10 - 14세,1998,1642,870,772
'1138058000,  응암1동,'20,15 - 19세,1998,2137,1152,985
'1138058000,  응암1동,'25,20 - 24세,1998,2576,1224,1352
'1138058000,  응암1동,'30,25 - 29세,1998,3862,1868,1994
'1138058000,  응암1동,'35,30 - 34세,1998,3218,1670,1548
'1138058000,  응암1동,'40,35 - 39세,1998,2683,1409,1274
'1138058000,  응암1동,'45,40 - 44세,1998,2157,1016,1141
'1138058000,  응암1동,'50,45 - 49세,1998,1645,745,900
'1138058000,  응암1동,'55,50 - 54세,1998,1568,738,830
'1138058000,  응암1동,'60,55 - 59세,1998,1471,722,749
'1138058000,  응암1동,'65,60 - 64세,1998,1063,512,551
'1138058000,  응암1동,'70,65 - 69세,1998,604,294,310
'1138058000,  응암1동,'75,70 - 74세,1998,343,135,208
'1138058000,  응암1동,'80,75 - 79세,1998,234,80,154
'1138058000,  응암1동,'85,80 - 84세,1998,132,35,97
'1138058000,  응암1동,'90,85+ ,1998,89,16,73
'1138059000,  응암2동,'00,계,1998,21141,10557,10584
'1138059000,  응암2동,'05,0 - 4세,1998,1393,719,674
'1138059000,  응암2동,'10,5 - 9세,1998,1285,692,593
'1138059000,  응암2동,'15,10 - 14세,1998,1104,540,564
'1138059000,  응암2동,'20,15 - 19세,1998,1785,910,875
'1138059000,  응암2동,'25,20 - 24세,1998,1958,998,960
'1138059000,  응암2동,'30,25 - 29세,1998,2528,1277,1251
'1138059000,  응암2동,'35,30 - 34세,1998,2131,1146,985
'1138059000,  응암2동,'40,35 - 39세,1998,1840,931,909
'1138059000,  응암2동,'45,40 - 44세,1998,1636,785,851
'1138059000,  응암2동,'50,45 - 49세,1998,1252,600,652
'1138059000,  응암2동,'55,50 - 54세,1998,1210,595,615
'1138059000,  응암2동,'60,55 - 59세,1998,1115,556,559
'1138059000,  응암2동,'65,60 - 64세,1998,767,372,395
'1138059000,  응암2동,'70,65 - 69세,1998,463,197,266
'1138059000,  응암2동,'75,70 - 74세,1998,281,123,158
'1138059000,  응암2동,'80,75 - 79세,1998,216,78,138
'1138059000,  응암2동,'85,80 - 84세,1998,90,23,67
'1138059000,  응암2동,'90,85+ ,1998,87,15,72
'1138060000,  응암3동,'00,계,1998,22418,11279,11139
'1138060000,  응암3동,'05,0 - 4세,1998,1528,802,726
'1138060000,  응암3동,'10,5 - 9세,1998,1403,769,634
'1138060000,  응암3동,'15,10 - 14세,1998,1333,677,656
'1138060000,  응암3동,'20,15 - 19세,1998,1826,954,872
'1138060000,  응암3동,'25,20 - 24세,1998,1995,1009,986
'1138060000,  응암3동,'30,25 - 29세,1998,2622,1364,1258
'1138060000,  응암3동,'35,30 - 34세,1998,2187,1136,1051
'1138060000,  응암3동,'40,35 - 39세,1998,2080,1070,1010
'1138060000,  응암3동,'45,40 - 44세,1998,1748,845,903
'1138060000,  응암3동,'50,45 - 49세,1998,1357,648,709
'1138060000,  응암3동,'55,50 - 54세,1998,1219,584,635
'1138060000,  응암3동,'60,55 - 59세,1998,1161,572,589
'1138060000,  응암3동,'65,60 - 64세,1998,833,405,428
'1138060000,  응암3동,'70,65 - 69세,1998,498,234,264
'1138060000,  응암3동,'75,70 - 74세,1998,283,104,179
'1138060000,  응암3동,'80,75 - 79세,1998,194,64,130
'1138060000,  응암3동,'85,80 - 84세,1998,101,31,70
'1138060000,  응암3동,'90,85+ ,1998,50,11,39
'1138061000,  역촌1동,'00,계,1998,22083,10817,11266
'1138061000,  역촌1동,'05,0 - 4세,1998,1686,904,782
'1138061000,  역촌1동,'10,5 - 9세,1998,1470,772,698
'1138061000,  역촌1동,'15,10 - 14세,1998,1243,602,641
'1138061000,  역촌1동,'20,15 - 19세,1998,1767,840,927
'1138061000,  역촌1동,'25,20 - 24세,1998,1884,917,967
'1138061000,  역촌1동,'30,25 - 29세,1998,2463,1167,1296
'1138061000,  역촌1동,'35,30 - 34세,1998,2325,1177,1148
'1138061000,  역촌1동,'40,35 - 39세,1998,2152,1129,1023
'1138061000,  역촌1동,'45,40 - 44세,1998,1653,792,861
'1138061000,  역촌1동,'50,45 - 49세,1998,1381,632,749
'1138061000,  역촌1동,'55,50 - 54세,1998,1152,587,565
'1138061000,  역촌1동,'60,55 - 59세,1998,1044,511,533
'1138061000,  역촌1동,'65,60 - 64세,1998,734,360,374
'1138061000,  역촌1동,'70,65 - 69세,1998,450,193,257
'1138061000,  역촌1동,'75,70 - 74세,1998,298,120,178
'1138061000,  역촌1동,'80,75 - 79세,1998,200,66,134
'1138061000,  역촌1동,'85,80 - 84세,1998,112,29,83
'1138061000,  역촌1동,'90,85+ ,1998,69,19,50
'1138062000,  역촌2동,'00,계,1998,19864,9773,10091
'1138062000,  역촌2동,'05,0 - 4세,1998,1329,693,636
'1138062000,  역촌2동,'10,5 - 9세,1998,1470,787,683
'1138062000,  역촌2동,'15,10 - 14세,1998,1287,628,659
'1138062000,  역촌2동,'20,15 - 19세,1998,1640,829,811
'1138062000,  역촌2동,'25,20 - 24세,1998,1676,793,883
'1138062000,  역촌2동,'30,25 - 29세,1998,2112,1053,1059
'1138062000,  역촌2동,'35,30 - 34세,1998,1890,945,945
'1138062000,  역촌2동,'40,35 - 39세,1998,1948,951,997
'1138062000,  역촌2동,'45,40 - 44세,1998,1651,801,850
'1138062000,  역촌2동,'50,45 - 49세,1998,1201,568,633
'1138062000,  역촌2동,'55,50 - 54세,1998,1114,549,565
'1138062000,  역촌2동,'60,55 - 59세,1998,917,475,442
'1138062000,  역촌2동,'65,60 - 64세,1998,633,323,310
'1138062000,  역촌2동,'70,65 - 69세,1998,387,171,216
'1138062000,  역촌2동,'75,70 - 74세,1998,258,104,154
'1138062000,  역촌2동,'80,75 - 79세,1998,164,54,110
'1138062000,  역촌2동,'85,80 - 84세,1998,115,35,80
'1138062000,  역촌2동,'90,85+ ,1998,72,14,58
'1138063100,  신사1동,'00,계,1998,24942,12338,12604
'1138063100,  신사1동,'05,0 - 4세,1998,1570,807,763
'1138063100,  신사1동,'10,5 - 9세,1998,1770,963,807
'1138063100,  신사1동,'15,10 - 14세,1998,1768,871,897
'1138063100,  신사1동,'20,15 - 19세,1998,2174,1095,1079
'1138063100,  신사1동,'25,20 - 24세,1998,2011,1010,1001
'1138063100,  신사1동,'30,25 - 29세,1998,2461,1204,1257
'1138063100,  신사1동,'35,30 - 34세,1998,2230,1122,1108
'1138063100,  신사1동,'40,35 - 39세,1998,2503,1199,1304
'1138063100,  신사1동,'45,40 - 44세,1998,2331,1176,1155
'1138063100,  신사1동,'50,45 - 49세,1998,1580,779,801
'1138063100,  신사1동,'55,50 - 54세,1998,1297,649,648
'1138063100,  신사1동,'60,55 - 59세,1998,1170,606,564
'1138063100,  신사1동,'65,60 - 64세,1998,794,391,403
'1138063100,  신사1동,'70,65 - 69세,1998,493,207,286
'1138063100,  신사1동,'75,70 - 74세,1998,326,119,207
'1138063100,  신사1동,'80,75 - 79세,1998,226,75,151
'1138063100,  신사1동,'85,80 - 84세,1998,139,42,97
'1138063100,  신사1동,'90,85+ ,1998,99,23,76
'1138063200,  신사2동,'00,계,1998,25192,12741,12451
'1138063200,  신사2동,'05,0 - 4세,1998,1639,823,816
'1138063200,  신사2동,'10,5 - 9세,1998,1832,990,842
'1138063200,  신사2동,'15,10 - 14세,1998,1872,1021,851
'1138063200,  신사2동,'20,15 - 19세,1998,2422,1331,1091
'1138063200,  신사2동,'25,20 - 24세,1998,1939,1034,905
'1138063200,  신사2동,'30,25 - 29세,1998,2306,1177,1129
'1138063200,  신사2동,'35,30 - 34세,1998,2273,1096,1177
'1138063200,  신사2동,'40,35 - 39세,1998,2511,1235,1276
'1138063200,  신사2동,'45,40 - 44세,1998,2502,1223,1279
'1138063200,  신사2동,'50,45 - 49세,1998,1588,788,800
'1138063200,  신사2동,'55,50 - 54세,1998,1253,673,580
'1138063200,  신사2동,'60,55 - 59세,1998,1107,566,541
'1138063200,  신사2동,'65,60 - 64세,1998,722,335,387
'1138063200,  신사2동,'70,65 - 69세,1998,514,213,301
'1138063200,  신사2동,'75,70 - 74세,1998,332,124,208
'1138063200,  신사2동,'80,75 - 79세,1998,212,78,134
'1138063200,  신사2동,'85,80 - 84세,1998,98,18,80
'1138063200,  신사2동,'90,85+ ,1998,70,16,54
'1138064000,  증산동,'00,계,1998,19885,10059,9826
'1138064000,  증산동,'05,0 - 4세,1998,1260,660,600
'1138064000,  증산동,'10,5 - 9세,1998,1312,697,615
'1138064000,  증산동,'15,10 - 14세,1998,1336,714,622
'1138064000,  증산동,'20,15 - 19세,1998,1750,994,756
'1138064000,  증산동,'25,20 - 24세,1998,1678,836,842
'1138064000,  증산동,'30,25 - 29세,1998,2148,1100,1048
'1138064000,  증산동,'35,30 - 34세,1998,1769,896,873
'1138064000,  증산동,'40,35 - 39세,1998,1873,885,988
'1138064000,  증산동,'45,40 - 44세,1998,1761,908,853
'1138064000,  증산동,'50,45 - 49세,1998,1178,591,587
'1138064000,  증산동,'55,50 - 54세,1998,1140,557,583
'1138064000,  증산동,'60,55 - 59세,1998,972,485,487
'1138064000,  증산동,'65,60 - 64세,1998,675,319,356
'1138064000,  증산동,'70,65 - 69세,1998,454,206,248
'1138064000,  증산동,'75,70 - 74세,1998,271,111,160
'1138064000,  증산동,'80,75 - 79세,1998,146,59,87
'1138064000,  증산동,'85,80 - 84세,1998,102,25,77
'1138064000,  증산동,'90,85+ ,1998,60,16,44
'1138065000,  수색동,'00,계,1998,18764,9530,9234
'1138065000,  수색동,'05,0 - 4세,1998,1090,591,499
'1138065000,  수색동,'10,5 - 9세,1998,1151,622,529
'1138065000,  수색동,'15,10 - 14세,1998,1315,678,637
'1138065000,  수색동,'20,15 - 19세,1998,1709,873,836
'1138065000,  수색동,'25,20 - 24세,1998,1543,817,726
'1138065000,  수색동,'30,25 - 29세,1998,2013,1093,920
'1138065000,  수색동,'35,30 - 34세,1998,1626,859,767
'1138065000,  수색동,'40,35 - 39세,1998,1711,856,855
'1138065000,  수색동,'45,40 - 44세,1998,1581,812,769
'1138065000,  수색동,'50,45 - 49세,1998,1097,523,574
'1138065000,  수색동,'55,50 - 54세,1998,989,457,532
'1138065000,  수색동,'60,55 - 59세,1998,1063,522,541
'1138065000,  수색동,'65,60 - 64세,1998,761,373,388
'1138065000,  수색동,'70,65 - 69세,1998,494,236,258
'1138065000,  수색동,'75,70 - 74세,1998,279,115,164
'1138065000,  수색동,'80,75 - 79세,1998,184,67,117
'1138065000,  수색동,'85,80 - 84세,1998,96,18,78
'1138065000,  수색동,'90,85+ ,1998,62,18,44
'1138066000,  진관내동,'00,계,1998,11842,5952,5890
'1138066000,  진관내동,'05,0 - 4세,1998,541,272,269
'1138066000,  진관내동,'10,5 - 9세,1998,662,332,330
'1138066000,  진관내동,'15,10 - 14세,1998,801,430,371
'1138066000,  진관내동,'20,15 - 19세,1998,1113,586,527
'1138066000,  진관내동,'25,20 - 24세,1998,1076,560,516
'1138066000,  진관내동,'30,25 - 29세,1998,1148,628,520
'1138066000,  진관내동,'35,30 - 34세,1998,881,481,400
'1138066000,  진관내동,'40,35 - 39세,1998,984,471,513
'1138066000,  진관내동,'45,40 - 44세,1998,1012,486,526
'1138066000,  진관내동,'50,45 - 49세,1998,759,354,405
'1138066000,  진관내동,'55,50 - 54세,1998,743,367,376
'1138066000,  진관내동,'60,55 - 59세,1998,744,377,367
'1138066000,  진관내동,'65,60 - 64세,1998,537,273,264
'1138066000,  진관내동,'70,65 - 69세,1998,339,155,184
'1138066000,  진관내동,'75,70 - 74세,1998,238,86,152
'1138066000,  진관내동,'80,75 - 79세,1998,150,49,101
'1138066000,  진관내동,'85,80 - 84세,1998,77,30,47
'1138066000,  진관내동,'90,85+ ,1998,37,15,22
'1138067000,  진관외동,'00,계,1998,12241,6193,6048
'1138067000,  진관외동,'05,0 - 4세,1998,510,275,235
'1138067000,  진관외동,'10,5 - 9세,1998,730,395,335
'1138067000,  진관외동,'15,10 - 14세,1998,768,384,384
'1138067000,  진관외동,'20,15 - 19세,1998,1071,553,518
'1138067000,  진관외동,'25,20 - 24세,1998,1132,597,535
'1138067000,  진관외동,'30,25 - 29세,1998,1176,670,506
'1138067000,  진관외동,'35,30 - 34세,1998,894,466,428
'1138067000,  진관외동,'40,35 - 39세,1998,1032,504,528
'1138067000,  진관외동,'45,40 - 44세,1998,955,478,477
'1138067000,  진관외동,'50,45 - 49세,1998,841,406,435
'1138067000,  진관외동,'55,50 - 54세,1998,791,373,418
'1138067000,  진관외동,'60,55 - 59세,1998,821,407,414
'1138067000,  진관외동,'65,60 - 64세,1998,622,324,298
'1138067000,  진관외동,'70,65 - 69세,1998,348,156,192
'1138067000,  진관외동,'75,70 - 74세,1998,230,103,127
'1138067000,  진관외동,'80,75 - 79세,1998,161,64,97
'1138067000,  진관외동,'85,80 - 84세,1998,100,28,72
'1138067000,  진관외동,'90,85+ ,1998,59,10,49
'1138068000,  응암4동,'00,계,1998,21534,10820,10714
'1138068000,  응암4동,'05,0 - 4세,1998,1401,737,664
'1138068000,  응암4동,'10,5 - 9세,1998,1396,741,655
'1138068000,  응암4동,'15,10 - 14세,1998,1283,694,589
'1138068000,  응암4동,'20,15 - 19세,1998,1916,1036,880
'1138068000,  응암4동,'25,20 - 24세,1998,1904,903,1001
'1138068000,  응암4동,'30,25 - 29세,1998,2392,1237,1155
'1138068000,  응암4동,'35,30 - 34세,1998,2023,1050,973
'1138068000,  응암4동,'40,35 - 39세,1998,1935,969,966
'1138068000,  응암4동,'45,40 - 44세,1998,1795,879,916
'1138068000,  응암4동,'50,45 - 49세,1998,1339,667,672
'1138068000,  응암4동,'55,50 - 54세,1998,1161,555,606
'1138068000,  응암4동,'60,55 - 59세,1998,1141,538,603
'1138068000,  응암4동,'65,60 - 64세,1998,813,419,394
'1138068000,  응암4동,'70,65 - 69세,1998,444,193,251
'1138068000,  응암4동,'75,70 - 74세,1998,265,107,158
'1138068000,  응암4동,'80,75 - 79세,1998,183,61,122
'1138068000,  응암4동,'85,80 - 84세,1998,90,24,66
'1138068000,  응암4동,'90,85+ ,1998,53,10,43
'11410, 서대문구,'00,계,1998,361733,179690,182043
'11410, 서대문구,'05,0 - 4세,1998,24186,12643,11543
'11410, 서대문구,'10,5 - 9세,1998,21929,11716,10213
'11410, 서대문구,'15,10 - 14세,1998,19689,10197,9492
'11410, 서대문구,'20,15 - 19세,1998,26848,13908,12940
'11410, 서대문구,'25,20 - 24세,1998,32519,15866,16653
'11410, 서대문구,'30,25 - 29세,1998,46202,23694,22508
'11410, 서대문구,'35,30 - 34세,1998,35218,18430,16788
'11410, 서대문구,'40,35 - 39세,1998,32085,16325,15760
'11410, 서대문구,'45,40 - 44세,1998,27609,13638,13971
'11410, 서대문구,'50,45 - 49세,1998,20386,9634,10752
'11410, 서대문구,'55,50 - 54세,1998,19440,8821,10619
'11410, 서대문구,'60,55 - 59세,1998,20261,9699,10562
'11410, 서대문구,'65,60 - 64세,1998,14639,7051,7588
'11410, 서대문구,'70,65 - 69세,1998,8660,3797,4863
'11410, 서대문구,'75,70 - 74세,1998,5381,2147,3234
'11410, 서대문구,'80,75 - 79세,1998,3607,1319,2288
'11410, 서대문구,'85,80 - 84세,1998,1901,537,1364
'11410, 서대문구,'90,85+ ,1998,1173,268,905
'1141051000,  충정로동,'00,계,1998,9302,4644,4658
'1141051000,  충정로동,'05,0 - 4세,1998,425,215,210
'1141051000,  충정로동,'10,5 - 9세,1998,482,268,214
'1141051000,  충정로동,'15,10 - 14세,1998,435,238,197
'1141051000,  충정로동,'20,15 - 19세,1998,757,426,331
'1141051000,  충정로동,'25,20 - 24세,1998,932,481,451
'1141051000,  충정로동,'30,25 - 29세,1998,1101,596,505
'1141051000,  충정로동,'35,30 - 34세,1998,801,430,371
'1141051000,  충정로동,'40,35 - 39세,1998,756,364,392
'1141051000,  충정로동,'45,40 - 44세,1998,751,346,405
'1141051000,  충정로동,'50,45 - 49세,1998,574,261,313
'1141051000,  충정로동,'55,50 - 54세,1998,582,263,319
'1141051000,  충정로동,'60,55 - 59세,1998,576,277,299
'1141051000,  충정로동,'65,60 - 64세,1998,442,218,224
'1141051000,  충정로동,'70,65 - 69세,1998,262,100,162
'1141051000,  충정로동,'75,70 - 74세,1998,189,78,111
'1141051000,  충정로동,'80,75 - 79세,1998,126,48,78
'1141051000,  충정로동,'85,80 - 84세,1998,61,21,40
'1141051000,  충정로동,'90,85+ ,1998,50,14,36
'1141052000,  천연동,'00,계,1998,20520,10205,10315
'1141052000,  천연동,'05,0 - 4세,1998,1313,710,603
'1141052000,  천연동,'10,5 - 9세,1998,1329,727,602
'1141052000,  천연동,'15,10 - 14세,1998,1167,603,564
'1141052000,  천연동,'20,15 - 19세,1998,1413,738,675
'1141052000,  천연동,'25,20 - 24세,1998,1596,838,758
'1141052000,  천연동,'30,25 - 29세,1998,2475,1270,1205
'1141052000,  천연동,'35,30 - 34세,1998,1945,984,961
'1141052000,  천연동,'40,35 - 39세,1998,2061,1085,976
'1141052000,  천연동,'45,40 - 44세,1998,1592,799,793
'1141052000,  천연동,'50,45 - 49세,1998,1182,554,628
'1141052000,  천연동,'55,50 - 54세,1998,1048,460,588
'1141052000,  천연동,'60,55 - 59세,1998,1200,528,672
'1141052000,  천연동,'65,60 - 64세,1998,887,415,472
'1141052000,  천연동,'70,65 - 69세,1998,574,224,350
'1141052000,  천연동,'75,70 - 74세,1998,326,124,202
'1141052000,  천연동,'80,75 - 79세,1998,239,87,152
'1141052000,  천연동,'85,80 - 84세,1998,118,44,74
'1141052000,  천연동,'90,85+ ,1998,55,15,40
'1141054000,  북아현1동,'00,계,1998,11615,5747,5868
'1141054000,  북아현1동,'05,0 - 4세,1998,781,416,365
'1141054000,  북아현1동,'10,5 - 9세,1998,604,341,263
'1141054000,  북아현1동,'15,10 - 14세,1998,517,271,246
'1141054000,  북아현1동,'20,15 - 19세,1998,820,440,380
'1141054000,  북아현1동,'25,20 - 24세,1998,1106,540,566
'1141054000,  북아현1동,'30,25 - 29세,1998,1874,914,960
'1141054000,  북아현1동,'35,30 - 34세,1998,1214,660,554
'1141054000,  북아현1동,'40,35 - 39세,1998,948,486,462
'1141054000,  북아현1동,'45,40 - 44세,1998,768,361,407
'1141054000,  북아현1동,'50,45 - 49세,1998,647,298,349
'1141054000,  북아현1동,'55,50 - 54세,1998,591,252,339
'1141054000,  북아현1동,'60,55 - 59세,1998,630,288,342
'1141054000,  북아현1동,'65,60 - 64세,1998,505,242,263
'1141054000,  북아현1동,'70,65 - 69세,1998,268,123,145
'1141054000,  북아현1동,'75,70 - 74세,1998,153,53,100
'1141054000,  북아현1동,'80,75 - 79세,1998,108,39,69
'1141054000,  북아현1동,'85,80 - 84세,1998,44,12,32
'1141054000,  북아현1동,'90,85+ ,1998,37,11,26
'1141055000,  북아현2동,'00,계,1998,8337,4137,4200
'1141055000,  북아현2동,'05,0 - 4세,1998,512,274,238
'1141055000,  북아현2동,'10,5 - 9세,1998,458,263,195
'1141055000,  북아현2동,'15,10 - 14세,1998,449,255,194
'1141055000,  북아현2동,'20,15 - 19세,1998,624,321,303
'1141055000,  북아현2동,'25,20 - 24세,1998,877,380,497
'1141055000,  북아현2동,'30,25 - 29세,1998,1173,615,558
'1141055000,  북아현2동,'35,30 - 34세,1998,850,438,412
'1141055000,  북아현2동,'40,35 - 39세,1998,710,369,341
'1141055000,  북아현2동,'45,40 - 44세,1998,663,331,332
'1141055000,  북아현2동,'50,45 - 49세,1998,457,208,249
'1141055000,  북아현2동,'55,50 - 54세,1998,391,187,204
'1141055000,  북아현2동,'60,55 - 59세,1998,429,189,240
'1141055000,  북아현2동,'65,60 - 64세,1998,284,130,154
'1141055000,  북아현2동,'70,65 - 69세,1998,201,76,125
'1141055000,  북아현2동,'75,70 - 74세,1998,109,41,68
'1141055000,  북아현2동,'80,75 - 79세,1998,81,36,45
'1141055000,  북아현2동,'85,80 - 84세,1998,42,16,26
'1141055000,  북아현2동,'90,85+ ,1998,27,8,19
'1141056000,  북아현3동,'00,계,1998,16064,7982,8082
'1141056000,  북아현3동,'05,0 - 4세,1998,991,522,469
'1141056000,  북아현3동,'10,5 - 9세,1998,843,445,398
'1141056000,  북아현3동,'15,10 - 14세,1998,825,417,408
'1141056000,  북아현3동,'20,15 - 19세,1998,1347,720,627
'1141056000,  북아현3동,'25,20 - 24세,1998,1496,709,787
'1141056000,  북아현3동,'30,25 - 29세,1998,2013,1075,938
'1141056000,  북아현3동,'35,30 - 34세,1998,1608,841,767
'1141056000,  북아현3동,'40,35 - 39세,1998,1384,712,672
'1141056000,  북아현3동,'45,40 - 44세,1998,1199,569,630
'1141056000,  북아현3동,'50,45 - 49세,1998,928,427,501
'1141056000,  북아현3동,'55,50 - 54세,1998,857,404,453
'1141056000,  북아현3동,'60,55 - 59세,1998,877,422,455
'1141056000,  북아현3동,'65,60 - 64세,1998,665,302,363
'1141056000,  북아현3동,'70,65 - 69세,1998,432,185,247
'1141056000,  북아현3동,'75,70 - 74세,1998,248,104,144
'1141056000,  북아현3동,'80,75 - 79세,1998,192,79,113
'1141056000,  북아현3동,'85,80 - 84세,1998,91,35,56
'1141056000,  북아현3동,'90,85+ ,1998,68,14,54
'1141057000,  대신동,'00,계,1998,8443,3924,4519
'1141057000,  대신동,'05,0 - 4세,1998,418,210,208
'1141057000,  대신동,'10,5 - 9세,1998,453,228,225
'1141057000,  대신동,'15,10 - 14세,1998,444,212,232
'1141057000,  대신동,'20,15 - 19세,1998,566,247,319
'1141057000,  대신동,'25,20 - 24세,1998,1001,337,664
'1141057000,  대신동,'30,25 - 29세,1998,1190,628,562
'1141057000,  대신동,'35,30 - 34세,1998,778,429,349
'1141057000,  대신동,'40,35 - 39세,1998,727,356,371
'1141057000,  대신동,'45,40 - 44세,1998,593,305,288
'1141057000,  대신동,'50,45 - 49세,1998,423,184,239
'1141057000,  대신동,'55,50 - 54세,1998,419,191,228
'1141057000,  대신동,'60,55 - 59세,1998,419,180,239
'1141057000,  대신동,'65,60 - 64세,1998,364,161,203
'1141057000,  대신동,'70,65 - 69세,1998,259,108,151
'1141057000,  대신동,'75,70 - 74세,1998,167,63,104
'1141057000,  대신동,'80,75 - 79세,1998,128,54,74
'1141057000,  대신동,'85,80 - 84세,1998,62,20,42
'1141057000,  대신동,'90,85+ ,1998,32,11,21
'1141058000,  창천동,'00,계,1998,11936,5864,6072
'1141058000,  창천동,'05,0 - 4세,1998,1332,713,619
'1141058000,  창천동,'10,5 - 9세,1998,524,281,243
'1141058000,  창천동,'15,10 - 14세,1998,480,261,219
'1141058000,  창천동,'20,15 - 19세,1998,712,326,386
'1141058000,  창천동,'25,20 - 24세,1998,1370,612,758
'1141058000,  창천동,'30,25 - 29세,1998,1950,1044,906
'1141058000,  창천동,'35,30 - 34세,1998,1036,573,463
'1141058000,  창천동,'40,35 - 39세,1998,775,409,366
'1141058000,  창천동,'45,40 - 44세,1998,701,343,358
'1141058000,  창천동,'50,45 - 49세,1998,551,225,326
'1141058000,  창천동,'55,50 - 54세,1998,611,256,355
'1141058000,  창천동,'60,55 - 59세,1998,688,296,392
'1141058000,  창천동,'65,60 - 64세,1998,486,210,276
'1141058000,  창천동,'70,65 - 69세,1998,312,158,154
'1141058000,  창천동,'75,70 - 74세,1998,175,79,96
'1141058000,  창천동,'80,75 - 79세,1998,117,48,69
'1141058000,  창천동,'85,80 - 84세,1998,71,23,48
'1141058000,  창천동,'90,85+ ,1998,45,7,38
'1141059000,  연희1동,'00,계,1998,15778,7775,8003
'1141059000,  연희1동,'05,0 - 4세,1998,931,455,476
'1141059000,  연희1동,'10,5 - 9세,1998,865,454,411
'1141059000,  연희1동,'15,10 - 14세,1998,786,385,401
'1141059000,  연희1동,'20,15 - 19세,1998,1117,581,536
'1141059000,  연희1동,'25,20 - 24세,1998,1452,704,748
'1141059000,  연희1동,'30,25 - 29세,1998,2118,1097,1021
'1141059000,  연희1동,'35,30 - 34세,1998,1465,804,661
'1141059000,  연희1동,'40,35 - 39세,1998,1329,653,676
'1141059000,  연희1동,'45,40 - 44세,1998,1138,559,579
'1141059000,  연희1동,'50,45 - 49세,1998,825,382,443
'1141059000,  연희1동,'55,50 - 54세,1998,938,426,512
'1141059000,  연희1동,'60,55 - 59세,1998,1022,500,522
'1141059000,  연희1동,'65,60 - 64세,1998,717,345,372
'1141059000,  연희1동,'70,65 - 69세,1998,467,212,255
'1141059000,  연희1동,'75,70 - 74세,1998,287,121,166
'1141059000,  연희1동,'80,75 - 79세,1998,160,61,99
'1141059000,  연희1동,'85,80 - 84세,1998,94,19,75
'1141059000,  연희1동,'90,85+ ,1998,67,17,50
'1141060000,  연희2동,'00,계,1998,12673,6293,6380
'1141060000,  연희2동,'05,0 - 4세,1998,705,375,330
'1141060000,  연희2동,'10,5 - 9세,1998,687,365,322
'1141060000,  연희2동,'15,10 - 14세,1998,672,341,331
'1141060000,  연희2동,'20,15 - 19세,1998,1007,524,483
'1141060000,  연희2동,'25,20 - 24세,1998,1127,563,564
'1141060000,  연희2동,'30,25 - 29세,1998,1595,836,759
'1141060000,  연희2동,'35,30 - 34세,1998,1155,608,547
'1141060000,  연희2동,'40,35 - 39세,1998,1023,504,519
'1141060000,  연희2동,'45,40 - 44세,1998,932,441,491
'1141060000,  연희2동,'50,45 - 49세,1998,761,357,404
'1141060000,  연희2동,'55,50 - 54세,1998,729,306,423
'1141060000,  연희2동,'60,55 - 59세,1998,865,438,427
'1141060000,  연희2동,'65,60 - 64세,1998,588,303,285
'1141060000,  연희2동,'70,65 - 69세,1998,338,153,185
'1141060000,  연희2동,'75,70 - 74세,1998,230,98,132
'1141060000,  연희2동,'80,75 - 79세,1998,147,59,88
'1141060000,  연희2동,'85,80 - 84세,1998,82,17,65
'1141060000,  연희2동,'90,85+ ,1998,30,5,25
'1141061000,  연희3동,'00,계,1998,12759,6279,6480
'1141061000,  연희3동,'05,0 - 4세,1998,629,333,296
'1141061000,  연희3동,'10,5 - 9세,1998,647,347,300
'1141061000,  연희3동,'15,10 - 14세,1998,666,350,316
'1141061000,  연희3동,'20,15 - 19세,1998,858,442,416
'1141061000,  연희3동,'25,20 - 24세,1998,1526,678,848
'1141061000,  연희3동,'30,25 - 29세,1998,2139,1201,938
'1141061000,  연희3동,'35,30 - 34세,1998,1105,563,542
'1141061000,  연희3동,'40,35 - 39세,1998,974,472,502
'1141061000,  연희3동,'45,40 - 44세,1998,895,401,494
'1141061000,  연희3동,'50,45 - 49세,1998,638,307,331
'1141061000,  연희3동,'55,50 - 54세,1998,636,270,366
'1141061000,  연희3동,'60,55 - 59세,1998,717,330,387
'1141061000,  연희3동,'65,60 - 64세,1998,561,271,290
'1141061000,  연희3동,'70,65 - 69세,1998,328,136,192
'1141061000,  연희3동,'75,70 - 74세,1998,183,85,98
'1141061000,  연희3동,'80,75 - 79세,1998,136,55,81
'1141061000,  연희3동,'85,80 - 84세,1998,69,23,46
'1141061000,  연희3동,'90,85+ ,1998,52,15,37
'1141062000,  홍제1동,'00,계,1998,15679,7639,8040
'1141062000,  홍제1동,'05,0 - 4세,1998,1044,530,514
'1141062000,  홍제1동,'10,5 - 9세,1998,875,449,426
'1141062000,  홍제1동,'15,10 - 14세,1998,841,426,415
'1141062000,  홍제1동,'20,15 - 19세,1998,1183,615,568
'1141062000,  홍제1동,'25,20 - 24세,1998,1416,657,759
'1141062000,  홍제1동,'30,25 - 29세,1998,2050,1030,1020
'1141062000,  홍제1동,'35,30 - 34세,1998,1514,781,733
'1141062000,  홍제1동,'40,35 - 39세,1998,1312,660,652
'1141062000,  홍제1동,'45,40 - 44세,1998,1177,560,617
'1141062000,  홍제1동,'50,45 - 49세,1998,898,415,483
'1141062000,  홍제1동,'55,50 - 54세,1998,866,390,476
'1141062000,  홍제1동,'60,55 - 59세,1998,902,433,469
'1141062000,  홍제1동,'65,60 - 64세,1998,664,307,357
'1141062000,  홍제1동,'70,65 - 69세,1998,389,188,201
'1141062000,  홍제1동,'75,70 - 74세,1998,249,93,156
'1141062000,  홍제1동,'80,75 - 79세,1998,159,67,92
'1141062000,  홍제1동,'85,80 - 84세,1998,81,27,54
'1141062000,  홍제1동,'90,85+ ,1998,59,11,48
'1141063000,  홍제2동,'00,계,1998,13060,6506,6554
'1141063000,  홍제2동,'05,0 - 4세,1998,1003,550,453
'1141063000,  홍제2동,'10,5 - 9세,1998,819,428,391
'1141063000,  홍제2동,'15,10 - 14세,1998,721,378,343
'1141063000,  홍제2동,'20,15 - 19세,1998,859,442,417
'1141063000,  홍제2동,'25,20 - 24세,1998,1008,486,522
'1141063000,  홍제2동,'30,25 - 29세,1998,1839,886,953
'1141063000,  홍제2동,'35,30 - 34세,1998,1390,747,643
'1141063000,  홍제2동,'40,35 - 39세,1998,1248,633,615
'1141063000,  홍제2동,'45,40 - 44세,1998,999,501,498
'1141063000,  홍제2동,'50,45 - 49세,1998,665,326,339
'1141063000,  홍제2동,'55,50 - 54세,1998,615,262,353
'1141063000,  홍제2동,'60,55 - 59세,1998,684,351,333
'1141063000,  홍제2동,'65,60 - 64세,1998,498,234,264
'1141063000,  홍제2동,'70,65 - 69세,1998,293,124,169
'1141063000,  홍제2동,'75,70 - 74세,1998,201,81,120
'1141063000,  홍제2동,'80,75 - 79세,1998,128,46,82
'1141063000,  홍제2동,'85,80 - 84세,1998,50,18,32
'1141063000,  홍제2동,'90,85+ ,1998,40,13,27
'1141064000,  홍제3동,'00,계,1998,20529,10300,10229
'1141064000,  홍제3동,'05,0 - 4세,1998,1211,624,587
'1141064000,  홍제3동,'10,5 - 9세,1998,1089,581,508
'1141064000,  홍제3동,'15,10 - 14세,1998,1103,564,539
'1141064000,  홍제3동,'20,15 - 19세,1998,1579,827,752
'1141064000,  홍제3동,'25,20 - 24세,1998,1933,971,962
'1141064000,  홍제3동,'30,25 - 29세,1998,2549,1375,1174
'1141064000,  홍제3동,'35,30 - 34세,1998,1898,1031,867
'1141064000,  홍제3동,'40,35 - 39세,1998,1747,870,877
'1141064000,  홍제3동,'45,40 - 44세,1998,1593,800,793
'1141064000,  홍제3동,'50,45 - 49세,1998,1197,570,627
'1141064000,  홍제3동,'55,50 - 54세,1998,1180,530,650
'1141064000,  홍제3동,'60,55 - 59세,1998,1279,601,678
'1141064000,  홍제3동,'65,60 - 64세,1998,952,475,477
'1141064000,  홍제3동,'70,65 - 69세,1998,508,231,277
'1141064000,  홍제3동,'75,70 - 74세,1998,307,116,191
'1141064000,  홍제3동,'80,75 - 79세,1998,219,87,132
'1141064000,  홍제3동,'85,80 - 84세,1998,123,31,92
'1141064000,  홍제3동,'90,85+ ,1998,62,16,46
'1141065000,  홍제4동,'00,계,1998,16686,8223,8463
'1141065000,  홍제4동,'05,0 - 4세,1998,1367,727,640
'1141065000,  홍제4동,'10,5 - 9세,1998,1291,684,607
'1141065000,  홍제4동,'15,10 - 14세,1998,989,494,495
'1141065000,  홍제4동,'20,15 - 19세,1998,1110,590,520
'1141065000,  홍제4동,'25,20 - 24세,1998,1153,567,586
'1141065000,  홍제4동,'30,25 - 29세,1998,1920,873,1047
'1141065000,  홍제4동,'35,30 - 34세,1998,1906,952,954
'1141065000,  홍제4동,'40,35 - 39세,1998,1847,949,898
'1141065000,  홍제4동,'45,40 - 44세,1998,1338,731,607
'1141065000,  홍제4동,'50,45 - 49세,1998,837,385,452
'1141065000,  홍제4동,'55,50 - 54세,1998,794,369,425
'1141065000,  홍제4동,'60,55 - 59세,1998,774,360,414
'1141065000,  홍제4동,'65,60 - 64세,1998,537,244,293
'1141065000,  홍제4동,'70,65 - 69세,1998,324,125,199
'1141065000,  홍제4동,'75,70 - 74세,1998,234,92,142
'1141065000,  홍제4동,'80,75 - 79세,1998,147,52,95
'1141065000,  홍제4동,'85,80 - 84세,1998,78,22,56
'1141065000,  홍제4동,'90,85+ ,1998,40,7,33
'1141066000,  홍은1동,'00,계,1998,11906,5935,5971
'1141066000,  홍은1동,'05,0 - 4세,1998,805,444,361
'1141066000,  홍은1동,'10,5 - 9세,1998,911,488,423
'1141066000,  홍은1동,'15,10 - 14세,1998,750,384,366
'1141066000,  홍은1동,'20,15 - 19세,1998,865,448,417
'1141066000,  홍은1동,'25,20 - 24세,1998,858,450,408
'1141066000,  홍은1동,'30,25 - 29세,1998,1264,630,634
'1141066000,  홍은1동,'35,30 - 34세,1998,1118,541,577
'1141066000,  홍은1동,'40,35 - 39세,1998,1203,600,603
'1141066000,  홍은1동,'45,40 - 44세,1998,1035,542,493
'1141066000,  홍은1동,'50,45 - 49세,1998,638,318,320
'1141066000,  홍은1동,'55,50 - 54세,1998,637,282,355
'1141066000,  홍은1동,'60,55 - 59세,1998,644,298,346
'1141066000,  홍은1동,'65,60 - 64세,1998,512,264,248
'1141066000,  홍은1동,'70,65 - 69세,1998,295,134,161
'1141066000,  홍은1동,'75,70 - 74세,1998,182,68,114
'1141066000,  홍은1동,'80,75 - 79세,1998,105,31,74
'1141066000,  홍은1동,'85,80 - 84세,1998,67,11,56
'1141066000,  홍은1동,'90,85+ ,1998,17,2,15
'1141067000,  홍은2동,'00,계,1998,21946,11025,10921
'1141067000,  홍은2동,'05,0 - 4세,1998,1588,829,759
'1141067000,  홍은2동,'10,5 - 9세,1998,1502,798,704
'1141067000,  홍은2동,'15,10 - 14세,1998,1215,600,615
'1141067000,  홍은2동,'20,15 - 19세,1998,1578,793,785
'1141067000,  홍은2동,'25,20 - 24세,1998,1829,929,900
'1141067000,  홍은2동,'30,25 - 29세,1998,2696,1425,1271
'1141067000,  홍은2동,'35,30 - 34세,1998,2191,1094,1097
'1141067000,  홍은2동,'40,35 - 39세,1998,2027,1087,940
'1141067000,  홍은2동,'45,40 - 44세,1998,1672,871,801
'1141067000,  홍은2동,'50,45 - 49세,1998,1232,608,624
'1141067000,  홍은2동,'55,50 - 54세,1998,1085,519,566
'1141067000,  홍은2동,'60,55 - 59세,1998,1212,582,630
'1141067000,  홍은2동,'65,60 - 64세,1998,920,422,498
'1141067000,  홍은2동,'70,65 - 69세,1998,507,217,290
'1141067000,  홍은2동,'75,70 - 74세,1998,315,126,189
'1141067000,  홍은2동,'80,75 - 79세,1998,201,81,120
'1141067000,  홍은2동,'85,80 - 84세,1998,103,29,74
'1141067000,  홍은2동,'90,85+ ,1998,73,15,58
'1141068000,  홍은3동,'00,계,1998,29612,14697,14915
'1141068000,  홍은3동,'05,0 - 4세,1998,2070,1057,1013
'1141068000,  홍은3동,'10,5 - 9세,1998,1924,1015,909
'1141068000,  홍은3동,'15,10 - 14세,1998,1740,940,800
'1141068000,  홍은3동,'20,15 - 19세,1998,2157,1147,1010
'1141068000,  홍은3동,'25,20 - 24세,1998,2302,1127,1175
'1141068000,  홍은3동,'30,25 - 29세,1998,3525,1733,1792
'1141068000,  홍은3동,'35,30 - 34세,1998,3034,1588,1446
'1141068000,  홍은3동,'40,35 - 39세,1998,2791,1385,1406
'1141068000,  홍은3동,'45,40 - 44세,1998,2375,1156,1219
'1141068000,  홍은3동,'50,45 - 49세,1998,1682,843,839
'1141068000,  홍은3동,'55,50 - 54세,1998,1566,705,861
'1141068000,  홍은3동,'60,55 - 59세,1998,1582,779,803
'1141068000,  홍은3동,'65,60 - 64세,1998,1150,572,578
'1141068000,  홍은3동,'70,65 - 69세,1998,696,320,376
'1141068000,  홍은3동,'75,70 - 74세,1998,411,155,256
'1141068000,  홍은3동,'80,75 - 79세,1998,334,115,219
'1141068000,  홍은3동,'85,80 - 84세,1998,157,36,121
'1141068000,  홍은3동,'90,85+ ,1998,116,24,92
'1141069000,  남가좌1동,'00,계,1998,20094,10081,10013
'1141069000,  남가좌1동,'05,0 - 4세,1998,1324,679,645
'1141069000,  남가좌1동,'10,5 - 9세,1998,1085,595,490
'1141069000,  남가좌1동,'15,10 - 14세,1998,921,465,456
'1141069000,  남가좌1동,'20,15 - 19세,1998,1594,836,758
'1141069000,  남가좌1동,'25,20 - 24세,1998,2002,1029,973
'1141069000,  남가좌1동,'30,25 - 29세,1998,2581,1353,1228
'1141069000,  남가좌1동,'35,30 - 34세,1998,1956,1085,871
'1141069000,  남가좌1동,'40,35 - 39세,1998,1563,830,733
'1141069000,  남가좌1동,'45,40 - 44세,1998,1504,727,777
'1141069000,  남가좌1동,'50,45 - 49세,1998,1222,562,660
'1141069000,  남가좌1동,'55,50 - 54세,1998,1213,536,677
'1141069000,  남가좌1동,'60,55 - 59세,1998,1220,589,631
'1141069000,  남가좌1동,'65,60 - 64세,1998,817,389,428
'1141069000,  남가좌1동,'70,65 - 69세,1998,441,182,259
'1141069000,  남가좌1동,'75,70 - 74세,1998,326,128,198
'1141069000,  남가좌1동,'80,75 - 79세,1998,182,65,117
'1141069000,  남가좌1동,'85,80 - 84세,1998,88,21,67
'1141069000,  남가좌1동,'90,85+ ,1998,55,10,45
'1141070000,  남가좌2동,'00,계,1998,29687,14798,14889
'1141070000,  남가좌2동,'05,0 - 4세,1998,2095,1063,1032
'1141070000,  남가좌2동,'10,5 - 9세,1998,1918,1018,900
'1141070000,  남가좌2동,'15,10 - 14세,1998,1714,916,798
'1141070000,  남가좌2동,'20,15 - 19세,1998,2341,1200,1141
'1141070000,  남가좌2동,'25,20 - 24세,1998,2633,1304,1329
'1141070000,  남가좌2동,'30,25 - 29세,1998,3711,1885,1826
'1141070000,  남가좌2동,'35,30 - 34세,1998,3006,1554,1452
'1141070000,  남가좌2동,'40,35 - 39세,1998,2650,1361,1289
'1141070000,  남가좌2동,'45,40 - 44세,1998,2276,1104,1172
'1141070000,  남가좌2동,'50,45 - 49세,1998,1725,799,926
'1141070000,  남가좌2동,'55,50 - 54세,1998,1650,773,877
'1141070000,  남가좌2동,'60,55 - 59세,1998,1503,755,748
'1141070000,  남가좌2동,'65,60 - 64세,1998,1041,517,524
'1141070000,  남가좌2동,'70,65 - 69세,1998,580,248,332
'1141070000,  남가좌2동,'75,70 - 74세,1998,396,174,222
'1141070000,  남가좌2동,'80,75 - 79세,1998,228,63,165
'1141070000,  남가좌2동,'85,80 - 84세,1998,130,47,83
'1141070000,  남가좌2동,'90,85+ ,1998,90,17,73
'1141071000,  북가좌1동,'00,계,1998,21336,10716,10620
'1141071000,  북가좌1동,'05,0 - 4세,1998,1434,748,686
'1141071000,  북가좌1동,'10,5 - 9세,1998,1402,740,662
'1141071000,  북가좌1동,'15,10 - 14세,1998,1246,665,581
'1141071000,  북가좌1동,'20,15 - 19세,1998,1618,843,775
'1141071000,  북가좌1동,'25,20 - 24세,1998,1911,965,946
'1141071000,  북가좌1동,'30,25 - 29세,1998,2563,1274,1289
'1141071000,  북가좌1동,'35,30 - 34세,1998,1993,1071,922
'1141071000,  북가좌1동,'40,35 - 39세,1998,1958,999,959
'1141071000,  북가좌1동,'45,40 - 44세,1998,1646,818,828
'1141071000,  북가좌1동,'50,45 - 49세,1998,1245,591,654
'1141071000,  북가좌1동,'55,50 - 54세,1998,1222,602,620
'1141071000,  북가좌1동,'60,55 - 59세,1998,1188,578,610
'1141071000,  북가좌1동,'65,60 - 64세,1998,764,374,390
'1141071000,  북가좌1동,'70,65 - 69세,1998,493,228,265
'1141071000,  북가좌1동,'75,70 - 74세,1998,277,112,165
'1141071000,  북가좌1동,'80,75 - 79세,1998,186,68,118
'1141071000,  북가좌1동,'85,80 - 84세,1998,130,29,101
'1141071000,  북가좌1동,'90,85+ ,1998,60,11,49
'1141072000,  북가좌2동,'00,계,1998,33771,16920,16851
'1141072000,  북가좌2동,'05,0 - 4세,1998,2208,1169,1039
'1141072000,  북가좌2동,'10,5 - 9세,1998,2221,1201,1020
'1141072000,  북가좌2동,'15,10 - 14세,1998,2008,1032,976
'1141072000,  북가좌2동,'20,15 - 19세,1998,2743,1402,1341
'1141072000,  북가좌2동,'25,20 - 24세,1998,2991,1539,1452
'1141072000,  북가좌2동,'30,25 - 29세,1998,3876,1954,1922
'1141072000,  북가좌2동,'35,30 - 34세,1998,3255,1656,1599
'1141072000,  북가좌2동,'40,35 - 39세,1998,3052,1541,1511
'1141072000,  북가좌2동,'45,40 - 44세,1998,2762,1373,1389
'1141072000,  북가좌2동,'50,45 - 49세,1998,2059,1014,1045
'1141072000,  북가좌2동,'55,50 - 54세,1998,1810,838,972
'1141072000,  북가좌2동,'60,55 - 59세,1998,1850,925,925
'1141072000,  북가좌2동,'65,60 - 64세,1998,1285,656,629
'1141072000,  북가좌2동,'70,65 - 69세,1998,693,325,368
'1141072000,  북가좌2동,'75,70 - 74세,1998,416,156,260
'1141072000,  북가좌2동,'80,75 - 79세,1998,284,78,206
'1141072000,  북가좌2동,'85,80 - 84세,1998,160,36,124
'1141072000,  북가좌2동,'90,85+ ,1998,98,25,73
'11440, 마포구,'00,계,1998,384550,190861,193689
'11440, 마포구,'05,0 - 4세,1998,25897,13406,12491
'11440, 마포구,'10,5 - 9세,1998,21904,11411,10493
'11440, 마포구,'15,10 - 14세,1998,19737,10242,9495
'11440, 마포구,'20,15 - 19세,1998,28893,14812,14081
'11440, 마포구,'25,20 - 24세,1998,36164,17344,18820
'11440, 마포구,'30,25 - 29세,1998,51678,26332,25346
'11440, 마포구,'35,30 - 34세,1998,38823,20800,18023
'11440, 마포구,'40,35 - 39세,1998,33494,17297,16197
'11440, 마포구,'45,40 - 44세,1998,28436,13817,14619
'11440, 마포구,'50,45 - 49세,1998,21749,10244,11505
'11440, 마포구,'55,50 - 54세,1998,20935,9718,11217
'11440, 마포구,'60,55 - 59세,1998,20176,9862,10314
'11440, 마포구,'65,60 - 64세,1998,14707,6952,7755
'11440, 마포구,'70,65 - 69세,1998,9093,4070,5023
'11440, 마포구,'75,70 - 74세,1998,5618,2227,3391
'11440, 마포구,'80,75 - 79세,1998,3945,1452,2493
'11440, 마포구,'85,80 - 84세,1998,2024,590,1434
'11440, 마포구,'90,85+ ,1998,1277,285,992
'1144051000,  아현1동,'00,계,1998,16927,8565,8362
'1144051000,  아현1동,'05,0 - 4세,1998,888,455,433
'1144051000,  아현1동,'10,5 - 9세,1998,836,432,404
'1144051000,  아현1동,'15,10 - 14세,1998,885,476,409
'1144051000,  아현1동,'20,15 - 19세,1998,1396,745,651
'1144051000,  아현1동,'25,20 - 24세,1998,1662,868,794
'1144051000,  아현1동,'30,25 - 29세,1998,2095,1142,953
'1144051000,  아현1동,'35,30 - 34세,1998,1491,825,666
'1144051000,  아현1동,'40,35 - 39세,1998,1390,731,659
'1144051000,  아현1동,'45,40 - 44세,1998,1307,622,685
'1144051000,  아현1동,'50,45 - 49세,1998,1063,490,573
'1144051000,  아현1동,'55,50 - 54세,1998,1075,487,588
'1144051000,  아현1동,'60,55 - 59세,1998,1017,505,512
'1144051000,  아현1동,'65,60 - 64세,1998,756,345,411
'1144051000,  아현1동,'70,65 - 69세,1998,444,206,238
'1144051000,  아현1동,'75,70 - 74세,1998,290,114,176
'1144051000,  아현1동,'80,75 - 79세,1998,190,78,112
'1144051000,  아현1동,'85,80 - 84세,1998,94,32,62
'1144051000,  아현1동,'90,85+ ,1998,48,12,36
'1144052000,  아현2동,'00,계,1998,11365,5566,5799
'1144052000,  아현2동,'05,0 - 4세,1998,549,290,259
'1144052000,  아현2동,'10,5 - 9세,1998,619,324,295
'1144052000,  아현2동,'15,10 - 14세,1998,604,311,293
'1144052000,  아현2동,'20,15 - 19세,1998,954,486,468
'1144052000,  아현2동,'25,20 - 24세,1998,1146,531,615
'1144052000,  아현2동,'30,25 - 29세,1998,1350,696,654
'1144052000,  아현2동,'35,30 - 34세,1998,1024,555,469
'1144052000,  아현2동,'40,35 - 39세,1998,928,477,451
'1144052000,  아현2동,'45,40 - 44세,1998,920,439,481
'1144052000,  아현2동,'50,45 - 49세,1998,701,321,380
'1144052000,  아현2동,'55,50 - 54세,1998,651,310,341
'1144052000,  아현2동,'60,55 - 59세,1998,675,291,384
'1144052000,  아현2동,'65,60 - 64세,1998,532,241,291
'1144052000,  아현2동,'70,65 - 69세,1998,301,130,171
'1144052000,  아현2동,'75,70 - 74세,1998,203,96,107
'1144052000,  아현2동,'80,75 - 79세,1998,109,44,65
'1144052000,  아현2동,'85,80 - 84세,1998,67,17,50
'1144052000,  아현2동,'90,85+ ,1998,32,7,25
'1144053000,  아현3동,'00,계,1998,10220,5080,5140
'1144053000,  아현3동,'05,0 - 4세,1998,634,323,311
'1144053000,  아현3동,'10,5 - 9세,1998,541,296,245
'1144053000,  아현3동,'15,10 - 14세,1998,502,279,223
'1144053000,  아현3동,'20,15 - 19세,1998,758,386,372
'1144053000,  아현3동,'25,20 - 24세,1998,982,457,525
'1144053000,  아현3동,'30,25 - 29세,1998,1462,754,708
'1144053000,  아현3동,'35,30 - 34세,1998,996,561,435
'1144053000,  아현3동,'40,35 - 39세,1998,860,462,398
'1144053000,  아현3동,'45,40 - 44세,1998,748,339,409
'1144053000,  아현3동,'50,45 - 49세,1998,563,266,297
'1144053000,  아현3동,'55,50 - 54세,1998,556,258,298
'1144053000,  아현3동,'60,55 - 59세,1998,560,262,298
'1144053000,  아현3동,'65,60 - 64세,1998,424,207,217
'1144053000,  아현3동,'70,65 - 69세,1998,273,118,155
'1144053000,  아현3동,'75,70 - 74세,1998,162,56,106
'1144053000,  아현3동,'80,75 - 79세,1998,114,32,82
'1144053000,  아현3동,'85,80 - 84세,1998,56,18,38
'1144053000,  아현3동,'90,85+ ,1998,29,6,23
'1144054000,  공덕1동,'00,계,1998,12399,6147,6252
'1144054000,  공덕1동,'05,0 - 4세,1998,817,428,389
'1144054000,  공덕1동,'10,5 - 9세,1998,718,363,355
'1144054000,  공덕1동,'15,10 - 14세,1998,546,241,305
'1144054000,  공덕1동,'20,15 - 19세,1998,884,488,396
'1144054000,  공덕1동,'25,20 - 24세,1998,1243,614,629
'1144054000,  공덕1동,'30,25 - 29세,1998,1672,839,833
'1144054000,  공덕1동,'35,30 - 34세,1998,1242,677,565
'1144054000,  공덕1동,'40,35 - 39세,1998,1055,562,493
'1144054000,  공덕1동,'45,40 - 44세,1998,809,406,403
'1144054000,  공덕1동,'50,45 - 49세,1998,712,316,396
'1144054000,  공덕1동,'55,50 - 54세,1998,692,329,363
'1144054000,  공덕1동,'60,55 - 59세,1998,676,327,349
'1144054000,  공덕1동,'65,60 - 64세,1998,556,259,297
'1144054000,  공덕1동,'70,65 - 69세,1998,330,150,180
'1144054000,  공덕1동,'75,70 - 74세,1998,202,69,133
'1144054000,  공덕1동,'80,75 - 79세,1998,145,51,94
'1144054000,  공덕1동,'85,80 - 84세,1998,63,20,43
'1144054000,  공덕1동,'90,85+ ,1998,37,8,29
'1144055000,  공덕2동,'00,계,1998,11063,5523,5540
'1144055000,  공덕2동,'05,0 - 4세,1998,632,331,301
'1144055000,  공덕2동,'10,5 - 9세,1998,579,309,270
'1144055000,  공덕2동,'15,10 - 14세,1998,569,295,274
'1144055000,  공덕2동,'20,15 - 19세,1998,876,464,412
'1144055000,  공덕2동,'25,20 - 24세,1998,953,486,467
'1144055000,  공덕2동,'30,25 - 29세,1998,1339,705,634
'1144055000,  공덕2동,'35,30 - 34세,1998,1008,553,455
'1144055000,  공덕2동,'40,35 - 39세,1998,996,495,501
'1144055000,  공덕2동,'45,40 - 44세,1998,886,435,451
'1144055000,  공덕2동,'50,45 - 49세,1998,712,367,345
'1144055000,  공덕2동,'55,50 - 54세,1998,613,266,347
'1144055000,  공덕2동,'60,55 - 59세,1998,619,298,321
'1144055000,  공덕2동,'65,60 - 64세,1998,510,230,280
'1144055000,  공덕2동,'70,65 - 69세,1998,305,125,180
'1144055000,  공덕2동,'75,70 - 74세,1998,199,77,122
'1144055000,  공덕2동,'80,75 - 79세,1998,149,52,97
'1144055000,  공덕2동,'85,80 - 84세,1998,76,28,48
'1144055000,  공덕2동,'90,85+ ,1998,42,7,35
'1144056000,  신공덕동,'00,계,1998,7679,3866,3813
'1144056000,  신공덕동,'05,0 - 4세,1998,412,229,183
'1144056000,  신공덕동,'10,5 - 9세,1998,398,204,194
'1144056000,  신공덕동,'15,10 - 14세,1998,398,194,204
'1144056000,  신공덕동,'20,15 - 19세,1998,588,307,281
'1144056000,  신공덕동,'25,20 - 24세,1998,622,326,296
'1144056000,  신공덕동,'30,25 - 29세,1998,883,491,392
'1144056000,  신공덕동,'35,30 - 34세,1998,667,352,315
'1144056000,  신공덕동,'40,35 - 39세,1998,654,378,276
'1144056000,  신공덕동,'45,40 - 44세,1998,575,285,290
'1144056000,  신공덕동,'50,45 - 49세,1998,450,220,230
'1144056000,  신공덕동,'55,50 - 54세,1998,441,199,242
'1144056000,  신공덕동,'60,55 - 59세,1998,536,231,305
'1144056000,  신공덕동,'65,60 - 64세,1998,389,189,200
'1144056000,  신공덕동,'70,65 - 69세,1998,241,95,146
'1144056000,  신공덕동,'75,70 - 74세,1998,190,75,115
'1144056000,  신공덕동,'80,75 - 79세,1998,142,61,81
'1144056000,  신공덕동,'85,80 - 84세,1998,64,20,44
'1144056000,  신공덕동,'90,85+ ,1998,29,10,19
'1144057000,  도화1동,'00,계,1998,11122,5446,5676
'1144057000,  도화1동,'05,0 - 4세,1998,783,405,378
'1144057000,  도화1동,'10,5 - 9세,1998,733,377,356
'1144057000,  도화1동,'15,10 - 14세,1998,602,309,293
'1144057000,  도화1동,'20,15 - 19세,1998,781,387,394
'1144057000,  도화1동,'25,20 - 24세,1998,856,431,425
'1144057000,  도화1동,'30,25 - 29세,1998,1369,661,708
'1144057000,  도화1동,'35,30 - 34세,1998,1148,567,581
'1144057000,  도화1동,'40,35 - 39세,1998,1028,533,495
'1144057000,  도화1동,'45,40 - 44세,1998,871,433,438
'1144057000,  도화1동,'50,45 - 49세,1998,605,287,318
'1144057000,  도화1동,'55,50 - 54세,1998,620,278,342
'1144057000,  도화1동,'60,55 - 59세,1998,583,284,299
'1144057000,  도화1동,'65,60 - 64세,1998,452,213,239
'1144057000,  도화1동,'70,65 - 69세,1998,273,133,140
'1144057000,  도화1동,'75,70 - 74세,1998,198,80,118
'1144057000,  도화1동,'80,75 - 79세,1998,117,40,77
'1144057000,  도화1동,'85,80 - 84세,1998,68,22,46
'1144057000,  도화1동,'90,85+ ,1998,35,6,29
'1144058000,  도화2동,'00,계,1998,10936,5361,5575
'1144058000,  도화2동,'05,0 - 4세,1998,790,423,367
'1144058000,  도화2동,'10,5 - 9세,1998,644,300,344
'1144058000,  도화2동,'15,10 - 14세,1998,568,301,267
'1144058000,  도화2동,'20,15 - 19세,1998,681,340,341
'1144058000,  도화2동,'25,20 - 24세,1998,812,408,404
'1144058000,  도화2동,'30,25 - 29세,1998,1362,651,711
'1144058000,  도화2동,'35,30 - 34세,1998,1180,612,568
'1144058000,  도화2동,'40,35 - 39세,1998,1045,542,503
'1144058000,  도화2동,'45,40 - 44세,1998,837,417,420
'1144058000,  도화2동,'50,45 - 49세,1998,586,276,310
'1144058000,  도화2동,'55,50 - 54세,1998,588,254,334
'1144058000,  도화2동,'60,55 - 59세,1998,637,319,318
'1144058000,  도화2동,'65,60 - 64세,1998,488,221,267
'1144058000,  도화2동,'70,65 - 69세,1998,319,140,179
'1144058000,  도화2동,'75,70 - 74세,1998,178,88,90
'1144058000,  도화2동,'80,75 - 79세,1998,128,45,83
'1144058000,  도화2동,'85,80 - 84세,1998,59,20,39
'1144058000,  도화2동,'90,85+ ,1998,34,4,30
'1144059000,  용강동,'00,계,1998,11106,5577,5529
'1144059000,  용강동,'05,0 - 4세,1998,739,371,368
'1144059000,  용강동,'10,5 - 9세,1998,603,313,290
'1144059000,  용강동,'15,10 - 14세,1998,503,275,228
'1144059000,  용강동,'20,15 - 19세,1998,765,375,390
'1144059000,  용강동,'25,20 - 24세,1998,947,457,490
'1144059000,  용강동,'30,25 - 29세,1998,1600,849,751
'1144059000,  용강동,'35,30 - 34세,1998,1172,634,538
'1144059000,  용강동,'40,35 - 39세,1998,967,524,443
'1144059000,  용강동,'45,40 - 44세,1998,829,407,422
'1144059000,  용강동,'50,45 - 49세,1998,651,313,338
'1144059000,  용강동,'55,50 - 54세,1998,665,285,380
'1144059000,  용강동,'60,55 - 59세,1998,634,326,308
'1144059000,  용강동,'65,60 - 64세,1998,434,220,214
'1144059000,  용강동,'70,65 - 69세,1998,248,117,131
'1144059000,  용강동,'75,70 - 74세,1998,140,50,90
'1144059000,  용강동,'80,75 - 79세,1998,125,42,83
'1144059000,  용강동,'85,80 - 84세,1998,51,14,37
'1144059000,  용강동,'90,85+ ,1998,33,5,28
'1144060000,  대흥동,'00,계,1998,10352,5130,5222
'1144060000,  대흥동,'05,0 - 4세,1998,552,267,285
'1144060000,  대흥동,'10,5 - 9세,1998,484,238,246
'1144060000,  대흥동,'15,10 - 14세,1998,469,246,223
'1144060000,  대흥동,'20,15 - 19세,1998,828,441,387
'1144060000,  대흥동,'25,20 - 24세,1998,1100,545,555
'1144060000,  대흥동,'30,25 - 29세,1998,1414,740,674
'1144060000,  대흥동,'35,30 - 34세,1998,963,542,421
'1144060000,  대흥동,'40,35 - 39세,1998,835,436,399
'1144060000,  대흥동,'45,40 - 44세,1998,739,345,394
'1144060000,  대흥동,'50,45 - 49세,1998,627,279,348
'1144060000,  대흥동,'55,50 - 54세,1998,603,298,305
'1144060000,  대흥동,'60,55 - 59세,1998,606,273,333
'1144060000,  대흥동,'65,60 - 64세,1998,456,205,251
'1144060000,  대흥동,'70,65 - 69세,1998,269,122,147
'1144060000,  대흥동,'75,70 - 74세,1998,176,69,107
'1144060000,  대흥동,'80,75 - 79세,1998,124,55,69
'1144060000,  대흥동,'85,80 - 84세,1998,63,17,46
'1144060000,  대흥동,'90,85+ ,1998,44,12,32
'1144061000,  염리동,'00,계,1998,21114,10451,10663
'1144061000,  염리동,'05,0 - 4세,1998,1355,696,659
'1144061000,  염리동,'10,5 - 9세,1998,1102,573,529
'1144061000,  염리동,'15,10 - 14세,1998,1115,576,539
'1144061000,  염리동,'20,15 - 19세,1998,1532,795,737
'1144061000,  염리동,'25,20 - 24세,1998,2169,992,1177
'1144061000,  염리동,'30,25 - 29세,1998,2937,1518,1419
'1144061000,  염리동,'35,30 - 34세,1998,2003,1073,930
'1144061000,  염리동,'40,35 - 39세,1998,1932,983,949
'1144061000,  염리동,'45,40 - 44세,1998,1613,811,802
'1144061000,  염리동,'50,45 - 49세,1998,1119,552,567
'1144061000,  염리동,'55,50 - 54세,1998,1073,484,589
'1144061000,  염리동,'60,55 - 59세,1998,1122,532,590
'1144061000,  염리동,'65,60 - 64세,1998,819,364,455
'1144061000,  염리동,'70,65 - 69세,1998,518,232,286
'1144061000,  염리동,'75,70 - 74세,1998,308,143,165
'1144061000,  염리동,'80,75 - 79세,1998,230,68,162
'1144061000,  염리동,'85,80 - 84세,1998,100,37,63
'1144061000,  염리동,'90,85+ ,1998,67,22,45
'1144062000,  노고산동,'00,계,1998,9915,4833,5082
'1144062000,  노고산동,'05,0 - 4세,1998,463,250,213
'1144062000,  노고산동,'10,5 - 9세,1998,429,238,191
'1144062000,  노고산동,'15,10 - 14세,1998,407,210,197
'1144062000,  노고산동,'20,15 - 19세,1998,712,364,348
'1144062000,  노고산동,'25,20 - 24세,1998,1218,507,711
'1144062000,  노고산동,'30,25 - 29세,1998,1700,900,800
'1144062000,  노고산동,'35,30 - 34세,1998,899,499,400
'1144062000,  노고산동,'40,35 - 39세,1998,778,402,376
'1144062000,  노고산동,'45,40 - 44세,1998,656,299,357
'1144062000,  노고산동,'50,45 - 49세,1998,562,253,309
'1144062000,  노고산동,'55,50 - 54세,1998,525,256,269
'1144062000,  노고산동,'60,55 - 59세,1998,526,256,270
'1144062000,  노고산동,'65,60 - 64세,1998,400,152,248
'1144062000,  노고산동,'70,65 - 69세,1998,252,110,142
'1144062000,  노고산동,'75,70 - 74세,1998,173,67,106
'1144062000,  노고산동,'80,75 - 79세,1998,124,42,82
'1144062000,  노고산동,'85,80 - 84세,1998,51,15,36
'1144062000,  노고산동,'90,85+ ,1998,40,13,27
'1144063000,  신수동,'00,계,1998,21181,10653,10528
'1144063000,  신수동,'05,0 - 4세,1998,1328,674,654
'1144063000,  신수동,'10,5 - 9세,1998,1234,657,577
'1144063000,  신수동,'15,10 - 14세,1998,1161,639,522
'1144063000,  신수동,'20,15 - 19세,1998,1689,859,830
'1144063000,  신수동,'25,20 - 24세,1998,1977,964,1013
'1144063000,  신수동,'30,25 - 29세,1998,2733,1475,1258
'1144063000,  신수동,'35,30 - 34세,1998,1962,1063,899
'1144063000,  신수동,'40,35 - 39세,1998,1834,905,929
'1144063000,  신수동,'45,40 - 44세,1998,1688,826,862
'1144063000,  신수동,'50,45 - 49세,1998,1267,627,640
'1144063000,  신수동,'55,50 - 54세,1998,1165,541,624
'1144063000,  신수동,'60,55 - 59세,1998,1160,563,597
'1144063000,  신수동,'65,60 - 64세,1998,816,419,397
'1144063000,  신수동,'70,65 - 69세,1998,481,209,272
'1144063000,  신수동,'75,70 - 74세,1998,294,113,181
'1144063000,  신수동,'80,75 - 79세,1998,208,75,133
'1144063000,  신수동,'85,80 - 84세,1998,114,29,85
'1144063000,  신수동,'90,85+ ,1998,70,15,55
'1144064000,  창전동,'00,계,1998,13056,6484,6572
'1144064000,  창전동,'05,0 - 4세,1998,753,363,390
'1144064000,  창전동,'10,5 - 9세,1998,764,422,342
'1144064000,  창전동,'15,10 - 14세,1998,708,337,371
'1144064000,  창전동,'20,15 - 19세,1998,977,487,490
'1144064000,  창전동,'25,20 - 24세,1998,1254,571,683
'1144064000,  창전동,'30,25 - 29세,1998,1907,1035,872
'1144064000,  창전동,'35,30 - 34세,1998,1295,701,594
'1144064000,  창전동,'40,35 - 39세,1998,1205,614,591
'1144064000,  창전동,'45,40 - 44세,1998,936,476,460
'1144064000,  창전동,'50,45 - 49세,1998,731,366,365
'1144064000,  창전동,'55,50 - 54세,1998,645,280,365
'1144064000,  창전동,'60,55 - 59세,1998,688,347,341
'1144064000,  창전동,'65,60 - 64세,1998,474,220,254
'1144064000,  창전동,'70,65 - 69세,1998,274,115,159
'1144064000,  창전동,'75,70 - 74세,1998,193,62,131
'1144064000,  창전동,'80,75 - 79세,1998,141,58,83
'1144064000,  창전동,'85,80 - 84세,1998,67,19,48
'1144064000,  창전동,'90,85+ ,1998,44,11,33
'1144065000,  상수동,'00,계,1998,13712,6775,6937
'1144065000,  상수동,'05,0 - 4세,1998,870,441,429
'1144065000,  상수동,'10,5 - 9세,1998,777,426,351
'1144065000,  상수동,'15,10 - 14세,1998,759,377,382
'1144065000,  상수동,'20,15 - 19세,1998,1028,508,520
'1144065000,  상수동,'25,20 - 24세,1998,1373,648,725
'1144065000,  상수동,'30,25 - 29세,1998,1867,967,900
'1144065000,  상수동,'35,30 - 34세,1998,1353,742,611
'1144065000,  상수동,'40,35 - 39세,1998,1211,601,610
'1144065000,  상수동,'45,40 - 44세,1998,1016,472,544
'1144065000,  상수동,'50,45 - 49세,1998,789,372,417
'1144065000,  상수동,'55,50 - 54세,1998,781,371,410
'1144065000,  상수동,'60,55 - 59세,1998,703,350,353
'1144065000,  상수동,'65,60 - 64세,1998,469,210,259
'1144065000,  상수동,'70,65 - 69세,1998,299,142,157
'1144065000,  상수동,'75,70 - 74세,1998,179,68,111
'1144065000,  상수동,'80,75 - 79세,1998,118,46,72
'1144065000,  상수동,'85,80 - 84세,1998,65,23,42
'1144065000,  상수동,'90,85+ ,1998,55,11,44
'1144066000,  서교동,'00,계,1998,18479,8967,9512
'1144066000,  서교동,'05,0 - 4세,1998,1098,544,554
'1144066000,  서교동,'10,5 - 9세,1998,952,480,472
'1144066000,  서교동,'15,10 - 14세,1998,783,392,391
'1144066000,  서교동,'20,15 - 19세,1998,1218,612,606
'1144066000,  서교동,'25,20 - 24세,1998,1861,817,1044
'1144066000,  서교동,'30,25 - 29세,1998,3087,1518,1569
'1144066000,  서교동,'35,30 - 34세,1998,1999,1079,920
'1144066000,  서교동,'40,35 - 39세,1998,1459,723,736
'1144066000,  서교동,'45,40 - 44세,1998,1196,562,634
'1144066000,  서교동,'50,45 - 49세,1998,974,448,526
'1144066000,  서교동,'55,50 - 54세,1998,991,448,543
'1144066000,  서교동,'60,55 - 59세,1998,953,469,484
'1144066000,  서교동,'65,60 - 64세,1998,815,390,425
'1144066000,  서교동,'70,65 - 69세,1998,483,244,239
'1144066000,  서교동,'75,70 - 74세,1998,260,120,140
'1144066000,  서교동,'80,75 - 79세,1998,163,72,91
'1144066000,  서교동,'85,80 - 84세,1998,103,31,72
'1144066000,  서교동,'90,85+ ,1998,84,18,66
'1144067000,  동교동,'00,계,1998,13848,6678,7170
'1144067000,  동교동,'05,0 - 4세,1998,738,367,371
'1144067000,  동교동,'10,5 - 9세,1998,692,351,341
'1144067000,  동교동,'15,10 - 14세,1998,612,311,301
'1144067000,  동교동,'20,15 - 19세,1998,915,450,465
'1144067000,  동교동,'25,20 - 24세,1998,1515,666,849
'1144067000,  동교동,'30,25 - 29세,1998,2369,1184,1185
'1144067000,  동교동,'35,30 - 34세,1998,1502,814,688
'1144067000,  동교동,'40,35 - 39세,1998,1052,517,535
'1144067000,  동교동,'45,40 - 44세,1998,962,459,503
'1144067000,  동교동,'50,45 - 49세,1998,684,294,390
'1144067000,  동교동,'55,50 - 54세,1998,718,330,388
'1144067000,  동교동,'60,55 - 59세,1998,736,347,389
'1144067000,  동교동,'65,60 - 64세,1998,550,254,296
'1144067000,  동교동,'70,65 - 69세,1998,352,169,183
'1144067000,  동교동,'75,70 - 74세,1998,199,80,119
'1144067000,  동교동,'80,75 - 79세,1998,133,57,76
'1144067000,  동교동,'85,80 - 84세,1998,66,19,47
'1144067000,  동교동,'90,85+ ,1998,53,9,44
'1144068000,  합정동,'00,계,1998,23581,11614,11967
'1144068000,  합정동,'05,0 - 4세,1998,2607,1357,1250
'1144068000,  합정동,'10,5 - 9세,1998,1254,641,613
'1144068000,  합정동,'15,10 - 14세,1998,1043,533,510
'1144068000,  합정동,'20,15 - 19세,1998,1558,837,721
'1144068000,  합정동,'25,20 - 24세,1998,2113,982,1131
'1144068000,  합정동,'30,25 - 29세,1998,3458,1657,1801
'1144068000,  합정동,'35,30 - 34세,1998,2550,1380,1170
'1144068000,  합정동,'40,35 - 39세,1998,1874,994,880
'1144068000,  합정동,'45,40 - 44세,1998,1499,699,800
'1144068000,  합정동,'50,45 - 49세,1998,1207,550,657
'1144068000,  합정동,'55,50 - 54세,1998,1213,557,656
'1144068000,  합정동,'60,55 - 59세,1998,1167,571,596
'1144068000,  합정동,'65,60 - 64세,1998,824,387,437
'1144068000,  합정동,'70,65 - 69세,1998,530,237,293
'1144068000,  합정동,'75,70 - 74세,1998,297,125,172
'1144068000,  합정동,'80,75 - 79세,1998,202,74,128
'1144068000,  합정동,'85,80 - 84세,1998,116,21,95
'1144068000,  합정동,'90,85+ ,1998,69,12,57
'1144069000,  망원1동,'00,계,1998,25628,12897,12731
'1144069000,  망원1동,'05,0 - 4세,1998,1994,1027,967
'1144069000,  망원1동,'10,5 - 9세,1998,1636,854,782
'1144069000,  망원1동,'15,10 - 14세,1998,1408,750,658
'1144069000,  망원1동,'20,15 - 19세,1998,1919,985,934
'1144069000,  망원1동,'25,20 - 24세,1998,2269,1157,1112
'1144069000,  망원1동,'30,25 - 29세,1998,3448,1706,1742
'1144069000,  망원1동,'35,30 - 34세,1998,2836,1500,1336
'1144069000,  망원1동,'40,35 - 39세,1998,2404,1266,1138
'1144069000,  망원1동,'45,40 - 44세,1998,1857,928,929
'1144069000,  망원1동,'50,45 - 49세,1998,1386,663,723
'1144069000,  망원1동,'55,50 - 54세,1998,1357,649,708
'1144069000,  망원1동,'60,55 - 59세,1998,1124,577,547
'1144069000,  망원1동,'65,60 - 64세,1998,816,400,416
'1144069000,  망원1동,'70,65 - 69세,1998,493,213,280
'1144069000,  망원1동,'75,70 - 74세,1998,291,111,180
'1144069000,  망원1동,'80,75 - 79세,1998,210,68,142
'1144069000,  망원1동,'85,80 - 84세,1998,117,31,86
'1144069000,  망원1동,'90,85+ ,1998,63,12,51
'1144070000,  망원2동,'00,계,1998,21269,10648,10621
'1144070000,  망원2동,'05,0 - 4세,1998,1539,814,725
'1144070000,  망원2동,'10,5 - 9세,1998,1396,715,681
'1144070000,  망원2동,'15,10 - 14세,1998,1260,643,617
'1144070000,  망원2동,'20,15 - 19세,1998,1719,866,853
'1144070000,  망원2동,'25,20 - 24세,1998,1872,900,972
'1144070000,  망원2동,'30,25 - 29세,1998,2579,1311,1268
'1144070000,  망원2동,'35,30 - 34세,1998,2098,1097,1001
'1144070000,  망원2동,'40,35 - 39세,1998,1914,994,920
'1144070000,  망원2동,'45,40 - 44세,1998,1678,818,860
'1144070000,  망원2동,'50,45 - 49세,1998,1274,608,666
'1144070000,  망원2동,'55,50 - 54세,1998,1161,582,579
'1144070000,  망원2동,'60,55 - 59세,1998,1046,543,503
'1144070000,  망원2동,'65,60 - 64세,1998,713,352,361
'1144070000,  망원2동,'70,65 - 69세,1998,450,202,248
'1144070000,  망원2동,'75,70 - 74세,1998,259,102,157
'1144070000,  망원2동,'80,75 - 79세,1998,157,57,100
'1144070000,  망원2동,'85,80 - 84세,1998,94,30,64
'1144070000,  망원2동,'90,85+ ,1998,60,14,46
'1144071000,  연남동,'00,계,1998,19580,9737,9843
'1144071000,  연남동,'05,0 - 4세,1998,1299,694,605
'1144071000,  연남동,'10,5 - 9세,1998,1026,538,488
'1144071000,  연남동,'15,10 - 14세,1998,927,512,415
'1144071000,  연남동,'20,15 - 19세,1998,1395,719,676
'1144071000,  연남동,'25,20 - 24세,1998,1835,866,969
'1144071000,  연남동,'30,25 - 29세,1998,2928,1482,1446
'1144071000,  연남동,'35,30 - 34세,1998,2085,1122,963
'1144071000,  연남동,'40,35 - 39세,1998,1586,820,766
'1144071000,  연남동,'45,40 - 44세,1998,1381,642,739
'1144071000,  연남동,'50,45 - 49세,1998,1115,528,587
'1144071000,  연남동,'55,50 - 54세,1998,1066,477,589
'1144071000,  연남동,'60,55 - 59세,1998,1019,472,547
'1144071000,  연남동,'65,60 - 64세,1998,749,366,383
'1144071000,  연남동,'70,65 - 69세,1998,504,239,265
'1144071000,  연남동,'75,70 - 74세,1998,272,123,149
'1144071000,  연남동,'80,75 - 79세,1998,206,85,121
'1144071000,  연남동,'85,80 - 84세,1998,107,35,72
'1144071000,  연남동,'90,85+ ,1998,80,17,63
'1144072000,  성산1동,'00,계,1998,19540,9729,9811
'1144072000,  성산1동,'05,0 - 4세,1998,1371,715,656
'1144072000,  성산1동,'10,5 - 9세,1998,1105,552,553
'1144072000,  성산1동,'15,10 - 14세,1998,997,523,474
'1144072000,  성산1동,'20,15 - 19세,1998,1536,804,732
'1144072000,  성산1동,'25,20 - 24세,1998,1726,845,881
'1144072000,  성산1동,'30,25 - 29세,1998,2555,1303,1252
'1144072000,  성산1동,'35,30 - 34세,1998,2122,1117,1005
'1144072000,  성산1동,'40,35 - 39세,1998,1696,862,834
'1144072000,  성산1동,'45,40 - 44세,1998,1486,704,782
'1144072000,  성산1동,'50,45 - 49세,1998,1113,517,596
'1144072000,  성산1동,'55,50 - 54세,1998,1060,533,527
'1144072000,  성산1동,'60,55 - 59세,1998,1011,495,516
'1144072000,  성산1동,'65,60 - 64세,1998,703,356,347
'1144072000,  성산1동,'70,65 - 69세,1998,444,194,250
'1144072000,  성산1동,'75,70 - 74세,1998,237,94,143
'1144072000,  성산1동,'80,75 - 79세,1998,195,73,122
'1144072000,  성산1동,'85,80 - 84세,1998,103,25,78
'1144072000,  성산1동,'90,85+ ,1998,80,17,63
'1144073000,  성산2동,'00,계,1998,39877,19640,20237
'1144073000,  성산2동,'05,0 - 4세,1998,3117,1629,1488
'1144073000,  성산2동,'10,5 - 9세,1998,2760,1468,1292
'1144073000,  성산2동,'15,10 - 14세,1998,2233,1158,1075
'1144073000,  성산2동,'20,15 - 19세,1998,3187,1604,1583
'1144073000,  성산2동,'25,20 - 24세,1998,3777,1850,1927
'1144073000,  성산2동,'30,25 - 29세,1998,4530,2162,2368
'1144073000,  성산2동,'35,30 - 34세,1998,4346,2233,2113
'1144073000,  성산2동,'40,35 - 39세,1998,3856,1980,1876
'1144073000,  성산2동,'45,40 - 44세,1998,3071,1540,1531
'1144073000,  성산2동,'50,45 - 49세,1998,2191,950,1241
'1144073000,  성산2동,'55,50 - 54세,1998,2092,957,1135
'1144073000,  성산2동,'60,55 - 59세,1998,1760,906,854
'1144073000,  성산2동,'65,60 - 64세,1998,1120,545,575
'1144073000,  성산2동,'70,65 - 69세,1998,712,305,407
'1144073000,  성산2동,'75,70 - 74세,1998,479,161,318
'1144073000,  성산2동,'80,75 - 79세,1998,365,126,239
'1144073000,  성산2동,'85,80 - 84세,1998,183,43,140
'1144073000,  성산2동,'90,85+ ,1998,98,23,75
'1144074000,  상암동,'00,계,1998,10601,5494,5107
'1144074000,  상암동,'05,0 - 4세,1998,569,313,256
'1144074000,  상암동,'10,5 - 9세,1998,622,340,282
'1144074000,  상암동,'15,10 - 14세,1998,678,354,324
'1144074000,  상암동,'20,15 - 19세,1998,997,503,494
'1144074000,  상암동,'25,20 - 24세,1998,882,456,426
'1144074000,  상암동,'30,25 - 29세,1998,1034,586,448
'1144074000,  상암동,'35,30 - 34세,1998,882,502,380
'1144074000,  상암동,'40,35 - 39세,1998,935,496,439
'1144074000,  상암동,'45,40 - 44세,1998,876,453,423
'1144074000,  상암동,'50,45 - 49세,1998,667,381,286
'1144074000,  상암동,'55,50 - 54세,1998,584,289,295
'1144074000,  상암동,'60,55 - 59세,1998,618,318,300
'1144074000,  상암동,'65,60 - 64세,1998,442,207,235
'1144074000,  상암동,'70,65 - 69세,1998,298,123,175
'1144074000,  상암동,'75,70 - 74세,1998,239,84,155
'1144074000,  상암동,'80,75 - 79세,1998,150,51,99
'1144074000,  상암동,'85,80 - 84세,1998,77,24,53
'1144074000,  상암동,'90,85+ ,1998,51,14,37
'11470, 양천구,'00,계,1998,483674,243631,240043
'11470, 양천구,'05,0 - 4세,1998,30168,15956,14212
'11470, 양천구,'10,5 - 9세,1998,33666,18004,15662
'11470, 양천구,'15,10 - 14세,1998,37494,19946,17548
'11470, 양천구,'20,15 - 19세,1998,50293,26123,24170
'11470, 양천구,'25,20 - 24세,1998,40320,20142,20178
'11470, 양천구,'30,25 - 29세,1998,44264,22253,22011
'11470, 양천구,'35,30 - 34세,1998,41334,20709,20625
'11470, 양천구,'40,35 - 39세,1998,47501,23009,24492
'11470, 양천구,'45,40 - 44세,1998,48872,23246,25626
'11470, 양천구,'50,45 - 49세,1998,35163,18675,16488
'11470, 양천구,'55,50 - 54세,1998,24182,13333,10849
'11470, 양천구,'60,55 - 59세,1998,17618,9464,8154
'11470, 양천구,'65,60 - 64세,1998,11704,5558,6146
'11470, 양천구,'70,65 - 69세,1998,8111,3189,4922
'11470, 양천구,'75,70 - 74세,1998,5676,1898,3778
'11470, 양천구,'80,75 - 79세,1998,3992,1300,2692
'11470, 양천구,'85,80 - 84세,1998,2113,554,1559
'11470, 양천구,'90,85+ ,1998,1203,272,931
'1147051000,  목1동,'00,계,1998,23423,11699,11724
'1147051000,  목1동,'05,0 - 4세,1998,1450,769,681
'1147051000,  목1동,'10,5 - 9세,1998,1635,885,750
'1147051000,  목1동,'15,10 - 14세,1998,1979,1068,911
'1147051000,  목1동,'20,15 - 19세,1998,2612,1312,1300
'1147051000,  목1동,'25,20 - 24세,1998,1726,863,863
'1147051000,  목1동,'30,25 - 29세,1998,1936,929,1007
'1147051000,  목1동,'35,30 - 34세,1998,1889,921,968
'1147051000,  목1동,'40,35 - 39세,1998,2365,1136,1229
'1147051000,  목1동,'45,40 - 44세,1998,2552,1176,1376
'1147051000,  목1동,'50,45 - 49세,1998,1851,987,864
'1147051000,  목1동,'55,50 - 54세,1998,1142,660,482
'1147051000,  목1동,'60,55 - 59세,1998,817,461,356
'1147051000,  목1동,'65,60 - 64세,1998,494,226,268
'1147051000,  목1동,'70,65 - 69세,1998,364,134,230
'1147051000,  목1동,'75,70 - 74세,1998,269,80,189
'1147051000,  목1동,'80,75 - 79세,1998,180,58,122
'1147051000,  목1동,'85,80 - 84세,1998,110,24,86
'1147051000,  목1동,'90,85+ ,1998,52,10,42
'1147052000,  목2동,'00,계,1998,31071,15637,15434
'1147052000,  목2동,'05,0 - 4세,1998,2223,1226,997
'1147052000,  목2동,'10,5 - 9세,1998,2114,1101,1013
'1147052000,  목2동,'15,10 - 14세,1998,2111,1106,1005
'1147052000,  목2동,'20,15 - 19세,1998,2906,1555,1351
'1147052000,  목2동,'25,20 - 24세,1998,2621,1322,1299
'1147052000,  목2동,'30,25 - 29세,1998,3157,1559,1598
'1147052000,  목2동,'35,30 - 34세,1998,2986,1513,1473
'1147052000,  목2동,'40,35 - 39세,1998,3061,1517,1544
'1147052000,  목2동,'45,40 - 44세,1998,2951,1433,1518
'1147052000,  목2동,'50,45 - 49세,1998,2104,1056,1048
'1147052000,  목2동,'55,50 - 54세,1998,1456,800,656
'1147052000,  목2동,'60,55 - 59세,1998,1185,614,571
'1147052000,  목2동,'65,60 - 64세,1998,795,344,451
'1147052000,  목2동,'70,65 - 69세,1998,538,221,317
'1147052000,  목2동,'75,70 - 74세,1998,354,115,239
'1147052000,  목2동,'80,75 - 79세,1998,279,89,190
'1147052000,  목2동,'85,80 - 84세,1998,149,45,104
'1147052000,  목2동,'90,85+ ,1998,81,21,60
'1147053000,  목3동,'00,계,1998,22990,11508,11482
'1147053000,  목3동,'05,0 - 4세,1998,1739,923,816
'1147053000,  목3동,'10,5 - 9세,1998,1479,780,699
'1147053000,  목3동,'15,10 - 14세,1998,1387,732,655
'1147053000,  목3동,'20,15 - 19세,1998,2071,1105,966
'1147053000,  목3동,'25,20 - 24세,1998,2036,1025,1011
'1147053000,  목3동,'30,25 - 29세,1998,2605,1247,1358
'1147053000,  목3동,'35,30 - 34세,1998,2362,1250,1112
'1147053000,  목3동,'40,35 - 39세,1998,2214,1131,1083
'1147053000,  목3동,'45,40 - 44세,1998,1938,886,1052
'1147053000,  목3동,'50,45 - 49세,1998,1516,728,788
'1147053000,  목3동,'55,50 - 54세,1998,1179,622,557
'1147053000,  목3동,'60,55 - 59세,1998,866,474,392
'1147053000,  목3동,'65,60 - 64세,1998,537,241,296
'1147053000,  목3동,'70,65 - 69세,1998,396,157,239
'1147053000,  목3동,'75,70 - 74세,1998,285,93,192
'1147053000,  목3동,'80,75 - 79세,1998,211,64,147
'1147053000,  목3동,'85,80 - 84세,1998,107,35,72
'1147053000,  목3동,'90,85+ ,1998,62,15,47
'1147054000,  목4동,'00,계,1998,26126,13180,12946
'1147054000,  목4동,'05,0 - 4세,1998,1573,807,766
'1147054000,  목4동,'10,5 - 9세,1998,1742,954,788
'1147054000,  목4동,'15,10 - 14세,1998,1849,987,862
'1147054000,  목4동,'20,15 - 19세,1998,2770,1512,1258
'1147054000,  목4동,'25,20 - 24세,1998,2398,1185,1213
'1147054000,  목4동,'30,25 - 29세,1998,2570,1307,1263
'1147054000,  목4동,'35,30 - 34세,1998,2216,1114,1102
'1147054000,  목4동,'40,35 - 39세,1998,2577,1259,1318
'1147054000,  목4동,'45,40 - 44세,1998,2527,1163,1364
'1147054000,  목4동,'50,45 - 49세,1998,1870,967,903
'1147054000,  목4동,'55,50 - 54세,1998,1380,746,634
'1147054000,  목4동,'60,55 - 59세,1998,938,517,421
'1147054000,  목4동,'65,60 - 64세,1998,626,303,323
'1147054000,  목4동,'70,65 - 69세,1998,411,150,261
'1147054000,  목4동,'75,70 - 74세,1998,300,100,200
'1147054000,  목4동,'80,75 - 79세,1998,216,67,149
'1147054000,  목4동,'85,80 - 84세,1998,110,31,79
'1147054000,  목4동,'90,85+ ,1998,53,11,42
'1147055000,  목5동,'00,계,1998,19270,9658,9612
'1147055000,  목5동,'05,0 - 4세,1998,887,477,410
'1147055000,  목5동,'10,5 - 9세,1998,1582,878,704
'1147055000,  목5동,'15,10 - 14세,1998,2284,1286,998
'1147055000,  목5동,'20,15 - 19세,1998,2350,1298,1052
'1147055000,  목5동,'25,20 - 24세,1998,1157,598,559
'1147055000,  목5동,'30,25 - 29세,1998,848,359,489
'1147055000,  목5동,'35,30 - 34세,1998,1161,489,672
'1147055000,  목5동,'40,35 - 39세,1998,2020,832,1188
'1147055000,  목5동,'45,40 - 44세,1998,2677,1207,1470
'1147055000,  목5동,'50,45 - 49세,1998,1660,939,721
'1147055000,  목5동,'55,50 - 54세,1998,904,576,328
'1147055000,  목5동,'60,55 - 59세,1998,471,274,197
'1147055000,  목5동,'65,60 - 64세,1998,355,166,189
'1147055000,  목5동,'70,65 - 69세,1998,329,113,216
'1147055000,  목5동,'75,70 - 74세,1998,239,73,166
'1147055000,  목5동,'80,75 - 79세,1998,178,57,121
'1147055000,  목5동,'85,80 - 84세,1998,97,21,76
'1147055000,  목5동,'90,85+ ,1998,71,15,56
'1147055100,  목6동,'00,계,1998,25108,12673,12435
'1147055100,  목6동,'05,0 - 4세,1998,1086,585,501
'1147055100,  목6동,'10,5 - 9세,1998,1951,1035,916
'1147055100,  목6동,'15,10 - 14세,1998,3034,1729,1305
'1147055100,  목6동,'20,15 - 19세,1998,3415,1933,1482
'1147055100,  목6동,'25,20 - 24세,1998,1441,717,724
'1147055100,  목6동,'30,25 - 29세,1998,996,414,582
'1147055100,  목6동,'35,30 - 34세,1998,1373,562,811
'1147055100,  목6동,'40,35 - 39세,1998,2629,1078,1551
'1147055100,  목6동,'45,40 - 44세,1998,3559,1610,1949
'1147055100,  목6동,'50,45 - 49세,1998,2332,1353,979
'1147055100,  목6동,'55,50 - 54세,1998,1137,737,400
'1147055100,  목6동,'60,55 - 59세,1998,538,311,227
'1147055100,  목6동,'65,60 - 64세,1998,432,198,234
'1147055100,  목6동,'70,65 - 69세,1998,412,149,263
'1147055100,  목6동,'75,70 - 74세,1998,338,115,223
'1147055100,  목6동,'80,75 - 79세,1998,226,87,139
'1147055100,  목6동,'85,80 - 84세,1998,123,38,85
'1147055100,  목6동,'90,85+ ,1998,86,22,64
'1147056000,  신월1동,'00,계,1998,28332,14275,14057
'1147056000,  신월1동,'05,0 - 4세,1998,2112,1132,980
'1147056000,  신월1동,'10,5 - 9세,1998,2136,1090,1046
'1147056000,  신월1동,'15,10 - 14세,1998,1878,937,941
'1147056000,  신월1동,'20,15 - 19세,1998,2566,1304,1262
'1147056000,  신월1동,'25,20 - 24세,1998,2428,1246,1182
'1147056000,  신월1동,'30,25 - 29세,1998,2963,1449,1514
'1147056000,  신월1동,'35,30 - 34세,1998,2919,1492,1427
'1147056000,  신월1동,'40,35 - 39세,1998,2985,1570,1415
'1147056000,  신월1동,'45,40 - 44세,1998,2459,1205,1254
'1147056000,  신월1동,'50,45 - 49세,1998,1731,880,851
'1147056000,  신월1동,'55,50 - 54세,1998,1362,723,639
'1147056000,  신월1동,'60,55 - 59세,1998,1063,588,475
'1147056000,  신월1동,'65,60 - 64세,1998,621,302,319
'1147056000,  신월1동,'70,65 - 69세,1998,389,158,231
'1147056000,  신월1동,'75,70 - 74세,1998,303,90,213
'1147056000,  신월1동,'80,75 - 79세,1998,225,66,159
'1147056000,  신월1동,'85,80 - 84세,1998,127,31,96
'1147056000,  신월1동,'90,85+ ,1998,65,12,53
'1147057000,  신월2동,'00,계,1998,26347,13431,12916
'1147057000,  신월2동,'05,0 - 4세,1998,1378,732,646
'1147057000,  신월2동,'10,5 - 9세,1998,1646,874,772
'1147057000,  신월2동,'15,10 - 14세,1998,1909,998,911
'1147057000,  신월2동,'20,15 - 19세,1998,2892,1501,1391
'1147057000,  신월2동,'25,20 - 24세,1998,2531,1327,1204
'1147057000,  신월2동,'30,25 - 29세,1998,2383,1301,1082
'1147057000,  신월2동,'35,30 - 34세,1998,2038,1024,1014
'1147057000,  신월2동,'40,35 - 39세,1998,2535,1202,1333
'1147057000,  신월2동,'45,40 - 44세,1998,2619,1299,1320
'1147057000,  신월2동,'50,45 - 49세,1998,1990,1019,971
'1147057000,  신월2동,'55,50 - 54세,1998,1495,806,689
'1147057000,  신월2동,'60,55 - 59세,1998,1077,596,481
'1147057000,  신월2동,'65,60 - 64세,1998,670,324,346
'1147057000,  신월2동,'70,65 - 69세,1998,486,198,288
'1147057000,  신월2동,'75,70 - 74세,1998,329,115,214
'1147057000,  신월2동,'80,75 - 79세,1998,205,68,137
'1147057000,  신월2동,'85,80 - 84세,1998,100,29,71
'1147057000,  신월2동,'90,85+ ,1998,64,18,46
'1147058000,  신월3동,'00,계,1998,23226,11707,11519
'1147058000,  신월3동,'05,0 - 4세,1998,1688,882,806
'1147058000,  신월3동,'10,5 - 9세,1998,1614,847,767
'1147058000,  신월3동,'15,10 - 14세,1998,1548,785,763
'1147058000,  신월3동,'20,15 - 19세,1998,2189,1093,1096
'1147058000,  신월3동,'25,20 - 24세,1998,2247,1083,1164
'1147058000,  신월3동,'30,25 - 29세,1998,2768,1425,1343
'1147058000,  신월3동,'35,30 - 34세,1998,2309,1200,1109
'1147058000,  신월3동,'40,35 - 39세,1998,2149,1127,1022
'1147058000,  신월3동,'45,40 - 44세,1998,1904,959,945
'1147058000,  신월3동,'50,45 - 49세,1998,1375,705,670
'1147058000,  신월3동,'55,50 - 54세,1998,1124,593,531
'1147058000,  신월3동,'60,55 - 59세,1998,866,432,434
'1147058000,  신월3동,'65,60 - 64세,1998,573,276,297
'1147058000,  신월3동,'70,65 - 69세,1998,352,135,217
'1147058000,  신월3동,'75,70 - 74세,1998,227,83,144
'1147058000,  신월3동,'80,75 - 79세,1998,163,51,112
'1147058000,  신월3동,'85,80 - 84세,1998,81,22,59
'1147058000,  신월3동,'90,85+ ,1998,49,9,40
'1147059000,  신월4동,'00,계,1998,18612,9500,9112
'1147059000,  신월4동,'05,0 - 4세,1998,1017,546,471
'1147059000,  신월4동,'10,5 - 9세,1998,1128,609,519
'1147059000,  신월4동,'15,10 - 14세,1998,1332,700,632
'1147059000,  신월4동,'20,15 - 19세,1998,2071,1082,989
'1147059000,  신월4동,'25,20 - 24세,1998,1811,916,895
'1147059000,  신월4동,'30,25 - 29세,1998,1597,833,764
'1147059000,  신월4동,'35,30 - 34세,1998,1470,748,722
'1147059000,  신월4동,'40,35 - 39세,1998,1708,837,871
'1147059000,  신월4동,'45,40 - 44세,1998,1827,880,947
'1147059000,  신월4동,'50,45 - 49세,1998,1428,743,685
'1147059000,  신월4동,'55,50 - 54세,1998,1044,593,451
'1147059000,  신월4동,'60,55 - 59세,1998,761,418,343
'1147059000,  신월4동,'65,60 - 64세,1998,539,259,280
'1147059000,  신월4동,'70,65 - 69세,1998,372,151,221
'1147059000,  신월4동,'75,70 - 74세,1998,234,84,150
'1147059000,  신월4동,'80,75 - 79세,1998,150,66,84
'1147059000,  신월4동,'85,80 - 84세,1998,79,20,59
'1147059000,  신월4동,'90,85+ ,1998,44,15,29
'1147060000,  신월5동,'00,계,1998,16699,8590,8109
'1147060000,  신월5동,'05,0 - 4세,1998,964,514,450
'1147060000,  신월5동,'10,5 - 9세,1998,1059,570,489
'1147060000,  신월5동,'15,10 - 14세,1998,1185,629,556
'1147060000,  신월5동,'20,15 - 19세,1998,1732,891,841
'1147060000,  신월5동,'25,20 - 24세,1998,1495,764,731
'1147060000,  신월5동,'30,25 - 29세,1998,1862,1075,787
'1147060000,  신월5동,'35,30 - 34세,1998,1449,761,688
'1147060000,  신월5동,'40,35 - 39세,1998,1554,753,801
'1147060000,  신월5동,'45,40 - 44세,1998,1598,747,851
'1147060000,  신월5동,'50,45 - 49세,1998,1175,624,551
'1147060000,  신월5동,'55,50 - 54세,1998,854,453,401
'1147060000,  신월5동,'60,55 - 59세,1998,688,387,301
'1147060000,  신월5동,'65,60 - 64세,1998,387,183,204
'1147060000,  신월5동,'70,65 - 69세,1998,254,110,144
'1147060000,  신월5동,'75,70 - 74세,1998,196,67,129
'1147060000,  신월5동,'80,75 - 79세,1998,132,38,94
'1147060000,  신월5동,'85,80 - 84세,1998,69,14,55
'1147060000,  신월5동,'90,85+ ,1998,46,10,36
'1147061000,  신월6동,'00,계,1998,16734,8446,8288
'1147061000,  신월6동,'05,0 - 4세,1998,933,482,451
'1147061000,  신월6동,'10,5 - 9세,1998,1071,569,502
'1147061000,  신월6동,'15,10 - 14세,1998,1163,602,561
'1147061000,  신월6동,'20,15 - 19세,1998,1862,970,892
'1147061000,  신월6동,'25,20 - 24세,1998,1542,750,792
'1147061000,  신월6동,'30,25 - 29세,1998,1532,810,722
'1147061000,  신월6동,'35,30 - 34세,1998,1314,684,630
'1147061000,  신월6동,'40,35 - 39세,1998,1590,785,805
'1147061000,  신월6동,'45,40 - 44세,1998,1595,767,828
'1147061000,  신월6동,'50,45 - 49세,1998,1262,676,586
'1147061000,  신월6동,'55,50 - 54세,1998,915,493,422
'1147061000,  신월6동,'60,55 - 59세,1998,700,372,328
'1147061000,  신월6동,'65,60 - 64세,1998,509,234,275
'1147061000,  신월6동,'70,65 - 69세,1998,273,110,163
'1147061000,  신월6동,'75,70 - 74세,1998,190,64,126
'1147061000,  신월6동,'80,75 - 79세,1998,159,45,114
'1147061000,  신월6동,'85,80 - 84세,1998,84,22,62
'1147061000,  신월6동,'90,85+ ,1998,40,11,29
'1147061100,  신월7동,'00,계,1998,31706,15960,15746
'1147061100,  신월7동,'05,0 - 4세,1998,2285,1172,1113
'1147061100,  신월7동,'10,5 - 9세,1998,2545,1306,1239
'1147061100,  신월7동,'15,10 - 14세,1998,2354,1235,1119
'1147061100,  신월7동,'20,15 - 19세,1998,2986,1497,1489
'1147061100,  신월7동,'25,20 - 24세,1998,2240,1193,1047
'1147061100,  신월7동,'30,25 - 29세,1998,2812,1360,1452
'1147061100,  신월7동,'35,30 - 34세,1998,2987,1502,1485
'1147061100,  신월7동,'40,35 - 39세,1998,3583,1760,1823
'1147061100,  신월7동,'45,40 - 44세,1998,3187,1636,1551
'1147061100,  신월7동,'50,45 - 49세,1998,1945,1107,838
'1147061100,  신월7동,'55,50 - 54세,1998,1345,713,632
'1147061100,  신월7동,'60,55 - 59세,1998,1156,575,581
'1147061100,  신월7동,'65,60 - 64세,1998,904,408,496
'1147061100,  신월7동,'70,65 - 69세,1998,636,256,380
'1147061100,  신월7동,'75,70 - 74세,1998,344,119,225
'1147061100,  신월7동,'80,75 - 79세,1998,230,75,155
'1147061100,  신월7동,'85,80 - 84세,1998,115,32,83
'1147061100,  신월7동,'90,85+ ,1998,52,14,38
'1147062000,  신정1동,'00,계,1998,27884,13885,13999
'1147062000,  신정1동,'05,0 - 4세,1998,1534,818,716
'1147062000,  신정1동,'10,5 - 9세,1998,2026,1113,913
'1147062000,  신정1동,'15,10 - 14세,1998,2416,1258,1158
'1147062000,  신정1동,'20,15 - 19세,1998,3108,1567,1541
'1147062000,  신정1동,'25,20 - 24세,1998,2273,1091,1182
'1147062000,  신정1동,'30,25 - 29세,1998,2336,1167,1169
'1147062000,  신정1동,'35,30 - 34세,1998,2116,1020,1096
'1147062000,  신정1동,'40,35 - 39세,1998,2650,1190,1460
'1147062000,  신정1동,'45,40 - 44세,1998,2986,1381,1605
'1147062000,  신정1동,'50,45 - 49세,1998,2226,1217,1009
'1147062000,  신정1동,'55,50 - 54세,1998,1455,823,632
'1147062000,  신정1동,'60,55 - 59세,1998,936,518,418
'1147062000,  신정1동,'65,60 - 64세,1998,619,309,310
'1147062000,  신정1동,'70,65 - 69세,1998,453,189,264
'1147062000,  신정1동,'75,70 - 74세,1998,311,102,209
'1147062000,  신정1동,'80,75 - 79세,1998,247,76,171
'1147062000,  신정1동,'85,80 - 84세,1998,123,36,87
'1147062000,  신정1동,'90,85+ ,1998,69,10,59
'1147063000,  신정2동,'00,계,1998,22809,11451,11358
'1147063000,  신정2동,'05,0 - 4세,1998,1152,616,536
'1147063000,  신정2동,'10,5 - 9세,1998,1532,837,695
'1147063000,  신정2동,'15,10 - 14세,1998,2093,1128,965
'1147063000,  신정2동,'20,15 - 19세,1998,2675,1319,1356
'1147063000,  신정2동,'25,20 - 24세,1998,1802,891,911
'1147063000,  신정2동,'30,25 - 29세,1998,1743,884,859
'1147063000,  신정2동,'35,30 - 34세,1998,1581,756,825
'1147063000,  신정2동,'40,35 - 39세,1998,2302,1067,1235
'1147063000,  신정2동,'45,40 - 44세,1998,2690,1327,1363
'1147063000,  신정2동,'50,45 - 49세,1998,1772,973,799
'1147063000,  신정2동,'55,50 - 54세,1998,1122,631,491
'1147063000,  신정2동,'60,55 - 59세,1998,840,444,396
'1147063000,  신정2동,'65,60 - 64세,1998,563,280,283
'1147063000,  신정2동,'70,65 - 69세,1998,367,124,243
'1147063000,  신정2동,'75,70 - 74세,1998,243,86,157
'1147063000,  신정2동,'80,75 - 79세,1998,177,51,126
'1147063000,  신정2동,'85,80 - 84세,1998,106,26,80
'1147063000,  신정2동,'90,85+ ,1998,49,11,38
'1147064000,  신정3동,'00,계,1998,26090,13179,12911
'1147064000,  신정3동,'05,0 - 4세,1998,1902,992,910
'1147064000,  신정3동,'10,5 - 9세,1998,1570,824,746
'1147064000,  신정3동,'15,10 - 14세,1998,1471,776,695
'1147064000,  신정3동,'20,15 - 19세,1998,2379,1258,1121
'1147064000,  신정3동,'25,20 - 24세,1998,2666,1242,1424
'1147064000,  신정3동,'30,25 - 29세,1998,3280,1732,1548
'1147064000,  신정3동,'35,30 - 34세,1998,2613,1356,1257
'1147064000,  신정3동,'40,35 - 39세,1998,2222,1173,1049
'1147064000,  신정3동,'45,40 - 44세,1998,2079,988,1091
'1147064000,  신정3동,'50,45 - 49세,1998,1644,826,818
'1147064000,  신정3동,'55,50 - 54세,1998,1326,694,632
'1147064000,  신정3동,'60,55 - 59세,1998,1156,579,577
'1147064000,  신정3동,'65,60 - 64세,1998,715,354,361
'1147064000,  신정3동,'70,65 - 69세,1998,434,177,257
'1147064000,  신정3동,'75,70 - 74세,1998,272,100,172
'1147064000,  신정3동,'80,75 - 79세,1998,203,71,132
'1147064000,  신정3동,'85,80 - 84세,1998,109,29,80
'1147064000,  신정3동,'90,85+ ,1998,49,8,41
'1147065000,  신정4동,'00,계,1998,18131,9143,8988
'1147065000,  신정4동,'05,0 - 4세,1998,1192,632,560
'1147065000,  신정4동,'10,5 - 9세,1998,1132,581,551
'1147065000,  신정4동,'15,10 - 14세,1998,1047,552,495
'1147065000,  신정4동,'20,15 - 19세,1998,1660,844,816
'1147065000,  신정4동,'25,20 - 24세,1998,1883,932,951
'1147065000,  신정4동,'30,25 - 29세,1998,2242,1131,1111
'1147065000,  신정4동,'35,30 - 34세,1998,1712,943,769
'1147065000,  신정4동,'40,35 - 39세,1998,1553,774,779
'1147065000,  신정4동,'45,40 - 44세,1998,1506,743,763
'1147065000,  신정4동,'50,45 - 49세,1998,1254,601,653
'1147065000,  신정4동,'55,50 - 54세,1998,1010,499,511
'1147065000,  신정4동,'60,55 - 59세,1998,795,452,343
'1147065000,  신정4동,'65,60 - 64세,1998,437,220,217
'1147065000,  신정4동,'70,65 - 69세,1998,266,109,157
'1147065000,  신정4동,'75,70 - 74세,1998,186,64,122
'1147065000,  신정4동,'80,75 - 79세,1998,136,38,98
'1147065000,  신정4동,'85,80 - 84세,1998,76,14,62
'1147065000,  신정4동,'90,85+ ,1998,44,14,30
'1147066000,  신정5동,'00,계,1998,20036,10110,9926
'1147066000,  신정5동,'05,0 - 4세,1998,1377,734,643
'1147066000,  신정5동,'10,5 - 9세,1998,1159,592,567
'1147066000,  신정5동,'15,10 - 14세,1998,1148,585,563
'1147066000,  신정5동,'20,15 - 19세,1998,1863,973,890
'1147066000,  신정5동,'25,20 - 24세,1998,2108,1022,1086
'1147066000,  신정5동,'30,25 - 29세,1998,2541,1291,1250
'1147066000,  신정5동,'35,30 - 34세,1998,1991,1109,882
'1147066000,  신정5동,'40,35 - 39세,1998,1699,867,832
'1147066000,  신정5동,'45,40 - 44세,1998,1590,732,858
'1147066000,  신정5동,'50,45 - 49세,1998,1360,668,692
'1147066000,  신정5동,'55,50 - 54세,1998,1110,587,523
'1147066000,  신정5동,'60,55 - 59세,1998,840,447,393
'1147066000,  신정5동,'65,60 - 64세,1998,474,241,233
'1147066000,  신정5동,'70,65 - 69세,1998,301,137,164
'1147066000,  신정5동,'75,70 - 74세,1998,211,62,149
'1147066000,  신정5동,'80,75 - 79세,1998,152,41,111
'1147066000,  신정5동,'85,80 - 84세,1998,68,14,54
'1147066000,  신정5동,'90,85+ ,1998,44,8,36
'1147067000,  신정6동,'00,계,1998,26106,12887,13219
'1147067000,  신정6동,'05,0 - 4세,1998,1560,810,750
'1147067000,  신정6동,'10,5 - 9세,1998,2061,1182,879
'1147067000,  신정6동,'15,10 - 14세,1998,2600,1407,1193
'1147067000,  신정6동,'20,15 - 19세,1998,2986,1502,1484
'1147067000,  신정6동,'25,20 - 24세,1998,1573,756,817
'1147067000,  신정6동,'30,25 - 29세,1998,1581,695,886
'1147067000,  신정6동,'35,30 - 34세,1998,1993,880,1113
'1147067000,  신정6동,'40,35 - 39세,1998,2592,1176,1416
'1147067000,  신정6동,'45,40 - 44세,1998,3220,1456,1764
'1147067000,  신정6동,'50,45 - 49세,1998,2245,1272,973
'1147067000,  신정6동,'55,50 - 54세,1998,1167,676,491
'1147067000,  신정6동,'60,55 - 59세,1998,693,389,304
'1147067000,  신정6동,'65,60 - 64세,1998,545,252,293
'1147067000,  신정6동,'70,65 - 69세,1998,453,171,282
'1147067000,  신정6동,'75,70 - 74세,1998,382,132,250
'1147067000,  신정6동,'80,75 - 79세,1998,233,81,152
'1147067000,  신정6동,'85,80 - 84세,1998,136,31,105
'1147067000,  신정6동,'90,85+ ,1998,86,19,67
'1147068000,  신정7동,'00,계,1998,32974,16712,16262
'1147068000,  신정7동,'05,0 - 4세,1998,2116,1107,1009
'1147068000,  신정7동,'10,5 - 9세,1998,2484,1377,1107
'1147068000,  신정7동,'15,10 - 14세,1998,2706,1446,1260
'1147068000,  신정7동,'20,15 - 19세,1998,3200,1607,1593
'1147068000,  신정7동,'25,20 - 24세,1998,2342,1219,1123
'1147068000,  신정7동,'30,25 - 29세,1998,2512,1285,1227
'1147068000,  신정7동,'35,30 - 34세,1998,2855,1385,1470
'1147068000,  신정7동,'40,35 - 39세,1998,3513,1775,1738
'1147068000,  신정7동,'45,40 - 44세,1998,3408,1651,1757
'1147068000,  신정7동,'50,45 - 49세,1998,2423,1334,1089
'1147068000,  신정7동,'55,50 - 54세,1998,1655,908,747
'1147068000,  신정7동,'60,55 - 59세,1998,1232,616,616
'1147068000,  신정7동,'65,60 - 64세,1998,909,438,471
'1147068000,  신정7동,'70,65 - 69세,1998,625,240,385
'1147068000,  신정7동,'75,70 - 74세,1998,463,154,309
'1147068000,  신정7동,'80,75 - 79세,1998,290,111,179
'1147068000,  신정7동,'85,80 - 84세,1998,144,40,104
'1147068000,  신정7동,'90,85+ ,1998,97,19,78
'11500, 강서구,'00,계,1998,516590,257304,259286
'11500, 강서구,'05,0 - 4세,1998,34945,18385,16560
'11500, 강서구,'10,5 - 9세,1998,37054,19520,17534
'11500, 강서구,'15,10 - 14세,1998,36508,19150,17358
'11500, 강서구,'20,15 - 19세,1998,48870,25072,23798
'11500, 강서구,'25,20 - 24세,1998,43351,21471,21880
'11500, 강서구,'30,25 - 29세,1998,51844,25699,26145
'11500, 강서구,'35,30 - 34세,1998,48509,24225,24284
'11500, 강서구,'40,35 - 39세,1998,52613,26136,26477
'11500, 강서구,'45,40 - 44세,1998,47697,23265,24432
'11500, 강서구,'50,45 - 49세,1998,33085,16696,16389
'11500, 강서구,'55,50 - 54세,1998,25119,13183,11936
'11500, 강서구,'60,55 - 59세,1998,19272,9966,9306
'11500, 강서구,'65,60 - 64세,1998,13274,6076,7198
'11500, 강서구,'70,65 - 69세,1998,9211,3563,5648
'11500, 강서구,'75,70 - 74세,1998,6599,2279,4320
'11500, 강서구,'80,75 - 79세,1998,4718,1550,3168
'11500, 강서구,'85,80 - 84세,1998,2495,709,1786
'11500, 강서구,'90,85+ ,1998,1426,359,1067
'1150051000,  염창동,'00,계,1998,30064,15158,14906
'1150051000,  염창동,'05,0 - 4세,1998,2330,1272,1058
'1150051000,  염창동,'10,5 - 9세,1998,2721,1391,1330
'1150051000,  염창동,'15,10 - 14세,1998,2269,1162,1107
'1150051000,  염창동,'20,15 - 19세,1998,2415,1266,1149
'1150051000,  염창동,'25,20 - 24세,1998,1981,1032,949
'1150051000,  염창동,'30,25 - 29세,1998,2555,1213,1342
'1150051000,  염창동,'35,30 - 34세,1998,3072,1406,1666
'1150051000,  염창동,'40,35 - 39세,1998,3784,1914,1870
'1150051000,  염창동,'45,40 - 44세,1998,2991,1624,1367
'1150051000,  염창동,'50,45 - 49세,1998,1713,942,771
'1150051000,  염창동,'55,50 - 54세,1998,1251,634,617
'1150051000,  염창동,'60,55 - 59세,1998,1010,528,482
'1150051000,  염창동,'65,60 - 64세,1998,713,320,393
'1150051000,  염창동,'70,65 - 69세,1998,477,193,284
'1150051000,  염창동,'75,70 - 74세,1998,357,134,223
'1150051000,  염창동,'80,75 - 79세,1998,239,77,162
'1150051000,  염창동,'85,80 - 84세,1998,107,31,76
'1150051000,  염창동,'90,85+ ,1998,79,19,60
'1150052000,  등촌1동,'00,계,1998,14506,7383,7123
'1150052000,  등촌1동,'05,0 - 4세,1998,999,515,484
'1150052000,  등촌1동,'10,5 - 9세,1998,1022,513,509
'1150052000,  등촌1동,'15,10 - 14세,1998,967,516,451
'1150052000,  등촌1동,'20,15 - 19세,1998,1330,740,590
'1150052000,  등촌1동,'25,20 - 24세,1998,1161,579,582
'1150052000,  등촌1동,'30,25 - 29세,1998,1547,776,771
'1150052000,  등촌1동,'35,30 - 34세,1998,1435,757,678
'1150052000,  등촌1동,'40,35 - 39세,1998,1456,736,720
'1150052000,  등촌1동,'45,40 - 44세,1998,1363,666,697
'1150052000,  등촌1동,'50,45 - 49세,1998,896,489,407
'1150052000,  등촌1동,'55,50 - 54세,1998,726,372,354
'1150052000,  등촌1동,'60,55 - 59세,1998,601,320,281
'1150052000,  등촌1동,'65,60 - 64세,1998,411,192,219
'1150052000,  등촌1동,'70,65 - 69세,1998,249,111,138
'1150052000,  등촌1동,'75,70 - 74세,1998,149,42,107
'1150052000,  등촌1동,'80,75 - 79세,1998,112,36,76
'1150052000,  등촌1동,'85,80 - 84세,1998,56,14,42
'1150052000,  등촌1동,'90,85+ ,1998,26,9,17
'1150053000,  등촌2동,'00,계,1998,16467,8261,8206
'1150053000,  등촌2동,'05,0 - 4세,1998,1118,557,561
'1150053000,  등촌2동,'10,5 - 9세,1998,1072,585,487
'1150053000,  등촌2동,'15,10 - 14세,1998,1090,593,497
'1150053000,  등촌2동,'20,15 - 19세,1998,1644,863,781
'1150053000,  등촌2동,'25,20 - 24세,1998,1471,747,724
'1150053000,  등촌2동,'30,25 - 29세,1998,1682,829,853
'1150053000,  등촌2동,'35,30 - 34세,1998,1509,772,737
'1150053000,  등촌2동,'40,35 - 39세,1998,1566,755,811
'1150053000,  등촌2동,'45,40 - 44세,1998,1543,736,807
'1150053000,  등촌2동,'50,45 - 49세,1998,1141,577,564
'1150053000,  등촌2동,'55,50 - 54세,1998,892,476,416
'1150053000,  등촌2동,'60,55 - 59세,1998,653,336,317
'1150053000,  등촌2동,'65,60 - 64세,1998,398,221,177
'1150053000,  등촌2동,'70,65 - 69세,1998,254,89,165
'1150053000,  등촌2동,'75,70 - 74세,1998,172,58,114
'1150053000,  등촌2동,'80,75 - 79세,1998,133,34,99
'1150053000,  등촌2동,'85,80 - 84세,1998,90,21,69
'1150053000,  등촌2동,'90,85+ ,1998,39,12,27
'1150053500,  등촌3동,'00,계,1998,41877,20236,21641
'1150053500,  등촌3동,'05,0 - 4세,1998,2801,1495,1306
'1150053500,  등촌3동,'10,5 - 9세,1998,3975,2095,1880
'1150053500,  등촌3동,'15,10 - 14세,1998,3363,1739,1624
'1150053500,  등촌3동,'20,15 - 19세,1998,4109,2035,2074
'1150053500,  등촌3동,'25,20 - 24세,1998,2736,1391,1345
'1150053500,  등촌3동,'30,25 - 29세,1998,2901,1320,1581
'1150053500,  등촌3동,'35,30 - 34세,1998,3996,1798,2198
'1150053500,  등촌3동,'40,35 - 39세,1998,5038,2478,2560
'1150053500,  등촌3동,'45,40 - 44세,1998,4348,2060,2288
'1150053500,  등촌3동,'50,45 - 49세,1998,2448,1291,1157
'1150053500,  등촌3동,'55,50 - 54세,1998,1637,824,813
'1150053500,  등촌3동,'60,55 - 59세,1998,1244,581,663
'1150053500,  등촌3동,'65,60 - 64세,1998,1036,397,639
'1150053500,  등촌3동,'70,65 - 69세,1998,846,297,549
'1150053500,  등촌3동,'75,70 - 74세,1998,614,198,416
'1150053500,  등촌3동,'80,75 - 79세,1998,477,150,327
'1150053500,  등촌3동,'85,80 - 84세,1998,200,57,143
'1150053500,  등촌3동,'90,85+ ,1998,108,30,78
'1150054000,  화곡1동,'00,계,1998,21326,10732,10594
'1150054000,  화곡1동,'05,0 - 4세,1998,1509,781,728
'1150054000,  화곡1동,'10,5 - 9세,1998,1280,674,606
'1150054000,  화곡1동,'15,10 - 14세,1998,1131,623,508
'1150054000,  화곡1동,'20,15 - 19세,1998,1877,954,923
'1150054000,  화곡1동,'25,20 - 24세,1998,2149,1061,1088
'1150054000,  화곡1동,'30,25 - 29세,1998,2809,1403,1406
'1150054000,  화곡1동,'35,30 - 34세,1998,2101,1116,985
'1150054000,  화곡1동,'40,35 - 39세,1998,1824,933,891
'1150054000,  화곡1동,'45,40 - 44세,1998,1720,820,900
'1150054000,  화곡1동,'50,45 - 49세,1998,1415,669,746
'1150054000,  화곡1동,'55,50 - 54세,1998,1190,649,541
'1150054000,  화곡1동,'60,55 - 59세,1998,861,453,408
'1150054000,  화곡1동,'65,60 - 64세,1998,554,274,280
'1150054000,  화곡1동,'70,65 - 69세,1998,356,151,205
'1150054000,  화곡1동,'75,70 - 74세,1998,244,75,169
'1150054000,  화곡1동,'80,75 - 79세,1998,175,61,114
'1150054000,  화곡1동,'85,80 - 84세,1998,83,25,58
'1150054000,  화곡1동,'90,85+ ,1998,48,10,38
'1150055000,  화곡2동,'00,계,1998,19538,9768,9770
'1150055000,  화곡2동,'05,0 - 4세,1998,1582,797,785
'1150055000,  화곡2동,'10,5 - 9세,1998,1441,736,705
'1150055000,  화곡2동,'15,10 - 14세,1998,1181,612,569
'1150055000,  화곡2동,'20,15 - 19세,1998,1697,889,808
'1150055000,  화곡2동,'25,20 - 24세,1998,1703,805,898
'1150055000,  화곡2동,'30,25 - 29세,1998,2286,1159,1127
'1150055000,  화곡2동,'35,30 - 34세,1998,2046,1034,1012
'1150055000,  화곡2동,'40,35 - 39세,1998,1925,1020,905
'1150055000,  화곡2동,'45,40 - 44세,1998,1556,748,808
'1150055000,  화곡2동,'50,45 - 49세,1998,1203,584,619
'1150055000,  화곡2동,'55,50 - 54세,1998,953,508,445
'1150055000,  화곡2동,'60,55 - 59세,1998,726,388,338
'1150055000,  화곡2동,'65,60 - 64세,1998,441,224,217
'1150055000,  화곡2동,'70,65 - 69세,1998,287,108,179
'1150055000,  화곡2동,'75,70 - 74세,1998,223,66,157
'1150055000,  화곡2동,'80,75 - 79세,1998,164,55,109
'1150055000,  화곡2동,'85,80 - 84세,1998,80,29,51
'1150055000,  화곡2동,'90,85+ ,1998,44,6,38
'1150056000,  화곡3동,'00,계,1998,17746,8809,8937
'1150056000,  화곡3동,'05,0 - 4세,1998,1059,583,476
'1150056000,  화곡3동,'10,5 - 9세,1998,970,541,429
'1150056000,  화곡3동,'15,10 - 14세,1998,1184,618,566
'1150056000,  화곡3동,'20,15 - 19세,1998,1962,1035,927
'1150056000,  화곡3동,'25,20 - 24세,1998,1783,829,954
'1150056000,  화곡3동,'30,25 - 29세,1998,1900,935,965
'1150056000,  화곡3동,'35,30 - 34세,1998,1442,743,699
'1150056000,  화곡3동,'40,35 - 39세,1998,1513,742,771
'1150056000,  화곡3동,'45,40 - 44세,1998,1625,724,901
'1150056000,  화곡3동,'50,45 - 49세,1998,1374,677,697
'1150056000,  화곡3동,'55,50 - 54세,1998,1071,600,471
'1150056000,  화곡3동,'60,55 - 59세,1998,690,379,311
'1150056000,  화곡3동,'65,60 - 64세,1998,374,185,189
'1150056000,  화곡3동,'70,65 - 69세,1998,241,82,159
'1150056000,  화곡3동,'75,70 - 74세,1998,200,57,143
'1150056000,  화곡3동,'80,75 - 79세,1998,179,47,132
'1150056000,  화곡3동,'85,80 - 84세,1998,103,23,80
'1150056000,  화곡3동,'90,85+ ,1998,76,9,67
'1150057000,  화곡4동,'00,계,1998,23211,11723,11488
'1150057000,  화곡4동,'05,0 - 4세,1998,1707,894,813
'1150057000,  화곡4동,'10,5 - 9세,1998,1646,869,777
'1150057000,  화곡4동,'15,10 - 14세,1998,1382,710,672
'1150057000,  화곡4동,'20,15 - 19세,1998,2188,1200,988
'1150057000,  화곡4동,'25,20 - 24세,1998,2119,1096,1023
'1150057000,  화곡4동,'30,25 - 29세,1998,2564,1302,1262
'1150057000,  화곡4동,'35,30 - 34세,1998,2330,1146,1184
'1150057000,  화곡4동,'40,35 - 39세,1998,2175,1159,1016
'1150057000,  화곡4동,'45,40 - 44세,1998,1960,920,1040
'1150057000,  화곡4동,'50,45 - 49세,1998,1544,741,803
'1150057000,  화곡4동,'55,50 - 54세,1998,1207,634,573
'1150057000,  화곡4동,'60,55 - 59세,1998,879,481,398
'1150057000,  화곡4동,'65,60 - 64세,1998,553,271,282
'1150057000,  화곡4동,'70,65 - 69세,1998,360,126,234
'1150057000,  화곡4동,'75,70 - 74세,1998,266,86,180
'1150057000,  화곡4동,'80,75 - 79세,1998,170,55,115
'1150057000,  화곡4동,'85,80 - 84세,1998,99,21,78
'1150057000,  화곡4동,'90,85+ ,1998,62,12,50
'1150058000,  화곡5동,'00,계,1998,25599,12648,12951
'1150058000,  화곡5동,'05,0 - 4세,1998,1676,858,818
'1150058000,  화곡5동,'10,5 - 9세,1998,1616,861,755
'1150058000,  화곡5동,'15,10 - 14세,1998,1831,991,840
'1150058000,  화곡5동,'20,15 - 19세,1998,2834,1450,1384
'1150058000,  화곡5동,'25,20 - 24세,1998,2212,1049,1163
'1150058000,  화곡5동,'30,25 - 29세,1998,2628,1253,1375
'1150058000,  화곡5동,'35,30 - 34세,1998,2188,1105,1083
'1150058000,  화곡5동,'40,35 - 39세,1998,2371,1137,1234
'1150058000,  화곡5동,'45,40 - 44세,1998,2553,1138,1415
'1150058000,  화곡5동,'50,45 - 49세,1998,1961,986,975
'1150058000,  화곡5동,'55,50 - 54세,1998,1318,755,563
'1150058000,  화곡5동,'60,55 - 59세,1998,878,483,395
'1150058000,  화곡5동,'65,60 - 64세,1998,528,270,258
'1150058000,  화곡5동,'70,65 - 69세,1998,359,113,246
'1150058000,  화곡5동,'75,70 - 74세,1998,256,92,164
'1150058000,  화곡5동,'80,75 - 79세,1998,198,57,141
'1150058000,  화곡5동,'85,80 - 84세,1998,127,33,94
'1150058000,  화곡5동,'90,85+ ,1998,65,17,48
'1150059000,  화곡본동,'00,계,1998,28205,14103,14102
'1150059000,  화곡본동,'05,0 - 4세,1998,2106,1134,972
'1150059000,  화곡본동,'10,5 - 9세,1998,1858,976,882
'1150059000,  화곡본동,'15,10 - 14세,1998,1923,997,926
'1150059000,  화곡본동,'20,15 - 19세,1998,2367,1167,1200
'1150059000,  화곡본동,'25,20 - 24세,1998,2377,1163,1214
'1150059000,  화곡본동,'30,25 - 29세,1998,3429,1691,1738
'1150059000,  화곡본동,'35,30 - 34세,1998,2928,1515,1413
'1150059000,  화곡본동,'40,35 - 39세,1998,2729,1372,1357
'1150059000,  화곡본동,'45,40 - 44세,1998,2384,1189,1195
'1150059000,  화곡본동,'50,45 - 49세,1998,1675,822,853
'1150059000,  화곡본동,'55,50 - 54세,1998,1312,671,641
'1150059000,  화곡본동,'60,55 - 59세,1998,1096,592,504
'1150059000,  화곡본동,'65,60 - 64세,1998,755,357,398
'1150059000,  화곡본동,'70,65 - 69세,1998,495,217,278
'1150059000,  화곡본동,'75,70 - 74세,1998,321,111,210
'1150059000,  화곡본동,'80,75 - 79세,1998,242,81,161
'1150059000,  화곡본동,'85,80 - 84세,1998,133,29,104
'1150059000,  화곡본동,'90,85+ ,1998,75,19,56
'1150059100,  화곡6동,'00,계,1998,19048,9433,9615
'1150059100,  화곡6동,'05,0 - 4세,1998,1372,715,657
'1150059100,  화곡6동,'10,5 - 9세,1998,1308,687,621
'1150059100,  화곡6동,'15,10 - 14세,1998,1304,673,631
'1150059100,  화곡6동,'20,15 - 19세,1998,1702,867,835
'1150059100,  화곡6동,'25,20 - 24세,1998,1632,793,839
'1150059100,  화곡6동,'30,25 - 29세,1998,2088,1024,1064
'1150059100,  화곡6동,'35,30 - 34세,1998,1934,972,962
'1150059100,  화곡6동,'40,35 - 39세,1998,1889,936,953
'1150059100,  화곡6동,'45,40 - 44세,1998,1655,795,860
'1150059100,  화곡6동,'50,45 - 49세,1998,1198,618,580
'1150059100,  화곡6동,'55,50 - 54세,1998,906,480,426
'1150059100,  화곡6동,'60,55 - 59세,1998,658,333,325
'1150059100,  화곡6동,'65,60 - 64세,1998,460,199,261
'1150059100,  화곡6동,'70,65 - 69세,1998,376,156,220
'1150059100,  화곡6동,'75,70 - 74세,1998,234,88,146
'1150059100,  화곡6동,'80,75 - 79세,1998,177,50,127
'1150059100,  화곡6동,'85,80 - 84세,1998,96,28,68
'1150059100,  화곡6동,'90,85+ ,1998,59,19,40
'1150059200,  화곡7동,'00,계,1998,27217,13654,13563
'1150059200,  화곡7동,'05,0 - 4세,1998,1952,1022,930
'1150059200,  화곡7동,'10,5 - 9세,1998,1787,946,841
'1150059200,  화곡7동,'15,10 - 14세,1998,1784,954,830
'1150059200,  화곡7동,'20,15 - 19세,1998,2390,1222,1168
'1150059200,  화곡7동,'25,20 - 24세,1998,2539,1203,1336
'1150059200,  화곡7동,'30,25 - 29세,1998,3236,1590,1646
'1150059200,  화곡7동,'35,30 - 34세,1998,2692,1437,1255
'1150059200,  화곡7동,'40,35 - 39세,1998,2577,1286,1291
'1150059200,  화곡7동,'45,40 - 44세,1998,2236,1097,1139
'1150059200,  화곡7동,'50,45 - 49세,1998,1786,851,935
'1150059200,  화곡7동,'55,50 - 54세,1998,1434,769,665
'1150059200,  화곡7동,'60,55 - 59세,1998,1038,574,464
'1150059200,  화곡7동,'65,60 - 64세,1998,671,319,352
'1150059200,  화곡7동,'70,65 - 69세,1998,409,170,239
'1150059200,  화곡7동,'75,70 - 74세,1998,291,103,188
'1150059200,  화곡7동,'80,75 - 79세,1998,211,61,150
'1150059200,  화곡7동,'85,80 - 84세,1998,113,34,79
'1150059200,  화곡7동,'90,85+ ,1998,71,16,55
'1150059300,  화곡8동,'00,계,1998,23462,11741,11721
'1150059300,  화곡8동,'05,0 - 4세,1998,1802,919,883
'1150059300,  화곡8동,'10,5 - 9세,1998,1454,790,664
'1150059300,  화곡8동,'15,10 - 14세,1998,1430,737,693
'1150059300,  화곡8동,'20,15 - 19세,1998,2037,1056,981
'1150059300,  화곡8동,'25,20 - 24세,1998,2107,1003,1104
'1150059300,  화곡8동,'30,25 - 29세,1998,3033,1500,1533
'1150059300,  화곡8동,'35,30 - 34세,1998,2346,1287,1059
'1150059300,  화곡8동,'40,35 - 39세,1998,2074,1024,1050
'1150059300,  화곡8동,'45,40 - 44세,1998,1908,904,1004
'1150059300,  화곡8동,'50,45 - 49세,1998,1461,713,748
'1150059300,  화곡8동,'55,50 - 54세,1998,1201,617,584
'1150059300,  화곡8동,'60,55 - 59세,1998,954,510,444
'1150059300,  화곡8동,'65,60 - 64세,1998,629,323,306
'1150059300,  화곡8동,'70,65 - 69세,1998,395,164,231
'1150059300,  화곡8동,'75,70 - 74세,1998,253,88,165
'1150059300,  화곡8동,'80,75 - 79세,1998,191,55,136
'1150059300,  화곡8동,'85,80 - 84세,1998,106,29,77
'1150059300,  화곡8동,'90,85+ ,1998,81,22,59
'1150060300,  가양1동,'00,계,1998,20633,10481,10152
'1150060300,  가양1동,'05,0 - 4세,1998,1267,664,603
'1150060300,  가양1동,'10,5 - 9세,1998,1767,944,823
'1150060300,  가양1동,'15,10 - 14세,1998,2013,1075,938
'1150060300,  가양1동,'20,15 - 19세,1998,2014,1005,1009
'1150060300,  가양1동,'25,20 - 24세,1998,1295,667,628
'1150060300,  가양1동,'30,25 - 29세,1998,1548,782,766
'1150060300,  가양1동,'35,30 - 34세,1998,1759,791,968
'1150060300,  가양1동,'40,35 - 39세,1998,2564,1193,1371
'1150060300,  가양1동,'45,40 - 44세,1998,2389,1267,1122
'1150060300,  가양1동,'50,45 - 49세,1998,1352,786,566
'1150060300,  가양1동,'55,50 - 54세,1998,857,498,359
'1150060300,  가양1동,'60,55 - 59세,1998,576,319,257
'1150060300,  가양1동,'65,60 - 64세,1998,422,212,210
'1150060300,  가양1동,'70,65 - 69세,1998,295,116,179
'1150060300,  가양1동,'75,70 - 74세,1998,208,76,132
'1150060300,  가양1동,'80,75 - 79세,1998,149,45,104
'1150060300,  가양1동,'85,80 - 84세,1998,108,32,76
'1150060300,  가양1동,'90,85+ ,1998,50,9,41
'1150060400,  가양2동,'00,계,1998,22117,10758,11359
'1150060400,  가양2동,'05,0 - 4세,1998,979,519,460
'1150060400,  가양2동,'10,5 - 9세,1998,1699,928,771
'1150060400,  가양2동,'15,10 - 14세,1998,1959,1026,933
'1150060400,  가양2동,'20,15 - 19세,1998,2555,1308,1247
'1150060400,  가양2동,'25,20 - 24세,1998,1853,980,873
'1150060400,  가양2동,'30,25 - 29세,1998,1401,738,663
'1150060400,  가양2동,'35,30 - 34세,1998,1563,675,888
'1150060400,  가양2동,'40,35 - 39세,1998,2488,1140,1348
'1150060400,  가양2동,'45,40 - 44세,1998,2335,1153,1182
'1150060400,  가양2동,'50,45 - 49세,1998,1458,725,733
'1150060400,  가양2동,'55,50 - 54세,1998,1055,515,540
'1150060400,  가양2동,'60,55 - 59세,1998,772,353,419
'1150060400,  가양2동,'65,60 - 64세,1998,664,248,416
'1150060400,  가양2동,'70,65 - 69세,1998,465,155,310
'1150060400,  가양2동,'75,70 - 74세,1998,406,146,260
'1150060400,  가양2동,'80,75 - 79세,1998,267,96,171
'1150060400,  가양2동,'85,80 - 84세,1998,125,31,94
'1150060400,  가양2동,'90,85+ ,1998,73,22,51
'1150060500,  가양3동,'00,계,1998,20650,10194,10456
'1150060500,  가양3동,'05,0 - 4세,1998,1265,668,597
'1150060500,  가양3동,'10,5 - 9세,1998,1320,713,607
'1150060500,  가양3동,'15,10 - 14세,1998,1358,732,626
'1150060500,  가양3동,'20,15 - 19세,1998,1999,1063,936
'1150060500,  가양3동,'25,20 - 24세,1998,2015,1092,923
'1150060500,  가양3동,'30,25 - 29세,1998,1735,824,911
'1150060500,  가양3동,'35,30 - 34세,1998,1836,914,922
'1150060500,  가양3동,'40,35 - 39세,1998,2021,1022,999
'1150060500,  가양3동,'45,40 - 44세,1998,1855,893,962
'1150060500,  가양3동,'50,45 - 49세,1998,1313,617,696
'1150060500,  가양3동,'55,50 - 54세,1998,998,459,539
'1150060500,  가양3동,'60,55 - 59세,1998,897,426,471
'1150060500,  가양3동,'65,60 - 64세,1998,632,243,389
'1150060500,  가양3동,'70,65 - 69세,1998,537,192,345
'1150060500,  가양3동,'75,70 - 74세,1998,393,141,252
'1150060500,  가양3동,'80,75 - 79세,1998,268,108,160
'1150060500,  가양3동,'85,80 - 84세,1998,139,58,81
'1150060500,  가양3동,'90,85+ ,1998,69,29,40
'1150061100,  발산1동,'00,계,1998,15437,7595,7842
'1150061100,  발산1동,'05,0 - 4세,1998,644,319,325
'1150061100,  발산1동,'10,5 - 9세,1998,847,435,412
'1150061100,  발산1동,'15,10 - 14세,1998,1350,695,655
'1150061100,  발산1동,'20,15 - 19세,1998,2043,1035,1008
'1150061100,  발산1동,'25,20 - 24세,1998,1485,732,753
'1150061100,  발산1동,'30,25 - 29세,1998,1174,651,523
'1150061100,  발산1동,'35,30 - 34세,1998,1003,492,511
'1150061100,  발산1동,'40,35 - 39세,1998,1373,601,772
'1150061100,  발산1동,'45,40 - 44세,1998,1669,706,963
'1150061100,  발산1동,'50,45 - 49세,1998,1272,649,623
'1150061100,  발산1동,'55,50 - 54세,1998,926,527,399
'1150061100,  발산1동,'60,55 - 59세,1998,594,336,258
'1150061100,  발산1동,'65,60 - 64세,1998,359,176,183
'1150061100,  발산1동,'70,65 - 69세,1998,259,121,138
'1150061100,  발산1동,'75,70 - 74세,1998,190,59,131
'1150061100,  발산1동,'80,75 - 79세,1998,144,38,106
'1150061100,  발산1동,'85,80 - 84세,1998,66,16,50
'1150061100,  발산1동,'90,85+ ,1998,39,7,32
'1150061200,  발산2동,'00,계,1998,16725,8157,8568
'1150061200,  발산2동,'05,0 - 4세,1998,1098,590,508
'1150061200,  발산2동,'10,5 - 9세,1998,1150,562,588
'1150061200,  발산2동,'15,10 - 14세,1998,1340,676,664
'1150061200,  발산2동,'20,15 - 19세,1998,1750,891,859
'1150061200,  발산2동,'25,20 - 24세,1998,1378,658,720
'1150061200,  발산2동,'30,25 - 29세,1998,1587,757,830
'1150061200,  발산2동,'35,30 - 34세,1998,1494,744,750
'1150061200,  발산2동,'40,35 - 39세,1998,1625,760,865
'1150061200,  발산2동,'45,40 - 44세,1998,1737,811,926
'1150061200,  발산2동,'50,45 - 49세,1998,1217,628,589
'1150061200,  발산2동,'55,50 - 54세,1998,818,446,372
'1150061200,  발산2동,'60,55 - 59세,1998,510,297,213
'1150061200,  발산2동,'65,60 - 64세,1998,315,122,193
'1150061200,  발산2동,'70,65 - 69세,1998,236,74,162
'1150061200,  발산2동,'75,70 - 74세,1998,199,52,147
'1150061200,  발산2동,'80,75 - 79세,1998,142,52,90
'1150061200,  발산2동,'85,80 - 84세,1998,87,27,60
'1150061200,  발산2동,'90,85+ ,1998,42,10,32
'1150062000,  공항동,'00,계,1998,23899,12256,11643
'1150062000,  공항동,'05,0 - 4세,1998,1806,944,862
'1150062000,  공항동,'10,5 - 9세,1998,1583,864,719
'1150062000,  공항동,'15,10 - 14세,1998,1365,747,618
'1150062000,  공항동,'20,15 - 19세,1998,1738,905,833
'1150062000,  공항동,'25,20 - 24세,1998,2147,1019,1128
'1150062000,  공항동,'30,25 - 29세,1998,3158,1647,1511
'1150062000,  공항동,'35,30 - 34세,1998,2470,1358,1112
'1150062000,  공항동,'40,35 - 39세,1998,2301,1255,1046
'1150062000,  공항동,'45,40 - 44세,1998,1812,957,855
'1150062000,  공항동,'50,45 - 49세,1998,1291,619,672
'1150062000,  공항동,'55,50 - 54세,1998,1177,607,570
'1150062000,  공항동,'60,55 - 59세,1998,1041,495,546
'1150062000,  공항동,'65,60 - 64세,1998,789,373,416
'1150062000,  공항동,'70,65 - 69세,1998,489,209,280
'1150062000,  공항동,'75,70 - 74세,1998,299,100,199
'1150062000,  공항동,'80,75 - 79세,1998,246,94,152
'1150062000,  공항동,'85,80 - 84세,1998,121,41,80
'1150062000,  공항동,'90,85+ ,1998,66,22,44
'1150063000,  방화1동,'00,계,1998,28589,14463,14126
'1150063000,  방화1동,'05,0 - 4세,1998,2033,1100,933
'1150063000,  방화1동,'10,5 - 9세,1998,2173,1114,1059
'1150063000,  방화1동,'15,10 - 14세,1998,1998,1058,940
'1150063000,  방화1동,'20,15 - 19세,1998,2380,1213,1167
'1150063000,  방화1동,'25,20 - 24세,1998,2280,1096,1184
'1150063000,  방화1동,'30,25 - 29세,1998,2859,1474,1385
'1150063000,  방화1동,'35,30 - 34세,1998,2794,1392,1402
'1150063000,  방화1동,'40,35 - 39세,1998,3054,1565,1489
'1150063000,  방화1동,'45,40 - 44세,1998,2590,1359,1231
'1150063000,  방화1동,'50,45 - 49세,1998,1703,873,830
'1150063000,  방화1동,'55,50 - 54세,1998,1382,710,672
'1150063000,  방화1동,'60,55 - 59세,1998,1209,615,594
'1150063000,  방화1동,'65,60 - 64세,1998,819,394,425
'1150063000,  방화1동,'70,65 - 69세,1998,530,216,314
'1150063000,  방화1동,'75,70 - 74세,1998,354,146,208
'1150063000,  방화1동,'80,75 - 79세,1998,248,85,163
'1150063000,  방화1동,'85,80 - 84세,1998,111,35,76
'1150063000,  방화1동,'90,85+ ,1998,72,18,54
'1150064000,  방화2동,'00,계,1998,28585,14122,14463
'1150064000,  방화2동,'05,0 - 4세,1998,1807,945,862
'1150064000,  방화2동,'10,5 - 9세,1998,1827,950,877
'1150064000,  방화2동,'15,10 - 14세,1998,1857,965,892
'1150064000,  방화2동,'20,15 - 19세,1998,2757,1368,1389
'1150064000,  방화2동,'25,20 - 24세,1998,2482,1201,1281
'1150064000,  방화2동,'30,25 - 29세,1998,2987,1553,1434
'1150064000,  방화2동,'35,30 - 34세,1998,2640,1381,1259
'1150064000,  방화2동,'40,35 - 39세,1998,2702,1363,1339
'1150064000,  방화2동,'45,40 - 44세,1998,2506,1191,1315
'1150064000,  방화2동,'50,45 - 49세,1998,1691,810,881
'1150064000,  방화2동,'55,50 - 54세,1998,1432,723,709
'1150064000,  방화2동,'60,55 - 59세,1998,1250,605,645
'1150064000,  방화2동,'65,60 - 64세,1998,960,424,536
'1150064000,  방화2동,'70,65 - 69세,1998,664,280,384
'1150064000,  방화2동,'75,70 - 74세,1998,497,185,312
'1150064000,  방화2동,'80,75 - 79세,1998,263,104,159
'1150064000,  방화2동,'85,80 - 84세,1998,172,55,117
'1150064000,  방화2동,'90,85+ ,1998,91,19,72
'1150064100,  방화3동,'00,계,1998,31689,15629,16060
'1150064100,  방화3동,'05,0 - 4세,1998,2033,1094,939
'1150064100,  방화3동,'10,5 - 9세,1998,2538,1346,1192
'1150064100,  방화3동,'15,10 - 14세,1998,2429,1251,1178
'1150064100,  방화3동,'20,15 - 19세,1998,3082,1540,1542
'1150064100,  방화3동,'25,20 - 24세,1998,2446,1275,1171
'1150064100,  방화3동,'30,25 - 29세,1998,2737,1278,1459
'1150064100,  방화3동,'35,30 - 34세,1998,2931,1390,1541
'1150064100,  방화3동,'40,35 - 39세,1998,3564,1745,1819
'1150064100,  방화3동,'45,40 - 44세,1998,2962,1507,1455
'1150064100,  방화3동,'50,45 - 49세,1998,1973,1029,944
'1150064100,  방화3동,'55,50 - 54세,1998,1376,709,667
'1150064100,  방화3동,'60,55 - 59세,1998,1135,562,573
'1150064100,  방화3동,'65,60 - 64세,1998,791,332,459
'1150064100,  방화3동,'70,65 - 69세,1998,632,223,409
'1150064100,  방화3동,'75,70 - 74세,1998,473,176,297
'1150064100,  방화3동,'80,75 - 79세,1998,323,109,214
'1150064100,  방화3동,'85,80 - 84세,1998,173,40,133
'1150064100,  방화3동,'90,85+ ,1998,91,23,68
'11530, 구로구,'00,계,1998,380623,194526,186097
'11530, 구로구,'05,0 - 4세,1998,26529,13886,12643
'11530, 구로구,'10,5 - 9세,1998,24965,13259,11706
'11530, 구로구,'15,10 - 14세,1998,23832,12474,11358
'11530, 구로구,'20,15 - 19세,1998,33109,17231,15878
'11530, 구로구,'25,20 - 24세,1998,35286,17605,17681
'11530, 구로구,'30,25 - 29세,1998,44642,23319,21323
'11530, 구로구,'35,30 - 34세,1998,37684,20331,17353
'11530, 구로구,'40,35 - 39세,1998,36223,18714,17509
'11530, 구로구,'45,40 - 44세,1998,31801,16025,15776
'11530, 구로구,'50,45 - 49세,1998,23728,11937,11791
'11530, 구로구,'55,50 - 54세,1998,19641,10074,9567
'11530, 구로구,'60,55 - 59세,1998,16598,8608,7990
'11530, 구로구,'65,60 - 64세,1998,10821,5316,5505
'11530, 구로구,'70,65 - 69세,1998,6332,2725,3607
'11530, 구로구,'75,70 - 74세,1998,4145,1513,2632
'11530, 구로구,'80,75 - 79세,1998,2882,941,1941
'11530, 구로구,'85,80 - 84세,1998,1487,383,1104
'11530, 구로구,'90,85+ ,1998,918,185,733
'1153051000,  신도림동,'00,계,1998,12247,6261,5986
'1153051000,  신도림동,'05,0 - 4세,1998,873,472,401
'1153051000,  신도림동,'10,5 - 9세,1998,825,432,393
'1153051000,  신도림동,'15,10 - 14세,1998,762,405,357
'1153051000,  신도림동,'20,15 - 19세,1998,1011,538,473
'1153051000,  신도림동,'25,20 - 24세,1998,1107,554,553
'1153051000,  신도림동,'30,25 - 29세,1998,1324,662,662
'1153051000,  신도림동,'35,30 - 34세,1998,1217,638,579
'1153051000,  신도림동,'40,35 - 39세,1998,1260,650,610
'1153051000,  신도림동,'45,40 - 44세,1998,1018,545,473
'1153051000,  신도림동,'50,45 - 49세,1998,752,362,390
'1153051000,  신도림동,'55,50 - 54세,1998,640,346,294
'1153051000,  신도림동,'60,55 - 59세,1998,527,267,260
'1153051000,  신도림동,'65,60 - 64세,1998,401,185,216
'1153051000,  신도림동,'70,65 - 69세,1998,220,98,122
'1153051000,  신도림동,'75,70 - 74세,1998,156,57,99
'1153051000,  신도림동,'80,75 - 79세,1998,90,34,56
'1153051000,  신도림동,'85,80 - 84세,1998,35,11,24
'1153051000,  신도림동,'90,85+ ,1998,29,5,24
'1153052000,  구로1동,'00,계,1998,23686,11856,11830
'1153052000,  구로1동,'05,0 - 4세,1998,1439,766,673
'1153052000,  구로1동,'10,5 - 9세,1998,1995,1103,892
'1153052000,  구로1동,'15,10 - 14세,1998,2379,1230,1149
'1153052000,  구로1동,'20,15 - 19세,1998,2684,1411,1273
'1153052000,  구로1동,'25,20 - 24세,1998,1290,652,638
'1153052000,  구로1동,'30,25 - 29세,1998,1654,760,894
'1153052000,  구로1동,'35,30 - 34세,1998,1977,954,1023
'1153052000,  구로1동,'40,35 - 39세,1998,2736,1209,1527
'1153052000,  구로1동,'45,40 - 44세,1998,3092,1514,1578
'1153052000,  구로1동,'50,45 - 49세,1998,1717,1015,702
'1153052000,  구로1동,'55,50 - 54세,1998,852,510,342
'1153052000,  구로1동,'60,55 - 59세,1998,532,285,247
'1153052000,  구로1동,'65,60 - 64세,1998,390,166,224
'1153052000,  구로1동,'70,65 - 69세,1998,338,114,224
'1153052000,  구로1동,'75,70 - 74세,1998,274,83,191
'1153052000,  구로1동,'80,75 - 79세,1998,187,47,140
'1153052000,  구로1동,'85,80 - 84세,1998,95,25,70
'1153052000,  구로1동,'90,85+ ,1998,55,12,43
'1153053000,  구로2동,'00,계,1998,21725,11177,10548
'1153053000,  구로2동,'05,0 - 4세,1998,1637,849,788
'1153053000,  구로2동,'10,5 - 9세,1998,1344,730,614
'1153053000,  구로2동,'15,10 - 14세,1998,1099,573,526
'1153053000,  구로2동,'20,15 - 19세,1998,1739,916,823
'1153053000,  구로2동,'25,20 - 24세,1998,2252,1110,1142
'1153053000,  구로2동,'30,25 - 29세,1998,2983,1540,1443
'1153053000,  구로2동,'35,30 - 34세,1998,2341,1312,1029
'1153053000,  구로2동,'40,35 - 39세,1998,1933,1085,848
'1153053000,  구로2동,'45,40 - 44세,1998,1556,802,754
'1153053000,  구로2동,'50,45 - 49세,1998,1254,595,659
'1153053000,  구로2동,'55,50 - 54세,1998,1083,528,555
'1153053000,  구로2동,'60,55 - 59세,1998,1009,525,484
'1153053000,  구로2동,'65,60 - 64세,1998,639,309,330
'1153053000,  구로2동,'70,65 - 69세,1998,348,158,190
'1153053000,  구로2동,'75,70 - 74세,1998,206,72,134
'1153053000,  구로2동,'80,75 - 79세,1998,158,36,122
'1153053000,  구로2동,'85,80 - 84세,1998,87,21,66
'1153053000,  구로2동,'90,85+ ,1998,57,16,41
'1153054000,  구로3동,'00,계,1998,25006,12744,12262
'1153054000,  구로3동,'05,0 - 4세,1998,1640,843,797
'1153054000,  구로3동,'10,5 - 9세,1998,1506,797,709
'1153054000,  구로3동,'15,10 - 14세,1998,1366,677,689
'1153054000,  구로3동,'20,15 - 19세,1998,2149,1120,1029
'1153054000,  구로3동,'25,20 - 24세,1998,2467,1255,1212
'1153054000,  구로3동,'30,25 - 29세,1998,3090,1623,1467
'1153054000,  구로3동,'35,30 - 34세,1998,2511,1379,1132
'1153054000,  구로3동,'40,35 - 39세,1998,2308,1209,1099
'1153054000,  구로3동,'45,40 - 44세,1998,1908,1010,898
'1153054000,  구로3동,'50,45 - 49세,1998,1554,753,801
'1153054000,  구로3동,'55,50 - 54세,1998,1400,703,697
'1153054000,  구로3동,'60,55 - 59세,1998,1174,579,595
'1153054000,  구로3동,'65,60 - 64세,1998,848,400,448
'1153054000,  구로3동,'70,65 - 69세,1998,464,195,269
'1153054000,  구로3동,'75,70 - 74세,1998,281,100,181
'1153054000,  구로3동,'80,75 - 79세,1998,187,62,125
'1153054000,  구로3동,'85,80 - 84세,1998,96,29,67
'1153054000,  구로3동,'90,85+ ,1998,57,10,47
'1153055000,  구로4동,'00,계,1998,13745,6969,6776
'1153055000,  구로4동,'05,0 - 4세,1998,1152,609,543
'1153055000,  구로4동,'10,5 - 9세,1998,714,378,336
'1153055000,  구로4동,'15,10 - 14세,1998,603,305,298
'1153055000,  구로4동,'20,15 - 19세,1998,1165,566,599
'1153055000,  구로4동,'25,20 - 24세,1998,1368,681,687
'1153055000,  구로4동,'30,25 - 29세,1998,1996,1012,984
'1153055000,  구로4동,'35,30 - 34세,1998,1554,919,635
'1153055000,  구로4동,'40,35 - 39세,1998,1112,605,507
'1153055000,  구로4동,'45,40 - 44세,1998,909,420,489
'1153055000,  구로4동,'50,45 - 49세,1998,814,377,437
'1153055000,  구로4동,'55,50 - 54세,1998,718,362,356
'1153055000,  구로4동,'60,55 - 59세,1998,677,329,348
'1153055000,  구로4동,'65,60 - 64세,1998,442,212,230
'1153055000,  구로4동,'70,65 - 69세,1998,242,104,138
'1153055000,  구로4동,'75,70 - 74세,1998,111,43,68
'1153055000,  구로4동,'80,75 - 79세,1998,97,27,70
'1153055000,  구로4동,'85,80 - 84세,1998,39,10,29
'1153055000,  구로4동,'90,85+ ,1998,32,10,22
'1153056000,  구로5동,'00,계,1998,24054,12432,11622
'1153056000,  구로5동,'05,0 - 4세,1998,1964,1050,914
'1153056000,  구로5동,'10,5 - 9세,1998,1668,858,810
'1153056000,  구로5동,'15,10 - 14세,1998,1275,695,580
'1153056000,  구로5동,'20,15 - 19세,1998,1755,929,826
'1153056000,  구로5동,'25,20 - 24세,1998,2258,1069,1189
'1153056000,  구로5동,'30,25 - 29세,1998,3369,1771,1598
'1153056000,  구로5동,'35,30 - 34세,1998,2786,1544,1242
'1153056000,  구로5동,'40,35 - 39세,1998,2349,1305,1044
'1153056000,  구로5동,'45,40 - 44세,1998,1665,854,811
'1153056000,  구로5동,'50,45 - 49세,1998,1313,648,665
'1153056000,  구로5동,'55,50 - 54세,1998,1137,562,575
'1153056000,  구로5동,'60,55 - 59세,1998,1007,511,496
'1153056000,  구로5동,'65,60 - 64세,1998,640,315,325
'1153056000,  구로5동,'70,65 - 69세,1998,393,183,210
'1153056000,  구로5동,'75,70 - 74세,1998,220,75,145
'1153056000,  구로5동,'80,75 - 79세,1998,153,42,111
'1153056000,  구로5동,'85,80 - 84세,1998,56,9,47
'1153056000,  구로5동,'90,85+ ,1998,46,12,34
'1153056500,  구로본동,'00,계,1998,20994,10789,10205
'1153056500,  구로본동,'05,0 - 4세,1998,1654,852,802
'1153056500,  구로본동,'10,5 - 9세,1998,1353,730,623
'1153056500,  구로본동,'15,10 - 14세,1998,1078,558,520
'1153056500,  구로본동,'20,15 - 19세,1998,1570,832,738
'1153056500,  구로본동,'25,20 - 24세,1998,2039,970,1069
'1153056500,  구로본동,'30,25 - 29세,1998,3018,1589,1429
'1153056500,  구로본동,'35,30 - 34세,1998,2349,1312,1037
'1153056500,  구로본동,'40,35 - 39세,1998,1931,1044,887
'1153056500,  구로본동,'45,40 - 44세,1998,1474,777,697
'1153056500,  구로본동,'50,45 - 49세,1998,1086,528,558
'1153056500,  구로본동,'55,50 - 54세,1998,996,464,532
'1153056500,  구로본동,'60,55 - 59세,1998,1047,541,506
'1153056500,  구로본동,'65,60 - 64세,1998,613,286,327
'1153056500,  구로본동,'70,65 - 69세,1998,313,143,170
'1153056500,  구로본동,'75,70 - 74세,1998,196,79,117
'1153056500,  구로본동,'80,75 - 79세,1998,144,56,88
'1153056500,  구로본동,'85,80 - 84세,1998,82,21,61
'1153056500,  구로본동,'90,85+ ,1998,51,7,44
'1153057000,  구로6동,'00,계,1998,16517,8420,8097
'1153057000,  구로6동,'05,0 - 4세,1998,1175,616,559
'1153057000,  구로6동,'10,5 - 9세,1998,1025,535,490
'1153057000,  구로6동,'15,10 - 14세,1998,925,486,439
'1153057000,  구로6동,'20,15 - 19세,1998,1264,665,599
'1153057000,  구로6동,'25,20 - 24세,1998,1708,815,893
'1153057000,  구로6동,'30,25 - 29세,1998,2354,1219,1135
'1153057000,  구로6동,'35,30 - 34세,1998,1835,1010,825
'1153057000,  구로6동,'40,35 - 39세,1998,1473,765,708
'1153057000,  구로6동,'45,40 - 44세,1998,1183,614,569
'1153057000,  구로6동,'50,45 - 49세,1998,917,455,462
'1153057000,  구로6동,'55,50 - 54세,1998,829,409,420
'1153057000,  구로6동,'60,55 - 59세,1998,749,372,377
'1153057000,  구로6동,'65,60 - 64세,1998,484,239,245
'1153057000,  구로6동,'70,65 - 69세,1998,231,97,134
'1153057000,  구로6동,'75,70 - 74세,1998,169,67,102
'1153057000,  구로6동,'80,75 - 79세,1998,117,37,80
'1153057000,  구로6동,'85,80 - 84세,1998,51,11,40
'1153057000,  구로6동,'90,85+ ,1998,28,8,20
'1153058000,  가리봉1동,'00,계,1998,12555,6795,5760
'1153058000,  가리봉1동,'05,0 - 4세,1998,764,375,389
'1153058000,  가리봉1동,'10,5 - 9세,1998,676,359,317
'1153058000,  가리봉1동,'15,10 - 14세,1998,624,322,302
'1153058000,  가리봉1동,'20,15 - 19세,1998,927,483,444
'1153058000,  가리봉1동,'25,20 - 24세,1998,1203,609,594
'1153058000,  가리봉1동,'30,25 - 29세,1998,1668,974,694
'1153058000,  가리봉1동,'35,30 - 34세,1998,1508,897,611
'1153058000,  가리봉1동,'40,35 - 39세,1998,1433,904,529
'1153058000,  가리봉1동,'45,40 - 44세,1998,1062,587,475
'1153058000,  가리봉1동,'50,45 - 49세,1998,708,366,342
'1153058000,  가리봉1동,'55,50 - 54세,1998,575,311,264
'1153058000,  가리봉1동,'60,55 - 59세,1998,530,267,263
'1153058000,  가리봉1동,'65,60 - 64세,1998,351,165,186
'1153058000,  가리봉1동,'70,65 - 69세,1998,222,84,138
'1153058000,  가리봉1동,'75,70 - 74세,1998,130,53,77
'1153058000,  가리봉1동,'80,75 - 79세,1998,88,20,68
'1153058000,  가리봉1동,'85,80 - 84세,1998,59,15,44
'1153058000,  가리봉1동,'90,85+ ,1998,27,4,23
'1153059000,  가리봉2동,'00,계,1998,6844,3651,3193
'1153059000,  가리봉2동,'05,0 - 4세,1998,544,290,254
'1153059000,  가리봉2동,'10,5 - 9세,1998,466,251,215
'1153059000,  가리봉2동,'15,10 - 14세,1998,371,180,191
'1153059000,  가리봉2동,'20,15 - 19세,1998,473,251,222
'1153059000,  가리봉2동,'25,20 - 24세,1998,678,324,354
'1153059000,  가리봉2동,'30,25 - 29세,1998,954,546,408
'1153059000,  가리봉2동,'35,30 - 34세,1998,791,456,335
'1153059000,  가리봉2동,'40,35 - 39세,1998,741,442,299
'1153059000,  가리봉2동,'45,40 - 44세,1998,504,294,210
'1153059000,  가리봉2동,'50,45 - 49세,1998,323,167,156
'1153059000,  가리봉2동,'55,50 - 54세,1998,307,148,159
'1153059000,  가리봉2동,'60,55 - 59세,1998,258,131,127
'1153059000,  가리봉2동,'65,60 - 64세,1998,174,81,93
'1153059000,  가리봉2동,'70,65 - 69세,1998,101,47,54
'1153059000,  가리봉2동,'75,70 - 74세,1998,68,28,40
'1153059000,  가리봉2동,'80,75 - 79세,1998,47,9,38
'1153059000,  가리봉2동,'85,80 - 84세,1998,29,6,23
'1153059000,  가리봉2동,'90,85+ ,1998,15,0,15
'1153072000,  고척1동,'00,계,1998,24748,12564,12184
'1153072000,  고척1동,'05,0 - 4세,1998,1453,750,703
'1153072000,  고척1동,'10,5 - 9세,1998,1606,834,772
'1153072000,  고척1동,'15,10 - 14세,1998,1746,936,810
'1153072000,  고척1동,'20,15 - 19세,1998,2338,1183,1155
'1153072000,  고척1동,'25,20 - 24세,1998,2335,1212,1123
'1153072000,  고척1동,'30,25 - 29세,1998,2459,1312,1147
'1153072000,  고척1동,'35,30 - 34세,1998,2067,1090,977
'1153072000,  고척1동,'40,35 - 39세,1998,2352,1122,1230
'1153072000,  고척1동,'45,40 - 44세,1998,2252,1132,1120
'1153072000,  고척1동,'50,45 - 49세,1998,1729,884,845
'1153072000,  고척1동,'55,50 - 54세,1998,1440,724,716
'1153072000,  고척1동,'60,55 - 59세,1998,1179,655,524
'1153072000,  고척1동,'65,60 - 64세,1998,720,344,376
'1153072000,  고척1동,'70,65 - 69세,1998,448,188,260
'1153072000,  고척1동,'75,70 - 74세,1998,279,99,180
'1153072000,  고척1동,'80,75 - 79세,1998,191,69,122
'1153072000,  고척1동,'85,80 - 84세,1998,98,19,79
'1153072000,  고척1동,'90,85+ ,1998,56,11,45
'1153073000,  고척2동,'00,계,1998,30043,15427,14616
'1153073000,  고척2동,'05,0 - 4세,1998,2331,1222,1109
'1153073000,  고척2동,'10,5 - 9세,1998,2125,1172,953
'1153073000,  고척2동,'15,10 - 14세,1998,1821,959,862
'1153073000,  고척2동,'20,15 - 19세,1998,2564,1280,1284
'1153073000,  고척2동,'25,20 - 24세,1998,2825,1407,1418
'1153073000,  고척2동,'30,25 - 29세,1998,3481,1833,1648
'1153073000,  고척2동,'35,30 - 34세,1998,3036,1624,1412
'1153073000,  고척2동,'40,35 - 39세,1998,2797,1488,1309
'1153073000,  고척2동,'45,40 - 44세,1998,2364,1173,1191
'1153073000,  고척2동,'50,45 - 49세,1998,1853,928,925
'1153073000,  고척2동,'55,50 - 54세,1998,1578,813,765
'1153073000,  고척2동,'60,55 - 59세,1998,1342,709,633
'1153073000,  고척2동,'65,60 - 64세,1998,833,437,396
'1153073000,  고척2동,'70,65 - 69세,1998,410,182,228
'1153073000,  고척2동,'75,70 - 74세,1998,285,96,189
'1153073000,  고척2동,'80,75 - 79세,1998,212,67,145
'1153073000,  고척2동,'85,80 - 84세,1998,114,29,85
'1153073000,  고척2동,'90,85+ ,1998,72,8,64
'1153074000,  개봉1동,'00,계,1998,19634,10090,9544
'1153074000,  개봉1동,'05,0 - 4세,1998,1363,745,618
'1153074000,  개봉1동,'10,5 - 9세,1998,1388,701,687
'1153074000,  개봉1동,'15,10 - 14세,1998,1315,756,559
'1153074000,  개봉1동,'20,15 - 19세,1998,1860,945,915
'1153074000,  개봉1동,'25,20 - 24세,1998,1744,863,881
'1153074000,  개봉1동,'30,25 - 29세,1998,2196,1143,1053
'1153074000,  개봉1동,'35,30 - 34세,1998,1890,984,906
'1153074000,  개봉1동,'40,35 - 39세,1998,1916,981,935
'1153074000,  개봉1동,'45,40 - 44세,1998,1733,874,859
'1153074000,  개봉1동,'50,45 - 49세,1998,1190,624,566
'1153074000,  개봉1동,'55,50 - 54세,1998,994,517,477
'1153074000,  개봉1동,'60,55 - 59세,1998,837,447,390
'1153074000,  개봉1동,'65,60 - 64세,1998,475,234,241
'1153074000,  개봉1동,'70,65 - 69세,1998,286,137,149
'1153074000,  개봉1동,'75,70 - 74세,1998,208,71,137
'1153074000,  개봉1동,'80,75 - 79세,1998,134,43,91
'1153074000,  개봉1동,'85,80 - 84세,1998,66,20,46
'1153074000,  개봉1동,'90,85+ ,1998,39,5,34
'1153075000,  개봉2동,'00,계,1998,22449,11303,11146
'1153075000,  개봉2동,'05,0 - 4세,1998,1415,737,678
'1153075000,  개봉2동,'10,5 - 9세,1998,1248,697,551
'1153075000,  개봉2동,'15,10 - 14세,1998,1471,744,727
'1153075000,  개봉2동,'20,15 - 19세,1998,2076,1080,996
'1153075000,  개봉2동,'25,20 - 24세,1998,2330,1102,1228
'1153075000,  개봉2동,'30,25 - 29세,1998,2611,1361,1250
'1153075000,  개봉2동,'35,30 - 34세,1998,1935,1053,882
'1153075000,  개봉2동,'40,35 - 39세,1998,1792,815,977
'1153075000,  개봉2동,'45,40 - 44세,1998,2008,987,1021
'1153075000,  개봉2동,'50,45 - 49세,1998,1604,794,810
'1153075000,  개봉2동,'55,50 - 54세,1998,1298,690,608
'1153075000,  개봉2동,'60,55 - 59세,1998,995,527,468
'1153075000,  개봉2동,'65,60 - 64세,1998,637,320,317
'1153075000,  개봉2동,'70,65 - 69세,1998,392,179,213
'1153075000,  개봉2동,'75,70 - 74세,1998,273,96,177
'1153075000,  개봉2동,'80,75 - 79세,1998,198,75,123
'1153075000,  개봉2동,'85,80 - 84세,1998,110,31,79
'1153075000,  개봉2동,'90,85+ ,1998,56,15,41
'1153076000,  개봉3동,'00,계,1998,18831,9429,9402
'1153076000,  개봉3동,'05,0 - 4세,1998,1099,534,565
'1153076000,  개봉3동,'10,5 - 9세,1998,1197,665,532
'1153076000,  개봉3동,'15,10 - 14세,1998,1385,719,666
'1153076000,  개봉3동,'20,15 - 19세,1998,1980,1024,956
'1153076000,  개봉3동,'25,20 - 24세,1998,1863,947,916
'1153076000,  개봉3동,'30,25 - 29세,1998,1822,958,864
'1153076000,  개봉3동,'35,30 - 34세,1998,1492,727,765
'1153076000,  개봉3동,'40,35 - 39세,1998,1742,814,928
'1153076000,  개봉3동,'45,40 - 44세,1998,1739,823,916
'1153076000,  개봉3동,'50,45 - 49세,1998,1373,699,674
'1153076000,  개봉3동,'55,50 - 54세,1998,1086,582,504
'1153076000,  개봉3동,'60,55 - 59세,1998,736,393,343
'1153076000,  개봉3동,'65,60 - 64세,1998,455,229,226
'1153076000,  개봉3동,'70,65 - 69세,1998,322,124,198
'1153076000,  개봉3동,'75,70 - 74세,1998,226,85,141
'1153076000,  개봉3동,'80,75 - 79세,1998,174,71,103
'1153076000,  개봉3동,'85,80 - 84세,1998,85,19,66
'1153076000,  개봉3동,'90,85+ ,1998,55,16,39
'1153076500,  개봉본동,'00,계,1998,14478,7377,7101
'1153076500,  개봉본동,'05,0 - 4세,1998,950,497,453
'1153076500,  개봉본동,'10,5 - 9세,1998,826,446,380
'1153076500,  개봉본동,'15,10 - 14세,1998,785,393,392
'1153076500,  개봉본동,'20,15 - 19세,1998,1239,616,623
'1153076500,  개봉본동,'25,20 - 24세,1998,1481,760,721
'1153076500,  개봉본동,'30,25 - 29세,1998,1884,1012,872
'1153076500,  개봉본동,'35,30 - 34세,1998,1390,763,627
'1153076500,  개봉본동,'40,35 - 39세,1998,1278,673,605
'1153076500,  개봉본동,'45,40 - 44세,1998,1094,522,572
'1153076500,  개봉본동,'50,45 - 49세,1998,918,426,492
'1153076500,  개봉본동,'55,50 - 54세,1998,882,428,454
'1153076500,  개봉본동,'60,55 - 59세,1998,733,401,332
'1153076500,  개봉본동,'65,60 - 64세,1998,441,232,209
'1153076500,  개봉본동,'70,65 - 69세,1998,217,90,127
'1153076500,  개봉본동,'75,70 - 74세,1998,148,61,87
'1153076500,  개봉본동,'80,75 - 79세,1998,104,37,67
'1153076500,  개봉본동,'85,80 - 84세,1998,74,16,58
'1153076500,  개봉본동,'90,85+ ,1998,34,4,30
'1153077000,  오류1동,'00,계,1998,20175,10240,9935
'1153077000,  오류1동,'05,0 - 4세,1998,1478,810,668
'1153077000,  오류1동,'10,5 - 9세,1998,1428,704,724
'1153077000,  오류1동,'15,10 - 14세,1998,1235,648,587
'1153077000,  오류1동,'20,15 - 19세,1998,1542,821,721
'1153077000,  오류1동,'25,20 - 24세,1998,1841,932,909
'1153077000,  오류1동,'30,25 - 29세,1998,2281,1190,1091
'1153077000,  오류1동,'35,30 - 34세,1998,2021,1040,981
'1153077000,  오류1동,'40,35 - 39세,1998,1919,1005,914
'1153077000,  오류1동,'45,40 - 44세,1998,1552,771,781
'1153077000,  오류1동,'50,45 - 49세,1998,1236,605,631
'1153077000,  오류1동,'55,50 - 54세,1998,1026,534,492
'1153077000,  오류1동,'60,55 - 59세,1998,979,477,502
'1153077000,  오류1동,'65,60 - 64세,1998,669,336,333
'1153077000,  오류1동,'70,65 - 69세,1998,414,189,225
'1153077000,  오류1동,'75,70 - 74세,1998,253,86,167
'1153077000,  오류1동,'80,75 - 79세,1998,149,54,95
'1153077000,  오류1동,'85,80 - 84세,1998,84,23,61
'1153077000,  오류1동,'90,85+ ,1998,68,15,53
'1153078000,  오류2동,'00,계,1998,27870,14130,13740
'1153078000,  오류2동,'05,0 - 4세,1998,1862,974,888
'1153078000,  오류2동,'10,5 - 9세,1998,1921,978,943
'1153078000,  오류2동,'15,10 - 14세,1998,1817,942,875
'1153078000,  오류2동,'20,15 - 19세,1998,2469,1309,1160
'1153078000,  오류2동,'25,20 - 24세,1998,2344,1201,1143
'1153078000,  오류2동,'30,25 - 29세,1998,3021,1544,1477
'1153078000,  오류2동,'35,30 - 34세,1998,2637,1397,1240
'1153078000,  오류2동,'40,35 - 39세,1998,2716,1384,1332
'1153078000,  오류2동,'45,40 - 44세,1998,2392,1187,1205
'1153078000,  오류2동,'50,45 - 49세,1998,1701,861,840
'1153078000,  오류2동,'55,50 - 54세,1998,1450,712,738
'1153078000,  오류2동,'60,55 - 59세,1998,1296,665,631
'1153078000,  오류2동,'65,60 - 64세,1998,904,468,436
'1153078000,  오류2동,'70,65 - 69세,1998,529,225,304
'1153078000,  오류2동,'75,70 - 74세,1998,373,149,224
'1153078000,  오류2동,'80,75 - 79세,1998,239,80,159
'1153078000,  오류2동,'85,80 - 84세,1998,129,39,90
'1153078000,  오류2동,'90,85+ ,1998,70,15,55
'1153079000,  수궁동,'00,계,1998,25022,12872,12150
'1153079000,  수궁동,'05,0 - 4세,1998,1736,895,841
'1153079000,  수궁동,'10,5 - 9세,1998,1654,889,765
'1153079000,  수궁동,'15,10 - 14세,1998,1775,946,829
'1153079000,  수궁동,'20,15 - 19세,1998,2304,1262,1042
'1153079000,  수궁동,'25,20 - 24세,1998,2153,1142,1011
'1153079000,  수궁동,'30,25 - 29세,1998,2477,1270,1207
'1153079000,  수궁동,'35,30 - 34세,1998,2347,1232,1115
'1153079000,  수궁동,'40,35 - 39세,1998,2435,1214,1221
'1153079000,  수궁동,'45,40 - 44세,1998,2296,1139,1157
'1153079000,  수궁동,'50,45 - 49세,1998,1686,850,836
'1153079000,  수궁동,'55,50 - 54세,1998,1350,731,619
'1153079000,  수궁동,'60,55 - 59세,1998,991,527,464
'1153079000,  수궁동,'65,60 - 64세,1998,705,358,347
'1153079000,  수궁동,'70,65 - 69세,1998,442,188,254
'1153079000,  수궁동,'75,70 - 74세,1998,289,113,176
'1153079000,  수궁동,'80,75 - 79세,1998,213,75,138
'1153079000,  수궁동,'85,80 - 84세,1998,98,29,69
'1153079000,  수궁동,'90,85+ ,1998,71,12,59
'11545, 금천구,'00,계,1998,272276,139298,132978
'11545, 금천구,'05,0 - 4세,1998,19924,10311,9613
'11545, 금천구,'10,5 - 9세,1998,19516,10284,9232
'11545, 금천구,'15,10 - 14세,1998,17080,9082,7998
'11545, 금천구,'20,15 - 19세,1998,23216,12085,11131
'11545, 금천구,'25,20 - 24세,1998,24753,12248,12505
'11545, 금천구,'30,25 - 29세,1998,31401,16332,15069
'11545, 금천구,'35,30 - 34세,1998,28883,15447,13436
'11545, 금천구,'40,35 - 39세,1998,27297,14472,12825
'11545, 금천구,'45,40 - 44세,1998,21936,11133,10803
'11545, 금천구,'50,45 - 49세,1998,15888,8056,7832
'11545, 금천구,'55,50 - 54세,1998,13274,6712,6562
'11545, 금천구,'60,55 - 59세,1998,11183,5767,5416
'11545, 금천구,'65,60 - 64세,1998,7156,3496,3660
'11545, 금천구,'70,65 - 69세,1998,4346,1845,2501
'11545, 금천구,'75,70 - 74세,1998,2821,993,1828
'11545, 금천구,'80,75 - 79세,1998,1980,633,1347
'11545, 금천구,'85,80 - 84세,1998,1020,270,750
'11545, 금천구,'90,85+ ,1998,602,132,470
'1154551000,  가산동,'00,계,1998,22311,11926,10385
'1154551000,  가산동,'05,0 - 4세,1998,1493,783,710
'1154551000,  가산동,'10,5 - 9세,1998,1539,823,716
'1154551000,  가산동,'15,10 - 14세,1998,1298,668,630
'1154551000,  가산동,'20,15 - 19세,1998,1731,876,855
'1154551000,  가산동,'25,20 - 24세,1998,2173,1120,1053
'1154551000,  가산동,'30,25 - 29세,1998,2760,1549,1211
'1154551000,  가산동,'35,30 - 34세,1998,2600,1535,1065
'1154551000,  가산동,'40,35 - 39세,1998,2471,1397,1074
'1154551000,  가산동,'45,40 - 44세,1998,1876,1046,830
'1154551000,  가산동,'50,45 - 49세,1998,1288,678,610
'1154551000,  가산동,'55,50 - 54세,1998,1020,539,481
'1154551000,  가산동,'60,55 - 59세,1998,818,425,393
'1154551000,  가산동,'65,60 - 64세,1998,486,227,259
'1154551000,  가산동,'70,65 - 69세,1998,301,107,194
'1154551000,  가산동,'75,70 - 74세,1998,215,86,129
'1154551000,  가산동,'80,75 - 79세,1998,132,38,94
'1154551000,  가산동,'85,80 - 84세,1998,67,20,47
'1154551000,  가산동,'90,85+ ,1998,43,9,34
'1154561000,  독산1동,'00,계,1998,34115,17488,16627
'1154561000,  독산1동,'05,0 - 4세,1998,2111,1096,1015
'1154561000,  독산1동,'10,5 - 9세,1998,2319,1236,1083
'1154561000,  독산1동,'15,10 - 14세,1998,2215,1164,1051
'1154561000,  독산1동,'20,15 - 19세,1998,3026,1520,1506
'1154561000,  독산1동,'25,20 - 24세,1998,3564,1817,1747
'1154561000,  독산1동,'30,25 - 29세,1998,3886,2113,1773
'1154561000,  독산1동,'35,30 - 34세,1998,3258,1730,1528
'1154561000,  독산1동,'40,35 - 39세,1998,3215,1691,1524
'1154561000,  독산1동,'45,40 - 44세,1998,2736,1398,1338
'1154561000,  독산1동,'50,45 - 49세,1998,2068,1041,1027
'1154561000,  독산1동,'55,50 - 54세,1998,1778,859,919
'1154561000,  독산1동,'60,55 - 59세,1998,1640,842,798
'1154561000,  독산1동,'65,60 - 64세,1998,967,504,463
'1154561000,  독산1동,'70,65 - 69세,1998,550,249,301
'1154561000,  독산1동,'75,70 - 74세,1998,317,103,214
'1154561000,  독산1동,'80,75 - 79세,1998,251,80,171
'1154561000,  독산1동,'85,80 - 84세,1998,127,29,98
'1154561000,  독산1동,'90,85+ ,1998,87,16,71
'1154562000,  독산2동,'00,계,1998,28988,14680,14308
'1154562000,  독산2동,'05,0 - 4세,1998,2487,1258,1229
'1154562000,  독산2동,'10,5 - 9세,1998,2361,1224,1137
'1154562000,  독산2동,'15,10 - 14세,1998,1838,962,876
'1154562000,  독산2동,'20,15 - 19세,1998,2241,1182,1059
'1154562000,  독산2동,'25,20 - 24세,1998,2445,1121,1324
'1154562000,  독산2동,'30,25 - 29세,1998,3466,1721,1745
'1154562000,  독산2동,'35,30 - 34세,1998,3393,1797,1596
'1154562000,  독산2동,'40,35 - 39세,1998,3080,1655,1425
'1154562000,  독산2동,'45,40 - 44세,1998,2203,1142,1061
'1154562000,  독산2동,'50,45 - 49세,1998,1459,761,698
'1154562000,  독산2동,'55,50 - 54세,1998,1285,619,666
'1154562000,  독산2동,'60,55 - 59세,1998,1012,527,485
'1154562000,  독산2동,'65,60 - 64세,1998,697,331,366
'1154562000,  독산2동,'70,65 - 69세,1998,432,179,253
'1154562000,  독산2동,'75,70 - 74세,1998,255,91,164
'1154562000,  독산2동,'80,75 - 79세,1998,167,59,108
'1154562000,  독산2동,'85,80 - 84세,1998,108,38,70
'1154562000,  독산2동,'90,85+ ,1998,59,13,46
'1154563000,  독산3동,'00,계,1998,17518,8970,8548
'1154563000,  독산3동,'05,0 - 4세,1998,1316,703,613
'1154563000,  독산3동,'10,5 - 9세,1998,1219,655,564
'1154563000,  독산3동,'15,10 - 14세,1998,1049,568,481
'1154563000,  독산3동,'20,15 - 19세,1998,1443,757,686
'1154563000,  독산3동,'25,20 - 24세,1998,1611,796,815
'1154563000,  독산3동,'30,25 - 29세,1998,2156,1094,1062
'1154563000,  독산3동,'35,30 - 34세,1998,1913,1008,905
'1154563000,  독산3동,'40,35 - 39세,1998,1761,933,828
'1154563000,  독산3동,'45,40 - 44세,1998,1408,703,705
'1154563000,  독산3동,'50,45 - 49세,1998,997,493,504
'1154563000,  독산3동,'55,50 - 54세,1998,883,431,452
'1154563000,  독산3동,'60,55 - 59세,1998,721,402,319
'1154563000,  독산3동,'65,60 - 64세,1998,406,202,204
'1154563000,  독산3동,'70,65 - 69세,1998,262,108,154
'1154563000,  독산3동,'75,70 - 74세,1998,163,59,104
'1154563000,  독산3동,'80,75 - 79세,1998,111,26,85
'1154563000,  독산3동,'85,80 - 84세,1998,66,23,43
'1154563000,  독산3동,'90,85+ ,1998,33,9,24
'1154564000,  독산4동,'00,계,1998,22653,11668,10985
'1154564000,  독산4동,'05,0 - 4세,1998,1821,947,874
'1154564000,  독산4동,'10,5 - 9세,1998,1692,910,782
'1154564000,  독산4동,'15,10 - 14세,1998,1328,716,612
'1154564000,  독산4동,'20,15 - 19세,1998,1812,941,871
'1154564000,  독산4동,'25,20 - 24세,1998,2124,1024,1100
'1154564000,  독산4동,'30,25 - 29세,1998,2886,1490,1396
'1154564000,  독산4동,'35,30 - 34세,1998,2683,1444,1239
'1154564000,  독산4동,'40,35 - 39세,1998,2238,1227,1011
'1154564000,  독산4동,'45,40 - 44세,1998,1700,851,849
'1154564000,  독산4동,'50,45 - 49세,1998,1273,643,630
'1154564000,  독산4동,'55,50 - 54세,1998,1002,516,486
'1154564000,  독산4동,'60,55 - 59세,1998,839,447,392
'1154564000,  독산4동,'65,60 - 64세,1998,514,264,250
'1154564000,  독산4동,'70,65 - 69세,1998,276,117,159
'1154564000,  독산4동,'75,70 - 74세,1998,195,62,133
'1154564000,  독산4동,'80,75 - 79세,1998,152,44,108
'1154564000,  독산4동,'85,80 - 84세,1998,82,17,65
'1154564000,  독산4동,'90,85+ ,1998,36,8,28
'1154565000,  독산본동,'00,계,1998,18232,9284,8948
'1154565000,  독산본동,'05,0 - 4세,1998,1314,661,653
'1154565000,  독산본동,'10,5 - 9세,1998,1330,697,633
'1154565000,  독산본동,'15,10 - 14세,1998,1088,556,532
'1154565000,  독산본동,'20,15 - 19세,1998,1565,818,747
'1154565000,  독산본동,'25,20 - 24세,1998,1622,775,847
'1154565000,  독산본동,'30,25 - 29세,1998,2216,1155,1061
'1154565000,  독산본동,'35,30 - 34세,1998,2097,1123,974
'1154565000,  독산본동,'40,35 - 39세,1998,1914,1025,889
'1154565000,  독산본동,'45,40 - 44세,1998,1412,724,688
'1154565000,  독산본동,'50,45 - 49세,1998,1011,526,485
'1154565000,  독산본동,'55,50 - 54세,1998,848,434,414
'1154565000,  독산본동,'60,55 - 59세,1998,671,316,355
'1154565000,  독산본동,'65,60 - 64세,1998,483,229,254
'1154565000,  독산본동,'70,65 - 69세,1998,286,124,162
'1154565000,  독산본동,'75,70 - 74세,1998,174,65,109
'1154565000,  독산본동,'80,75 - 79세,1998,106,34,72
'1154565000,  독산본동,'85,80 - 84세,1998,59,16,43
'1154565000,  독산본동,'90,85+ ,1998,36,6,30
'1154566000,  시흥본동,'00,계,1998,26655,13519,13136
'1154566000,  시흥본동,'05,0 - 4세,1998,2007,985,1022
'1154566000,  시흥본동,'10,5 - 9세,1998,1818,964,854
'1154566000,  시흥본동,'15,10 - 14세,1998,1505,816,689
'1154566000,  시흥본동,'20,15 - 19세,1998,2145,1127,1018
'1154566000,  시흥본동,'25,20 - 24세,1998,2578,1266,1312
'1154566000,  시흥본동,'30,25 - 29세,1998,3404,1802,1602
'1154566000,  시흥본동,'35,30 - 34세,1998,2752,1486,1266
'1154566000,  시흥본동,'40,35 - 39세,1998,2515,1372,1143
'1154566000,  시흥본동,'45,40 - 44세,1998,1968,937,1031
'1154566000,  시흥본동,'50,45 - 49세,1998,1447,671,776
'1154566000,  시흥본동,'55,50 - 54세,1998,1460,720,740
'1154566000,  시흥본동,'60,55 - 59세,1998,1187,610,577
'1154566000,  시흥본동,'65,60 - 64세,1998,766,363,403
'1154566000,  시흥본동,'70,65 - 69세,1998,430,184,246
'1154566000,  시흥본동,'75,70 - 74세,1998,291,102,189
'1154566000,  시흥본동,'80,75 - 79세,1998,220,74,146
'1154566000,  시흥본동,'85,80 - 84세,1998,97,24,73
'1154566000,  시흥본동,'90,85+ ,1998,65,16,49
'1154567000,  시흥1동,'00,계,1998,18316,9349,8967
'1154567000,  시흥1동,'05,0 - 4세,1998,1335,691,644
'1154567000,  시흥1동,'10,5 - 9세,1998,1322,692,630
'1154567000,  시흥1동,'15,10 - 14세,1998,1340,766,574
'1154567000,  시흥1동,'20,15 - 19세,1998,1804,1052,752
'1154567000,  시흥1동,'25,20 - 24세,1998,1343,706,637
'1154567000,  시흥1동,'30,25 - 29세,1998,1791,831,960
'1154567000,  시흥1동,'35,30 - 34세,1998,1792,912,880
'1154567000,  시흥1동,'40,35 - 39세,1998,1961,956,1005
'1154567000,  시흥1동,'45,40 - 44세,1998,1750,843,907
'1154567000,  시흥1동,'50,45 - 49세,1998,1249,651,598
'1154567000,  시흥1동,'55,50 - 54세,1998,851,472,379
'1154567000,  시흥1동,'60,55 - 59세,1998,617,305,312
'1154567000,  시흥1동,'65,60 - 64세,1998,415,190,225
'1154567000,  시흥1동,'70,65 - 69세,1998,276,123,153
'1154567000,  시흥1동,'75,70 - 74세,1998,235,87,148
'1154567000,  시흥1동,'80,75 - 79세,1998,138,47,91
'1154567000,  시흥1동,'85,80 - 84세,1998,67,17,50
'1154567000,  시흥1동,'90,85+ ,1998,30,8,22
'1154568000,  시흥2동,'00,계,1998,11264,5614,5650
'1154568000,  시흥2동,'05,0 - 4세,1998,840,428,412
'1154568000,  시흥2동,'10,5 - 9세,1998,881,461,420
'1154568000,  시흥2동,'15,10 - 14세,1998,742,387,355
'1154568000,  시흥2동,'20,15 - 19세,1998,940,457,483
'1154568000,  시흥2동,'25,20 - 24세,1998,895,464,431
'1154568000,  시흥2동,'30,25 - 29세,1998,1071,535,536
'1154568000,  시흥2동,'35,30 - 34세,1998,1064,524,540
'1154568000,  시흥2동,'40,35 - 39세,1998,1168,590,578
'1154568000,  시흥2동,'45,40 - 44세,1998,952,504,448
'1154568000,  시흥2동,'50,45 - 49세,1998,656,324,332
'1154568000,  시흥2동,'55,50 - 54세,1998,574,297,277
'1154568000,  시흥2동,'60,55 - 59세,1998,531,274,257
'1154568000,  시흥2동,'65,60 - 64세,1998,354,176,178
'1154568000,  시흥2동,'70,65 - 69세,1998,219,95,124
'1154568000,  시흥2동,'75,70 - 74세,1998,141,43,98
'1154568000,  시흥2동,'80,75 - 79세,1998,134,33,101
'1154568000,  시흥2동,'85,80 - 84세,1998,61,13,48
'1154568000,  시흥2동,'90,85+ ,1998,41,9,32
'1154569000,  시흥3동,'00,계,1998,14904,7603,7301
'1154569000,  시흥3동,'05,0 - 4세,1998,891,460,431
'1154569000,  시흥3동,'10,5 - 9세,1998,901,452,449
'1154569000,  시흥3동,'15,10 - 14세,1998,986,528,458
'1154569000,  시흥3동,'20,15 - 19세,1998,1408,738,670
'1154569000,  시흥3동,'25,20 - 24세,1998,1311,670,641
'1154569000,  시흥3동,'30,25 - 29세,1998,1537,830,707
'1154569000,  시흥3동,'35,30 - 34세,1998,1329,752,577
'1154569000,  시흥3동,'40,35 - 39세,1998,1367,662,705
'1154569000,  시흥3동,'45,40 - 44세,1998,1310,651,659
'1154569000,  시흥3동,'50,45 - 49세,1998,1007,498,509
'1154569000,  시흥3동,'55,50 - 54세,1998,850,445,405
'1154569000,  시흥3동,'60,55 - 59세,1998,776,398,378
'1154569000,  시흥3동,'65,60 - 64세,1998,481,232,249
'1154569000,  시흥3동,'70,65 - 69세,1998,346,160,186
'1154569000,  시흥3동,'75,70 - 74세,1998,182,63,119
'1154569000,  시흥3동,'80,75 - 79세,1998,139,43,96
'1154569000,  시흥3동,'85,80 - 84세,1998,49,10,39
'1154569000,  시흥3동,'90,85+ ,1998,34,11,23
'1154570000,  시흥4동,'00,계,1998,28429,14486,13943
'1154570000,  시흥4동,'05,0 - 4세,1998,2289,1208,1081
'1154570000,  시흥4동,'10,5 - 9세,1998,2159,1125,1034
'1154570000,  시흥4동,'15,10 - 14세,1998,1774,958,816
'1154570000,  시흥4동,'20,15 - 19세,1998,2442,1254,1188
'1154570000,  시흥4동,'25,20 - 24세,1998,2517,1238,1279
'1154570000,  시흥4동,'30,25 - 29세,1998,3159,1611,1548
'1154570000,  시흥4동,'35,30 - 34세,1998,3148,1646,1502
'1154570000,  시흥4동,'40,35 - 39세,1998,2811,1482,1329
'1154570000,  시흥4동,'45,40 - 44세,1998,2230,1140,1090
'1154570000,  시흥4동,'50,45 - 49세,1998,1670,852,818
'1154570000,  시흥4동,'55,50 - 54세,1998,1310,669,641
'1154570000,  시흥4동,'60,55 - 59세,1998,1041,545,496
'1154570000,  시흥4동,'65,60 - 64세,1998,759,360,399
'1154570000,  시흥4동,'70,65 - 69세,1998,458,180,278
'1154570000,  시흥4동,'75,70 - 74세,1998,304,111,193
'1154570000,  시흥4동,'80,75 - 79세,1998,182,67,115
'1154570000,  시흥4동,'85,80 - 84세,1998,107,27,80
'1154570000,  시흥4동,'90,85+ ,1998,69,13,56
'1154571000,  시흥5동,'00,계,1998,28891,14711,14180
'1154571000,  시흥5동,'05,0 - 4세,1998,2020,1091,929
'1154571000,  시흥5동,'10,5 - 9세,1998,1975,1045,930
'1154571000,  시흥5동,'15,10 - 14세,1998,1917,993,924
'1154571000,  시흥5동,'20,15 - 19세,1998,2659,1363,1296
'1154571000,  시흥5동,'25,20 - 24세,1998,2570,1251,1319
'1154571000,  시흥5동,'30,25 - 29세,1998,3069,1601,1468
'1154571000,  시흥5동,'35,30 - 34세,1998,2854,1490,1364
'1154571000,  시흥5동,'40,35 - 39세,1998,2796,1482,1314
'1154571000,  시흥5동,'45,40 - 44세,1998,2391,1194,1197
'1154571000,  시흥5동,'50,45 - 49세,1998,1763,918,845
'1154571000,  시흥5동,'55,50 - 54세,1998,1413,711,702
'1154571000,  시흥5동,'60,55 - 59세,1998,1330,676,654
'1154571000,  시흥5동,'65,60 - 64세,1998,828,418,410
'1154571000,  시흥5동,'70,65 - 69세,1998,510,219,291
'1154571000,  시흥5동,'75,70 - 74세,1998,349,121,228
'1154571000,  시흥5동,'80,75 - 79세,1998,248,88,160
'1154571000,  시흥5동,'85,80 - 84세,1998,130,36,94
'1154571000,  시흥5동,'90,85+ ,1998,69,14,55
'11560, 영등포구,'00,계,1998,403380,203862,199518
'11560, 영등포구,'05,0 - 4세,1998,28412,14935,13477
'11560, 영등포구,'10,5 - 9세,1998,25644,13559,12085
'11560, 영등포구,'15,10 - 14세,1998,23283,12190,11093
'11560, 영등포구,'20,15 - 19세,1998,31899,16721,15178
'11560, 영등포구,'25,20 - 24세,1998,37081,17857,19224
'11560, 영등포구,'30,25 - 29세,1998,50360,25716,24644
'11560, 영등포구,'35,30 - 34세,1998,41179,22298,18881
'11560, 영등포구,'40,35 - 39세,1998,37156,19291,17865
'11560, 영등포구,'45,40 - 44세,1998,32102,16063,16039
'11560, 영등포구,'50,45 - 49세,1998,23957,11760,12197
'11560, 영등포구,'55,50 - 54세,1998,20762,10271,10491
'11560, 영등포구,'60,55 - 59세,1998,18957,9368,9589
'11560, 영등포구,'65,60 - 64세,1998,13205,6447,6758
'11560, 영등포구,'70,65 - 69세,1998,7992,3510,4482
'11560, 영등포구,'75,70 - 74세,1998,5081,1915,3166
'11560, 영등포구,'80,75 - 79세,1998,3460,1221,2239
'11560, 영등포구,'85,80 - 84세,1998,1749,478,1271
'11560, 영등포구,'90,85+ ,1998,1101,262,839
'1156051000,  영등포1동,'00,계,1998,8396,4311,4085
'1156051000,  영등포1동,'05,0 - 4세,1998,596,316,280
'1156051000,  영등포1동,'10,5 - 9세,1998,425,223,202
'1156051000,  영등포1동,'15,10 - 14세,1998,351,177,174
'1156051000,  영등포1동,'20,15 - 19세,1998,610,322,288
'1156051000,  영등포1동,'25,20 - 24세,1998,908,444,464
'1156051000,  영등포1동,'30,25 - 29세,1998,1203,654,549
'1156051000,  영등포1동,'35,30 - 34세,1998,880,505,375
'1156051000,  영등포1동,'40,35 - 39세,1998,684,390,294
'1156051000,  영등포1동,'45,40 - 44세,1998,602,286,316
'1156051000,  영등포1동,'50,45 - 49세,1998,487,234,253
'1156051000,  영등포1동,'55,50 - 54세,1998,459,225,234
'1156051000,  영등포1동,'60,55 - 59세,1998,430,208,222
'1156051000,  영등포1동,'65,60 - 64세,1998,306,142,164
'1156051000,  영등포1동,'70,65 - 69세,1998,179,71,108
'1156051000,  영등포1동,'75,70 - 74세,1998,131,59,72
'1156051000,  영등포1동,'80,75 - 79세,1998,89,39,50
'1156051000,  영등포1동,'85,80 - 84세,1998,37,11,26
'1156051000,  영등포1동,'90,85+ ,1998,19,5,14
'1156052000,  영등포2동,'00,계,1998,5596,2983,2613
'1156052000,  영등포2동,'05,0 - 4세,1998,208,115,93
'1156052000,  영등포2동,'10,5 - 9세,1998,193,96,97
'1156052000,  영등포2동,'15,10 - 14세,1998,241,149,92
'1156052000,  영등포2동,'20,15 - 19세,1998,451,227,224
'1156052000,  영등포2동,'25,20 - 24세,1998,534,298,236
'1156052000,  영등포2동,'30,25 - 29세,1998,590,344,246
'1156052000,  영등포2동,'35,30 - 34세,1998,392,237,155
'1156052000,  영등포2동,'40,35 - 39세,1998,443,251,192
'1156052000,  영등포2동,'45,40 - 44세,1998,507,278,229
'1156052000,  영등포2동,'50,45 - 49세,1998,426,211,215
'1156052000,  영등포2동,'55,50 - 54세,1998,423,209,214
'1156052000,  영등포2동,'60,55 - 59세,1998,415,215,200
'1156052000,  영등포2동,'65,60 - 64세,1998,295,153,142
'1156052000,  영등포2동,'70,65 - 69세,1998,179,76,103
'1156052000,  영등포2동,'75,70 - 74세,1998,144,59,85
'1156052000,  영등포2동,'80,75 - 79세,1998,82,35,47
'1156052000,  영등포2동,'85,80 - 84세,1998,44,16,28
'1156052000,  영등포2동,'90,85+ ,1998,29,14,15
'1156053000,  영등포3동,'00,계,1998,8809,4458,4351
'1156053000,  영등포3동,'05,0 - 4세,1998,511,266,245
'1156053000,  영등포3동,'10,5 - 9세,1998,500,276,224
'1156053000,  영등포3동,'15,10 - 14세,1998,463,221,242
'1156053000,  영등포3동,'20,15 - 19세,1998,657,340,317
'1156053000,  영등포3동,'25,20 - 24세,1998,783,397,386
'1156053000,  영등포3동,'30,25 - 29세,1998,1025,578,447
'1156053000,  영등포3동,'35,30 - 34세,1998,783,392,391
'1156053000,  영등포3동,'40,35 - 39세,1998,762,398,364
'1156053000,  영등포3동,'45,40 - 44세,1998,685,352,333
'1156053000,  영등포3동,'50,45 - 49세,1998,553,269,284
'1156053000,  영등포3동,'55,50 - 54세,1998,557,264,293
'1156053000,  영등포3동,'60,55 - 59세,1998,550,278,272
'1156053000,  영등포3동,'65,60 - 64세,1998,374,174,200
'1156053000,  영등포3동,'70,65 - 69세,1998,274,131,143
'1156053000,  영등포3동,'75,70 - 74세,1998,160,63,97
'1156053000,  영등포3동,'80,75 - 79세,1998,85,30,55
'1156053000,  영등포3동,'85,80 - 84세,1998,53,17,36
'1156053000,  영등포3동,'90,85+ ,1998,34,12,22
'1156054000,  여의동,'00,계,1998,31249,15307,15942
'1156054000,  여의동,'05,0 - 4세,1998,1380,738,642
'1156054000,  여의동,'10,5 - 9세,1998,1615,867,748
'1156054000,  여의동,'15,10 - 14세,1998,2160,1173,987
'1156054000,  여의동,'20,15 - 19세,1998,3189,1710,1479
'1156054000,  여의동,'25,20 - 24세,1998,2747,1392,1355
'1156054000,  여의동,'30,25 - 29세,1998,3275,1627,1648
'1156054000,  여의동,'35,30 - 34세,1998,2191,1078,1113
'1156054000,  여의동,'40,35 - 39세,1998,2339,1041,1298
'1156054000,  여의동,'45,40 - 44세,1998,2816,1176,1640
'1156054000,  여의동,'50,45 - 49세,1998,2343,1111,1232
'1156054000,  여의동,'55,50 - 54세,1998,2163,1016,1147
'1156054000,  여의동,'60,55 - 59세,1998,1822,906,916
'1156054000,  여의동,'65,60 - 64세,1998,1285,697,588
'1156054000,  여의동,'70,65 - 69세,1998,720,362,358
'1156054000,  여의동,'75,70 - 74세,1998,483,205,278
'1156054000,  여의동,'80,75 - 79세,1998,352,123,229
'1156054000,  여의동,'85,80 - 84세,1998,208,48,160
'1156054000,  여의동,'90,85+ ,1998,161,37,124
'1156055000,  당산1동,'00,계,1998,21495,10474,11021
'1156055000,  당산1동,'05,0 - 4세,1998,1326,676,650
'1156055000,  당산1동,'10,5 - 9세,1998,1226,645,581
'1156055000,  당산1동,'15,10 - 14세,1998,1025,541,484
'1156055000,  당산1동,'20,15 - 19세,1998,1679,837,842
'1156055000,  당산1동,'25,20 - 24세,1998,2440,985,1455
'1156055000,  당산1동,'30,25 - 29세,1998,2741,1339,1402
'1156055000,  당산1동,'35,30 - 34세,1998,1956,1057,899
'1156055000,  당산1동,'40,35 - 39세,1998,1745,916,829
'1156055000,  당산1동,'45,40 - 44세,1998,1638,801,837
'1156055000,  당산1동,'50,45 - 49세,1998,1321,620,701
'1156055000,  당산1동,'55,50 - 54세,1998,1201,575,626
'1156055000,  당산1동,'60,55 - 59세,1998,1185,602,583
'1156055000,  당산1동,'65,60 - 64세,1998,851,422,429
'1156055000,  당산1동,'70,65 - 69세,1998,470,215,255
'1156055000,  당산1동,'75,70 - 74세,1998,304,105,199
'1156055000,  당산1동,'80,75 - 79세,1998,233,99,134
'1156055000,  당산1동,'85,80 - 84세,1998,88,26,62
'1156055000,  당산1동,'90,85+ ,1998,66,13,53
'1156056000,  당산2동,'00,계,1998,24463,12287,12176
'1156056000,  당산2동,'05,0 - 4세,1998,1532,815,717
'1156056000,  당산2동,'10,5 - 9세,1998,1522,839,683
'1156056000,  당산2동,'15,10 - 14세,1998,1476,797,679
'1156056000,  당산2동,'20,15 - 19세,1998,1769,889,880
'1156056000,  당산2동,'25,20 - 24세,1998,2131,1043,1088
'1156056000,  당산2동,'30,25 - 29세,1998,2924,1502,1422
'1156056000,  당산2동,'35,30 - 34세,1998,2291,1210,1081
'1156056000,  당산2동,'40,35 - 39세,1998,2174,1091,1083
'1156056000,  당산2동,'45,40 - 44세,1998,1942,968,974
'1156056000,  당산2동,'50,45 - 49세,1998,1514,712,802
'1156056000,  당산2동,'55,50 - 54세,1998,1417,704,713
'1156056000,  당산2동,'60,55 - 59세,1998,1304,635,669
'1156056000,  당산2동,'65,60 - 64세,1998,972,493,479
'1156056000,  당산2동,'70,65 - 69세,1998,607,275,332
'1156056000,  당산2동,'75,70 - 74세,1998,387,152,235
'1156056000,  당산2동,'80,75 - 79세,1998,272,93,179
'1156056000,  당산2동,'85,80 - 84세,1998,149,41,108
'1156056000,  당산2동,'90,85+ ,1998,80,28,52
'1156057000,  도림1동,'00,계,1998,10475,5394,5081
'1156057000,  도림1동,'05,0 - 4세,1998,777,408,369
'1156057000,  도림1동,'10,5 - 9세,1998,701,376,325
'1156057000,  도림1동,'15,10 - 14세,1998,565,297,268
'1156057000,  도림1동,'20,15 - 19세,1998,768,397,371
'1156057000,  도림1동,'25,20 - 24세,1998,967,473,494
'1156057000,  도림1동,'30,25 - 29세,1998,1501,764,737
'1156057000,  도림1동,'35,30 - 34세,1998,1176,670,506
'1156057000,  도림1동,'40,35 - 39세,1998,1014,549,465
'1156057000,  도림1동,'45,40 - 44세,1998,747,393,354
'1156057000,  도림1동,'50,45 - 49세,1998,567,291,276
'1156057000,  도림1동,'55,50 - 54세,1998,482,242,240
'1156057000,  도림1동,'60,55 - 59세,1998,453,216,237
'1156057000,  도림1동,'65,60 - 64세,1998,310,156,154
'1156057000,  도림1동,'70,65 - 69세,1998,188,81,107
'1156057000,  도림1동,'75,70 - 74세,1998,107,38,69
'1156057000,  도림1동,'80,75 - 79세,1998,86,28,58
'1156057000,  도림1동,'85,80 - 84세,1998,44,9,35
'1156057000,  도림1동,'90,85+ ,1998,22,6,16
'1156058000,  도림2동,'00,계,1998,12528,6484,6044
'1156058000,  도림2동,'05,0 - 4세,1998,981,516,465
'1156058000,  도림2동,'10,5 - 9세,1998,697,376,321
'1156058000,  도림2동,'15,10 - 14세,1998,601,299,302
'1156058000,  도림2동,'20,15 - 19세,1998,988,508,480
'1156058000,  도림2동,'25,20 - 24세,1998,1208,607,601
'1156058000,  도림2동,'30,25 - 29세,1998,1815,941,874
'1156058000,  도림2동,'35,30 - 34세,1998,1441,851,590
'1156058000,  도림2동,'40,35 - 39세,1998,1059,589,470
'1156058000,  도림2동,'45,40 - 44세,1998,872,467,405
'1156058000,  도림2동,'50,45 - 49세,1998,687,359,328
'1156058000,  도림2동,'55,50 - 54세,1998,588,278,310
'1156058000,  도림2동,'60,55 - 59세,1998,582,269,313
'1156058000,  도림2동,'65,60 - 64세,1998,432,214,218
'1156058000,  도림2동,'70,65 - 69세,1998,236,101,135
'1156058000,  도림2동,'75,70 - 74세,1998,158,50,108
'1156058000,  도림2동,'80,75 - 79세,1998,102,40,62
'1156058000,  도림2동,'85,80 - 84세,1998,51,12,39
'1156058000,  도림2동,'90,85+ ,1998,30,7,23
'1156059000,  문래1동,'00,계,1998,6290,3182,3108
'1156059000,  문래1동,'05,0 - 4세,1998,420,222,198
'1156059000,  문래1동,'10,5 - 9세,1998,394,212,182
'1156059000,  문래1동,'15,10 - 14세,1998,340,175,165
'1156059000,  문래1동,'20,15 - 19세,1998,485,258,227
'1156059000,  문래1동,'25,20 - 24세,1998,505,224,281
'1156059000,  문래1동,'30,25 - 29세,1998,676,353,323
'1156059000,  문래1동,'35,30 - 34세,1998,613,319,294
'1156059000,  문래1동,'40,35 - 39세,1998,575,318,257
'1156059000,  문래1동,'45,40 - 44세,1998,453,224,229
'1156059000,  문래1동,'50,45 - 49세,1998,370,190,180
'1156059000,  문래1동,'55,50 - 54세,1998,364,178,186
'1156059000,  문래1동,'60,55 - 59세,1998,400,189,211
'1156059000,  문래1동,'65,60 - 64세,1998,270,143,127
'1156059000,  문래1동,'70,65 - 69세,1998,163,71,92
'1156059000,  문래1동,'75,70 - 74세,1998,128,52,76
'1156059000,  문래1동,'80,75 - 79세,1998,85,37,48
'1156059000,  문래1동,'85,80 - 84세,1998,30,12,18
'1156059000,  문래1동,'90,85+ ,1998,19,5,14
'1156060000,  문래2동,'00,계,1998,12238,6293,5945
'1156060000,  문래2동,'05,0 - 4세,1998,896,497,399
'1156060000,  문래2동,'10,5 - 9세,1998,903,495,408
'1156060000,  문래2동,'15,10 - 14세,1998,878,461,417
'1156060000,  문래2동,'20,15 - 19세,1998,957,526,431
'1156060000,  문래2동,'25,20 - 24세,1998,888,466,422
'1156060000,  문래2동,'30,25 - 29세,1998,1185,571,614
'1156060000,  문래2동,'35,30 - 34세,1998,1263,647,616
'1156060000,  문래2동,'40,35 - 39세,1998,1300,661,639
'1156060000,  문래2동,'45,40 - 44세,1998,1124,585,539
'1156060000,  문래2동,'50,45 - 49세,1998,771,426,345
'1156060000,  문래2동,'55,50 - 54세,1998,607,305,302
'1156060000,  문래2동,'60,55 - 59세,1998,499,251,248
'1156060000,  문래2동,'65,60 - 64세,1998,370,183,187
'1156060000,  문래2동,'70,65 - 69세,1998,232,103,129
'1156060000,  문래2동,'75,70 - 74세,1998,162,52,110
'1156060000,  문래2동,'80,75 - 79세,1998,115,40,75
'1156060000,  문래2동,'85,80 - 84세,1998,56,16,40
'1156060000,  문래2동,'90,85+ ,1998,32,8,24
'1156061000,  양평1동,'00,계,1998,14720,7560,7160
'1156061000,  양평1동,'05,0 - 4세,1998,1086,561,525
'1156061000,  양평1동,'10,5 - 9세,1998,825,457,368
'1156061000,  양평1동,'15,10 - 14세,1998,761,377,384
'1156061000,  양평1동,'20,15 - 19세,1998,1133,599,534
'1156061000,  양평1동,'25,20 - 24세,1998,1357,711,646
'1156061000,  양평1동,'30,25 - 29세,1998,1816,945,871
'1156061000,  양평1동,'35,30 - 34세,1998,1592,881,711
'1156061000,  양평1동,'40,35 - 39세,1998,1296,708,588
'1156061000,  양평1동,'45,40 - 44세,1998,1172,575,597
'1156061000,  양평1동,'50,45 - 49세,1998,902,433,469
'1156061000,  양평1동,'55,50 - 54세,1998,797,406,391
'1156061000,  양평1동,'60,55 - 59세,1998,715,362,353
'1156061000,  양평1동,'65,60 - 64세,1998,516,255,261
'1156061000,  양평1동,'70,65 - 69세,1998,316,128,188
'1156061000,  양평1동,'75,70 - 74세,1998,215,83,132
'1156061000,  양평1동,'80,75 - 79세,1998,125,52,73
'1156061000,  양평1동,'85,80 - 84세,1998,62,18,44
'1156061000,  양평1동,'90,85+ ,1998,34,9,25
'1156062000,  양평2동,'00,계,1998,15070,7745,7325
'1156062000,  양평2동,'05,0 - 4세,1998,1122,603,519
'1156062000,  양평2동,'10,5 - 9세,1998,1174,610,564
'1156062000,  양평2동,'15,10 - 14세,1998,1047,542,505
'1156062000,  양평2동,'20,15 - 19세,1998,1063,565,498
'1156062000,  양평2동,'25,20 - 24세,1998,1093,547,546
'1156062000,  양평2동,'30,25 - 29세,1998,1574,812,762
'1156062000,  양평2동,'35,30 - 34세,1998,1564,814,750
'1156062000,  양평2동,'40,35 - 39세,1998,1699,868,831
'1156062000,  양평2동,'45,40 - 44세,1998,1384,770,614
'1156062000,  양평2동,'50,45 - 49세,1998,871,450,421
'1156062000,  양평2동,'55,50 - 54세,1998,707,373,334
'1156062000,  양평2동,'60,55 - 59세,1998,623,303,320
'1156062000,  양평2동,'65,60 - 64세,1998,462,231,231
'1156062000,  양평2동,'70,65 - 69세,1998,280,118,162
'1156062000,  양평2동,'75,70 - 74세,1998,179,71,108
'1156062000,  양평2동,'80,75 - 79세,1998,130,41,89
'1156062000,  양평2동,'85,80 - 84세,1998,64,21,43
'1156062000,  양평2동,'90,85+ ,1998,34,6,28
'1156063000,  신길1동,'00,계,1998,24481,12260,12221
'1156063000,  신길1동,'05,0 - 4세,1998,1755,920,835
'1156063000,  신길1동,'10,5 - 9세,1998,1387,716,671
'1156063000,  신길1동,'15,10 - 14세,1998,1203,604,599
'1156063000,  신길1동,'20,15 - 19세,1998,1781,944,837
'1156063000,  신길1동,'25,20 - 24세,1998,2373,1120,1253
'1156063000,  신길1동,'30,25 - 29세,1998,3596,1834,1762
'1156063000,  신길1동,'35,30 - 34세,1998,2575,1447,1128
'1156063000,  신길1동,'40,35 - 39세,1998,2119,1110,1009
'1156063000,  신길1동,'45,40 - 44세,1998,1793,879,914
'1156063000,  신길1동,'50,45 - 49세,1998,1324,630,694
'1156063000,  신길1동,'55,50 - 54세,1998,1256,604,652
'1156063000,  신길1동,'60,55 - 59세,1998,1225,577,648
'1156063000,  신길1동,'65,60 - 64세,1998,845,389,456
'1156063000,  신길1동,'70,65 - 69세,1998,535,241,294
'1156063000,  신길1동,'75,70 - 74세,1998,342,140,202
'1156063000,  신길1동,'80,75 - 79세,1998,198,67,131
'1156063000,  신길1동,'85,80 - 84세,1998,104,24,80
'1156063000,  신길1동,'90,85+ ,1998,70,14,56
'1156064000,  신길2동,'00,계,1998,12652,6357,6295
'1156064000,  신길2동,'05,0 - 4세,1998,757,398,359
'1156064000,  신길2동,'10,5 - 9세,1998,689,348,341
'1156064000,  신길2동,'15,10 - 14세,1998,706,361,345
'1156064000,  신길2동,'20,15 - 19세,1998,1095,589,506
'1156064000,  신길2동,'25,20 - 24세,1998,1270,576,694
'1156064000,  신길2동,'30,25 - 29세,1998,1606,857,749
'1156064000,  신길2동,'35,30 - 34세,1998,1156,656,500
'1156064000,  신길2동,'40,35 - 39세,1998,1110,540,570
'1156064000,  신길2동,'45,40 - 44세,1998,1080,544,536
'1156064000,  신길2동,'50,45 - 49세,1998,794,388,406
'1156064000,  신길2동,'55,50 - 54세,1998,654,327,327
'1156064000,  신길2동,'60,55 - 59세,1998,628,310,318
'1156064000,  신길2동,'65,60 - 64세,1998,434,198,236
'1156064000,  신길2동,'70,65 - 69세,1998,276,127,149
'1156064000,  신길2동,'75,70 - 74세,1998,171,68,103
'1156064000,  신길2동,'80,75 - 79세,1998,140,50,90
'1156064000,  신길2동,'85,80 - 84세,1998,54,10,44
'1156064000,  신길2동,'90,85+ ,1998,32,10,22
'1156065000,  신길3동,'00,계,1998,24767,12391,12376
'1156065000,  신길3동,'05,0 - 4세,1998,1817,952,865
'1156065000,  신길3동,'10,5 - 9세,1998,1705,923,782
'1156065000,  신길3동,'15,10 - 14세,1998,1578,811,767
'1156065000,  신길3동,'20,15 - 19세,1998,2044,1067,977
'1156065000,  신길3동,'25,20 - 24세,1998,2185,1022,1163
'1156065000,  신길3동,'30,25 - 29세,1998,2873,1436,1437
'1156065000,  신길3동,'35,30 - 34세,1998,2551,1340,1211
'1156065000,  신길3동,'40,35 - 39세,1998,2365,1201,1164
'1156065000,  신길3동,'45,40 - 44세,1998,2048,1014,1034
'1156065000,  신길3동,'50,45 - 49세,1998,1463,740,723
'1156065000,  신길3동,'55,50 - 54세,1998,1169,585,584
'1156065000,  신길3동,'60,55 - 59세,1998,1109,519,590
'1156065000,  신길3동,'65,60 - 64세,1998,787,389,398
'1156065000,  신길3동,'70,65 - 69세,1998,459,191,268
'1156065000,  신길3동,'75,70 - 74세,1998,281,101,180
'1156065000,  신길3동,'80,75 - 79세,1998,178,59,119
'1156065000,  신길3동,'85,80 - 84세,1998,94,27,67
'1156065000,  신길3동,'90,85+ ,1998,61,14,47
'1156066000,  신길4동,'00,계,1998,13400,6726,6674
'1156066000,  신길4동,'05,0 - 4세,1998,765,396,369
'1156066000,  신길4동,'10,5 - 9세,1998,914,451,463
'1156066000,  신길4동,'15,10 - 14세,1998,852,431,421
'1156066000,  신길4동,'20,15 - 19세,1998,1156,602,554
'1156066000,  신길4동,'25,20 - 24세,1998,1262,598,664
'1156066000,  신길4동,'30,25 - 29세,1998,1571,837,734
'1156066000,  신길4동,'35,30 - 34세,1998,1262,670,592
'1156066000,  신길4동,'40,35 - 39세,1998,1255,653,602
'1156066000,  신길4동,'45,40 - 44세,1998,1099,554,545
'1156066000,  신길4동,'50,45 - 49세,1998,809,423,386
'1156066000,  신길4동,'55,50 - 54세,1998,694,340,354
'1156066000,  신길4동,'60,55 - 59세,1998,646,300,346
'1156066000,  신길4동,'65,60 - 64세,1998,474,220,254
'1156066000,  신길4동,'70,65 - 69세,1998,285,127,158
'1156066000,  신길4동,'75,70 - 74세,1998,172,66,106
'1156066000,  신길4동,'80,75 - 79세,1998,110,36,74
'1156066000,  신길4동,'85,80 - 84세,1998,46,16,30
'1156066000,  신길4동,'90,85+ ,1998,28,6,22
'1156067000,  신길5동,'00,계,1998,22431,11446,10985
'1156067000,  신길5동,'05,0 - 4세,1998,1676,869,807
'1156067000,  신길5동,'10,5 - 9세,1998,1410,752,658
'1156067000,  신길5동,'15,10 - 14세,1998,1315,715,600
'1156067000,  신길5동,'20,15 - 19세,1998,1821,939,882
'1156067000,  신길5동,'25,20 - 24세,1998,2176,1081,1095
'1156067000,  신길5동,'30,25 - 29세,1998,2856,1518,1338
'1156067000,  신길5동,'35,30 - 34세,1998,2316,1242,1074
'1156067000,  신길5동,'40,35 - 39세,1998,2056,1094,962
'1156067000,  신길5동,'45,40 - 44세,1998,1766,880,886
'1156067000,  신길5동,'50,45 - 49세,1998,1295,639,656
'1156067000,  신길5동,'55,50 - 54세,1998,1023,506,517
'1156067000,  신길5동,'60,55 - 59세,1998,1035,518,517
'1156067000,  신길5동,'65,60 - 64세,1998,690,320,370
'1156067000,  신길5동,'70,65 - 69세,1998,431,188,243
'1156067000,  신길5동,'75,70 - 74세,1998,234,91,143
'1156067000,  신길5동,'80,75 - 79세,1998,182,69,113
'1156067000,  신길5동,'85,80 - 84세,1998,96,21,75
'1156067000,  신길5동,'90,85+ ,1998,53,4,49
'1156068000,  신길6동,'00,계,1998,30327,15310,15017
'1156068000,  신길6동,'05,0 - 4세,1998,2201,1161,1040
'1156068000,  신길6동,'10,5 - 9세,1998,2163,1151,1012
'1156068000,  신길6동,'15,10 - 14세,1998,1777,913,864
'1156068000,  신길6동,'20,15 - 19세,1998,2568,1333,1235
'1156068000,  신길6동,'25,20 - 24세,1998,2527,1295,1232
'1156068000,  신길6동,'30,25 - 29세,1998,3420,1745,1675
'1156068000,  신길6동,'35,30 - 34세,1998,3055,1600,1455
'1156068000,  신길6동,'40,35 - 39세,1998,3003,1519,1484
'1156068000,  신길6동,'45,40 - 44세,1998,2579,1280,1299
'1156068000,  신길6동,'50,45 - 49세,1998,1923,982,941
'1156068000,  신길6동,'55,50 - 54세,1998,1495,760,735
'1156068000,  신길6동,'60,55 - 59세,1998,1291,636,655
'1156068000,  신길6동,'65,60 - 64세,1998,914,404,510
'1156068000,  신길6동,'70,65 - 69세,1998,589,253,336
'1156068000,  신길6동,'75,70 - 74세,1998,360,129,231
'1156068000,  신길6동,'80,75 - 79세,1998,250,83,167
'1156068000,  신길6동,'85,80 - 84세,1998,129,41,88
'1156068000,  신길6동,'90,85+ ,1998,83,25,58
'1156069000,  신길7동,'00,계,1998,20564,10421,10143
'1156069000,  신길7동,'05,0 - 4세,1998,1763,945,818
'1156069000,  신길7동,'10,5 - 9세,1998,1376,733,643
'1156069000,  신길7동,'15,10 - 14세,1998,1255,651,604
'1156069000,  신길7동,'20,15 - 19세,1998,1564,826,738
'1156069000,  신길7동,'25,20 - 24세,1998,1662,815,847
'1156069000,  신길7동,'30,25 - 29세,1998,2589,1227,1362
'1156069000,  신길7동,'35,30 - 34세,1998,2361,1305,1056
'1156069000,  신길7동,'40,35 - 39세,1998,1951,994,957
'1156069000,  신길7동,'45,40 - 44세,1998,1726,904,822
'1156069000,  신길7동,'50,45 - 49세,1998,1143,574,569
'1156069000,  신길7동,'55,50 - 54세,1998,925,469,456
'1156069000,  신길7동,'60,55 - 59세,1998,830,416,414
'1156069000,  신길7동,'65,60 - 64세,1998,592,276,316
'1156069000,  신길7동,'70,65 - 69세,1998,357,137,220
'1156069000,  신길7동,'75,70 - 74세,1998,214,79,135
'1156069000,  신길7동,'80,75 - 79세,1998,140,47,93
'1156069000,  신길7동,'85,80 - 84세,1998,70,16,54
'1156069000,  신길7동,'90,85+ ,1998,46,7,39
'1156070000,  대림1동,'00,계,1998,21787,11027,10760
'1156070000,  대림1동,'05,0 - 4세,1998,1675,872,803
'1156070000,  대림1동,'10,5 - 9세,1998,1355,716,639
'1156070000,  대림1동,'15,10 - 14세,1998,1078,584,494
'1156070000,  대림1동,'20,15 - 19세,1998,1799,990,809
'1156070000,  대림1동,'25,20 - 24세,1998,2241,1061,1180
'1156070000,  대림1동,'30,25 - 29세,1998,2888,1478,1410
'1156070000,  대림1동,'35,30 - 34세,1998,2358,1255,1103
'1156070000,  대림1동,'40,35 - 39세,1998,1926,1019,907
'1156070000,  대림1동,'45,40 - 44세,1998,1615,809,806
'1156070000,  대림1동,'50,45 - 49세,1998,1290,598,692
'1156070000,  대림1동,'55,50 - 54세,1998,1099,553,546
'1156070000,  대림1동,'60,55 - 59세,1998,964,498,466
'1156070000,  대림1동,'65,60 - 64세,1998,605,295,310
'1156070000,  대림1동,'70,65 - 69세,1998,379,136,243
'1156070000,  대림1동,'75,70 - 74세,1998,211,81,130
'1156070000,  대림1동,'80,75 - 79세,1998,164,43,121
'1156070000,  대림1동,'85,80 - 84세,1998,86,25,61
'1156070000,  대림1동,'90,85+ ,1998,54,14,40
'1156071000,  대림2동,'00,계,1998,25242,12931,12311
'1156071000,  대림2동,'05,0 - 4세,1998,2041,1086,955
'1156071000,  대림2동,'10,5 - 9세,1998,1671,866,805
'1156071000,  대림2동,'15,10 - 14세,1998,1242,645,597
'1156071000,  대림2동,'20,15 - 19세,1998,1784,921,863
'1156071000,  대림2동,'25,20 - 24세,1998,2663,1190,1473
'1156071000,  대림2동,'30,25 - 29세,1998,4041,2088,1953
'1156071000,  대림2동,'35,30 - 34세,1998,3056,1776,1280
'1156071000,  대림2동,'40,35 - 39세,1998,2320,1293,1027
'1156071000,  대림2동,'45,40 - 44세,1998,1631,836,795
'1156071000,  대림2동,'50,45 - 49세,1998,1223,570,653
'1156071000,  대림2동,'55,50 - 54세,1998,1136,544,592
'1156071000,  대림2동,'60,55 - 59세,1998,1014,536,478
'1156071000,  대림2동,'65,60 - 64세,1998,579,286,293
'1156071000,  대림2동,'70,65 - 69세,1998,358,161,197
'1156071000,  대림2동,'75,70 - 74세,1998,208,60,148
'1156071000,  대림2동,'80,75 - 79세,1998,144,44,100
'1156071000,  대림2동,'85,80 - 84세,1998,73,22,51
'1156071000,  대림2동,'90,85+ ,1998,58,7,51
'1156072000,  대림3동,'00,계,1998,36400,18515,17885
'1156072000,  대림3동,'05,0 - 4세,1998,3127,1603,1524
'1156072000,  대림3동,'10,5 - 9세,1998,2799,1431,1368
'1156072000,  대림3동,'15,10 - 14세,1998,2369,1266,1103
'1156072000,  대림3동,'20,15 - 19세,1998,2538,1332,1206
'1156072000,  대림3동,'25,20 - 24세,1998,3161,1512,1649
'1156072000,  대림3동,'30,25 - 29세,1998,4595,2266,2329
'1156072000,  대림3동,'35,30 - 34세,1998,4347,2346,2001
'1156072000,  대림3동,'40,35 - 39세,1998,3961,2088,1873
'1156072000,  대림3동,'45,40 - 44세,1998,2823,1488,1335
'1156072000,  대림3동,'50,45 - 49세,1998,1881,910,971
'1156072000,  대림3동,'55,50 - 54세,1998,1546,808,738
'1156072000,  대림3동,'60,55 - 59세,1998,1237,624,613
'1156072000,  대림3동,'65,60 - 64세,1998,842,407,435
'1156072000,  대림3동,'70,65 - 69세,1998,479,217,262
'1156072000,  대림3동,'75,70 - 74세,1998,330,111,219
'1156072000,  대림3동,'80,75 - 79세,1998,198,66,132
'1156072000,  대림3동,'85,80 - 84세,1998,111,29,82
'1156072000,  대림3동,'90,85+ ,1998,56,11,45
'11590, 동작구,'00,계,1998,424636,213756,210880
'11590, 동작구,'05,0 - 4세,1998,29803,15633,14170
'11590, 동작구,'10,5 - 9세,1998,25339,13403,11936
'11590, 동작구,'15,10 - 14세,1998,22363,11710,10653
'11590, 동작구,'20,15 - 19세,1998,32784,17143,15641
'11590, 동작구,'25,20 - 24세,1998,40403,20017,20386
'11590, 동작구,'30,25 - 29세,1998,56952,29533,27419
'11590, 동작구,'35,30 - 34세,1998,42647,22938,19709
'11590, 동작구,'40,35 - 39세,1998,36426,18657,17769
'11590, 동작구,'45,40 - 44세,1998,31495,15412,16083
'11590, 동작구,'50,45 - 49세,1998,24624,11658,12966
'11590, 동작구,'55,50 - 54세,1998,23228,10919,12309
'11590, 동작구,'60,55 - 59세,1998,21734,10917,10817
'11590, 동작구,'65,60 - 64세,1998,15162,7426,7736
'11590, 동작구,'70,65 - 69세,1998,8866,4020,4846
'11590, 동작구,'75,70 - 74세,1998,5495,2215,3280
'11590, 동작구,'80,75 - 79세,1998,3936,1322,2614
'11590, 동작구,'85,80 - 84세,1998,2058,545,1513
'11590, 동작구,'90,85+ ,1998,1321,288,1033
'1159051000,  노량진1동,'00,계,1998,17822,9018,8804
'1159051000,  노량진1동,'05,0 - 4세,1998,1131,600,531
'1159051000,  노량진1동,'10,5 - 9세,1998,1026,519,507
'1159051000,  노량진1동,'15,10 - 14세,1998,919,477,442
'1159051000,  노량진1동,'20,15 - 19세,1998,1360,687,673
'1159051000,  노량진1동,'25,20 - 24세,1998,1714,855,859
'1159051000,  노량진1동,'30,25 - 29세,1998,2507,1365,1142
'1159051000,  노량진1동,'35,30 - 34세,1998,1727,964,763
'1159051000,  노량진1동,'40,35 - 39세,1998,1542,794,748
'1159051000,  노량진1동,'45,40 - 44세,1998,1324,667,657
'1159051000,  노량진1동,'50,45 - 49세,1998,1010,452,558
'1159051000,  노량진1동,'55,50 - 54세,1998,988,473,515
'1159051000,  노량진1동,'60,55 - 59세,1998,948,482,466
'1159051000,  노량진1동,'65,60 - 64세,1998,666,306,360
'1159051000,  노량진1동,'70,65 - 69세,1998,389,183,206
'1159051000,  노량진1동,'75,70 - 74세,1998,239,93,146
'1159051000,  노량진1동,'80,75 - 79세,1998,162,51,111
'1159051000,  노량진1동,'85,80 - 84세,1998,109,33,76
'1159051000,  노량진1동,'90,85+ ,1998,61,17,44
'1159052000,  노량진2동,'00,계,1998,21969,11109,10860
'1159052000,  노량진2동,'05,0 - 4세,1998,1544,790,754
'1159052000,  노량진2동,'10,5 - 9세,1998,1396,731,665
'1159052000,  노량진2동,'15,10 - 14세,1998,1043,535,508
'1159052000,  노량진2동,'20,15 - 19세,1998,1509,827,682
'1159052000,  노량진2동,'25,20 - 24세,1998,2192,1045,1147
'1159052000,  노량진2동,'30,25 - 29세,1998,3286,1732,1554
'1159052000,  노량진2동,'35,30 - 34세,1998,2414,1364,1050
'1159052000,  노량진2동,'40,35 - 39세,1998,1900,1014,886
'1159052000,  노량진2동,'45,40 - 44세,1998,1481,712,769
'1159052000,  노량진2동,'50,45 - 49세,1998,1170,538,632
'1159052000,  노량진2동,'55,50 - 54세,1998,1089,499,590
'1159052000,  노량진2동,'60,55 - 59세,1998,1088,524,564
'1159052000,  노량진2동,'65,60 - 64세,1998,755,360,395
'1159052000,  노량진2동,'70,65 - 69세,1998,499,220,279
'1159052000,  노량진2동,'75,70 - 74세,1998,271,117,154
'1159052000,  노량진2동,'80,75 - 79세,1998,183,66,117
'1159052000,  노량진2동,'85,80 - 84세,1998,88,22,66
'1159052000,  노량진2동,'90,85+ ,1998,61,13,48
'1159053000,  상도1동,'00,계,1998,16375,8167,8208
'1159053000,  상도1동,'05,0 - 4세,1998,982,493,489
'1159053000,  상도1동,'10,5 - 9세,1998,1091,553,538
'1159053000,  상도1동,'15,10 - 14세,1998,1005,507,498
'1159053000,  상도1동,'20,15 - 19세,1998,1332,682,650
'1159053000,  상도1동,'25,20 - 24세,1998,1364,710,654
'1159053000,  상도1동,'30,25 - 29세,1998,1918,1033,885
'1159053000,  상도1동,'35,30 - 34세,1998,1482,800,682
'1159053000,  상도1동,'40,35 - 39세,1998,1506,729,777
'1159053000,  상도1동,'45,40 - 44세,1998,1278,652,626
'1159053000,  상도1동,'50,45 - 49세,1998,913,458,455
'1159053000,  상도1동,'55,50 - 54세,1998,900,396,504
'1159053000,  상도1동,'60,55 - 59세,1998,884,443,441
'1159053000,  상도1동,'65,60 - 64세,1998,651,281,370
'1159053000,  상도1동,'70,65 - 69세,1998,421,193,228
'1159053000,  상도1동,'75,70 - 74세,1998,271,126,145
'1159053000,  상도1동,'80,75 - 79세,1998,228,76,152
'1159053000,  상도1동,'85,80 - 84세,1998,92,23,69
'1159053000,  상도1동,'90,85+ ,1998,57,12,45
'1159054000,  상도2동,'00,계,1998,25929,12931,12998
'1159054000,  상도2동,'05,0 - 4세,1998,1741,905,836
'1159054000,  상도2동,'10,5 - 9세,1998,1554,818,736
'1159054000,  상도2동,'15,10 - 14세,1998,1369,715,654
'1159054000,  상도2동,'20,15 - 19세,1998,1979,1005,974
'1159054000,  상도2동,'25,20 - 24세,1998,2383,1171,1212
'1159054000,  상도2동,'30,25 - 29세,1998,3170,1669,1501
'1159054000,  상도2동,'35,30 - 34세,1998,2488,1298,1190
'1159054000,  상도2동,'40,35 - 39세,1998,2262,1196,1066
'1159054000,  상도2동,'45,40 - 44세,1998,1892,896,996
'1159054000,  상도2동,'50,45 - 49세,1998,1574,739,835
'1159054000,  상도2동,'55,50 - 54세,1998,1516,722,794
'1159054000,  상도2동,'60,55 - 59세,1998,1406,684,722
'1159054000,  상도2동,'65,60 - 64세,1998,1037,503,534
'1159054000,  상도2동,'70,65 - 69세,1998,613,264,349
'1159054000,  상도2동,'75,70 - 74세,1998,401,175,226
'1159054000,  상도2동,'80,75 - 79세,1998,292,107,185
'1159054000,  상도2동,'85,80 - 84세,1998,151,37,114
'1159054000,  상도2동,'90,85+ ,1998,101,27,74
'1159055000,  상도3동,'00,계,1998,23230,11762,11468
'1159055000,  상도3동,'05,0 - 4세,1998,1689,929,760
'1159055000,  상도3동,'10,5 - 9세,1998,1432,747,685
'1159055000,  상도3동,'15,10 - 14세,1998,1215,638,577
'1159055000,  상도3동,'20,15 - 19세,1998,1744,935,809
'1159055000,  상도3동,'25,20 - 24세,1998,2129,1092,1037
'1159055000,  상도3동,'30,25 - 29세,1998,3110,1562,1548
'1159055000,  상도3동,'35,30 - 34세,1998,2388,1261,1127
'1159055000,  상도3동,'40,35 - 39세,1998,2008,1051,957
'1159055000,  상도3동,'45,40 - 44세,1998,1736,860,876
'1159055000,  상도3동,'50,45 - 49세,1998,1238,587,651
'1159055000,  상도3동,'55,50 - 54세,1998,1219,585,634
'1159055000,  상도3동,'60,55 - 59세,1998,1251,603,648
'1159055000,  상도3동,'65,60 - 64세,1998,886,424,462
'1159055000,  상도3동,'70,65 - 69세,1998,509,254,255
'1159055000,  상도3동,'75,70 - 74세,1998,308,131,177
'1159055000,  상도3동,'80,75 - 79세,1998,180,60,120
'1159055000,  상도3동,'85,80 - 84세,1998,105,30,75
'1159055000,  상도3동,'90,85+ ,1998,83,13,70
'1159056000,  상도4동,'00,계,1998,32993,16637,16356
'1159056000,  상도4동,'05,0 - 4세,1998,2671,1404,1267
'1159056000,  상도4동,'10,5 - 9세,1998,2255,1204,1051
'1159056000,  상도4동,'15,10 - 14세,1998,1889,943,946
'1159056000,  상도4동,'20,15 - 19세,1998,2474,1285,1189
'1159056000,  상도4동,'25,20 - 24세,1998,2848,1439,1409
'1159056000,  상도4동,'30,25 - 29세,1998,4063,2046,2017
'1159056000,  상도4동,'35,30 - 34세,1998,3441,1792,1649
'1159056000,  상도4동,'40,35 - 39세,1998,3139,1634,1505
'1159056000,  상도4동,'45,40 - 44세,1998,2477,1270,1207
'1159056000,  상도4동,'50,45 - 49세,1998,1805,881,924
'1159056000,  상도4동,'55,50 - 54세,1998,1629,774,855
'1159056000,  상도4동,'60,55 - 59세,1998,1567,793,774
'1159056000,  상도4동,'65,60 - 64세,1998,1137,523,614
'1159056000,  상도4동,'70,65 - 69세,1998,721,356,365
'1159056000,  상도4동,'75,70 - 74세,1998,388,161,227
'1159056000,  상도4동,'80,75 - 79세,1998,259,83,176
'1159056000,  상도4동,'85,80 - 84세,1998,131,34,97
'1159056000,  상도4동,'90,85+ ,1998,99,15,84
'1159056100,  상도5동,'00,계,1998,20555,10333,10222
'1159056100,  상도5동,'05,0 - 4세,1998,1372,743,629
'1159056100,  상도5동,'10,5 - 9세,1998,1265,648,617
'1159056100,  상도5동,'15,10 - 14세,1998,1113,577,536
'1159056100,  상도5동,'20,15 - 19세,1998,1468,726,742
'1159056100,  상도5동,'25,20 - 24세,1998,1800,927,873
'1159056100,  상도5동,'30,25 - 29세,1998,2556,1374,1182
'1159056100,  상도5동,'35,30 - 34세,1998,1989,1073,916
'1159056100,  상도5동,'40,35 - 39세,1998,1854,945,909
'1159056100,  상도5동,'45,40 - 44세,1998,1544,772,772
'1159056100,  상도5동,'50,45 - 49세,1998,1145,554,591
'1159056100,  상도5동,'55,50 - 54세,1998,1136,520,616
'1159056100,  상도5동,'60,55 - 59세,1998,1092,548,544
'1159056100,  상도5동,'65,60 - 64세,1998,880,414,466
'1159056100,  상도5동,'70,65 - 69세,1998,548,239,309
'1159056100,  상도5동,'75,70 - 74세,1998,351,128,223
'1159056100,  상도5동,'80,75 - 79세,1998,235,86,149
'1159056100,  상도5동,'85,80 - 84세,1998,124,35,89
'1159056100,  상도5동,'90,85+ ,1998,83,24,59
'1159057000,  본동,'00,계,1998,14470,7332,7138
'1159057000,  본동,'05,0 - 4세,1998,962,513,449
'1159057000,  본동,'10,5 - 9세,1998,864,465,399
'1159057000,  본동,'15,10 - 14세,1998,719,380,339
'1159057000,  본동,'20,15 - 19세,1998,1073,533,540
'1159057000,  본동,'25,20 - 24세,1998,1254,634,620
'1159057000,  본동,'30,25 - 29세,1998,1851,1015,836
'1159057000,  본동,'35,30 - 34세,1998,1451,810,641
'1159057000,  본동,'40,35 - 39세,1998,1319,663,656
'1159057000,  본동,'45,40 - 44세,1998,1120,575,545
'1159057000,  본동,'50,45 - 49세,1998,840,413,427
'1159057000,  본동,'55,50 - 54세,1998,778,370,408
'1159057000,  본동,'60,55 - 59세,1998,767,355,412
'1159057000,  본동,'65,60 - 64세,1998,603,276,327
'1159057000,  본동,'70,65 - 69세,1998,344,149,195
'1159057000,  본동,'75,70 - 74세,1998,228,87,141
'1159057000,  본동,'80,75 - 79세,1998,176,61,115
'1159057000,  본동,'85,80 - 84세,1998,82,22,60
'1159057000,  본동,'90,85+ ,1998,39,11,28
'1159058000,  흑석1동,'00,계,1998,16600,8482,8118
'1159058000,  흑석1동,'05,0 - 4세,1998,992,492,500
'1159058000,  흑석1동,'10,5 - 9세,1998,918,489,429
'1159058000,  흑석1동,'15,10 - 14세,1998,761,386,375
'1159058000,  흑석1동,'20,15 - 19세,1998,1193,633,560
'1159058000,  흑석1동,'25,20 - 24세,1998,1792,909,883
'1159058000,  흑석1동,'30,25 - 29세,1998,2601,1529,1072
'1159058000,  흑석1동,'35,30 - 34세,1998,1592,880,712
'1159058000,  흑석1동,'40,35 - 39세,1998,1362,709,653
'1159058000,  흑석1동,'45,40 - 44세,1998,1111,552,559
'1159058000,  흑석1동,'50,45 - 49세,1998,858,400,458
'1159058000,  흑석1동,'55,50 - 54세,1998,827,354,473
'1159058000,  흑석1동,'60,55 - 59세,1998,928,438,490
'1159058000,  흑석1동,'65,60 - 64세,1998,652,321,331
'1159058000,  흑석1동,'70,65 - 69세,1998,396,167,229
'1159058000,  흑석1동,'75,70 - 74세,1998,259,107,152
'1159058000,  흑석1동,'80,75 - 79세,1998,197,72,125
'1159058000,  흑석1동,'85,80 - 84세,1998,97,30,67
'1159058000,  흑석1동,'90,85+ ,1998,64,14,50
'1159059000,  흑석2동,'00,계,1998,15317,7608,7709
'1159059000,  흑석2동,'05,0 - 4세,1998,1044,566,478
'1159059000,  흑석2동,'10,5 - 9세,1998,872,446,426
'1159059000,  흑석2동,'15,10 - 14세,1998,702,380,322
'1159059000,  흑석2동,'20,15 - 19세,1998,1131,578,553
'1159059000,  흑석2동,'25,20 - 24세,1998,1372,668,704
'1159059000,  흑석2동,'30,25 - 29세,1998,2054,1023,1031
'1159059000,  흑석2동,'35,30 - 34세,1998,1498,782,716
'1159059000,  흑석2동,'40,35 - 39세,1998,1239,629,610
'1159059000,  흑석2동,'45,40 - 44세,1998,1057,533,524
'1159059000,  흑석2동,'50,45 - 49세,1998,906,403,503
'1159059000,  흑석2동,'55,50 - 54세,1998,905,434,471
'1159059000,  흑석2동,'60,55 - 59세,1998,928,436,492
'1159059000,  흑석2동,'65,60 - 64세,1998,659,326,333
'1159059000,  흑석2동,'70,65 - 69세,1998,402,196,206
'1159059000,  흑석2동,'75,70 - 74세,1998,234,97,137
'1159059000,  흑석2동,'80,75 - 79세,1998,171,63,108
'1159059000,  흑석2동,'85,80 - 84세,1998,93,34,59
'1159059000,  흑석2동,'90,85+ ,1998,50,14,36
'1159060000,  흑석3동,'00,계,1998,12309,6259,6050
'1159060000,  흑석3동,'05,0 - 4세,1998,817,409,408
'1159060000,  흑석3동,'10,5 - 9세,1998,645,330,315
'1159060000,  흑석3동,'15,10 - 14세,1998,534,278,256
'1159060000,  흑석3동,'20,15 - 19세,1998,957,485,472
'1159060000,  흑석3동,'25,20 - 24세,1998,1167,628,539
'1159060000,  흑석3동,'30,25 - 29세,1998,1775,988,787
'1159060000,  흑석3동,'35,30 - 34세,1998,1293,719,574
'1159060000,  흑석3동,'40,35 - 39세,1998,967,506,461
'1159060000,  흑석3동,'45,40 - 44세,1998,807,394,413
'1159060000,  흑석3동,'50,45 - 49세,1998,714,355,359
'1159060000,  흑석3동,'55,50 - 54세,1998,646,289,357
'1159060000,  흑석3동,'60,55 - 59세,1998,702,322,380
'1159060000,  흑석3동,'65,60 - 64세,1998,565,287,278
'1159060000,  흑석3동,'70,65 - 69세,1998,314,141,173
'1159060000,  흑석3동,'75,70 - 74세,1998,179,63,116
'1159060000,  흑석3동,'80,75 - 79세,1998,137,47,90
'1159060000,  흑석3동,'85,80 - 84세,1998,53,13,40
'1159060000,  흑석3동,'90,85+ ,1998,37,5,32
'1159061000,  동작동,'00,계,1998,21721,10915,10806
'1159061000,  동작동,'05,0 - 4세,1998,1456,749,707
'1159061000,  동작동,'10,5 - 9세,1998,1101,597,504
'1159061000,  동작동,'15,10 - 14세,1998,1036,530,506
'1159061000,  동작동,'20,15 - 19세,1998,1691,891,800
'1159061000,  동작동,'25,20 - 24세,1998,2280,1136,1144
'1159061000,  동작동,'30,25 - 29세,1998,3244,1679,1565
'1159061000,  동작동,'35,30 - 34세,1998,2094,1122,972
'1159061000,  동작동,'40,35 - 39세,1998,1713,905,808
'1159061000,  동작동,'45,40 - 44세,1998,1514,711,803
'1159061000,  동작동,'50,45 - 49세,1998,1320,579,741
'1159061000,  동작동,'55,50 - 54세,1998,1315,612,703
'1159061000,  동작동,'60,55 - 59세,1998,1222,660,562
'1159061000,  동작동,'65,60 - 64세,1998,756,373,383
'1159061000,  동작동,'70,65 - 69세,1998,387,176,211
'1159061000,  동작동,'75,70 - 74세,1998,246,95,151
'1159061000,  동작동,'80,75 - 79세,1998,189,59,130
'1159061000,  동작동,'85,80 - 84세,1998,92,27,65
'1159061000,  동작동,'90,85+ ,1998,65,14,51
'1159062000,  사당1동,'00,계,1998,26169,13094,13075
'1159062000,  사당1동,'05,0 - 4세,1998,1988,1029,959
'1159062000,  사당1동,'10,5 - 9세,1998,1341,725,616
'1159062000,  사당1동,'15,10 - 14세,1998,1083,555,528
'1159062000,  사당1동,'20,15 - 19세,1998,1919,1008,911
'1159062000,  사당1동,'25,20 - 24세,1998,2948,1373,1575
'1159062000,  사당1동,'30,25 - 29세,1998,4425,2253,2172
'1159062000,  사당1동,'35,30 - 34세,1998,2830,1544,1286
'1159062000,  사당1동,'40,35 - 39세,1998,1936,1015,921
'1159062000,  사당1동,'45,40 - 44세,1998,1642,756,886
'1159062000,  사당1동,'50,45 - 49세,1998,1525,708,817
'1159062000,  사당1동,'55,50 - 54세,1998,1441,672,769
'1159062000,  사당1동,'60,55 - 59세,1998,1290,672,618
'1159062000,  사당1동,'65,60 - 64세,1998,745,392,353
'1159062000,  사당1동,'70,65 - 69세,1998,426,188,238
'1159062000,  사당1동,'75,70 - 74세,1998,261,109,152
'1159062000,  사당1동,'80,75 - 79세,1998,192,59,133
'1159062000,  사당1동,'85,80 - 84세,1998,105,19,86
'1159062000,  사당1동,'90,85+ ,1998,72,17,55
'1159063000,  사당2동,'00,계,1998,14311,7149,7162
'1159063000,  사당2동,'05,0 - 4세,1998,1118,584,534
'1159063000,  사당2동,'10,5 - 9세,1998,787,428,359
'1159063000,  사당2동,'15,10 - 14세,1998,685,338,347
'1159063000,  사당2동,'20,15 - 19세,1998,973,517,456
'1159063000,  사당2동,'25,20 - 24세,1998,1303,668,635
'1159063000,  사당2동,'30,25 - 29세,1998,2020,958,1062
'1159063000,  사당2동,'35,30 - 34세,1998,1529,840,689
'1159063000,  사당2동,'40,35 - 39세,1998,1104,567,537
'1159063000,  사당2동,'45,40 - 44세,1998,1062,511,551
'1159063000,  사당2동,'50,45 - 49세,1998,888,399,489
'1159063000,  사당2동,'55,50 - 54세,1998,870,399,471
'1159063000,  사당2동,'60,55 - 59세,1998,790,423,367
'1159063000,  사당2동,'65,60 - 64세,1998,521,282,239
'1159063000,  사당2동,'70,65 - 69세,1998,260,113,147
'1159063000,  사당2동,'75,70 - 74세,1998,163,57,106
'1159063000,  사당2동,'80,75 - 79세,1998,123,38,85
'1159063000,  사당2동,'85,80 - 84세,1998,74,20,54
'1159063000,  사당2동,'90,85+ ,1998,41,7,34
'1159064000,  사당3동,'00,계,1998,31166,15678,15488
'1159064000,  사당3동,'05,0 - 4세,1998,2140,1146,994
'1159064000,  사당3동,'10,5 - 9세,1998,1935,1015,920
'1159064000,  사당3동,'15,10 - 14세,1998,1752,913,839
'1159064000,  사당3동,'20,15 - 19세,1998,2565,1318,1247
'1159064000,  사당3동,'25,20 - 24세,1998,2997,1464,1533
'1159064000,  사당3동,'30,25 - 29세,1998,3914,2029,1885
'1159064000,  사당3동,'35,30 - 34세,1998,3007,1586,1421
'1159064000,  사당3동,'40,35 - 39세,1998,2622,1312,1310
'1159064000,  사당3동,'45,40 - 44세,1998,2411,1185,1226
'1159064000,  사당3동,'50,45 - 49세,1998,1901,915,986
'1159064000,  사당3동,'55,50 - 54세,1998,1781,852,929
'1159064000,  사당3동,'60,55 - 59세,1998,1676,858,818
'1159064000,  사당3동,'65,60 - 64세,1998,1044,529,515
'1159064000,  사당3동,'70,65 - 69세,1998,570,280,290
'1159064000,  사당3동,'75,70 - 74세,1998,371,155,216
'1159064000,  사당3동,'80,75 - 79세,1998,257,83,174
'1159064000,  사당3동,'85,80 - 84세,1998,134,27,107
'1159064000,  사당3동,'90,85+ ,1998,89,11,78
'1159065000,  사당4동,'00,계,1998,17044,8607,8437
'1159065000,  사당4동,'05,0 - 4세,1998,1287,688,599
'1159065000,  사당4동,'10,5 - 9세,1998,975,504,471
'1159065000,  사당4동,'15,10 - 14세,1998,813,455,358
'1159065000,  사당4동,'20,15 - 19세,1998,1435,749,686
'1159065000,  사당4동,'25,20 - 24세,1998,1749,827,922
'1159065000,  사당4동,'30,25 - 29세,1998,2299,1195,1104
'1159065000,  사당4동,'35,30 - 34세,1998,1724,920,804
'1159065000,  사당4동,'40,35 - 39세,1998,1398,719,679
'1159065000,  사당4동,'45,40 - 44세,1998,1242,604,638
'1159065000,  사당4동,'50,45 - 49세,1998,990,458,532
'1159065000,  사당4동,'55,50 - 54세,1998,1004,479,525
'1159065000,  사당4동,'60,55 - 59세,1998,877,458,419
'1159065000,  사당4동,'65,60 - 64세,1998,534,284,250
'1159065000,  사당4동,'70,65 - 69세,1998,280,125,155
'1159065000,  사당4동,'75,70 - 74세,1998,176,62,114
'1159065000,  사당4동,'80,75 - 79세,1998,147,51,96
'1159065000,  사당4동,'85,80 - 84세,1998,68,16,52
'1159065000,  사당4동,'90,85+ ,1998,46,13,33
'1159065100,  사당5동,'00,계,1998,14115,7190,6925
'1159065100,  사당5동,'05,0 - 4세,1998,1015,535,480
'1159065100,  사당5동,'10,5 - 9세,1998,916,493,423
'1159065100,  사당5동,'15,10 - 14세,1998,725,389,336
'1159065100,  사당5동,'20,15 - 19세,1998,1226,641,585
'1159065100,  사당5동,'25,20 - 24세,1998,1318,672,646
'1159065100,  사당5동,'30,25 - 29세,1998,1765,897,868
'1159065100,  사당5동,'35,30 - 34세,1998,1481,802,679
'1159065100,  사당5동,'40,35 - 39세,1998,1223,629,594
'1159065100,  사당5동,'45,40 - 44세,1998,1094,520,574
'1159065100,  사당5동,'50,45 - 49세,1998,864,437,427
'1159065100,  사당5동,'55,50 - 54세,1998,755,366,389
'1159065100,  사당5동,'60,55 - 59세,1998,623,320,303
'1159065100,  사당5동,'65,60 - 64세,1998,466,242,224
'1159065100,  사당5동,'70,65 - 69세,1998,268,123,145
'1159065100,  사당5동,'75,70 - 74세,1998,148,55,93
'1159065100,  사당5동,'80,75 - 79세,1998,112,40,72
'1159065100,  사당5동,'85,80 - 84세,1998,75,20,55
'1159065100,  사당5동,'90,85+ ,1998,41,9,32
'1159066000,  대방동,'00,계,1998,37113,18632,18481
'1159066000,  대방동,'05,0 - 4세,1998,2408,1278,1130
'1159066000,  대방동,'10,5 - 9세,1998,2183,1187,996
'1159066000,  대방동,'15,10 - 14세,1998,2275,1262,1013
'1159066000,  대방동,'20,15 - 19세,1998,3379,1827,1552
'1159066000,  대방동,'25,20 - 24세,1998,3695,1882,1813
'1159066000,  대방동,'30,25 - 29세,1998,4257,2114,2143
'1159066000,  대방동,'35,30 - 34세,1998,3348,1767,1581
'1159066000,  대방동,'40,35 - 39세,1998,3161,1534,1627
'1159066000,  대방동,'45,40 - 44세,1998,3197,1500,1697
'1159066000,  대방동,'50,45 - 49세,1998,2422,1134,1288
'1159066000,  대방동,'55,50 - 54세,1998,2060,984,1076
'1159066000,  대방동,'60,55 - 59세,1998,1675,864,811
'1159066000,  대방동,'65,60 - 64세,1998,1195,595,600
'1159066000,  대방동,'70,65 - 69세,1998,719,314,405
'1159066000,  대방동,'75,70 - 74세,1998,491,199,292
'1159066000,  대방동,'80,75 - 79세,1998,343,108,235
'1159066000,  대방동,'85,80 - 84세,1998,186,56,130
'1159066000,  대방동,'90,85+ ,1998,119,27,92
'1159067000,  신대방1동,'00,계,1998,25901,13017,12884
'1159067000,  신대방1동,'05,0 - 4세,1998,2022,1060,962
'1159067000,  신대방1동,'10,5 - 9세,1998,1560,852,708
'1159067000,  신대방1동,'15,10 - 14세,1998,1563,842,721
'1159067000,  신대방1동,'20,15 - 19세,1998,1868,993,875
'1159067000,  신대방1동,'25,20 - 24세,1998,2291,1044,1247
'1159067000,  신대방1동,'30,25 - 29세,1998,3699,1845,1854
'1159067000,  신대방1동,'35,30 - 34세,1998,2845,1512,1333
'1159067000,  신대방1동,'40,35 - 39세,1998,2347,1179,1168
'1159067000,  신대방1동,'45,40 - 44세,1998,2027,1014,1013
'1159067000,  신대방1동,'50,45 - 49세,1998,1397,721,676
'1159067000,  신대방1동,'55,50 - 54세,1998,1271,586,685
'1159067000,  신대방1동,'60,55 - 59세,1998,1106,555,551
'1159067000,  신대방1동,'65,60 - 64세,1998,799,403,396
'1159067000,  신대방1동,'70,65 - 69세,1998,469,197,272
'1159067000,  신대방1동,'75,70 - 74세,1998,280,107,173
'1159067000,  신대방1동,'80,75 - 79세,1998,189,64,125
'1159067000,  신대방1동,'85,80 - 84세,1998,119,30,89
'1159067000,  신대방1동,'90,85+ ,1998,49,13,36
'1159068000,  신대방2동,'00,계,1998,19527,9836,9691
'1159068000,  신대방2동,'05,0 - 4세,1998,1424,720,704
'1159068000,  신대방2동,'10,5 - 9세,1998,1223,652,571
'1159068000,  신대방2동,'15,10 - 14세,1998,1162,610,552
'1159068000,  신대방2동,'20,15 - 19세,1998,1508,823,685
'1159068000,  신대방2동,'25,20 - 24세,1998,1807,873,934
'1159068000,  신대방2동,'30,25 - 29세,1998,2438,1227,1211
'1159068000,  신대방2동,'35,30 - 34세,1998,2026,1102,924
'1159068000,  신대방2동,'40,35 - 39세,1998,1824,927,897
'1159068000,  신대방2동,'45,40 - 44세,1998,1479,728,751
'1159068000,  신대방2동,'50,45 - 49세,1998,1144,527,617
'1159068000,  신대방2동,'55,50 - 54세,1998,1098,553,545
'1159068000,  신대방2동,'60,55 - 59세,1998,914,479,435
'1159068000,  신대방2동,'65,60 - 64세,1998,611,305,306
'1159068000,  신대방2동,'70,65 - 69세,1998,331,142,189
'1159068000,  신대방2동,'75,70 - 74세,1998,230,91,139
'1159068000,  신대방2동,'80,75 - 79세,1998,164,48,116
'1159068000,  신대방2동,'85,80 - 84세,1998,80,17,63
'1159068000,  신대방2동,'90,85+ ,1998,64,12,52
'11620, 관악구,'00,계,1998,525729,267308,258421
'11620, 관악구,'05,0 - 4세,1998,35948,18642,17306
'11620, 관악구,'10,5 - 9세,1998,29983,15816,14167
'11620, 관악구,'15,10 - 14세,1998,27830,14769,13061
'11620, 관악구,'20,15 - 19세,1998,43350,22390,20960
'11620, 관악구,'25,20 - 24세,1998,53167,26094,27073
'11620, 관악구,'30,25 - 29세,1998,73955,39258,34697
'11620, 관악구,'35,30 - 34세,1998,53947,29867,24080
'11620, 관악구,'40,35 - 39세,1998,44271,22910,21361
'11620, 관악구,'45,40 - 44세,1998,38346,18675,19671
'11620, 관악구,'50,45 - 49세,1998,31421,15155,16266
'11620, 관악구,'55,50 - 54세,1998,28674,13718,14956
'11620, 관악구,'60,55 - 59세,1998,25882,13335,12547
'11620, 관악구,'65,60 - 64세,1998,16334,8377,7957
'11620, 관악구,'70,65 - 69세,1998,9230,4100,5130
'11620, 관악구,'75,70 - 74세,1998,5593,2025,3568
'11620, 관악구,'80,75 - 79세,1998,4153,1294,2859
'11620, 관악구,'85,80 - 84세,1998,2214,558,1656
'11620, 관악구,'90,85+ ,1998,1431,325,1106
'1162051000,  봉천본동,'00,계,1998,10434,5318,5116
'1162051000,  봉천본동,'05,0 - 4세,1998,670,356,314
'1162051000,  봉천본동,'10,5 - 9세,1998,575,300,275
'1162051000,  봉천본동,'15,10 - 14세,1998,508,288,220
'1162051000,  봉천본동,'20,15 - 19세,1998,812,407,405
'1162051000,  봉천본동,'25,20 - 24세,1998,1112,546,566
'1162051000,  봉천본동,'30,25 - 29세,1998,1425,758,667
'1162051000,  봉천본동,'35,30 - 34세,1998,1014,567,447
'1162051000,  봉천본동,'40,35 - 39세,1998,836,442,394
'1162051000,  봉천본동,'45,40 - 44세,1998,721,354,367
'1162051000,  봉천본동,'50,45 - 49세,1998,625,307,318
'1162051000,  봉천본동,'55,50 - 54세,1998,622,281,341
'1162051000,  봉천본동,'60,55 - 59세,1998,612,310,302
'1162051000,  봉천본동,'65,60 - 64세,1998,407,220,187
'1162051000,  봉천본동,'70,65 - 69세,1998,210,96,114
'1162051000,  봉천본동,'75,70 - 74세,1998,109,46,63
'1162051000,  봉천본동,'80,75 - 79세,1998,83,25,58
'1162051000,  봉천본동,'85,80 - 84세,1998,50,9,41
'1162051000,  봉천본동,'90,85+ ,1998,43,6,37
'1162052000,  봉천1동,'00,계,1998,29393,14748,14645
'1162052000,  봉천1동,'05,0 - 4세,1998,2136,1089,1047
'1162052000,  봉천1동,'10,5 - 9세,1998,1878,981,897
'1162052000,  봉천1동,'15,10 - 14세,1998,1769,930,839
'1162052000,  봉천1동,'20,15 - 19세,1998,2416,1224,1192
'1162052000,  봉천1동,'25,20 - 24세,1998,2660,1280,1380
'1162052000,  봉천1동,'30,25 - 29세,1998,3791,1925,1866
'1162052000,  봉천1동,'35,30 - 34세,1998,3011,1584,1427
'1162052000,  봉천1동,'40,35 - 39세,1998,2681,1357,1324
'1162052000,  봉천1동,'45,40 - 44세,1998,2270,1159,1111
'1162052000,  봉천1동,'50,45 - 49세,1998,1675,819,856
'1162052000,  봉천1동,'55,50 - 54세,1998,1546,748,798
'1162052000,  봉천1동,'60,55 - 59세,1998,1418,731,687
'1162052000,  봉천1동,'65,60 - 64세,1998,876,456,420
'1162052000,  봉천1동,'70,65 - 69세,1998,516,242,274
'1162052000,  봉천1동,'75,70 - 74세,1998,343,110,233
'1162052000,  봉천1동,'80,75 - 79세,1998,218,74,144
'1162052000,  봉천1동,'85,80 - 84세,1998,108,22,86
'1162052000,  봉천1동,'90,85+ ,1998,81,17,64
'1162053000,  봉천2동,'00,계,1998,8470,4289,4181
'1162053000,  봉천2동,'05,0 - 4세,1998,442,225,217
'1162053000,  봉천2동,'10,5 - 9세,1998,407,197,210
'1162053000,  봉천2동,'15,10 - 14세,1998,467,256,211
'1162053000,  봉천2동,'20,15 - 19세,1998,775,387,388
'1162053000,  봉천2동,'25,20 - 24세,1998,926,474,452
'1162053000,  봉천2동,'30,25 - 29세,1998,1004,549,455
'1162053000,  봉천2동,'35,30 - 34세,1998,699,389,310
'1162053000,  봉천2동,'40,35 - 39세,1998,644,329,315
'1162053000,  봉천2동,'45,40 - 44세,1998,668,318,350
'1162053000,  봉천2동,'50,45 - 49세,1998,586,279,307
'1162053000,  봉천2동,'55,50 - 54세,1998,544,262,282
'1162053000,  봉천2동,'60,55 - 59세,1998,533,269,264
'1162053000,  봉천2동,'65,60 - 64세,1998,329,174,155
'1162053000,  봉천2동,'70,65 - 69세,1998,195,92,103
'1162053000,  봉천2동,'75,70 - 74세,1998,98,43,55
'1162053000,  봉천2동,'80,75 - 79세,1998,80,28,52
'1162053000,  봉천2동,'85,80 - 84세,1998,50,12,38
'1162053000,  봉천2동,'90,85+ ,1998,23,6,17
'1162054000,  봉천3동,'00,계,1998,19471,9856,9615
'1162054000,  봉천3동,'05,0 - 4세,1998,1155,618,537
'1162054000,  봉천3동,'10,5 - 9세,1998,1182,632,550
'1162054000,  봉천3동,'15,10 - 14세,1998,1076,563,513
'1162054000,  봉천3동,'20,15 - 19세,1998,1619,820,799
'1162054000,  봉천3동,'25,20 - 24세,1998,1835,960,875
'1162054000,  봉천3동,'30,25 - 29세,1998,2199,1173,1026
'1162054000,  봉천3동,'35,30 - 34세,1998,1740,918,822
'1162054000,  봉천3동,'40,35 - 39세,1998,1752,935,817
'1162054000,  봉천3동,'45,40 - 44세,1998,1503,756,747
'1162054000,  봉천3동,'50,45 - 49세,1998,1255,621,634
'1162054000,  봉천3동,'55,50 - 54세,1998,1173,541,632
'1162054000,  봉천3동,'60,55 - 59세,1998,1088,552,536
'1162054000,  봉천3동,'65,60 - 64세,1998,791,379,412
'1162054000,  봉천3동,'70,65 - 69세,1998,467,179,288
'1162054000,  봉천3동,'75,70 - 74세,1998,276,100,176
'1162054000,  봉천3동,'80,75 - 79세,1998,213,71,142
'1162054000,  봉천3동,'85,80 - 84세,1998,90,24,66
'1162054000,  봉천3동,'90,85+ ,1998,57,14,43
'1162055000,  봉천4동,'00,계,1998,17029,8590,8439
'1162055000,  봉천4동,'05,0 - 4세,1998,1060,551,509
'1162055000,  봉천4동,'10,5 - 9세,1998,893,484,409
'1162055000,  봉천4동,'15,10 - 14세,1998,787,374,413
'1162055000,  봉천4동,'20,15 - 19세,1998,1352,669,683
'1162055000,  봉천4동,'25,20 - 24세,1998,1924,940,984
'1162055000,  봉천4동,'30,25 - 29세,1998,2688,1483,1205
'1162055000,  봉천4동,'35,30 - 34세,1998,1684,914,770
'1162055000,  봉천4동,'40,35 - 39세,1998,1409,713,696
'1162055000,  봉천4동,'45,40 - 44세,1998,1166,584,582
'1162055000,  봉천4동,'50,45 - 49세,1998,948,447,501
'1162055000,  봉천4동,'55,50 - 54세,1998,954,406,548
'1162055000,  봉천4동,'60,55 - 59세,1998,922,475,447
'1162055000,  봉천4동,'65,60 - 64세,1998,578,288,290
'1162055000,  봉천4동,'70,65 - 69세,1998,295,142,153
'1162055000,  봉천4동,'75,70 - 74세,1998,155,55,100
'1162055000,  봉천4동,'80,75 - 79세,1998,118,36,82
'1162055000,  봉천4동,'85,80 - 84세,1998,58,19,39
'1162055000,  봉천4동,'90,85+ ,1998,38,10,28
'1162056000,  봉천5동,'00,계,1998,6402,3287,3115
'1162056000,  봉천5동,'05,0 - 4세,1998,283,149,134
'1162056000,  봉천5동,'10,5 - 9세,1998,312,172,140
'1162056000,  봉천5동,'15,10 - 14세,1998,400,203,197
'1162056000,  봉천5동,'20,15 - 19세,1998,646,310,336
'1162056000,  봉천5동,'25,20 - 24세,1998,688,379,309
'1162056000,  봉천5동,'30,25 - 29세,1998,692,418,274
'1162056000,  봉천5동,'35,30 - 34세,1998,443,252,191
'1162056000,  봉천5동,'40,35 - 39세,1998,528,253,275
'1162056000,  봉천5동,'45,40 - 44세,1998,480,242,238
'1162056000,  봉천5동,'50,45 - 49세,1998,473,235,238
'1162056000,  봉천5동,'55,50 - 54세,1998,381,178,203
'1162056000,  봉천5동,'60,55 - 59세,1998,432,208,224
'1162056000,  봉천5동,'65,60 - 64세,1998,284,145,139
'1162056000,  봉천5동,'70,65 - 69세,1998,152,74,78
'1162056000,  봉천5동,'75,70 - 74세,1998,85,34,51
'1162056000,  봉천5동,'80,75 - 79세,1998,70,20,50
'1162056000,  봉천5동,'85,80 - 84세,1998,32,10,22
'1162056000,  봉천5동,'90,85+ ,1998,21,5,16
'1162057000,  봉천6동,'00,계,1998,24991,12688,12303
'1162057000,  봉천6동,'05,0 - 4세,1998,1683,892,791
'1162057000,  봉천6동,'10,5 - 9세,1998,1156,588,568
'1162057000,  봉천6동,'15,10 - 14세,1998,1231,661,570
'1162057000,  봉천6동,'20,15 - 19세,1998,1989,1034,955
'1162057000,  봉천6동,'25,20 - 24세,1998,2665,1300,1365
'1162057000,  봉천6동,'30,25 - 29세,1998,3953,2090,1863
'1162057000,  봉천6동,'35,30 - 34세,1998,2523,1417,1106
'1162057000,  봉천6동,'40,35 - 39세,1998,1961,993,968
'1162057000,  봉천6동,'45,40 - 44세,1998,1684,811,873
'1162057000,  봉천6동,'50,45 - 49세,1998,1448,664,784
'1162057000,  봉천6동,'55,50 - 54세,1998,1465,686,779
'1162057000,  봉천6동,'60,55 - 59세,1998,1320,690,630
'1162057000,  봉천6동,'65,60 - 64세,1998,844,453,391
'1162057000,  봉천6동,'70,65 - 69세,1998,448,208,240
'1162057000,  봉천6동,'75,70 - 74세,1998,237,89,148
'1162057000,  봉천6동,'80,75 - 79세,1998,188,64,124
'1162057000,  봉천6동,'85,80 - 84세,1998,114,26,88
'1162057000,  봉천6동,'90,85+ ,1998,82,22,60
'1162058000,  봉천7동,'00,계,1998,16553,8430,8123
'1162058000,  봉천7동,'05,0 - 4세,1998,1175,596,579
'1162058000,  봉천7동,'10,5 - 9세,1998,965,508,457
'1162058000,  봉천7동,'15,10 - 14세,1998,771,372,399
'1162058000,  봉천7동,'20,15 - 19세,1998,1270,654,616
'1162058000,  봉천7동,'25,20 - 24세,1998,1799,943,856
'1162058000,  봉천7동,'30,25 - 29세,1998,2504,1373,1131
'1162058000,  봉천7동,'35,30 - 34세,1998,1813,1016,797
'1162058000,  봉천7동,'40,35 - 39세,1998,1269,657,612
'1162058000,  봉천7동,'45,40 - 44세,1998,1107,530,577
'1162058000,  봉천7동,'50,45 - 49세,1998,937,423,514
'1162058000,  봉천7동,'55,50 - 54세,1998,898,417,481
'1162058000,  봉천7동,'60,55 - 59세,1998,842,438,404
'1162058000,  봉천7동,'65,60 - 64세,1998,507,256,251
'1162058000,  봉천7동,'70,65 - 69세,1998,267,116,151
'1162058000,  봉천7동,'75,70 - 74세,1998,187,69,118
'1162058000,  봉천7동,'80,75 - 79세,1998,128,35,93
'1162058000,  봉천7동,'85,80 - 84세,1998,75,21,54
'1162058000,  봉천7동,'90,85+ ,1998,39,6,33
'1162059000,  봉천8동,'00,계,1998,20049,10131,9918
'1162059000,  봉천8동,'05,0 - 4세,1998,1262,650,612
'1162059000,  봉천8동,'10,5 - 9세,1998,1118,593,525
'1162059000,  봉천8동,'15,10 - 14세,1998,1040,562,478
'1162059000,  봉천8동,'20,15 - 19세,1998,1752,865,887
'1162059000,  봉천8동,'25,20 - 24세,1998,2212,1034,1178
'1162059000,  봉천8동,'30,25 - 29세,1998,2902,1605,1297
'1162059000,  봉천8동,'35,30 - 34세,1998,1963,1084,879
'1162059000,  봉천8동,'40,35 - 39세,1998,1626,836,790
'1162059000,  봉천8동,'45,40 - 44세,1998,1367,623,744
'1162059000,  봉천8동,'50,45 - 49세,1998,1305,631,674
'1162059000,  봉천8동,'55,50 - 54세,1998,1155,574,581
'1162059000,  봉천8동,'60,55 - 59세,1998,975,506,469
'1162059000,  봉천8동,'65,60 - 64세,1998,583,283,300
'1162059000,  봉천8동,'70,65 - 69세,1998,324,138,186
'1162059000,  봉천8동,'75,70 - 74세,1998,182,65,117
'1162059000,  봉천8동,'80,75 - 79세,1998,147,44,103
'1162059000,  봉천8동,'85,80 - 84세,1998,87,26,61
'1162059000,  봉천8동,'90,85+ ,1998,49,12,37
'1162060000,  봉천9동,'00,계,1998,12981,6662,6319
'1162060000,  봉천9동,'05,0 - 4세,1998,838,428,410
'1162060000,  봉천9동,'10,5 - 9세,1998,767,425,342
'1162060000,  봉천9동,'15,10 - 14세,1998,805,444,361
'1162060000,  봉천9동,'20,15 - 19세,1998,1123,607,516
'1162060000,  봉천9동,'25,20 - 24세,1998,1236,614,622
'1162060000,  봉천9동,'30,25 - 29세,1998,1468,768,700
'1162060000,  봉천9동,'35,30 - 34세,1998,1277,687,590
'1162060000,  봉천9동,'40,35 - 39세,1998,1132,559,573
'1162060000,  봉천9동,'45,40 - 44세,1998,1017,538,479
'1162060000,  봉천9동,'50,45 - 49세,1998,789,385,404
'1162060000,  봉천9동,'55,50 - 54세,1998,754,352,402
'1162060000,  봉천9동,'60,55 - 59세,1998,707,377,330
'1162060000,  봉천9동,'65,60 - 64세,1998,447,237,210
'1162060000,  봉천9동,'70,65 - 69세,1998,270,122,148
'1162060000,  봉천9동,'75,70 - 74세,1998,151,66,85
'1162060000,  봉천9동,'80,75 - 79세,1998,114,32,82
'1162060000,  봉천9동,'85,80 - 84세,1998,47,12,35
'1162060000,  봉천9동,'90,85+ ,1998,39,9,30
'1162061000,  봉천10동,'00,계,1998,16017,8097,7920
'1162061000,  봉천10동,'05,0 - 4세,1998,916,442,474
'1162061000,  봉천10동,'10,5 - 9세,1998,915,505,410
'1162061000,  봉천10동,'15,10 - 14세,1998,970,507,463
'1162061000,  봉천10동,'20,15 - 19세,1998,1392,705,687
'1162061000,  봉천10동,'25,20 - 24세,1998,1655,840,815
'1162061000,  봉천10동,'30,25 - 29세,1998,1958,1059,899
'1162061000,  봉천10동,'35,30 - 34세,1998,1417,744,673
'1162061000,  봉천10동,'40,35 - 39세,1998,1437,738,699
'1162061000,  봉천10동,'45,40 - 44세,1998,1213,599,614
'1162061000,  봉천10동,'50,45 - 49세,1998,1021,491,530
'1162061000,  봉천10동,'55,50 - 54세,1998,940,453,487
'1162061000,  봉천10동,'60,55 - 59세,1998,888,457,431
'1162061000,  봉천10동,'65,60 - 64세,1998,556,268,288
'1162061000,  봉천10동,'70,65 - 69세,1998,309,151,158
'1162061000,  봉천10동,'75,70 - 74세,1998,174,73,101
'1162061000,  봉천10동,'80,75 - 79세,1998,142,38,104
'1162061000,  봉천10동,'85,80 - 84세,1998,78,21,57
'1162061000,  봉천10동,'90,85+ ,1998,36,6,30
'1162062000,  봉천11동,'00,계,1998,28078,14108,13970
'1162062000,  봉천11동,'05,0 - 4세,1998,2149,1107,1042
'1162062000,  봉천11동,'10,5 - 9세,1998,1651,885,766
'1162062000,  봉천11동,'15,10 - 14세,1998,1331,696,635
'1162062000,  봉천11동,'20,15 - 19세,1998,2162,1149,1013
'1162062000,  봉천11동,'25,20 - 24세,1998,2849,1354,1495
'1162062000,  봉천11동,'30,25 - 29세,1998,4028,2039,1989
'1162062000,  봉천11동,'35,30 - 34세,1998,3033,1653,1380
'1162062000,  봉천11동,'40,35 - 39세,1998,2325,1216,1109
'1162062000,  봉천11동,'45,40 - 44세,1998,1936,924,1012
'1162062000,  봉천11동,'50,45 - 49세,1998,1617,774,843
'1162062000,  봉천11동,'55,50 - 54세,1998,1497,708,789
'1162062000,  봉천11동,'60,55 - 59세,1998,1404,704,700
'1162062000,  봉천11동,'65,60 - 64세,1998,883,449,434
'1162062000,  봉천11동,'70,65 - 69세,1998,491,226,265
'1162062000,  봉천11동,'75,70 - 74세,1998,298,99,199
'1162062000,  봉천11동,'80,75 - 79세,1998,226,73,153
'1162062000,  봉천11동,'85,80 - 84세,1998,110,25,85
'1162062000,  봉천11동,'90,85+ ,1998,88,27,61
'1162063000,  남현동,'00,계,1998,17726,8907,8819
'1162063000,  남현동,'05,0 - 4세,1998,1237,636,601
'1162063000,  남현동,'10,5 - 9세,1998,1015,505,510
'1162063000,  남현동,'15,10 - 14세,1998,871,464,407
'1162063000,  남현동,'20,15 - 19세,1998,1313,680,633
'1162063000,  남현동,'25,20 - 24세,1998,1788,848,940
'1162063000,  남현동,'30,25 - 29세,1998,2696,1364,1332
'1162063000,  남현동,'35,30 - 34세,1998,1917,1098,819
'1162063000,  남현동,'40,35 - 39세,1998,1423,728,695
'1162063000,  남현동,'45,40 - 44세,1998,1244,605,639
'1162063000,  남현동,'50,45 - 49세,1998,1035,495,540
'1162063000,  남현동,'55,50 - 54세,1998,946,430,516
'1162063000,  남현동,'60,55 - 59세,1998,854,445,409
'1162063000,  남현동,'65,60 - 64세,1998,528,295,233
'1162063000,  남현동,'70,65 - 69세,1998,344,154,190
'1162063000,  남현동,'75,70 - 74세,1998,220,81,139
'1162063000,  남현동,'80,75 - 79세,1998,147,47,100
'1162063000,  남현동,'85,80 - 84세,1998,91,21,70
'1162063000,  남현동,'90,85+ ,1998,57,11,46
'1162064000,  신림본동,'00,계,1998,25986,13050,12936
'1162064000,  신림본동,'05,0 - 4세,1998,2184,1134,1050
'1162064000,  신림본동,'10,5 - 9세,1998,1249,635,614
'1162064000,  신림본동,'15,10 - 14세,1998,929,512,417
'1162064000,  신림본동,'20,15 - 19세,1998,1814,960,854
'1162064000,  신림본동,'25,20 - 24세,1998,2656,1155,1501
'1162064000,  신림본동,'30,25 - 29세,1998,4868,2420,2448
'1162064000,  신림본동,'35,30 - 34세,1998,3122,1817,1305
'1162064000,  신림본동,'40,35 - 39세,1998,1836,987,849
'1162064000,  신림본동,'45,40 - 44세,1998,1550,735,815
'1162064000,  신림본동,'50,45 - 49세,1998,1373,621,752
'1162064000,  신림본동,'55,50 - 54세,1998,1321,604,717
'1162064000,  신림본동,'60,55 - 59세,1998,1282,660,622
'1162064000,  신림본동,'65,60 - 64세,1998,820,425,395
'1162064000,  신림본동,'70,65 - 69세,1998,403,197,206
'1162064000,  신림본동,'75,70 - 74세,1998,240,98,142
'1162064000,  신림본동,'80,75 - 79세,1998,165,46,119
'1162064000,  신림본동,'85,80 - 84세,1998,91,26,65
'1162064000,  신림본동,'90,85+ ,1998,83,18,65
'1162065000,  신림1동,'00,계,1998,25245,12640,12605
'1162065000,  신림1동,'05,0 - 4세,1998,1940,1006,934
'1162065000,  신림1동,'10,5 - 9세,1998,1466,768,698
'1162065000,  신림1동,'15,10 - 14세,1998,1216,646,570
'1162065000,  신림1동,'20,15 - 19세,1998,1865,971,894
'1162065000,  신림1동,'25,20 - 24세,1998,2465,1126,1339
'1162065000,  신림1동,'30,25 - 29세,1998,4006,2035,1971
'1162065000,  신림1동,'35,30 - 34세,1998,2885,1543,1342
'1162065000,  신림1동,'40,35 - 39세,1998,2062,1104,958
'1162065000,  신림1동,'45,40 - 44세,1998,1670,821,849
'1162065000,  신림1동,'50,45 - 49세,1998,1394,646,748
'1162065000,  신림1동,'55,50 - 54세,1998,1284,620,664
'1162065000,  신림1동,'60,55 - 59세,1998,1285,632,653
'1162065000,  신림1동,'65,60 - 64세,1998,801,410,391
'1162065000,  신림1동,'70,65 - 69세,1998,395,169,226
'1162065000,  신림1동,'75,70 - 74세,1998,219,75,144
'1162065000,  신림1동,'80,75 - 79세,1998,147,42,105
'1162065000,  신림1동,'85,80 - 84세,1998,92,19,73
'1162065000,  신림1동,'90,85+ ,1998,53,7,46
'1162066000,  신림2동,'00,계,1998,27530,14337,13193
'1162066000,  신림2동,'05,0 - 4세,1998,1737,903,834
'1162066000,  신림2동,'10,5 - 9세,1998,1340,741,599
'1162066000,  신림2동,'15,10 - 14세,1998,1381,738,643
'1162066000,  신림2동,'20,15 - 19세,1998,2332,1178,1154
'1162066000,  신림2동,'25,20 - 24세,1998,2953,1537,1416
'1162066000,  신림2동,'30,25 - 29세,1998,4166,2361,1805
'1162066000,  신림2동,'35,30 - 34세,1998,2863,1694,1169
'1162066000,  신림2동,'40,35 - 39세,1998,2136,1098,1038
'1162066000,  신림2동,'45,40 - 44세,1998,1978,915,1063
'1162066000,  신림2동,'50,45 - 49세,1998,1755,869,886
'1162066000,  신림2동,'55,50 - 54세,1998,1478,709,769
'1162066000,  신림2동,'60,55 - 59세,1998,1325,690,635
'1162066000,  신림2동,'65,60 - 64세,1998,880,450,430
'1162066000,  신림2동,'70,65 - 69세,1998,473,214,259
'1162066000,  신림2동,'75,70 - 74세,1998,302,115,187
'1162066000,  신림2동,'80,75 - 79세,1998,228,73,155
'1162066000,  신림2동,'85,80 - 84세,1998,117,30,87
'1162066000,  신림2동,'90,85+ ,1998,86,22,64
'1162067000,  신림3동,'00,계,1998,21174,10857,10317
'1162067000,  신림3동,'05,0 - 4세,1998,1689,867,822
'1162067000,  신림3동,'10,5 - 9세,1998,1422,797,625
'1162067000,  신림3동,'15,10 - 14세,1998,1256,705,551
'1162067000,  신림3동,'20,15 - 19세,1998,1830,995,835
'1162067000,  신림3동,'25,20 - 24세,1998,1961,1013,948
'1162067000,  신림3동,'30,25 - 29세,1998,2723,1388,1335
'1162067000,  신림3동,'35,30 - 34세,1998,2197,1141,1056
'1162067000,  신림3동,'40,35 - 39세,1998,1929,994,935
'1162067000,  신림3동,'45,40 - 44세,1998,1587,777,810
'1162067000,  신림3동,'50,45 - 49세,1998,1239,593,646
'1162067000,  신림3동,'55,50 - 54세,1998,1111,555,556
'1162067000,  신림3동,'60,55 - 59세,1998,906,475,431
'1162067000,  신림3동,'65,60 - 64세,1998,529,266,263
'1162067000,  신림3동,'70,65 - 69세,1998,324,145,179
'1162067000,  신림3동,'75,70 - 74세,1998,180,61,119
'1162067000,  신림3동,'80,75 - 79세,1998,159,54,105
'1162067000,  신림3동,'85,80 - 84세,1998,79,19,60
'1162067000,  신림3동,'90,85+ ,1998,53,12,41
'1162068000,  신림4동,'00,계,1998,30296,15173,15123
'1162068000,  신림4동,'05,0 - 4세,1998,2765,1418,1347
'1162068000,  신림4동,'10,5 - 9세,1998,2041,1083,958
'1162068000,  신림4동,'15,10 - 14세,1998,1575,844,731
'1162068000,  신림4동,'20,15 - 19세,1998,2179,1122,1057
'1162068000,  신림4동,'25,20 - 24세,1998,2788,1197,1591
'1162068000,  신림4동,'30,25 - 29세,1998,4902,2372,2530
'1162068000,  신림4동,'35,30 - 34세,1998,3790,2047,1743
'1162068000,  신림4동,'40,35 - 39세,1998,2838,1560,1278
'1162068000,  신림4동,'45,40 - 44세,1998,1969,950,1019
'1162068000,  신림4동,'50,45 - 49세,1998,1482,721,761
'1162068000,  신림4동,'55,50 - 54세,1998,1266,625,641
'1162068000,  신림4동,'60,55 - 59세,1998,1064,533,531
'1162068000,  신림4동,'65,60 - 64세,1998,652,337,315
'1162068000,  신림4동,'70,65 - 69세,1998,410,187,223
'1162068000,  신림4동,'75,70 - 74세,1998,245,92,153
'1162068000,  신림4동,'80,75 - 79세,1998,166,45,121
'1162068000,  신림4동,'85,80 - 84세,1998,93,20,73
'1162068000,  신림4동,'90,85+ ,1998,71,20,51
'1162069000,  신림5동,'00,계,1998,17042,8466,8576
'1162069000,  신림5동,'05,0 - 4세,1998,1126,584,542
'1162069000,  신림5동,'10,5 - 9세,1998,808,387,421
'1162069000,  신림5동,'15,10 - 14세,1998,667,353,314
'1162069000,  신림5동,'20,15 - 19세,1998,1285,663,622
'1162069000,  신림5동,'25,20 - 24세,1998,1901,894,1007
'1162069000,  신림5동,'30,25 - 29세,1998,2889,1464,1425
'1162069000,  신림5동,'35,30 - 34세,1998,1915,1058,857
'1162069000,  신림5동,'40,35 - 39세,1998,1241,652,589
'1162069000,  신림5동,'45,40 - 44세,1998,1119,524,595
'1162069000,  신림5동,'50,45 - 49세,1998,978,438,540
'1162069000,  신림5동,'55,50 - 54세,1998,985,430,555
'1162069000,  신림5동,'60,55 - 59세,1998,867,453,414
'1162069000,  신림5동,'65,60 - 64세,1998,530,277,253
'1162069000,  신림5동,'70,65 - 69세,1998,300,137,163
'1162069000,  신림5동,'75,70 - 74세,1998,166,70,96
'1162069000,  신림5동,'80,75 - 79세,1998,148,53,95
'1162069000,  신림5동,'85,80 - 84세,1998,71,18,53
'1162069000,  신림5동,'90,85+ ,1998,46,11,35
'1162070000,  신림6동,'00,계,1998,12152,6228,5924
'1162070000,  신림6동,'05,0 - 4세,1998,772,391,381
'1162070000,  신림6동,'10,5 - 9세,1998,632,348,284
'1162070000,  신림6동,'15,10 - 14세,1998,594,352,242
'1162070000,  신림6동,'20,15 - 19세,1998,1046,533,513
'1162070000,  신림6동,'25,20 - 24세,1998,1173,590,583
'1162070000,  신림6동,'30,25 - 29세,1998,1561,866,695
'1162070000,  신림6동,'35,30 - 34세,1998,1188,676,512
'1162070000,  신림6동,'40,35 - 39세,1998,924,499,425
'1162070000,  신림6동,'45,40 - 44세,1998,827,395,432
'1162070000,  신림6동,'50,45 - 49세,1998,738,339,399
'1162070000,  신림6동,'55,50 - 54세,1998,750,346,404
'1162070000,  신림6동,'60,55 - 59세,1998,771,381,390
'1162070000,  신림6동,'65,60 - 64세,1998,481,253,228
'1162070000,  신림6동,'70,65 - 69세,1998,287,111,176
'1162070000,  신림6동,'75,70 - 74세,1998,178,68,110
'1162070000,  신림6동,'80,75 - 79세,1998,125,46,79
'1162070000,  신림6동,'85,80 - 84세,1998,63,19,44
'1162070000,  신림6동,'90,85+ ,1998,42,15,27
'1162071000,  신림7동,'00,계,1998,16597,8517,8080
'1162071000,  신림7동,'05,0 - 4세,1998,888,452,436
'1162071000,  신림7동,'10,5 - 9세,1998,994,516,478
'1162071000,  신림7동,'15,10 - 14세,1998,903,467,436
'1162071000,  신림7동,'20,15 - 19세,1998,1576,842,734
'1162071000,  신림7동,'25,20 - 24세,1998,1785,919,866
'1162071000,  신림7동,'30,25 - 29세,1998,1786,1016,770
'1162071000,  신림7동,'35,30 - 34세,1998,1430,807,623
'1162071000,  신림7동,'40,35 - 39세,1998,1416,740,676
'1162071000,  신림7동,'45,40 - 44세,1998,1305,642,663
'1162071000,  신림7동,'50,45 - 49세,1998,1091,543,548
'1162071000,  신림7동,'55,50 - 54세,1998,986,509,477
'1162071000,  신림7동,'60,55 - 59세,1998,919,468,451
'1162071000,  신림7동,'65,60 - 64세,1998,593,288,305
'1162071000,  신림7동,'70,65 - 69세,1998,388,153,235
'1162071000,  신림7동,'75,70 - 74세,1998,231,80,151
'1162071000,  신림7동,'80,75 - 79세,1998,178,48,130
'1162071000,  신림7동,'85,80 - 84세,1998,79,20,59
'1162071000,  신림7동,'90,85+ ,1998,49,7,42
'1162072000,  신림8동,'00,계,1998,24329,12339,11990
'1162072000,  신림8동,'05,0 - 4세,1998,1837,970,867
'1162072000,  신림8동,'10,5 - 9세,1998,1384,725,659
'1162072000,  신림8동,'15,10 - 14세,1998,1179,641,538
'1162072000,  신림8동,'20,15 - 19세,1998,1970,1053,917
'1162072000,  신림8동,'25,20 - 24세,1998,2447,1168,1279
'1162072000,  신림8동,'30,25 - 29세,1998,3497,1810,1687
'1162072000,  신림8동,'35,30 - 34세,1998,2579,1417,1162
'1162072000,  신림8동,'40,35 - 39세,1998,2063,1068,995
'1162072000,  신림8동,'45,40 - 44세,1998,1834,858,976
'1162072000,  신림8동,'50,45 - 49세,1998,1461,725,736
'1162072000,  신림8동,'55,50 - 54세,1998,1302,639,663
'1162072000,  신림8동,'60,55 - 59세,1998,1096,557,539
'1162072000,  신림8동,'65,60 - 64세,1998,699,348,351
'1162072000,  신림8동,'70,65 - 69세,1998,387,184,203
'1162072000,  신림8동,'75,70 - 74세,1998,252,74,178
'1162072000,  신림8동,'80,75 - 79세,1998,175,59,116
'1162072000,  신림8동,'85,80 - 84세,1998,103,30,73
'1162072000,  신림8동,'90,85+ ,1998,64,13,51
'1162073000,  신림9동,'00,계,1998,26052,14260,11792
'1162073000,  신림9동,'05,0 - 4세,1998,1293,700,593
'1162073000,  신림9동,'10,5 - 9세,1998,1294,658,636
'1162073000,  신림9동,'15,10 - 14세,1998,1576,811,765
'1162073000,  신림9동,'20,15 - 19세,1998,2031,1029,1002
'1162073000,  신림9동,'25,20 - 24세,1998,2722,1453,1269
'1162073000,  신림9동,'30,25 - 29세,1998,4228,2809,1419
'1162073000,  신림9동,'35,30 - 34세,1998,2826,1865,961
'1162073000,  신림9동,'40,35 - 39세,1998,2284,1199,1085
'1162073000,  신림9동,'45,40 - 44세,1998,2071,1037,1034
'1162073000,  신림9동,'50,45 - 49세,1998,1476,736,740
'1162073000,  신림9동,'55,50 - 54세,1998,1272,609,663
'1162073000,  신림9동,'60,55 - 59세,1998,1131,577,554
'1162073000,  신림9동,'65,60 - 64세,1998,756,379,377
'1162073000,  신림9동,'70,65 - 69세,1998,437,201,236
'1162073000,  신림9동,'75,70 - 74세,1998,257,94,163
'1162073000,  신림9동,'80,75 - 79세,1998,211,68,143
'1162073000,  신림9동,'85,80 - 84세,1998,117,24,93
'1162073000,  신림9동,'90,85+ ,1998,70,11,59
'1162074000,  신림10동,'00,계,1998,15993,8057,7936
'1162074000,  신림10동,'05,0 - 4세,1998,840,438,402
'1162074000,  신림10동,'10,5 - 9세,1998,957,498,459
'1162074000,  신림10동,'15,10 - 14세,1998,1059,551,508
'1162074000,  신림10동,'20,15 - 19세,1998,1620,817,803
'1162074000,  신림10동,'25,20 - 24세,1998,1445,744,701
'1162074000,  신림10동,'30,25 - 29세,1998,1578,860,718
'1162074000,  신림10동,'35,30 - 34세,1998,1376,723,653
'1162074000,  신림10동,'40,35 - 39세,1998,1428,697,731
'1162074000,  신림10동,'45,40 - 44세,1998,1399,694,705
'1162074000,  신림10동,'50,45 - 49세,1998,1064,537,527
'1162074000,  신림10동,'55,50 - 54세,1998,958,464,494
'1162074000,  신림10동,'60,55 - 59세,1998,853,438,415
'1162074000,  신림10동,'65,60 - 64세,1998,547,286,261
'1162074000,  신림10동,'70,65 - 69세,1998,346,144,202
'1162074000,  신림10동,'75,70 - 74세,1998,232,84,148
'1162074000,  신림10동,'80,75 - 79세,1998,169,51,118
'1162074000,  신림10동,'85,80 - 84세,1998,77,21,56
'1162074000,  신림10동,'90,85+ ,1998,45,10,35
'1162075000,  신림11동,'00,계,1998,15870,8021,7849
'1162075000,  신림11동,'05,0 - 4세,1998,951,504,447
'1162075000,  신림11동,'10,5 - 9세,1998,994,539,455
'1162075000,  신림11동,'15,10 - 14세,1998,1077,558,519
'1162075000,  신림11동,'20,15 - 19세,1998,1628,869,759
'1162075000,  신림11동,'25,20 - 24세,1998,1559,790,769
'1162075000,  신림11동,'30,25 - 29세,1998,1672,866,806
'1162075000,  신림11동,'35,30 - 34세,1998,1385,707,678
'1162075000,  신림11동,'40,35 - 39세,1998,1453,698,755
'1162075000,  신림11동,'45,40 - 44세,1998,1478,684,794
'1162075000,  신림11동,'50,45 - 49세,1998,1143,579,564
'1162075000,  신림11동,'55,50 - 54세,1998,868,447,421
'1162075000,  신림11동,'60,55 - 59세,1998,668,381,287
'1162075000,  신림11동,'65,60 - 64세,1998,384,198,186
'1162075000,  신림11동,'70,65 - 69세,1998,218,82,136
'1162075000,  신림11동,'75,70 - 74세,1998,162,47,115
'1162075000,  신림11동,'80,75 - 79세,1998,128,45,83
'1162075000,  신림11동,'85,80 - 84세,1998,69,18,51
'1162075000,  신림11동,'90,85+ ,1998,33,9,24
'1162076000,  신림12동,'00,계,1998,21704,11013,10691
'1162076000,  신림12동,'05,0 - 4세,1998,1447,771,676
'1162076000,  신림12동,'10,5 - 9세,1998,1350,704,646
'1162076000,  신림12동,'15,10 - 14세,1998,1368,719,649
'1162076000,  신림12동,'20,15 - 19세,1998,2051,1064,987
'1162076000,  신림12동,'25,20 - 24세,1998,2247,1138,1109
'1162076000,  신림12동,'30,25 - 29세,1998,2461,1239,1222
'1162076000,  신림12동,'35,30 - 34세,1998,1904,992,912
'1162076000,  신림12동,'40,35 - 39세,1998,2003,1012,991
'1162076000,  신림12동,'45,40 - 44세,1998,1797,888,909
'1162076000,  신림12동,'50,45 - 49세,1998,1483,735,748
'1162076000,  신림12동,'55,50 - 54세,1998,1290,673,617
'1162076000,  신림12동,'60,55 - 59세,1998,954,543,411
'1162076000,  신림12동,'65,60 - 64세,1998,532,285,247
'1162076000,  신림12동,'70,65 - 69세,1998,283,108,175
'1162076000,  신림12동,'75,70 - 74세,1998,239,74,165
'1162076000,  신림12동,'80,75 - 79세,1998,159,39,120
'1162076000,  신림12동,'85,80 - 84세,1998,92,21,71
'1162076000,  신림12동,'90,85+ ,1998,44,8,36
'1162077000,  신림13동,'00,계,1998,18165,9239,8926
'1162077000,  신림13동,'05,0 - 4세,1998,1473,765,708
'1162077000,  신림13동,'10,5 - 9세,1998,1218,642,576
'1162077000,  신림13동,'15,10 - 14세,1998,1024,552,472
'1162077000,  신림13동,'20,15 - 19세,1998,1502,783,719
'1162077000,  신림13동,'25,20 - 24세,1998,1716,858,858
'1162077000,  신림13동,'30,25 - 29세,1998,2310,1148,1162
'1162077000,  신림13동,'35,30 - 34세,1998,1953,1057,896
'1162077000,  신림13동,'40,35 - 39세,1998,1635,846,789
'1162077000,  신림13동,'45,40 - 44세,1998,1386,712,674
'1162077000,  신림13동,'50,45 - 49세,1998,1030,502,528
'1162077000,  신림13동,'55,50 - 54세,1998,928,452,476
'1162077000,  신림13동,'60,55 - 59세,1998,766,385,381
'1162077000,  신림13동,'65,60 - 64세,1998,517,272,245
'1162077000,  신림13동,'70,65 - 69세,1998,291,128,163
'1162077000,  신림13동,'75,70 - 74세,1998,175,63,112
'1162077000,  신림13동,'80,75 - 79세,1998,121,38,83
'1162077000,  신림13동,'85,80 - 84세,1998,81,25,56
'1162077000,  신림13동,'90,85+ ,1998,39,11,28
'11650, 서초구,'00,계,1998,401179,198363,202816
'11650, 서초구,'05,0 - 4세,1998,20995,10975,10020
'11650, 서초구,'10,5 - 9세,1998,20866,11170,9696
'11650, 서초구,'15,10 - 14세,1998,25374,13388,11986
'11650, 서초구,'20,15 - 19세,1998,39198,20697,18501
'11650, 서초구,'25,20 - 24세,1998,41386,20498,20888
'11650, 서초구,'30,25 - 29세,1998,48100,23843,24257
'11650, 서초구,'35,30 - 34세,1998,32870,17122,15748
'11650, 서초구,'40,35 - 39세,1998,30726,14166,16560
'11650, 서초구,'45,40 - 44세,1998,35442,15663,19779
'11650, 서초구,'50,45 - 49세,1998,31072,14453,16619
'11650, 서초구,'55,50 - 54세,1998,26600,13418,13182
'11650, 서초구,'60,55 - 59세,1998,18823,10549,8274
'11650, 서초구,'65,60 - 64세,1998,10891,5798,5093
'11650, 서초구,'70,65 - 69세,1998,6578,2788,3790
'11650, 서초구,'75,70 - 74세,1998,4824,1690,3134
'11650, 서초구,'80,75 - 79세,1998,3749,1198,2551
'11650, 서초구,'85,80 - 84세,1998,2185,599,1586
'11650, 서초구,'90,85+ ,1998,1500,348,1152
'1165051000,  서초1동,'00,계,1998,16568,8309,8259
'1165051000,  서초1동,'05,0 - 4세,1998,844,440,404
'1165051000,  서초1동,'10,5 - 9세,1998,811,392,419
'1165051000,  서초1동,'15,10 - 14세,1998,891,484,407
'1165051000,  서초1동,'20,15 - 19세,1998,1612,897,715
'1165051000,  서초1동,'25,20 - 24세,1998,1918,972,946
'1165051000,  서초1동,'30,25 - 29세,1998,2130,1097,1033
'1165051000,  서초1동,'35,30 - 34세,1998,1383,730,653
'1165051000,  서초1동,'40,35 - 39세,1998,1194,569,625
'1165051000,  서초1동,'45,40 - 44세,1998,1368,601,767
'1165051000,  서초1동,'50,45 - 49세,1998,1331,607,724
'1165051000,  서초1동,'55,50 - 54세,1998,1116,560,556
'1165051000,  서초1동,'60,55 - 59세,1998,821,472,349
'1165051000,  서초1동,'65,60 - 64세,1998,432,225,207
'1165051000,  서초1동,'70,65 - 69세,1998,260,109,151
'1165051000,  서초1동,'75,70 - 74세,1998,187,69,118
'1165051000,  서초1동,'80,75 - 79세,1998,141,48,93
'1165051000,  서초1동,'85,80 - 84세,1998,77,24,53
'1165051000,  서초1동,'90,85+ ,1998,52,13,39
'1165052000,  서초2동,'00,계,1998,21090,10628,10462
'1165052000,  서초2동,'05,0 - 4세,1998,942,485,457
'1165052000,  서초2동,'10,5 - 9세,1998,1115,641,474
'1165052000,  서초2동,'15,10 - 14세,1998,1548,816,732
'1165052000,  서초2동,'20,15 - 19세,1998,2172,1205,967
'1165052000,  서초2동,'25,20 - 24세,1998,2131,1144,987
'1165052000,  서초2동,'30,25 - 29세,1998,2145,1070,1075
'1165052000,  서초2동,'35,30 - 34세,1998,1403,707,696
'1165052000,  서초2동,'40,35 - 39세,1998,1607,721,886
'1165052000,  서초2동,'45,40 - 44세,1998,2070,947,1123
'1165052000,  서초2동,'50,45 - 49세,1998,1837,860,977
'1165052000,  서초2동,'55,50 - 54세,1998,1563,809,754
'1165052000,  서초2동,'60,55 - 59세,1998,961,580,381
'1165052000,  서초2동,'65,60 - 64세,1998,504,270,234
'1165052000,  서초2동,'70,65 - 69세,1998,359,148,211
'1165052000,  서초2동,'75,70 - 74세,1998,286,100,186
'1165052000,  서초2동,'80,75 - 79세,1998,253,77,176
'1165052000,  서초2동,'85,80 - 84세,1998,114,34,80
'1165052000,  서초2동,'90,85+ ,1998,80,14,66
'1165053000,  서초3동,'00,계,1998,23519,12203,11316
'1165053000,  서초3동,'05,0 - 4세,1998,957,513,444
'1165053000,  서초3동,'10,5 - 9세,1998,878,442,436
'1165053000,  서초3동,'15,10 - 14세,1998,1257,707,550
'1165053000,  서초3동,'20,15 - 19세,1998,2458,1401,1057
'1165053000,  서초3동,'25,20 - 24세,1998,2968,1596,1372
'1165053000,  서초3동,'30,25 - 29세,1998,3266,1880,1386
'1165053000,  서초3동,'35,30 - 34세,1998,1749,1002,747
'1165053000,  서초3동,'40,35 - 39세,1998,1460,644,816
'1165053000,  서초3동,'45,40 - 44세,1998,1843,764,1079
'1165053000,  서초3동,'50,45 - 49세,1998,1909,871,1038
'1165053000,  서초3동,'55,50 - 54세,1998,1740,884,856
'1165053000,  서초3동,'60,55 - 59세,1998,1282,701,581
'1165053000,  서초3동,'65,60 - 64세,1998,715,395,320
'1165053000,  서초3동,'70,65 - 69세,1998,396,193,203
'1165053000,  서초3동,'75,70 - 74세,1998,238,89,149
'1165053000,  서초3동,'80,75 - 79세,1998,210,63,147
'1165053000,  서초3동,'85,80 - 84세,1998,110,31,79
'1165053000,  서초3동,'90,85+ ,1998,83,27,56
'1165053100,  서초4동,'00,계,1998,27086,13454,13632
'1165053100,  서초4동,'05,0 - 4세,1998,1289,673,616
'1165053100,  서초4동,'10,5 - 9세,1998,1472,775,697
'1165053100,  서초4동,'15,10 - 14세,1998,1855,999,856
'1165053100,  서초4동,'20,15 - 19세,1998,2983,1678,1305
'1165053100,  서초4동,'25,20 - 24세,1998,2812,1458,1354
'1165053100,  서초4동,'30,25 - 29세,1998,2572,1251,1321
'1165053100,  서초4동,'35,30 - 34세,1998,1829,859,970
'1165053100,  서초4동,'40,35 - 39세,1998,1947,906,1041
'1165053100,  서초4동,'45,40 - 44세,1998,2569,1057,1512
'1165053100,  서초4동,'50,45 - 49세,1998,2500,1132,1368
'1165053100,  서초4동,'55,50 - 54세,1998,2056,1113,943
'1165053100,  서초4동,'60,55 - 59세,1998,1301,778,523
'1165053100,  서초4동,'65,60 - 64세,1998,664,363,301
'1165053100,  서초4동,'70,65 - 69세,1998,402,170,232
'1165053100,  서초4동,'75,70 - 74세,1998,318,98,220
'1165053100,  서초4동,'80,75 - 79세,1998,244,86,158
'1165053100,  서초4동,'85,80 - 84세,1998,151,33,118
'1165053100,  서초4동,'90,85+ ,1998,122,25,97
'1165054000,  잠원동,'00,계,1998,35743,17086,18657
'1165054000,  잠원동,'05,0 - 4세,1998,2185,1099,1086
'1165054000,  잠원동,'10,5 - 9세,1998,2126,1168,958
'1165054000,  잠원동,'15,10 - 14세,1998,2415,1293,1122
'1165054000,  잠원동,'20,15 - 19세,1998,3052,1600,1452
'1165054000,  잠원동,'25,20 - 24세,1998,2984,1326,1658
'1165054000,  잠원동,'30,25 - 29세,1998,4520,2000,2520
'1165054000,  잠원동,'35,30 - 34세,1998,3588,1783,1805
'1165054000,  잠원동,'40,35 - 39세,1998,3305,1510,1795
'1165054000,  잠원동,'45,40 - 44세,1998,3476,1523,1953
'1165054000,  잠원동,'50,45 - 49세,1998,2512,1238,1274
'1165054000,  잠원동,'55,50 - 54세,1998,1866,939,927
'1165054000,  잠원동,'60,55 - 59세,1998,1264,663,601
'1165054000,  잠원동,'65,60 - 64세,1998,840,398,442
'1165054000,  잠원동,'70,65 - 69세,1998,585,209,376
'1165054000,  잠원동,'75,70 - 74세,1998,444,166,278
'1165054000,  잠원동,'80,75 - 79세,1998,317,101,216
'1165054000,  잠원동,'85,80 - 84세,1998,160,46,114
'1165054000,  잠원동,'90,85+ ,1998,104,24,80
'1165055000,  반포본동,'00,계,1998,14395,6790,7605
'1165055000,  반포본동,'05,0 - 4세,1998,543,296,247
'1165055000,  반포본동,'10,5 - 9세,1998,642,356,286
'1165055000,  반포본동,'15,10 - 14세,1998,1060,518,542
'1165055000,  반포본동,'20,15 - 19세,1998,1571,731,840
'1165055000,  반포본동,'25,20 - 24세,1998,1616,717,899
'1165055000,  반포본동,'30,25 - 29세,1998,1405,671,734
'1165055000,  반포본동,'35,30 - 34세,1998,763,380,383
'1165055000,  반포본동,'40,35 - 39세,1998,885,368,517
'1165055000,  반포본동,'45,40 - 44세,1998,1316,560,756
'1165055000,  반포본동,'50,45 - 49세,1998,1216,540,676
'1165055000,  반포본동,'55,50 - 54세,1998,1226,570,656
'1165055000,  반포본동,'60,55 - 59세,1998,902,525,377
'1165055000,  반포본동,'65,60 - 64세,1998,464,268,196
'1165055000,  반포본동,'70,65 - 69세,1998,269,125,144
'1165055000,  반포본동,'75,70 - 74세,1998,170,69,101
'1165055000,  반포본동,'80,75 - 79세,1998,149,47,102
'1165055000,  반포본동,'85,80 - 84세,1998,113,27,86
'1165055000,  반포본동,'90,85+ ,1998,85,22,63
'1165056000,  반포1동,'00,계,1998,28546,13833,14713
'1165056000,  반포1동,'05,0 - 4세,1998,1539,776,763
'1165056000,  반포1동,'10,5 - 9세,1998,1462,792,670
'1165056000,  반포1동,'15,10 - 14세,1998,1696,888,808
'1165056000,  반포1동,'20,15 - 19세,1998,2459,1303,1156
'1165056000,  반포1동,'25,20 - 24세,1998,2962,1384,1578
'1165056000,  반포1동,'30,25 - 29세,1998,4317,2030,2287
'1165056000,  반포1동,'35,30 - 34세,1998,2744,1448,1296
'1165056000,  반포1동,'40,35 - 39세,1998,2365,1077,1288
'1165056000,  반포1동,'45,40 - 44세,1998,2464,1089,1375
'1165056000,  반포1동,'50,45 - 49세,1998,2084,939,1145
'1165056000,  반포1동,'55,50 - 54세,1998,1659,871,788
'1165056000,  반포1동,'60,55 - 59세,1998,1063,576,487
'1165056000,  반포1동,'65,60 - 64세,1998,579,292,287
'1165056000,  반포1동,'70,65 - 69세,1998,385,147,238
'1165056000,  반포1동,'75,70 - 74세,1998,307,86,221
'1165056000,  반포1동,'80,75 - 79세,1998,232,81,151
'1165056000,  반포1동,'85,80 - 84세,1998,134,37,97
'1165056000,  반포1동,'90,85+ ,1998,95,17,78
'1165057000,  반포2동,'00,계,1998,19577,9511,10066
'1165057000,  반포2동,'05,0 - 4세,1998,748,391,357
'1165057000,  반포2동,'10,5 - 9세,1998,891,476,415
'1165057000,  반포2동,'15,10 - 14세,1998,1451,746,705
'1165057000,  반포2동,'20,15 - 19세,1998,2255,1194,1061
'1165057000,  반포2동,'25,20 - 24세,1998,2233,1087,1146
'1165057000,  반포2동,'30,25 - 29세,1998,1942,947,995
'1165057000,  반포2동,'35,30 - 34세,1998,1201,613,588
'1165057000,  반포2동,'40,35 - 39세,1998,1262,532,730
'1165057000,  반포2동,'45,40 - 44세,1998,1934,845,1089
'1165057000,  반포2동,'50,45 - 49세,1998,1805,809,996
'1165057000,  반포2동,'55,50 - 54세,1998,1587,793,794
'1165057000,  반포2동,'60,55 - 59세,1998,901,534,367
'1165057000,  반포2동,'65,60 - 64세,1998,465,271,194
'1165057000,  반포2동,'70,65 - 69세,1998,258,97,161
'1165057000,  반포2동,'75,70 - 74세,1998,229,59,170
'1165057000,  반포2동,'80,75 - 79세,1998,189,63,126
'1165057000,  반포2동,'85,80 - 84세,1998,135,32,103
'1165057000,  반포2동,'90,85+ ,1998,91,22,69
'1165058000,  반포3동,'00,계,1998,21011,10225,10786
'1165058000,  반포3동,'05,0 - 4세,1998,1016,550,466
'1165058000,  반포3동,'10,5 - 9세,1998,1206,645,561
'1165058000,  반포3동,'15,10 - 14세,1998,1439,791,648
'1165058000,  반포3동,'20,15 - 19세,1998,2080,1091,989
'1165058000,  반포3동,'25,20 - 24세,1998,2056,993,1063
'1165058000,  반포3동,'30,25 - 29세,1998,2122,1003,1119
'1165058000,  반포3동,'35,30 - 34세,1998,1637,799,838
'1165058000,  반포3동,'40,35 - 39세,1998,1606,714,892
'1165058000,  반포3동,'45,40 - 44세,1998,1894,827,1067
'1165058000,  반포3동,'50,45 - 49세,1998,1724,804,920
'1165058000,  반포3동,'55,50 - 54세,1998,1408,709,699
'1165058000,  반포3동,'60,55 - 59세,1998,1039,561,478
'1165058000,  반포3동,'65,60 - 64세,1998,656,347,309
'1165058000,  반포3동,'70,65 - 69세,1998,404,176,228
'1165058000,  반포3동,'75,70 - 74세,1998,300,93,207
'1165058000,  반포3동,'80,75 - 79세,1998,203,70,133
'1165058000,  반포3동,'85,80 - 84세,1998,124,30,94
'1165058000,  반포3동,'90,85+ ,1998,97,22,75
'1165058100,  반포4동,'00,계,1998,18736,9291,9445
'1165058100,  반포4동,'05,0 - 4세,1998,1004,525,479
'1165058100,  반포4동,'10,5 - 9세,1998,1025,528,497
'1165058100,  반포4동,'15,10 - 14세,1998,1335,729,606
'1165058100,  반포4동,'20,15 - 19세,1998,1961,1033,928
'1165058100,  반포4동,'25,20 - 24세,1998,1758,903,855
'1165058100,  반포4동,'30,25 - 29세,1998,1836,851,985
'1165058100,  반포4동,'35,30 - 34세,1998,1427,736,691
'1165058100,  반포4동,'40,35 - 39세,1998,1475,639,836
'1165058100,  반포4동,'45,40 - 44세,1998,1894,850,1044
'1165058100,  반포4동,'50,45 - 49세,1998,1567,784,783
'1165058100,  반포4동,'55,50 - 54세,1998,1213,642,571
'1165058100,  반포4동,'60,55 - 59세,1998,843,465,378
'1165058100,  반포4동,'65,60 - 64세,1998,503,286,217
'1165058100,  반포4동,'70,65 - 69세,1998,314,136,178
'1165058100,  반포4동,'75,70 - 74세,1998,243,84,159
'1165058100,  반포4동,'80,75 - 79세,1998,169,52,117
'1165058100,  반포4동,'85,80 - 84세,1998,99,26,73
'1165058100,  반포4동,'90,85+ ,1998,70,22,48
'1165059000,  방배본동,'00,계,1998,18577,9028,9549
'1165059000,  방배본동,'05,0 - 4세,1998,917,473,444
'1165059000,  방배본동,'10,5 - 9세,1998,952,522,430
'1165059000,  방배본동,'15,10 - 14세,1998,1207,649,558
'1165059000,  방배본동,'20,15 - 19세,1998,1772,886,886
'1165059000,  방배본동,'25,20 - 24세,1998,1911,886,1025
'1165059000,  방배본동,'30,25 - 29세,1998,2150,1037,1113
'1165059000,  방배본동,'35,30 - 34세,1998,1404,736,668
'1165059000,  방배본동,'40,35 - 39세,1998,1406,644,762
'1165059000,  방배본동,'45,40 - 44세,1998,1539,661,878
'1165059000,  방배본동,'50,45 - 49세,1998,1372,655,717
'1165059000,  방배본동,'55,50 - 54세,1998,1280,609,671
'1165059000,  방배본동,'60,55 - 59세,1998,962,528,434
'1165059000,  방배본동,'65,60 - 64세,1998,681,351,330
'1165059000,  방배본동,'70,65 - 69세,1998,377,172,205
'1165059000,  방배본동,'75,70 - 74세,1998,236,91,145
'1165059000,  방배본동,'80,75 - 79세,1998,193,72,121
'1165059000,  방배본동,'85,80 - 84세,1998,124,33,91
'1165059000,  방배본동,'90,85+ ,1998,94,23,71
'1165060000,  방배1동,'00,계,1998,18203,9046,9157
'1165060000,  방배1동,'05,0 - 4세,1998,992,533,459
'1165060000,  방배1동,'10,5 - 9세,1998,805,429,376
'1165060000,  방배1동,'15,10 - 14세,1998,944,482,462
'1165060000,  방배1동,'20,15 - 19세,1998,1741,922,819
'1165060000,  방배1동,'25,20 - 24세,1998,2083,1034,1049
'1165060000,  방배1동,'30,25 - 29세,1998,2585,1286,1299
'1165060000,  방배1동,'35,30 - 34세,1998,1598,879,719
'1165060000,  방배1동,'40,35 - 39세,1998,1256,592,664
'1165060000,  방배1동,'45,40 - 44세,1998,1369,597,772
'1165060000,  방배1동,'50,45 - 49세,1998,1337,606,731
'1165060000,  방배1동,'55,50 - 54세,1998,1227,587,640
'1165060000,  방배1동,'60,55 - 59세,1998,947,531,416
'1165060000,  방배1동,'65,60 - 64세,1998,515,288,227
'1165060000,  방배1동,'70,65 - 69세,1998,287,133,154
'1165060000,  방배1동,'75,70 - 74세,1998,191,66,125
'1165060000,  방배1동,'80,75 - 79세,1998,175,45,130
'1165060000,  방배1동,'85,80 - 84세,1998,84,20,64
'1165060000,  방배1동,'90,85+ ,1998,67,16,51
'1165061000,  방배2동,'00,계,1998,32209,15908,16301
'1165061000,  방배2동,'05,0 - 4세,1998,1771,954,817
'1165061000,  방배2동,'10,5 - 9세,1998,1629,868,761
'1165061000,  방배2동,'15,10 - 14세,1998,1896,966,930
'1165061000,  방배2동,'20,15 - 19세,1998,3252,1640,1612
'1165061000,  방배2동,'25,20 - 24세,1998,3595,1769,1826
'1165061000,  방배2동,'30,25 - 29세,1998,4017,2026,1991
'1165061000,  방배2동,'35,30 - 34세,1998,2642,1412,1230
'1165061000,  방배2동,'40,35 - 39세,1998,2323,1082,1241
'1165061000,  방배2동,'45,40 - 44세,1998,2647,1152,1495
'1165061000,  방배2동,'50,45 - 49세,1998,2439,1115,1324
'1165061000,  방배2동,'55,50 - 54세,1998,2134,1061,1073
'1165061000,  방배2동,'60,55 - 59세,1998,1588,880,708
'1165061000,  방배2동,'65,60 - 64세,1998,879,482,397
'1165061000,  방배2동,'70,65 - 69세,1998,481,207,274
'1165061000,  방배2동,'75,70 - 74세,1998,341,124,217
'1165061000,  방배2동,'80,75 - 79세,1998,307,98,209
'1165061000,  방배2동,'85,80 - 84세,1998,162,44,118
'1165061000,  방배2동,'90,85+ ,1998,106,28,78
'1165062000,  방배3동,'00,계,1998,27011,13546,13465
'1165062000,  방배3동,'05,0 - 4세,1998,1364,718,646
'1165062000,  방배3동,'10,5 - 9세,1998,1481,773,708
'1165062000,  방배3동,'15,10 - 14세,1998,1775,949,826
'1165062000,  방배3동,'20,15 - 19세,1998,2783,1495,1288
'1165062000,  방배3동,'25,20 - 24세,1998,2686,1364,1322
'1165062000,  방배3동,'30,25 - 29세,1998,2927,1508,1419
'1165062000,  방배3동,'35,30 - 34세,1998,1971,1008,963
'1165062000,  방배3동,'40,35 - 39세,1998,1974,883,1091
'1165062000,  방배3동,'45,40 - 44세,1998,2537,1145,1392
'1165062000,  방배3동,'50,45 - 49세,1998,2171,1049,1122
'1165062000,  방배3동,'55,50 - 54세,1998,1852,937,915
'1165062000,  방배3동,'60,55 - 59세,1998,1347,785,562
'1165062000,  방배3동,'65,60 - 64세,1998,779,434,345
'1165062000,  방배3동,'70,65 - 69세,1998,466,201,265
'1165062000,  방배3동,'75,70 - 74세,1998,374,146,228
'1165062000,  방배3동,'80,75 - 79세,1998,266,76,190
'1165062000,  방배3동,'85,80 - 84세,1998,161,57,104
'1165062000,  방배3동,'90,85+ ,1998,97,18,79
'1165062100,  방배4동,'00,계,1998,19399,9472,9927
'1165062100,  방배4동,'05,0 - 4세,1998,939,482,457
'1165062100,  방배4동,'10,5 - 9세,1998,935,508,427
'1165062100,  방배4동,'15,10 - 14세,1998,1136,573,563
'1165062100,  방배4동,'20,15 - 19세,1998,2007,997,1010
'1165062100,  방배4동,'25,20 - 24세,1998,2192,1090,1102
'1165062100,  방배4동,'30,25 - 29세,1998,2266,1160,1106
'1165062100,  방배4동,'35,30 - 34세,1998,1470,723,747
'1165062100,  방배4동,'40,35 - 39세,1998,1423,667,756
'1165062100,  방배4동,'45,40 - 44세,1998,1585,666,919
'1165062100,  방배4동,'50,45 - 49세,1998,1514,685,829
'1165062100,  방배4동,'55,50 - 54세,1998,1365,679,686
'1165062100,  방배4동,'60,55 - 59세,1998,1019,573,446
'1165062100,  방배4동,'65,60 - 64세,1998,641,338,303
'1165062100,  방배4동,'70,65 - 69세,1998,330,142,188
'1165062100,  방배4동,'75,70 - 74세,1998,219,80,139
'1165062100,  방배4동,'80,75 - 79세,1998,157,51,106
'1165062100,  방배4동,'85,80 - 84세,1998,137,45,92
'1165062100,  방배4동,'90,85+ ,1998,64,13,51
'1165065100,  양재1동,'00,계,1998,28844,14337,14507
'1165065100,  양재1동,'05,0 - 4세,1998,1646,853,793
'1165065100,  양재1동,'10,5 - 9세,1998,1734,938,796
'1165065100,  양재1동,'15,10 - 14세,1998,1909,1002,907
'1165065100,  양재1동,'20,15 - 19세,1998,2770,1436,1334
'1165065100,  양재1동,'25,20 - 24세,1998,2809,1449,1360
'1165065100,  양재1동,'30,25 - 29세,1998,3249,1674,1575
'1165065100,  양재1동,'35,30 - 34세,1998,2461,1253,1208
'1165065100,  양재1동,'40,35 - 39세,1998,2547,1188,1359
'1165065100,  양재1동,'45,40 - 44세,1998,2626,1240,1386
'1165065100,  양재1동,'50,45 - 49세,1998,2063,951,1112
'1165065100,  양재1동,'55,50 - 54세,1998,1666,840,826
'1165065100,  양재1동,'60,55 - 59세,1998,1242,661,581
'1165065100,  양재1동,'65,60 - 64세,1998,748,373,375
'1165065100,  양재1동,'70,65 - 69세,1998,484,205,279
'1165065100,  양재1동,'75,70 - 74세,1998,356,120,236
'1165065100,  양재1동,'80,75 - 79세,1998,276,88,188
'1165065100,  양재1동,'85,80 - 84세,1998,155,45,110
'1165065100,  양재1동,'90,85+ ,1998,103,21,82
'1165065200,  양재2동,'00,계,1998,21765,11088,10677
'1165065200,  양재2동,'05,0 - 4세,1998,1853,971,882
'1165065200,  양재2동,'10,5 - 9세,1998,1214,655,559
'1165065200,  양재2동,'15,10 - 14세,1998,985,495,490
'1165065200,  양재2동,'20,15 - 19세,1998,1456,748,708
'1165065200,  양재2동,'25,20 - 24세,1998,1857,891,966
'1165065200,  양재2동,'30,25 - 29세,1998,3688,1801,1887
'1165065200,  양재2동,'35,30 - 34세,1998,2941,1695,1246
'1165065200,  양재2동,'40,35 - 39세,1998,1970,1077,893
'1165065200,  양재2동,'45,40 - 44세,1998,1592,783,809
'1165065200,  양재2동,'50,45 - 49세,1998,1073,510,563
'1165065200,  양재2동,'55,50 - 54세,1998,1041,509,532
'1165065200,  양재2동,'60,55 - 59세,1998,820,442,378
'1165065200,  양재2동,'65,60 - 64세,1998,497,249,248
'1165065200,  양재2동,'70,65 - 69세,1998,280,115,165
'1165065200,  양재2동,'75,70 - 74세,1998,216,78,138
'1165065200,  양재2동,'80,75 - 79세,1998,157,41,116
'1165065200,  양재2동,'85,80 - 84세,1998,79,21,58
'1165065200,  양재2동,'90,85+ ,1998,46,7,39
'1165066000,  내곡동,'00,계,1998,8900,4608,4292
'1165066000,  내곡동,'05,0 - 4세,1998,446,243,203
'1165066000,  내곡동,'10,5 - 9세,1998,488,262,226
'1165066000,  내곡동,'15,10 - 14세,1998,575,301,274
'1165066000,  내곡동,'20,15 - 19세,1998,814,440,374
'1165066000,  내곡동,'25,20 - 24세,1998,815,435,380
'1165066000,  내곡동,'30,25 - 29세,1998,963,551,412
'1165066000,  내곡동,'35,30 - 34세,1998,659,359,300
'1165066000,  내곡동,'40,35 - 39세,1998,721,353,368
'1165066000,  내곡동,'45,40 - 44세,1998,719,356,363
'1165066000,  내곡동,'50,45 - 49세,1998,618,298,320
'1165066000,  내곡동,'55,50 - 54세,1998,601,306,295
'1165066000,  내곡동,'60,55 - 59세,1998,521,294,227
'1165066000,  내곡동,'65,60 - 64세,1998,329,168,161
'1165066000,  내곡동,'70,65 - 69세,1998,241,103,138
'1165066000,  내곡동,'75,70 - 74세,1998,169,72,97
'1165066000,  내곡동,'80,75 - 79세,1998,111,39,72
'1165066000,  내곡동,'85,80 - 84세,1998,66,14,52
'1165066000,  내곡동,'90,85+ ,1998,44,14,30
'11680, 강남구,'00,계,1998,550387,271238,279149
'11680, 강남구,'05,0 - 4세,1998,27778,14577,13201
'11680, 강남구,'10,5 - 9세,1998,28337,15204,13133
'11680, 강남구,'15,10 - 14세,1998,37112,19921,17191
'11680, 강남구,'20,15 - 19세,1998,59044,31138,27906
'11680, 강남구,'25,20 - 24세,1998,56448,28033,28415
'11680, 강남구,'30,25 - 29세,1998,61515,30232,31283
'11680, 강남구,'35,30 - 34세,1998,43122,22162,20960
'11680, 강남구,'40,35 - 39세,1998,42383,19163,23220
'11680, 강남구,'45,40 - 44세,1998,51489,22223,29266
'11680, 강남구,'50,45 - 49세,1998,44983,21076,23907
'11680, 강남구,'55,50 - 54세,1998,36417,19097,17320
'11680, 강남구,'60,55 - 59세,1998,23471,13281,10190
'11680, 강남구,'65,60 - 64세,1998,12929,6779,6150
'11680, 강남구,'70,65 - 69세,1998,8244,3311,4933
'11680, 강남구,'75,70 - 74세,1998,6642,2078,4564
'11680, 강남구,'80,75 - 79세,1998,5312,1645,3667
'11680, 강남구,'85,80 - 84세,1998,3153,819,2334
'11680, 강남구,'90,85+ ,1998,2008,499,1509
'1168051000,  신사동,'00,계,1998,23598,11438,12160
'1168051000,  신사동,'05,0 - 4세,1998,970,495,475
'1168051000,  신사동,'10,5 - 9세,1998,1012,539,473
'1168051000,  신사동,'15,10 - 14세,1998,1323,719,604
'1168051000,  신사동,'20,15 - 19세,1998,2227,1183,1044
'1168051000,  신사동,'25,20 - 24세,1998,2757,1287,1470
'1168051000,  신사동,'30,25 - 29세,1998,3104,1490,1614
'1168051000,  신사동,'35,30 - 34세,1998,1913,982,931
'1168051000,  신사동,'40,35 - 39세,1998,1596,717,879
'1168051000,  신사동,'45,40 - 44세,1998,1845,795,1050
'1168051000,  신사동,'50,45 - 49세,1998,1779,774,1005
'1168051000,  신사동,'55,50 - 54세,1998,1739,845,894
'1168051000,  신사동,'60,55 - 59세,1998,1312,709,603
'1168051000,  신사동,'65,60 - 64세,1998,799,439,360
'1168051000,  신사동,'70,65 - 69세,1998,455,207,248
'1168051000,  신사동,'75,70 - 74세,1998,304,118,186
'1168051000,  신사동,'80,75 - 79세,1998,221,78,143
'1168051000,  신사동,'85,80 - 84세,1998,132,37,95
'1168051000,  신사동,'90,85+ ,1998,110,24,86
'1168052100,  논현1동,'00,계,1998,26300,12589,13711
'1168052100,  논현1동,'05,0 - 4세,1998,1474,758,716
'1168052100,  논현1동,'10,5 - 9세,1998,1084,605,479
'1168052100,  논현1동,'15,10 - 14세,1998,1145,564,581
'1168052100,  논현1동,'20,15 - 19세,1998,1855,929,926
'1168052100,  논현1동,'25,20 - 24세,1998,2981,1322,1659
'1168052100,  논현1동,'30,25 - 29세,1998,4855,2257,2598
'1168052100,  논현1동,'35,30 - 34세,1998,2874,1522,1352
'1168052100,  논현1동,'40,35 - 39세,1998,2043,1027,1016
'1168052100,  논현1동,'45,40 - 44세,1998,1850,806,1044
'1168052100,  논현1동,'50,45 - 49세,1998,1523,669,854
'1168052100,  논현1동,'55,50 - 54세,1998,1434,648,786
'1168052100,  논현1동,'60,55 - 59세,1998,1178,621,557
'1168052100,  논현1동,'65,60 - 64세,1998,751,367,384
'1168052100,  논현1동,'70,65 - 69세,1998,490,224,266
'1168052100,  논현1동,'75,70 - 74세,1998,293,119,174
'1168052100,  논현1동,'80,75 - 79세,1998,236,86,150
'1168052100,  논현1동,'85,80 - 84세,1998,136,39,97
'1168052100,  논현1동,'90,85+ ,1998,98,26,72
'1168053100,  논현2동,'00,계,1998,22817,11276,11541
'1168053100,  논현2동,'05,0 - 4세,1998,1114,606,508
'1168053100,  논현2동,'10,5 - 9세,1998,919,459,460
'1168053100,  논현2동,'15,10 - 14세,1998,1136,626,510
'1168053100,  논현2동,'20,15 - 19세,1998,1931,1043,888
'1168053100,  논현2동,'25,20 - 24세,1998,2610,1312,1298
'1168053100,  논현2동,'30,25 - 29세,1998,3368,1641,1727
'1168053100,  논현2동,'35,30 - 34세,1998,2057,1099,958
'1168053100,  논현2동,'40,35 - 39세,1998,1568,720,848
'1168053100,  논현2동,'45,40 - 44세,1998,1689,731,958
'1168053100,  논현2동,'50,45 - 49세,1998,1679,705,974
'1168053100,  논현2동,'55,50 - 54세,1998,1685,856,829
'1168053100,  논현2동,'60,55 - 59세,1998,1208,650,558
'1168053100,  논현2동,'65,60 - 64세,1998,713,406,307
'1168053100,  논현2동,'70,65 - 69세,1998,391,169,222
'1168053100,  논현2동,'75,70 - 74세,1998,262,110,152
'1168053100,  논현2동,'80,75 - 79세,1998,234,77,157
'1168053100,  논현2동,'85,80 - 84세,1998,148,38,110
'1168053100,  논현2동,'90,85+ ,1998,105,28,77
'1168054000,  압구정1동,'00,계,1998,19962,9918,10044
'1168054000,  압구정1동,'05,0 - 4세,1998,742,375,367
'1168054000,  압구정1동,'10,5 - 9세,1998,916,499,417
'1168054000,  압구정1동,'15,10 - 14세,1998,1238,678,560
'1168054000,  압구정1동,'20,15 - 19세,1998,2070,1078,992
'1168054000,  압구정1동,'25,20 - 24세,1998,2263,1111,1152
'1168054000,  압구정1동,'30,25 - 29세,1998,2348,1318,1030
'1168054000,  압구정1동,'35,30 - 34세,1998,1293,650,643
'1168054000,  압구정1동,'40,35 - 39세,1998,1218,548,670
'1168054000,  압구정1동,'45,40 - 44세,1998,1580,641,939
'1168054000,  압구정1동,'50,45 - 49세,1998,1652,700,952
'1168054000,  압구정1동,'55,50 - 54세,1998,1688,821,867
'1168054000,  압구정1동,'60,55 - 59세,1998,1233,704,529
'1168054000,  압구정1동,'65,60 - 64세,1998,661,401,260
'1168054000,  압구정1동,'70,65 - 69세,1998,373,170,203
'1168054000,  압구정1동,'75,70 - 74세,1998,272,98,174
'1168054000,  압구정1동,'80,75 - 79세,1998,199,69,130
'1168054000,  압구정1동,'85,80 - 84세,1998,128,31,97
'1168054000,  압구정1동,'90,85+ ,1998,88,26,62
'1168055000,  압구정2동,'00,계,1998,14375,6980,7395
'1168055000,  압구정2동,'05,0 - 4세,1998,640,339,301
'1168055000,  압구정2동,'10,5 - 9세,1998,624,325,299
'1168055000,  압구정2동,'15,10 - 14세,1998,797,426,371
'1168055000,  압구정2동,'20,15 - 19세,1998,1434,747,687
'1168055000,  압구정2동,'25,20 - 24세,1998,1566,822,744
'1168055000,  압구정2동,'30,25 - 29세,1998,1696,823,873
'1168055000,  압구정2동,'35,30 - 34세,1998,1091,544,547
'1168055000,  압구정2동,'40,35 - 39세,1998,945,430,515
'1168055000,  압구정2동,'45,40 - 44세,1998,1141,446,695
'1168055000,  압구정2동,'50,45 - 49세,1998,1183,517,666
'1168055000,  압구정2동,'55,50 - 54세,1998,1098,550,548
'1168055000,  압구정2동,'60,55 - 59세,1998,778,419,359
'1168055000,  압구정2동,'65,60 - 64세,1998,498,258,240
'1168055000,  압구정2동,'70,65 - 69세,1998,324,144,180
'1168055000,  압구정2동,'75,70 - 74세,1998,204,81,123
'1168055000,  압구정2동,'80,75 - 79세,1998,168,51,117
'1168055000,  압구정2동,'85,80 - 84세,1998,100,30,70
'1168055000,  압구정2동,'90,85+ ,1998,88,28,60
'1168056000,  청담1동,'00,계,1998,19487,9756,9731
'1168056000,  청담1동,'05,0 - 4세,1998,816,439,377
'1168056000,  청담1동,'10,5 - 9세,1998,863,465,398
'1168056000,  청담1동,'15,10 - 14세,1998,1270,693,577
'1168056000,  청담1동,'20,15 - 19세,1998,2186,1224,962
'1168056000,  청담1동,'25,20 - 24세,1998,2145,1180,965
'1168056000,  청담1동,'30,25 - 29세,1998,2014,1036,978
'1168056000,  청담1동,'35,30 - 34세,1998,1340,626,714
'1168056000,  청담1동,'40,35 - 39세,1998,1447,666,781
'1168056000,  청담1동,'45,40 - 44세,1998,1807,764,1043
'1168056000,  청담1동,'50,45 - 49세,1998,1716,780,936
'1168056000,  청담1동,'55,50 - 54세,1998,1483,754,729
'1168056000,  청담1동,'60,55 - 59세,1998,1001,569,432
'1168056000,  청담1동,'65,60 - 64세,1998,473,270,203
'1168056000,  청담1동,'70,65 - 69세,1998,288,125,163
'1168056000,  청담1동,'75,70 - 74세,1998,239,63,176
'1168056000,  청담1동,'80,75 - 79세,1998,194,57,137
'1168056000,  청담1동,'85,80 - 84세,1998,119,30,89
'1168056000,  청담1동,'90,85+ ,1998,86,15,71
'1168057000,  청담2동,'00,계,1998,13368,6556,6812
'1168057000,  청담2동,'05,0 - 4세,1998,550,292,258
'1168057000,  청담2동,'10,5 - 9세,1998,566,322,244
'1168057000,  청담2동,'15,10 - 14세,1998,641,346,295
'1168057000,  청담2동,'20,15 - 19세,1998,1235,667,568
'1168057000,  청담2동,'25,20 - 24세,1998,1642,834,808
'1168057000,  청담2동,'30,25 - 29세,1998,1902,928,974
'1168057000,  청담2동,'35,30 - 34세,1998,1159,579,580
'1168057000,  청담2동,'40,35 - 39세,1998,961,447,514
'1168057000,  청담2동,'45,40 - 44세,1998,987,405,582
'1168057000,  청담2동,'50,45 - 49세,1998,1047,445,602
'1168057000,  청담2동,'55,50 - 54세,1998,1015,504,511
'1168057000,  청담2동,'60,55 - 59세,1998,682,386,296
'1168057000,  청담2동,'65,60 - 64세,1998,358,200,158
'1168057000,  청담2동,'70,65 - 69세,1998,195,78,117
'1168057000,  청담2동,'75,70 - 74세,1998,163,41,122
'1168057000,  청담2동,'80,75 - 79세,1998,134,44,90
'1168057000,  청담2동,'85,80 - 84세,1998,75,22,53
'1168057000,  청담2동,'90,85+ ,1998,56,16,40
'1168058000,  삼성1동,'00,계,1998,14283,7353,6930
'1168058000,  삼성1동,'05,0 - 4세,1998,554,304,250
'1168058000,  삼성1동,'10,5 - 9세,1998,542,286,256
'1168058000,  삼성1동,'15,10 - 14세,1998,889,522,367
'1168058000,  삼성1동,'20,15 - 19세,1998,1687,1031,656
'1168058000,  삼성1동,'25,20 - 24세,1998,1670,912,758
'1168058000,  삼성1동,'30,25 - 29세,1998,1565,823,742
'1168058000,  삼성1동,'35,30 - 34세,1998,871,479,392
'1168058000,  삼성1동,'40,35 - 39세,1998,945,408,537
'1168058000,  삼성1동,'45,40 - 44세,1998,1290,527,763
'1168058000,  삼성1동,'50,45 - 49세,1998,1253,555,698
'1168058000,  삼성1동,'55,50 - 54세,1998,1158,600,558
'1168058000,  삼성1동,'60,55 - 59세,1998,789,463,326
'1168058000,  삼성1동,'65,60 - 64세,1998,377,201,176
'1168058000,  삼성1동,'70,65 - 69세,1998,221,102,119
'1168058000,  삼성1동,'75,70 - 74세,1998,162,56,106
'1168058000,  삼성1동,'80,75 - 79세,1998,140,43,97
'1168058000,  삼성1동,'85,80 - 84세,1998,102,25,77
'1168058000,  삼성1동,'90,85+ ,1998,68,16,52
'1168059000,  삼성2동,'00,계,1998,25356,12942,12414
'1168059000,  삼성2동,'05,0 - 4세,1998,1323,698,625
'1168059000,  삼성2동,'10,5 - 9세,1998,1106,580,526
'1168059000,  삼성2동,'15,10 - 14세,1998,1390,817,573
'1168059000,  삼성2동,'20,15 - 19세,1998,2663,1573,1090
'1168059000,  삼성2동,'25,20 - 24세,1998,2838,1564,1274
'1168059000,  삼성2동,'30,25 - 29세,1998,3184,1574,1610
'1168059000,  삼성2동,'35,30 - 34세,1998,2140,1143,997
'1168059000,  삼성2동,'40,35 - 39세,1998,1709,794,915
'1168059000,  삼성2동,'45,40 - 44세,1998,2146,889,1257
'1168059000,  삼성2동,'50,45 - 49세,1998,2176,958,1218
'1168059000,  삼성2동,'55,50 - 54세,1998,1910,984,926
'1168059000,  삼성2동,'60,55 - 59세,1998,1181,713,468
'1168059000,  삼성2동,'65,60 - 64세,1998,547,311,236
'1168059000,  삼성2동,'70,65 - 69세,1998,321,129,192
'1168059000,  삼성2동,'75,70 - 74세,1998,281,89,192
'1168059000,  삼성2동,'80,75 - 79세,1998,213,69,144
'1168059000,  삼성2동,'85,80 - 84세,1998,142,39,103
'1168059000,  삼성2동,'90,85+ ,1998,86,18,68
'1168060000,  대치1동,'00,계,1998,21365,10566,10799
'1168060000,  대치1동,'05,0 - 4세,1998,569,313,256
'1168060000,  대치1동,'10,5 - 9세,1998,972,547,425
'1168060000,  대치1동,'15,10 - 14세,1998,1965,1057,908
'1168060000,  대치1동,'20,15 - 19세,1998,3114,1598,1516
'1168060000,  대치1동,'25,20 - 24세,1998,2371,1162,1209
'1168060000,  대치1동,'30,25 - 29세,1998,1430,740,690
'1168060000,  대치1동,'35,30 - 34세,1998,801,375,426
'1168060000,  대치1동,'40,35 - 39세,1998,1210,453,757
'1168060000,  대치1동,'45,40 - 44세,1998,2413,961,1452
'1168060000,  대치1동,'50,45 - 49세,1998,2377,1171,1206
'1168060000,  대치1동,'55,50 - 54세,1998,1816,1013,803
'1168060000,  대치1동,'60,55 - 59세,1998,983,635,348
'1168060000,  대치1동,'65,60 - 64세,1998,441,254,187
'1168060000,  대치1동,'70,65 - 69세,1998,260,112,148
'1168060000,  대치1동,'75,70 - 74세,1998,234,65,169
'1168060000,  대치1동,'80,75 - 79세,1998,183,54,129
'1168060000,  대치1동,'85,80 - 84세,1998,132,35,97
'1168060000,  대치1동,'90,85+ ,1998,94,21,73
'1168061000,  대치2동,'00,계,1998,28758,14190,14568
'1168061000,  대치2동,'05,0 - 4세,1998,669,354,315
'1168061000,  대치2동,'10,5 - 9세,1998,1274,701,573
'1168061000,  대치2동,'15,10 - 14세,1998,2575,1419,1156
'1168061000,  대치2동,'20,15 - 19세,1998,4378,2260,2118
'1168061000,  대치2동,'25,20 - 24세,1998,3246,1608,1638
'1168061000,  대치2동,'30,25 - 29세,1998,1842,981,861
'1168061000,  대치2동,'35,30 - 34세,1998,884,441,443
'1168061000,  대치2동,'40,35 - 39세,1998,1660,601,1059
'1168061000,  대치2동,'45,40 - 44세,1998,3381,1338,2043
'1168061000,  대치2동,'50,45 - 49세,1998,3424,1640,1784
'1168061000,  대치2동,'55,50 - 54세,1998,2383,1408,975
'1168061000,  대치2동,'60,55 - 59세,1998,1179,733,446
'1168061000,  대치2동,'65,60 - 64세,1998,521,296,225
'1168061000,  대치2동,'70,65 - 69세,1998,385,142,243
'1168061000,  대치2동,'75,70 - 74세,1998,370,106,264
'1168061000,  대치2동,'80,75 - 79세,1998,309,94,215
'1168061000,  대치2동,'85,80 - 84세,1998,164,42,122
'1168061000,  대치2동,'90,85+ ,1998,114,26,88
'1168062000,  대치3동,'00,계,1998,16076,8224,7852
'1168062000,  대치3동,'05,0 - 4세,1998,494,255,239
'1168062000,  대치3동,'10,5 - 9세,1998,681,351,330
'1168062000,  대치3동,'15,10 - 14세,1998,1214,676,538
'1168062000,  대치3동,'20,15 - 19세,1998,2123,1227,896
'1168062000,  대치3동,'25,20 - 24세,1998,1882,990,892
'1168062000,  대치3동,'30,25 - 29세,1998,1466,815,651
'1168062000,  대치3동,'35,30 - 34세,1998,867,455,412
'1168062000,  대치3동,'40,35 - 39세,1998,1035,424,611
'1168062000,  대치3동,'45,40 - 44세,1998,1655,678,977
'1168062000,  대치3동,'50,45 - 49세,1998,1619,772,847
'1168062000,  대치3동,'55,50 - 54세,1998,1250,695,555
'1168062000,  대치3동,'60,55 - 59세,1998,730,464,266
'1168062000,  대치3동,'65,60 - 64세,1998,358,194,164
'1168062000,  대치3동,'70,65 - 69세,1998,223,97,126
'1168062000,  대치3동,'75,70 - 74세,1998,191,65,126
'1168062000,  대치3동,'80,75 - 79세,1998,130,28,102
'1168062000,  대치3동,'85,80 - 84세,1998,97,25,72
'1168062000,  대치3동,'90,85+ ,1998,61,13,48
'1168063000,  대치4동,'00,계,1998,17224,8498,8726
'1168063000,  대치4동,'05,0 - 4세,1998,990,520,470
'1168063000,  대치4동,'10,5 - 9세,1998,670,356,314
'1168063000,  대치4동,'15,10 - 14세,1998,809,441,368
'1168063000,  대치4동,'20,15 - 19세,1998,1607,823,784
'1168063000,  대치4동,'25,20 - 24세,1998,2069,983,1086
'1168063000,  대치4동,'30,25 - 29세,1998,2873,1374,1499
'1168063000,  대치4동,'35,30 - 34세,1998,1618,909,709
'1168063000,  대치4동,'40,35 - 39세,1998,1129,554,575
'1168063000,  대치4동,'45,40 - 44세,1998,1200,513,687
'1168063000,  대치4동,'50,45 - 49세,1998,1195,519,676
'1168063000,  대치4동,'55,50 - 54세,1998,1139,544,595
'1168063000,  대치4동,'60,55 - 59세,1998,847,491,356
'1168063000,  대치4동,'65,60 - 64세,1998,413,246,167
'1168063000,  대치4동,'70,65 - 69세,1998,217,98,119
'1168063000,  대치4동,'75,70 - 74세,1998,179,55,124
'1168063000,  대치4동,'80,75 - 79세,1998,140,45,95
'1168063000,  대치4동,'85,80 - 84세,1998,91,20,71
'1168063000,  대치4동,'90,85+ ,1998,38,7,31
'1168064000,  역삼1동,'00,계,1998,31225,15510,15715
'1168064000,  역삼1동,'05,0 - 4세,1998,1590,806,784
'1168064000,  역삼1동,'10,5 - 9세,1998,1158,622,536
'1168064000,  역삼1동,'15,10 - 14세,1998,1256,677,579
'1168064000,  역삼1동,'20,15 - 19세,1998,2379,1243,1136
'1168064000,  역삼1동,'25,20 - 24세,1998,3610,1667,1943
'1168064000,  역삼1동,'30,25 - 29세,1998,5756,2906,2850
'1168064000,  역삼1동,'35,30 - 34세,1998,3162,1800,1362
'1168064000,  역삼1동,'40,35 - 39세,1998,2242,1134,1108
'1168064000,  역삼1동,'45,40 - 44세,1998,2097,934,1163
'1168064000,  역삼1동,'50,45 - 49세,1998,2040,892,1148
'1168064000,  역삼1동,'55,50 - 54세,1998,1991,951,1040
'1168064000,  역삼1동,'60,55 - 59세,1998,1606,871,735
'1168064000,  역삼1동,'65,60 - 64세,1998,900,488,412
'1168064000,  역삼1동,'70,65 - 69세,1998,490,226,264
'1168064000,  역삼1동,'75,70 - 74세,1998,344,125,219
'1168064000,  역삼1동,'80,75 - 79세,1998,289,91,198
'1168064000,  역삼1동,'85,80 - 84세,1998,182,38,144
'1168064000,  역삼1동,'90,85+ ,1998,133,39,94
'1168065000,  역삼2동,'00,계,1998,30408,14706,15702
'1168065000,  역삼2동,'05,0 - 4세,1998,2081,1118,963
'1168065000,  역삼2동,'10,5 - 9세,1998,1439,778,661
'1168065000,  역삼2동,'15,10 - 14세,1998,1679,862,817
'1168065000,  역삼2동,'20,15 - 19세,1998,2917,1495,1422
'1168065000,  역삼2동,'25,20 - 24세,1998,3358,1570,1788
'1168065000,  역삼2동,'30,25 - 29세,1998,3928,1867,2061
'1168065000,  역삼2동,'35,30 - 34세,1998,2525,1331,1194
'1168065000,  역삼2동,'40,35 - 39세,1998,2096,945,1151
'1168065000,  역삼2동,'45,40 - 44세,1998,2487,1028,1459
'1168065000,  역삼2동,'50,45 - 49세,1998,2359,1048,1311
'1168065000,  역삼2동,'55,50 - 54세,1998,2197,1117,1080
'1168065000,  역삼2동,'60,55 - 59세,1998,1377,793,584
'1168065000,  역삼2동,'65,60 - 64세,1998,637,355,282
'1168065000,  역삼2동,'70,65 - 69세,1998,424,157,267
'1168065000,  역삼2동,'75,70 - 74세,1998,341,101,240
'1168065000,  역삼2동,'80,75 - 79세,1998,305,80,225
'1168065000,  역삼2동,'85,80 - 84세,1998,160,35,125
'1168065000,  역삼2동,'90,85+ ,1998,98,26,72
'1168065500,  도곡1동,'00,계,1998,21135,10414,10721
'1168065500,  도곡1동,'05,0 - 4세,1998,1190,618,572
'1168065500,  도곡1동,'10,5 - 9세,1998,1250,665,585
'1168065500,  도곡1동,'15,10 - 14세,1998,1532,805,727
'1168065500,  도곡1동,'20,15 - 19세,1998,2202,1098,1104
'1168065500,  도곡1동,'25,20 - 24세,1998,1898,955,943
'1168065500,  도곡1동,'30,25 - 29세,1998,2169,1055,1114
'1168065500,  도곡1동,'35,30 - 34세,1998,1763,894,869
'1168065500,  도곡1동,'40,35 - 39세,1998,1785,796,989
'1168065500,  도곡1동,'45,40 - 44세,1998,2114,971,1143
'1168065500,  도곡1동,'50,45 - 49세,1998,1622,782,840
'1168065500,  도곡1동,'55,50 - 54세,1998,1324,744,580
'1168065500,  도곡1동,'60,55 - 59세,1998,824,469,355
'1168065500,  도곡1동,'65,60 - 64세,1998,472,244,228
'1168065500,  도곡1동,'70,65 - 69세,1998,327,135,192
'1168065500,  도곡1동,'75,70 - 74세,1998,255,68,187
'1168065500,  도곡1동,'80,75 - 79세,1998,217,70,147
'1168065500,  도곡1동,'85,80 - 84세,1998,120,29,91
'1168065500,  도곡1동,'90,85+ ,1998,71,16,55
'1168065600,  도곡2동,'00,계,1998,17504,8513,8991
'1168065600,  도곡2동,'05,0 - 4세,1998,1084,580,504
'1168065600,  도곡2동,'10,5 - 9세,1998,954,506,448
'1168065600,  도곡2동,'15,10 - 14세,1998,1190,620,570
'1168065600,  도곡2동,'20,15 - 19세,1998,1779,888,891
'1168065600,  도곡2동,'25,20 - 24세,1998,1602,743,859
'1168065600,  도곡2동,'30,25 - 29세,1998,2053,965,1088
'1168065600,  도곡2동,'35,30 - 34세,1998,1588,876,712
'1168065600,  도곡2동,'40,35 - 39세,1998,1458,665,793
'1168065600,  도곡2동,'45,40 - 44세,1998,1697,728,969
'1168065600,  도곡2동,'50,45 - 49세,1998,1406,661,745
'1168065600,  도곡2동,'55,50 - 54세,1998,1060,570,490
'1168065600,  도곡2동,'60,55 - 59세,1998,601,343,258
'1168065600,  도곡2동,'65,60 - 64세,1998,313,147,166
'1168065600,  도곡2동,'70,65 - 69세,1998,234,88,146
'1168065600,  도곡2동,'75,70 - 74세,1998,202,60,142
'1168065600,  도곡2동,'80,75 - 79세,1998,150,44,106
'1168065600,  도곡2동,'85,80 - 84세,1998,97,19,78
'1168065600,  도곡2동,'90,85+ ,1998,36,10,26
'1168066000,  개포1동,'00,계,1998,24969,12216,12753
'1168066000,  개포1동,'05,0 - 4세,1998,1466,796,670
'1168066000,  개포1동,'10,5 - 9세,1998,1606,832,774
'1168066000,  개포1동,'15,10 - 14세,1998,2063,1087,976
'1168066000,  개포1동,'20,15 - 19세,1998,2904,1512,1392
'1168066000,  개포1동,'25,20 - 24세,1998,2034,982,1052
'1168066000,  개포1동,'30,25 - 29세,1998,2034,953,1081
'1168066000,  개포1동,'35,30 - 34세,1998,1966,940,1026
'1168066000,  개포1동,'40,35 - 39세,1998,2253,1002,1251
'1168066000,  개포1동,'45,40 - 44세,1998,2683,1162,1521
'1168066000,  개포1동,'50,45 - 49세,1998,2133,1067,1066
'1168066000,  개포1동,'55,50 - 54세,1998,1524,837,687
'1168066000,  개포1동,'60,55 - 59세,1998,880,533,347
'1168066000,  개포1동,'65,60 - 64세,1998,450,242,208
'1168066000,  개포1동,'70,65 - 69세,1998,305,105,200
'1168066000,  개포1동,'75,70 - 74세,1998,268,68,200
'1168066000,  개포1동,'80,75 - 79세,1998,217,65,152
'1168066000,  개포1동,'85,80 - 84세,1998,109,23,86
'1168066000,  개포1동,'90,85+ ,1998,74,10,64
'1168067000,  개포2동,'00,계,1998,21142,10379,10763
'1168067000,  개포2동,'05,0 - 4세,1998,1335,710,625
'1168067000,  개포2동,'10,5 - 9세,1998,1448,805,643
'1168067000,  개포2동,'15,10 - 14세,1998,1722,916,806
'1168067000,  개포2동,'20,15 - 19세,1998,2296,1150,1146
'1168067000,  개포2동,'25,20 - 24세,1998,1587,811,776
'1168067000,  개포2동,'30,25 - 29세,1998,1812,834,978
'1168067000,  개포2동,'35,30 - 34세,1998,1885,888,997
'1168067000,  개포2동,'40,35 - 39세,1998,2198,982,1216
'1168067000,  개포2동,'45,40 - 44세,1998,2341,1078,1263
'1168067000,  개포2동,'50,45 - 49세,1998,1734,902,832
'1168067000,  개포2동,'55,50 - 54세,1998,1067,617,450
'1168067000,  개포2동,'60,55 - 59세,1998,550,319,231
'1168067000,  개포2동,'65,60 - 64세,1998,319,135,184
'1168067000,  개포2동,'70,65 - 69세,1998,237,78,159
'1168067000,  개포2동,'75,70 - 74세,1998,244,68,176
'1168067000,  개포2동,'80,75 - 79세,1998,176,36,140
'1168067000,  개포2동,'85,80 - 84세,1998,127,31,96
'1168067000,  개포2동,'90,85+ ,1998,64,19,45
'1168068000,  개포3동,'00,계,1998,18977,9491,9486
'1168068000,  개포3동,'05,0 - 4세,1998,1677,868,809
'1168068000,  개포3동,'10,5 - 9세,1998,1763,936,827
'1168068000,  개포3동,'15,10 - 14세,1998,1708,895,813
'1168068000,  개포3동,'20,15 - 19세,1998,1875,964,911
'1168068000,  개포3동,'25,20 - 24세,1998,973,487,486
'1168068000,  개포3동,'30,25 - 29세,1998,1227,541,686
'1168068000,  개포3동,'35,30 - 34세,1998,2031,986,1045
'1168068000,  개포3동,'40,35 - 39세,1998,2220,1133,1087
'1168068000,  개포3동,'45,40 - 44세,1998,2112,1018,1094
'1168068000,  개포3동,'50,45 - 49세,1998,1384,764,620
'1168068000,  개포3동,'55,50 - 54세,1998,736,457,279
'1168068000,  개포3동,'60,55 - 59세,1998,320,176,144
'1168068000,  개포3동,'65,60 - 64세,1998,232,74,158
'1168068000,  개포3동,'70,65 - 69세,1998,209,52,157
'1168068000,  개포3동,'75,70 - 74세,1998,191,52,139
'1168068000,  개포3동,'80,75 - 79세,1998,157,43,114
'1168068000,  개포3동,'85,80 - 84세,1998,105,31,74
'1168068000,  개포3동,'90,85+ ,1998,57,14,43
'1168069000,  개포4동,'00,계,1998,23387,11528,11859
'1168069000,  개포4동,'05,0 - 4세,1998,1669,904,765
'1168069000,  개포4동,'10,5 - 9세,1998,1648,876,772
'1168069000,  개포4동,'15,10 - 14세,1998,1702,869,833
'1168069000,  개포4동,'20,15 - 19세,1998,2124,1115,1009
'1168069000,  개포4동,'25,20 - 24세,1998,1823,869,954
'1168069000,  개포4동,'30,25 - 29세,1998,2660,1232,1428
'1168069000,  개포4동,'35,30 - 34세,1998,2453,1199,1254
'1168069000,  개포4동,'40,35 - 39세,1998,2293,1066,1227
'1168069000,  개포4동,'45,40 - 44세,1998,2188,1060,1128
'1168069000,  개포4동,'50,45 - 49세,1998,1595,793,802
'1168069000,  개포4동,'55,50 - 54세,1998,1147,621,526
'1168069000,  개포4동,'60,55 - 59세,1998,753,424,329
'1168069000,  개포4동,'65,60 - 64세,1998,435,230,205
'1168069000,  개포4동,'70,65 - 69세,1998,283,109,174
'1168069000,  개포4동,'75,70 - 74세,1998,258,58,200
'1168069000,  개포4동,'80,75 - 79세,1998,212,66,146
'1168069000,  개포4동,'85,80 - 84세,1998,96,27,69
'1168069000,  개포4동,'90,85+ ,1998,48,10,38
'1168070000,  세곡동,'00,계,1998,7131,3707,3424
'1168070000,  세곡동,'05,0 - 4세,1998,408,224,184
'1168070000,  세곡동,'10,5 - 9세,1998,421,236,185
'1168070000,  세곡동,'15,10 - 14세,1998,359,187,172
'1168070000,  세곡동,'20,15 - 19세,1998,646,329,317
'1168070000,  세곡동,'25,20 - 24세,1998,676,369,307
'1168070000,  세곡동,'30,25 - 29세,1998,772,423,349
'1168070000,  세곡동,'35,30 - 34세,1998,566,311,255
'1168070000,  세곡동,'40,35 - 39세,1998,582,311,271
'1168070000,  세곡동,'45,40 - 44세,1998,550,278,272
'1168070000,  세곡동,'50,45 - 49세,1998,498,233,265
'1168070000,  세곡동,'55,50 - 54세,1998,499,270,229
'1168070000,  세곡동,'60,55 - 59세,1998,420,218,202
'1168070000,  세곡동,'65,60 - 64세,1998,304,167,137
'1168070000,  세곡동,'70,65 - 69세,1998,159,68,91
'1168070000,  세곡동,'75,70 - 74세,1998,84,31,53
'1168070000,  세곡동,'80,75 - 79세,1998,94,30,64
'1168070000,  세곡동,'85,80 - 84세,1998,58,15,43
'1168070000,  세곡동,'90,85+ ,1998,35,7,28
'1168072000,  일원본동,'00,계,1998,25128,12541,12587
'1168072000,  일원본동,'05,0 - 4세,1998,1400,711,689
'1168072000,  일원본동,'10,5 - 9세,1998,2058,1131,927
'1168072000,  일원본동,'15,10 - 14세,1998,2828,1552,1276
'1168072000,  일원본동,'20,15 - 19세,1998,2841,1442,1399
'1168072000,  일원본동,'25,20 - 24세,1998,1359,684,675
'1168072000,  일원본동,'30,25 - 29세,1998,1534,692,842
'1168072000,  일원본동,'35,30 - 34세,1998,1779,804,975
'1168072000,  일원본동,'40,35 - 39세,1998,2661,1064,1597
'1168072000,  일원본동,'45,40 - 44세,1998,3629,1785,1844
'1168072000,  일원본동,'50,45 - 49세,1998,2091,1235,856
'1168072000,  일원본동,'55,50 - 54세,1998,1065,651,414
'1168072000,  일원본동,'60,55 - 59세,1998,492,306,186
'1168072000,  일원본동,'65,60 - 64세,1998,349,145,204
'1168072000,  일원본동,'70,65 - 69세,1998,329,119,210
'1168072000,  일원본동,'75,70 - 74세,1998,296,88,208
'1168072000,  일원본동,'80,75 - 79세,1998,239,80,159
'1168072000,  일원본동,'85,80 - 84세,1998,115,37,78
'1168072000,  일원본동,'90,85+ ,1998,63,15,48
'1168073000,  일원1동,'00,계,1998,22802,11261,11541
'1168073000,  일원1동,'05,0 - 4세,1998,1130,561,569
'1168073000,  일원1동,'10,5 - 9세,1998,1349,713,636
'1168073000,  일원1동,'15,10 - 14세,1998,1610,857,753
'1168073000,  일원1동,'20,15 - 19세,1998,2750,1516,1234
'1168073000,  일원1동,'25,20 - 24세,1998,2385,1194,1191
'1168073000,  일원1동,'30,25 - 29세,1998,2035,1037,998
'1168073000,  일원1동,'35,30 - 34세,1998,1681,851,830
'1168073000,  일원1동,'40,35 - 39세,1998,1903,893,1010
'1168073000,  일원1동,'45,40 - 44세,1998,2251,986,1265
'1168073000,  일원1동,'50,45 - 49세,1998,1791,864,927
'1168073000,  일원1동,'55,50 - 54세,1998,1337,736,601
'1168073000,  일원1동,'60,55 - 59세,1998,856,446,410
'1168073000,  일원1동,'65,60 - 64세,1998,557,247,310
'1168073000,  일원1동,'70,65 - 69세,1998,385,127,258
'1168073000,  일원1동,'75,70 - 74세,1998,329,91,238
'1168073000,  일원1동,'80,75 - 79세,1998,250,80,170
'1168073000,  일원1동,'85,80 - 84세,1998,133,44,89
'1168073000,  일원1동,'90,85+ ,1998,70,18,52
'1168074000,  일원2동,'00,계,1998,22178,10731,11447
'1168074000,  일원2동,'05,0 - 4세,1998,1005,506,499
'1168074000,  일원2동,'10,5 - 9세,1998,1122,623,499
'1168074000,  일원2동,'15,10 - 14세,1998,1754,947,807
'1168074000,  일원2동,'20,15 - 19세,1998,2911,1492,1419
'1168074000,  일원2동,'25,20 - 24세,1998,2410,1224,1186
'1168074000,  일원2동,'30,25 - 29세,1998,2028,978,1050
'1168074000,  일원2동,'35,30 - 34세,1998,1547,793,754
'1168074000,  일원2동,'40,35 - 39세,1998,1710,715,995
'1168074000,  일원2동,'45,40 - 44세,1998,2397,989,1408
'1168074000,  일원2동,'50,45 - 49세,1998,2002,968,1034
'1168074000,  일원2동,'55,50 - 54세,1998,1363,708,655
'1168074000,  일원2동,'60,55 - 59세,1998,740,397,343
'1168074000,  일원2동,'65,60 - 64세,1998,383,174,209
'1168074000,  일원2동,'70,65 - 69세,1998,248,85,163
'1168074000,  일원2동,'75,70 - 74세,1998,228,55,173
'1168074000,  일원2동,'80,75 - 79세,1998,182,47,135
'1168074000,  일원2동,'85,80 - 84세,1998,99,19,80
'1168074000,  일원2동,'90,85+ ,1998,49,11,38
'1168075000,  수서동,'00,계,1998,21432,9955,11477
'1168075000,  수서동,'05,0 - 4세,1998,838,427,411
'1168075000,  수서동,'10,5 - 9세,1998,892,446,446
'1168075000,  수서동,'15,10 - 14세,1998,1317,663,654
'1168075000,  수서동,'20,15 - 19세,1998,2910,1511,1399
'1168075000,  수서동,'25,20 - 24세,1998,2693,1391,1302
'1168075000,  수서동,'30,25 - 29세,1998,1860,949,911
'1168075000,  수서동,'35,30 - 34세,1998,1268,685,583
'1168075000,  수서동,'40,35 - 39세,1998,1516,668,848
'1168075000,  수서동,'45,40 - 44세,1998,1959,712,1247
'1168075000,  수서동,'50,45 - 49세,1998,1705,662,1043
'1168075000,  수서동,'55,50 - 54세,1998,1309,596,713
'1168075000,  수서동,'60,55 - 59세,1998,951,429,522
'1168075000,  수서동,'65,60 - 64세,1998,668,288,380
'1168075000,  수서동,'70,65 - 69세,1998,471,165,306
'1168075000,  수서동,'75,70 - 74세,1998,448,147,301
'1168075000,  수서동,'80,75 - 79세,1998,323,118,205
'1168075000,  수서동,'85,80 - 84세,1998,186,58,128
'1168075000,  수서동,'90,85+ ,1998,118,40,78
'11710, 송파구,'00,계,1998,668879,332700,336179
'11710, 송파구,'05,0 - 4세,1998,43644,22835,20809
'11710, 송파구,'10,5 - 9세,1998,45257,24034,21223
'11710, 송파구,'15,10 - 14세,1998,47632,24990,22642
'11710, 송파구,'20,15 - 19세,1998,64823,33246,31577
'11710, 송파구,'25,20 - 24세,1998,57840,28188,29652
'11710, 송파구,'30,25 - 29세,1998,71001,34942,36059
'11710, 송파구,'35,30 - 34세,1998,61124,31227,29897
'11710, 송파구,'40,35 - 39세,1998,62599,30060,32539
'11710, 송파구,'45,40 - 44세,1998,62359,29410,32949
'11710, 송파구,'50,45 - 49세,1998,46810,23462,23348
'11710, 송파구,'55,50 - 54세,1998,35486,19029,16457
'11710, 송파구,'60,55 - 59세,1998,25279,13614,11665
'11710, 송파구,'65,60 - 64세,1998,16183,7880,8303
'11710, 송파구,'70,65 - 69세,1998,10568,4229,6339
'11710, 송파구,'75,70 - 74세,1998,7690,2551,5139
'11710, 송파구,'80,75 - 79세,1998,5567,1774,3793
'11710, 송파구,'85,80 - 84세,1998,3108,762,2346
'11710, 송파구,'90,85+ ,1998,1909,467,1442
'1171051000,  풍납1동,'00,계,1998,25713,12835,12878
'1171051000,  풍납1동,'05,0 - 4세,1998,1704,866,838
'1171051000,  풍납1동,'10,5 - 9세,1998,1736,920,816
'1171051000,  풍납1동,'15,10 - 14세,1998,1783,909,874
'1171051000,  풍납1동,'20,15 - 19세,1998,2221,1130,1091
'1171051000,  풍납1동,'25,20 - 24세,1998,2381,1141,1240
'1171051000,  풍납1동,'30,25 - 29세,1998,3004,1547,1457
'1171051000,  풍납1동,'35,30 - 34세,1998,2435,1274,1161
'1171051000,  풍납1동,'40,35 - 39세,1998,2513,1191,1322
'1171051000,  풍납1동,'45,40 - 44세,1998,2339,1199,1140
'1171051000,  풍납1동,'50,45 - 49세,1998,1519,783,736
'1171051000,  풍납1동,'55,50 - 54세,1998,1320,674,646
'1171051000,  풍납1동,'60,55 - 59세,1998,1055,534,521
'1171051000,  풍납1동,'65,60 - 64세,1998,674,328,346
'1171051000,  풍납1동,'70,65 - 69세,1998,403,148,255
'1171051000,  풍납1동,'75,70 - 74세,1998,261,100,161
'1171051000,  풍납1동,'80,75 - 79세,1998,194,53,141
'1171051000,  풍납1동,'85,80 - 84세,1998,118,22,96
'1171051000,  풍납1동,'90,85+ ,1998,53,16,37
'1171052000,  풍납2동,'00,계,1998,31323,15636,15687
'1171052000,  풍납2동,'05,0 - 4세,1998,2061,1055,1006
'1171052000,  풍납2동,'10,5 - 9세,1998,2114,1112,1002
'1171052000,  풍납2동,'15,10 - 14세,1998,2286,1195,1091
'1171052000,  풍납2동,'20,15 - 19세,1998,3053,1580,1473
'1171052000,  풍납2동,'25,20 - 24세,1998,2665,1288,1377
'1171052000,  풍납2동,'30,25 - 29세,1998,3378,1636,1742
'1171052000,  풍납2동,'35,30 - 34세,1998,2779,1430,1349
'1171052000,  풍납2동,'40,35 - 39세,1998,2976,1395,1581
'1171052000,  풍납2동,'45,40 - 44세,1998,3196,1588,1608
'1171052000,  풍납2동,'50,45 - 49세,1998,2205,1140,1065
'1171052000,  풍납2동,'55,50 - 54세,1998,1600,888,712
'1171052000,  풍납2동,'60,55 - 59세,1998,1069,599,470
'1171052000,  풍납2동,'65,60 - 64세,1998,673,317,356
'1171052000,  풍납2동,'70,65 - 69세,1998,469,169,300
'1171052000,  풍납2동,'75,70 - 74세,1998,353,123,230
'1171052000,  풍납2동,'80,75 - 79세,1998,251,82,169
'1171052000,  풍납2동,'85,80 - 84세,1998,130,28,102
'1171052000,  풍납2동,'90,85+ ,1998,65,11,54
'1171053100,  거여1동,'00,계,1998,16526,8394,8132
'1171053100,  거여1동,'05,0 - 4세,1998,1197,671,526
'1171053100,  거여1동,'10,5 - 9세,1998,1388,739,649
'1171053100,  거여1동,'15,10 - 14세,1998,1171,626,545
'1171053100,  거여1동,'20,15 - 19세,1998,1565,804,761
'1171053100,  거여1동,'25,20 - 24세,1998,1326,650,676
'1171053100,  거여1동,'30,25 - 29세,1998,1609,797,812
'1171053100,  거여1동,'35,30 - 34세,1998,1647,820,827
'1171053100,  거여1동,'40,35 - 39세,1998,1820,915,905
'1171053100,  거여1동,'45,40 - 44세,1998,1507,754,753
'1171053100,  거여1동,'50,45 - 49세,1998,987,521,466
'1171053100,  거여1동,'55,50 - 54세,1998,762,413,349
'1171053100,  거여1동,'60,55 - 59세,1998,591,322,269
'1171053100,  거여1동,'65,60 - 64세,1998,348,160,188
'1171053100,  거여1동,'70,65 - 69세,1998,215,83,132
'1171053100,  거여1동,'75,70 - 74세,1998,154,52,102
'1171053100,  거여1동,'80,75 - 79세,1998,130,39,91
'1171053100,  거여1동,'85,80 - 84세,1998,76,19,57
'1171053100,  거여1동,'90,85+ ,1998,33,9,24
'1171053200,  거여2동,'00,계,1998,31437,15968,15469
'1171053200,  거여2동,'05,0 - 4세,1998,2770,1450,1320
'1171053200,  거여2동,'10,5 - 9세,1998,2323,1254,1069
'1171053200,  거여2동,'15,10 - 14세,1998,1839,939,900
'1171053200,  거여2동,'20,15 - 19세,1998,2521,1340,1181
'1171053200,  거여2동,'25,20 - 24세,1998,2582,1275,1307
'1171053200,  거여2동,'30,25 - 29세,1998,3973,1924,2049
'1171053200,  거여2동,'35,30 - 34세,1998,3639,1923,1716
'1171053200,  거여2동,'40,35 - 39세,1998,3147,1673,1474
'1171053200,  거여2동,'45,40 - 44세,1998,2410,1243,1167
'1171053200,  거여2동,'50,45 - 49세,1998,1701,855,846
'1171053200,  거여2동,'55,50 - 54세,1998,1432,743,689
'1171053200,  거여2동,'60,55 - 59세,1998,1125,590,535
'1171053200,  거여2동,'65,60 - 64세,1998,734,352,382
'1171053200,  거여2동,'70,65 - 69세,1998,473,183,290
'1171053200,  거여2동,'75,70 - 74세,1998,327,111,216
'1171053200,  거여2동,'80,75 - 79세,1998,211,55,156
'1171053200,  거여2동,'85,80 - 84세,1998,144,31,113
'1171053200,  거여2동,'90,85+ ,1998,86,27,59
'1171054000,  마천1동,'00,계,1998,23339,11902,11437
'1171054000,  마천1동,'05,0 - 4세,1998,1687,893,794
'1171054000,  마천1동,'10,5 - 9세,1998,1614,866,748
'1171054000,  마천1동,'15,10 - 14세,1998,1414,750,664
'1171054000,  마천1동,'20,15 - 19세,1998,2089,1061,1028
'1171054000,  마천1동,'25,20 - 24세,1998,2207,1115,1092
'1171054000,  마천1동,'30,25 - 29세,1998,2679,1396,1283
'1171054000,  마천1동,'35,30 - 34세,1998,2303,1212,1091
'1171054000,  마천1동,'40,35 - 39세,1998,2187,1162,1025
'1171054000,  마천1동,'45,40 - 44세,1998,1778,879,899
'1171054000,  마천1동,'50,45 - 49세,1998,1399,703,696
'1171054000,  마천1동,'55,50 - 54세,1998,1206,629,577
'1171054000,  마천1동,'60,55 - 59세,1998,1035,536,499
'1171054000,  마천1동,'65,60 - 64세,1998,700,341,359
'1171054000,  마천1동,'70,65 - 69세,1998,411,165,246
'1171054000,  마천1동,'75,70 - 74세,1998,264,96,168
'1171054000,  마천1동,'80,75 - 79세,1998,202,63,139
'1171054000,  마천1동,'85,80 - 84세,1998,96,20,76
'1171054000,  마천1동,'90,85+ ,1998,68,15,53
'1171055000,  마천2동,'00,계,1998,25708,13122,12586
'1171055000,  마천2동,'05,0 - 4세,1998,1882,988,894
'1171055000,  마천2동,'10,5 - 9세,1998,1956,1047,909
'1171055000,  마천2동,'15,10 - 14세,1998,1829,953,876
'1171055000,  마천2동,'20,15 - 19세,1998,2191,1145,1046
'1171055000,  마천2동,'25,20 - 24세,1998,2134,1075,1059
'1171055000,  마천2동,'30,25 - 29세,1998,2696,1395,1301
'1171055000,  마천2동,'35,30 - 34세,1998,2603,1377,1226
'1171055000,  마천2동,'40,35 - 39세,1998,2744,1403,1341
'1171055000,  마천2동,'45,40 - 44세,1998,2170,1146,1024
'1171055000,  마천2동,'50,45 - 49세,1998,1413,739,674
'1171055000,  마천2동,'55,50 - 54세,1998,1176,612,564
'1171055000,  마천2동,'60,55 - 59세,1998,1048,524,524
'1171055000,  마천2동,'65,60 - 64세,1998,732,353,379
'1171055000,  마천2동,'70,65 - 69세,1998,419,177,242
'1171055000,  마천2동,'75,70 - 74세,1998,303,91,212
'1171055000,  마천2동,'80,75 - 79세,1998,210,61,149
'1171055000,  마천2동,'85,80 - 84세,1998,124,22,102
'1171055000,  마천2동,'90,85+ ,1998,78,14,64
'1171056100,  방이1동,'00,계,1998,16581,8279,8302
'1171056100,  방이1동,'05,0 - 4세,1998,816,395,421
'1171056100,  방이1동,'10,5 - 9세,1998,1136,596,540
'1171056100,  방이1동,'15,10 - 14세,1998,1393,727,666
'1171056100,  방이1동,'20,15 - 19세,1998,1783,907,876
'1171056100,  방이1동,'25,20 - 24세,1998,1428,713,715
'1171056100,  방이1동,'30,25 - 29세,1998,1419,780,639
'1171056100,  방이1동,'35,30 - 34세,1998,1289,641,648
'1171056100,  방이1동,'40,35 - 39세,1998,1593,742,851
'1171056100,  방이1동,'45,40 - 44세,1998,1690,801,889
'1171056100,  방이1동,'50,45 - 49세,1998,1287,648,639
'1171056100,  방이1동,'55,50 - 54세,1998,909,508,401
'1171056100,  방이1동,'60,55 - 59세,1998,640,333,307
'1171056100,  방이1동,'65,60 - 64세,1998,442,209,233
'1171056100,  방이1동,'70,65 - 69세,1998,293,138,155
'1171056100,  방이1동,'75,70 - 74세,1998,196,65,131
'1171056100,  방이1동,'80,75 - 79세,1998,153,52,101
'1171056100,  방이1동,'85,80 - 84세,1998,70,17,53
'1171056100,  방이1동,'90,85+ ,1998,44,7,37
'1171056200,  방이2동,'00,계,1998,24594,12245,12349
'1171056200,  방이2동,'05,0 - 4세,1998,1745,884,861
'1171056200,  방이2동,'10,5 - 9세,1998,1563,834,729
'1171056200,  방이2동,'15,10 - 14세,1998,1499,760,739
'1171056200,  방이2동,'20,15 - 19세,1998,2247,1185,1062
'1171056200,  방이2동,'25,20 - 24세,1998,2312,1127,1185
'1171056200,  방이2동,'30,25 - 29세,1998,3029,1515,1514
'1171056200,  방이2동,'35,30 - 34세,1998,2475,1285,1190
'1171056200,  방이2동,'40,35 - 39세,1998,2378,1168,1210
'1171056200,  방이2동,'45,40 - 44세,1998,2075,989,1086
'1171056200,  방이2동,'50,45 - 49세,1998,1567,755,812
'1171056200,  방이2동,'55,50 - 54세,1998,1215,637,578
'1171056200,  방이2동,'60,55 - 59세,1998,929,518,411
'1171056200,  방이2동,'65,60 - 64세,1998,565,253,312
'1171056200,  방이2동,'70,65 - 69세,1998,351,132,219
'1171056200,  방이2동,'75,70 - 74세,1998,259,93,166
'1171056200,  방이2동,'80,75 - 79세,1998,200,62,138
'1171056200,  방이2동,'85,80 - 84세,1998,108,26,82
'1171056200,  방이2동,'90,85+ ,1998,77,22,55
'1171056600,  오륜동,'00,계,1998,22694,11042,11652
'1171056600,  오륜동,'05,0 - 4세,1998,584,296,288
'1171056600,  오륜동,'10,5 - 9세,1998,1371,768,603
'1171056600,  오륜동,'15,10 - 14세,1998,2545,1313,1232
'1171056600,  오륜동,'20,15 - 19세,1998,3722,1894,1828
'1171056600,  오륜동,'25,20 - 24세,1998,1820,829,991
'1171056600,  오륜동,'30,25 - 29세,1998,934,452,482
'1171056600,  오륜동,'35,30 - 34세,1998,755,303,452
'1171056600,  오륜동,'40,35 - 39세,1998,1646,593,1053
'1171056600,  오륜동,'45,40 - 44세,1998,3039,1202,1837
'1171056600,  오륜동,'50,45 - 49세,1998,2719,1469,1250
'1171056600,  오륜동,'55,50 - 54세,1998,1507,967,540
'1171056600,  오륜동,'60,55 - 59세,1998,676,408,268
'1171056600,  오륜동,'65,60 - 64세,1998,439,232,207
'1171056600,  오륜동,'70,65 - 69세,1998,300,120,180
'1171056600,  오륜동,'75,70 - 74세,1998,232,77,155
'1171056600,  오륜동,'80,75 - 79세,1998,204,63,141
'1171056600,  오륜동,'85,80 - 84세,1998,115,32,83
'1171056600,  오륜동,'90,85+ ,1998,86,24,62
'1171057000,  오금동,'00,계,1998,39821,19875,19946
'1171057000,  오금동,'05,0 - 4세,1998,2611,1396,1215
'1171057000,  오금동,'10,5 - 9세,1998,2946,1545,1401
'1171057000,  오금동,'15,10 - 14세,1998,3152,1621,1531
'1171057000,  오금동,'20,15 - 19세,1998,4027,2025,2002
'1171057000,  오금동,'25,20 - 24세,1998,3037,1490,1547
'1171057000,  오금동,'30,25 - 29세,1998,3536,1750,1786
'1171057000,  오금동,'35,30 - 34세,1998,3500,1737,1763
'1171057000,  오금동,'40,35 - 39세,1998,4002,1901,2101
'1171057000,  오금동,'45,40 - 44세,1998,3962,1908,2054
'1171057000,  오금동,'50,45 - 49세,1998,2856,1518,1338
'1171057000,  오금동,'55,50 - 54세,1998,2006,1108,898
'1171057000,  오금동,'60,55 - 59세,1998,1403,770,633
'1171057000,  오금동,'65,60 - 64세,1998,987,472,515
'1171057000,  오금동,'70,65 - 69세,1998,649,275,374
'1171057000,  오금동,'75,70 - 74세,1998,500,166,334
'1171057000,  오금동,'80,75 - 79세,1998,356,117,239
'1171057000,  오금동,'85,80 - 84세,1998,183,50,133
'1171057000,  오금동,'90,85+ ,1998,108,26,82
'1171058000,  송파1동,'00,계,1998,25922,12863,13059
'1171058000,  송파1동,'05,0 - 4세,1998,1734,910,824
'1171058000,  송파1동,'10,5 - 9세,1998,1697,913,784
'1171058000,  송파1동,'15,10 - 14세,1998,1566,798,768
'1171058000,  송파1동,'20,15 - 19세,1998,2373,1201,1172
'1171058000,  송파1동,'25,20 - 24세,1998,2447,1148,1299
'1171058000,  송파1동,'30,25 - 29세,1998,3307,1669,1638
'1171058000,  송파1동,'35,30 - 34세,1998,2510,1283,1227
'1171058000,  송파1동,'40,35 - 39세,1998,2333,1148,1185
'1171058000,  송파1동,'45,40 - 44세,1998,2161,1014,1147
'1171058000,  송파1동,'50,45 - 49세,1998,1664,802,862
'1171058000,  송파1동,'55,50 - 54세,1998,1299,660,639
'1171058000,  송파1동,'60,55 - 59세,1998,1075,576,499
'1171058000,  송파1동,'65,60 - 64세,1998,690,354,336
'1171058000,  송파1동,'70,65 - 69세,1998,424,173,251
'1171058000,  송파1동,'75,70 - 74세,1998,282,103,179
'1171058000,  송파1동,'80,75 - 79세,1998,177,68,109
'1171058000,  송파1동,'85,80 - 84세,1998,109,28,81
'1171058000,  송파1동,'90,85+ ,1998,74,15,59
'1171059000,  송파2동,'00,계,1998,21007,10382,10625
'1171059000,  송파2동,'05,0 - 4세,1998,962,505,457
'1171059000,  송파2동,'10,5 - 9세,1998,1375,736,639
'1171059000,  송파2동,'15,10 - 14세,1998,1852,1012,840
'1171059000,  송파2동,'20,15 - 19세,1998,2734,1369,1365
'1171059000,  송파2동,'25,20 - 24세,1998,1755,903,852
'1171059000,  송파2동,'30,25 - 29세,1998,1481,757,724
'1171059000,  송파2동,'35,30 - 34세,1998,1343,630,713
'1171059000,  송파2동,'40,35 - 39세,1998,1851,794,1057
'1171059000,  송파2동,'45,40 - 44세,1998,2407,1028,1379
'1171059000,  송파2동,'50,45 - 49세,1998,1875,977,898
'1171059000,  송파2동,'55,50 - 54세,1998,1222,716,506
'1171059000,  송파2동,'60,55 - 59세,1998,725,409,316
'1171059000,  송파2동,'65,60 - 64세,1998,442,217,225
'1171059000,  송파2동,'70,65 - 69세,1998,347,134,213
'1171059000,  송파2동,'75,70 - 74세,1998,272,83,189
'1171059000,  송파2동,'80,75 - 79세,1998,185,61,124
'1171059000,  송파2동,'85,80 - 84세,1998,109,31,78
'1171059000,  송파2동,'90,85+ ,1998,70,20,50
'1171060000,  석촌동,'00,계,1998,32101,16052,16049
'1171060000,  석촌동,'05,0 - 4세,1998,2189,1121,1068
'1171060000,  석촌동,'10,5 - 9세,1998,1806,987,819
'1171060000,  석촌동,'15,10 - 14세,1998,1873,958,915
'1171060000,  석촌동,'20,15 - 19세,1998,2752,1427,1325
'1171060000,  석촌동,'25,20 - 24세,1998,3278,1582,1696
'1171060000,  석촌동,'30,25 - 29세,1998,4534,2314,2220
'1171060000,  석촌동,'35,30 - 34세,1998,3295,1816,1479
'1171060000,  석촌동,'40,35 - 39세,1998,2800,1361,1439
'1171060000,  석촌동,'45,40 - 44세,1998,2598,1197,1401
'1171060000,  석촌동,'50,45 - 49세,1998,1959,918,1041
'1171060000,  석촌동,'55,50 - 54세,1998,1681,820,861
'1171060000,  석촌동,'60,55 - 59세,1998,1313,715,598
'1171060000,  석촌동,'65,60 - 64세,1998,814,412,402
'1171060000,  석촌동,'70,65 - 69세,1998,457,201,256
'1171060000,  석촌동,'75,70 - 74세,1998,322,97,225
'1171060000,  석촌동,'80,75 - 79세,1998,219,70,149
'1171060000,  석촌동,'85,80 - 84세,1998,117,32,85
'1171060000,  석촌동,'90,85+ ,1998,94,24,70
'1171061000,  삼전동,'00,계,1998,33186,16430,16756
'1171061000,  삼전동,'05,0 - 4세,1998,2626,1376,1250
'1171061000,  삼전동,'10,5 - 9세,1998,2123,1087,1036
'1171061000,  삼전동,'15,10 - 14세,1998,2010,1025,985
'1171061000,  삼전동,'20,15 - 19세,1998,2807,1462,1345
'1171061000,  삼전동,'25,20 - 24세,1998,3064,1451,1613
'1171061000,  삼전동,'30,25 - 29세,1998,4519,2151,2368
'1171061000,  삼전동,'35,30 - 34세,1998,3735,2008,1727
'1171061000,  삼전동,'40,35 - 39세,1998,3034,1474,1560
'1171061000,  삼전동,'45,40 - 44세,1998,2735,1306,1429
'1171061000,  삼전동,'50,45 - 49세,1998,1940,941,999
'1171061000,  삼전동,'55,50 - 54세,1998,1583,824,759
'1171061000,  삼전동,'60,55 - 59세,1998,1160,619,541
'1171061000,  삼전동,'65,60 - 64세,1998,716,346,370
'1171061000,  삼전동,'70,65 - 69세,1998,430,170,260
'1171061000,  삼전동,'75,70 - 74세,1998,291,90,201
'1171061000,  삼전동,'80,75 - 79세,1998,204,57,147
'1171061000,  삼전동,'85,80 - 84세,1998,127,23,104
'1171061000,  삼전동,'90,85+ ,1998,82,20,62
'1171062000,  가락본동,'00,계,1998,25491,12849,12642
'1171062000,  가락본동,'05,0 - 4세,1998,1780,932,848
'1171062000,  가락본동,'10,5 - 9세,1998,1911,973,938
'1171062000,  가락본동,'15,10 - 14세,1998,1906,1025,881
'1171062000,  가락본동,'20,15 - 19세,1998,2359,1229,1130
'1171062000,  가락본동,'25,20 - 24세,1998,1894,977,917
'1171062000,  가락본동,'30,25 - 29세,1998,2673,1339,1334
'1171062000,  가락본동,'35,30 - 34세,1998,2529,1287,1242
'1171062000,  가락본동,'40,35 - 39세,1998,2651,1299,1352
'1171062000,  가락본동,'45,40 - 44세,1998,2407,1163,1244
'1171062000,  가락본동,'50,45 - 49세,1998,1694,900,794
'1171062000,  가락본동,'55,50 - 54세,1998,1184,605,579
'1171062000,  가락본동,'60,55 - 59세,1998,918,480,438
'1171062000,  가락본동,'65,60 - 64세,1998,614,308,306
'1171062000,  가락본동,'70,65 - 69세,1998,351,145,206
'1171062000,  가락본동,'75,70 - 74세,1998,268,83,185
'1171062000,  가락본동,'80,75 - 79세,1998,184,65,119
'1171062000,  가락본동,'85,80 - 84세,1998,95,19,76
'1171062000,  가락본동,'90,85+ ,1998,73,20,53
'1171063100,  가락1동,'00,계,1998,23058,11527,11531
'1171063100,  가락1동,'05,0 - 4세,1998,1992,1012,980
'1171063100,  가락1동,'10,5 - 9세,1998,1831,970,861
'1171063100,  가락1동,'15,10 - 14세,1998,1564,845,719
'1171063100,  가락1동,'20,15 - 19세,1998,1879,1013,866
'1171063100,  가락1동,'25,20 - 24세,1998,1646,856,790
'1171063100,  가락1동,'30,25 - 29세,1998,2436,1148,1288
'1171063100,  가락1동,'35,30 - 34세,1998,2609,1305,1304
'1171063100,  가락1동,'40,35 - 39세,1998,2495,1264,1231
'1171063100,  가락1동,'45,40 - 44세,1998,2060,981,1079
'1171063100,  가락1동,'50,45 - 49세,1998,1453,736,717
'1171063100,  가락1동,'55,50 - 54세,1998,1013,555,458
'1171063100,  가락1동,'60,55 - 59세,1998,713,376,337
'1171063100,  가락1동,'65,60 - 64세,1998,449,186,263
'1171063100,  가락1동,'70,65 - 69세,1998,335,113,222
'1171063100,  가락1동,'75,70 - 74세,1998,248,74,174
'1171063100,  가락1동,'80,75 - 79세,1998,182,60,122
'1171063100,  가락1동,'85,80 - 84세,1998,99,20,79
'1171063100,  가락1동,'90,85+ ,1998,54,13,41
'1171063200,  가락2동,'00,계,1998,36979,18482,18497
'1171063200,  가락2동,'05,0 - 4세,1998,2729,1454,1275
'1171063200,  가락2동,'10,5 - 9세,1998,3470,1851,1619
'1171063200,  가락2동,'15,10 - 14세,1998,3373,1787,1586
'1171063200,  가락2동,'20,15 - 19세,1998,3294,1685,1609
'1171063200,  가락2동,'25,20 - 24세,1998,2247,1081,1166
'1171063200,  가락2동,'30,25 - 29세,1998,2976,1392,1584
'1171063200,  가락2동,'35,30 - 34세,1998,3535,1655,1880
'1171063200,  가락2동,'40,35 - 39세,1998,4374,2062,2312
'1171063200,  가락2동,'45,40 - 44세,1998,3969,2031,1938
'1171063200,  가락2동,'50,45 - 49세,1998,2378,1301,1077
'1171063200,  가락2동,'55,50 - 54세,1998,1436,805,631
'1171063200,  가락2동,'60,55 - 59세,1998,951,520,431
'1171063200,  가락2동,'65,60 - 64세,1998,712,327,385
'1171063200,  가락2동,'70,65 - 69세,1998,587,219,368
'1171063200,  가락2동,'75,70 - 74세,1998,435,168,267
'1171063200,  가락2동,'80,75 - 79세,1998,287,92,195
'1171063200,  가락2동,'85,80 - 84세,1998,136,31,105
'1171063200,  가락2동,'90,85+ ,1998,90,21,69
'1171064100,  문정1동,'00,계,1998,20474,10218,10256
'1171064100,  문정1동,'05,0 - 4세,1998,1472,788,684
'1171064100,  문정1동,'10,5 - 9세,1998,1669,879,790
'1171064100,  문정1동,'15,10 - 14세,1998,1486,778,708
'1171064100,  문정1동,'20,15 - 19세,1998,1815,942,873
'1171064100,  문정1동,'25,20 - 24세,1998,1580,753,827
'1171064100,  문정1동,'30,25 - 29세,1998,2099,1063,1036
'1171064100,  문정1동,'35,30 - 34세,1998,1998,974,1024
'1171064100,  문정1동,'40,35 - 39세,1998,2223,1108,1115
'1171064100,  문정1동,'45,40 - 44세,1998,1919,948,971
'1171064100,  문정1동,'50,45 - 49세,1998,1251,617,634
'1171064100,  문정1동,'55,50 - 54세,1998,941,540,401
'1171064100,  문정1동,'60,55 - 59세,1998,677,343,334
'1171064100,  문정1동,'65,60 - 64세,1998,462,214,248
'1171064100,  문정1동,'70,65 - 69세,1998,328,130,198
'1171064100,  문정1동,'75,70 - 74세,1998,217,59,158
'1171064100,  문정1동,'80,75 - 79세,1998,203,52,151
'1171064100,  문정1동,'85,80 - 84세,1998,87,23,64
'1171064100,  문정1동,'90,85+ ,1998,47,7,40
'1171064200,  문정2동,'00,계,1998,17727,8790,8937
'1171064200,  문정2동,'05,0 - 4세,1998,527,287,240
'1171064200,  문정2동,'10,5 - 9세,1998,875,464,411
'1171064200,  문정2동,'15,10 - 14세,1998,1414,749,665
'1171064200,  문정2동,'20,15 - 19세,1998,2145,1094,1051
'1171064200,  문정2동,'25,20 - 24세,1998,1721,877,844
'1171064200,  문정2동,'30,25 - 29세,1998,1349,707,642
'1171064200,  문정2동,'35,30 - 34세,1998,782,355,427
'1171064200,  문정2동,'40,35 - 39세,1998,1128,466,662
'1171064200,  문정2동,'45,40 - 44세,1998,1775,735,1040
'1171064200,  문정2동,'50,45 - 49세,1998,1738,852,886
'1171064200,  문정2동,'55,50 - 54세,1998,1408,760,648
'1171064200,  문정2동,'60,55 - 59세,1998,1109,602,507
'1171064200,  문정2동,'65,60 - 64세,1998,709,416,293
'1171064200,  문정2동,'70,65 - 69세,1998,415,201,214
'1171064200,  문정2동,'75,70 - 74세,1998,254,99,155
'1171064200,  문정2동,'80,75 - 79세,1998,184,81,103
'1171064200,  문정2동,'85,80 - 84세,1998,116,27,89
'1171064200,  문정2동,'90,85+ ,1998,78,18,60
'1171064600,  장지동,'00,계,1998,21336,10742,10594
'1171064600,  장지동,'05,0 - 4세,1998,1823,937,886
'1171064600,  장지동,'10,5 - 9세,1998,1790,941,849
'1171064600,  장지동,'15,10 - 14세,1998,1507,799,708
'1171064600,  장지동,'20,15 - 19세,1998,1732,912,820
'1171064600,  장지동,'25,20 - 24세,1998,1388,684,704
'1171064600,  장지동,'30,25 - 29세,1998,2267,1085,1182
'1171064600,  장지동,'35,30 - 34세,1998,2455,1266,1189
'1171064600,  장지동,'40,35 - 39세,1998,2426,1180,1246
'1171064600,  장지동,'45,40 - 44세,1998,2056,1088,968
'1171064600,  장지동,'50,45 - 49세,1998,1108,591,517
'1171064600,  장지동,'55,50 - 54세,1998,812,428,384
'1171064600,  장지동,'60,55 - 59세,1998,630,325,305
'1171064600,  장지동,'65,60 - 64세,1998,457,221,236
'1171064600,  장지동,'70,65 - 69세,1998,344,127,217
'1171064600,  장지동,'75,70 - 74세,1998,251,75,176
'1171064600,  장지동,'80,75 - 79세,1998,170,56,114
'1171064600,  장지동,'85,80 - 84세,1998,71,19,52
'1171064600,  장지동,'90,85+ ,1998,49,8,41
'1171065000,  잠실본동,'00,계,1998,30199,14675,15524
'1171065000,  잠실본동,'05,0 - 4세,1998,1762,949,813
'1171065000,  잠실본동,'10,5 - 9세,1998,1615,842,773
'1171065000,  잠실본동,'15,10 - 14세,1998,1841,926,915
'1171065000,  잠실본동,'20,15 - 19세,1998,2965,1432,1533
'1171065000,  잠실본동,'25,20 - 24세,1998,3184,1401,1783
'1171065000,  잠실본동,'30,25 - 29세,1998,4170,2009,2161
'1171065000,  잠실본동,'35,30 - 34세,1998,2852,1540,1312
'1171065000,  잠실본동,'40,35 - 39세,1998,2524,1208,1316
'1171065000,  잠실본동,'45,40 - 44세,1998,2561,1145,1416
'1171065000,  잠실본동,'50,45 - 49세,1998,2131,1014,1117
'1171065000,  잠실본동,'55,50 - 54세,1998,1673,918,755
'1171065000,  잠실본동,'60,55 - 59세,1998,1115,596,519
'1171065000,  잠실본동,'65,60 - 64세,1998,649,323,326
'1171065000,  잠실본동,'70,65 - 69세,1998,433,175,258
'1171065000,  잠실본동,'75,70 - 74세,1998,298,93,205
'1171065000,  잠실본동,'80,75 - 79세,1998,226,59,167
'1171065000,  잠실본동,'85,80 - 84세,1998,118,26,92
'1171065000,  잠실본동,'90,85+ ,1998,82,19,63
'1171066000,  잠실1동,'00,계,1998,15234,7423,7811
'1171066000,  잠실1동,'05,0 - 4세,1998,1087,573,514
'1171066000,  잠실1동,'10,5 - 9세,1998,944,505,439
'1171066000,  잠실1동,'15,10 - 14세,1998,917,496,421
'1171066000,  잠실1동,'20,15 - 19세,1998,1242,662,580
'1171066000,  잠실1동,'25,20 - 24세,1998,1292,658,634
'1171066000,  잠실1동,'30,25 - 29세,1998,1994,952,1042
'1171066000,  잠실1동,'35,30 - 34세,1998,1693,880,813
'1171066000,  잠실1동,'40,35 - 39세,1998,1496,719,777
'1171066000,  잠실1동,'45,40 - 44세,1998,1408,622,786
'1171066000,  잠실1동,'50,45 - 49세,1998,960,439,521
'1171066000,  잠실1동,'55,50 - 54세,1998,737,380,357
'1171066000,  잠실1동,'60,55 - 59세,1998,477,226,251
'1171066000,  잠실1동,'65,60 - 64세,1998,302,124,178
'1171066000,  잠실1동,'70,65 - 69세,1998,213,64,149
'1171066000,  잠실1동,'75,70 - 74세,1998,193,47,146
'1171066000,  잠실1동,'80,75 - 79세,1998,144,38,106
'1171066000,  잠실1동,'85,80 - 84세,1998,97,28,69
'1171066000,  잠실1동,'90,85+ ,1998,38,10,28
'1171067000,  잠실2동,'00,계,1998,14361,7023,7338
'1171067000,  잠실2동,'05,0 - 4세,1998,1042,552,490
'1171067000,  잠실2동,'10,5 - 9세,1998,910,481,429
'1171067000,  잠실2동,'15,10 - 14세,1998,1001,547,454
'1171067000,  잠실2동,'20,15 - 19세,1998,1354,731,623
'1171067000,  잠실2동,'25,20 - 24세,1998,1199,592,607
'1171067000,  잠실2동,'30,25 - 29세,1998,1606,715,891
'1171067000,  잠실2동,'35,30 - 34세,1998,1452,749,703
'1171067000,  잠실2동,'40,35 - 39세,1998,1269,622,647
'1171067000,  잠실2동,'45,40 - 44세,1998,1406,615,791
'1171067000,  잠실2동,'50,45 - 49세,1998,1088,530,558
'1171067000,  잠실2동,'55,50 - 54세,1998,729,361,368
'1171067000,  잠실2동,'60,55 - 59세,1998,447,250,197
'1171067000,  잠실2동,'65,60 - 64세,1998,243,100,143
'1171067000,  잠실2동,'70,65 - 69세,1998,190,60,130
'1171067000,  잠실2동,'75,70 - 74세,1998,172,44,128
'1171067000,  잠실2동,'80,75 - 79세,1998,129,40,89
'1171067000,  잠실2동,'85,80 - 84세,1998,78,24,54
'1171067000,  잠실2동,'90,85+ ,1998,46,10,36
'1171068000,  잠실3동,'00,계,1998,19554,9548,10006
'1171068000,  잠실3동,'05,0 - 4세,1998,1353,692,661
'1171068000,  잠실3동,'10,5 - 9세,1998,1228,620,608
'1171068000,  잠실3동,'15,10 - 14세,1998,1311,703,608
'1171068000,  잠실3동,'20,15 - 19세,1998,1922,955,967
'1171068000,  잠실3동,'25,20 - 24세,1998,1695,847,848
'1171068000,  잠실3동,'30,25 - 29세,1998,2046,975,1071
'1171068000,  잠실3동,'35,30 - 34세,1998,1789,887,902
'1171068000,  잠실3동,'40,35 - 39세,1998,1757,857,900
'1171068000,  잠실3동,'45,40 - 44세,1998,1842,850,992
'1171068000,  잠실3동,'50,45 - 49세,1998,1476,713,763
'1171068000,  잠실3동,'55,50 - 54세,1998,1131,574,557
'1171068000,  잠실3동,'60,55 - 59세,1998,749,409,340
'1171068000,  잠실3동,'65,60 - 64세,1998,412,200,212
'1171068000,  잠실3동,'70,65 - 69세,1998,269,96,173
'1171068000,  잠실3동,'75,70 - 74세,1998,245,79,166
'1171068000,  잠실3동,'80,75 - 79세,1998,183,54,129
'1171068000,  잠실3동,'85,80 - 84세,1998,101,26,75
'1171068000,  잠실3동,'90,85+ ,1998,45,11,34
'1171069000,  잠실4동,'00,계,1998,30607,15111,15496
'1171069000,  잠실4동,'05,0 - 4세,1998,2067,1095,972
'1171069000,  잠실4동,'10,5 - 9세,1998,1763,948,815
'1171069000,  잠실4동,'15,10 - 14세,1998,1871,1028,843
'1171069000,  잠실4동,'20,15 - 19세,1998,2675,1414,1261
'1171069000,  잠실4동,'25,20 - 24세,1998,2763,1391,1372
'1171069000,  잠실4동,'30,25 - 29세,1998,3574,1686,1888
'1171069000,  잠실4동,'35,30 - 34세,1998,2965,1547,1418
'1171069000,  잠실4동,'40,35 - 39세,1998,2467,1219,1248
'1171069000,  잠실4동,'45,40 - 44세,1998,2611,1186,1425
'1171069000,  잠실4동,'50,45 - 49세,1998,2212,1001,1211
'1171069000,  잠실4동,'55,50 - 54세,1998,1875,968,907
'1171069000,  잠실4동,'60,55 - 59세,1998,1360,706,654
'1171069000,  잠실4동,'65,60 - 64세,1998,857,387,470
'1171069000,  잠실4동,'70,65 - 69세,1998,554,220,334
'1171069000,  잠실4동,'75,70 - 74세,1998,411,140,271
'1171069000,  잠실4동,'80,75 - 79세,1998,293,93,200
'1171069000,  잠실4동,'85,80 - 84세,1998,187,56,131
'1171069000,  잠실4동,'90,85+ ,1998,102,26,76
'1171070000,  잠실5동,'00,계,1998,15610,7662,7948
'1171070000,  잠실5동,'05,0 - 4세,1998,332,178,154
'1171070000,  잠실5동,'10,5 - 9세,1998,615,343,272
'1171070000,  잠실5동,'15,10 - 14세,1998,1103,600,503
'1171070000,  잠실5동,'20,15 - 19세,1998,2195,1132,1063
'1171070000,  잠실5동,'25,20 - 24세,1998,1966,968,998
'1171070000,  잠실5동,'30,25 - 29세,1998,1196,601,595
'1171070000,  잠실5동,'35,30 - 34세,1998,532,261,271
'1171070000,  잠실5동,'40,35 - 39세,1998,838,311,527
'1171070000,  잠실5동,'45,40 - 44세,1998,1600,653,947
'1171070000,  잠실5동,'50,45 - 49세,1998,1738,807,931
'1171070000,  잠실5동,'55,50 - 54세,1998,1495,825,670
'1171070000,  잠실5동,'60,55 - 59세,1998,814,506,308
'1171070000,  잠실5동,'65,60 - 64세,1998,381,222,159
'1171070000,  잠실5동,'70,65 - 69세,1998,260,94,166
'1171070000,  잠실5동,'75,70 - 74세,1998,236,82,154
'1171070000,  잠실5동,'80,75 - 79세,1998,140,39,101
'1171070000,  잠실5동,'85,80 - 84세,1998,98,23,75
'1171070000,  잠실5동,'90,85+ ,1998,71,17,54
'1171071000,  잠실6동,'00,계,1998,16251,7865,8386
'1171071000,  잠실6동,'05,0 - 4세,1998,638,330,308
'1171071000,  잠실6동,'10,5 - 9세,1998,823,455,368
'1171071000,  잠실6동,'15,10 - 14세,1998,1211,656,555
'1171071000,  잠실6동,'20,15 - 19세,1998,1767,878,889
'1171071000,  잠실6동,'25,20 - 24세,1998,1643,781,862
'1171071000,  잠실6동,'30,25 - 29세,1998,1581,735,846
'1171071000,  잠실6동,'35,30 - 34세,1998,981,479,502
'1171071000,  잠실6동,'40,35 - 39세,1998,1168,505,663
'1171071000,  잠실6동,'45,40 - 44세,1998,1541,665,876
'1171071000,  잠실6동,'50,45 - 49세,1998,1370,666,704
'1171071000,  잠실6동,'55,50 - 54세,1998,1199,614,585
'1171071000,  잠실6동,'60,55 - 59세,1998,871,465,406
'1171071000,  잠실6동,'65,60 - 64세,1998,533,274,259
'1171071000,  잠실6동,'70,65 - 69세,1998,324,164,160
'1171071000,  잠실6동,'75,70 - 74세,1998,241,86,155
'1171071000,  잠실6동,'80,75 - 79세,1998,184,64,120
'1171071000,  잠실6동,'85,80 - 84세,1998,111,32,79
'1171071000,  잠실6동,'90,85+ ,1998,65,16,49
'1171072000,  잠실7동,'00,계,1998,12046,5760,6286
'1171072000,  잠실7동,'05,0 - 4세,1998,472,250,222
'1171072000,  잠실7동,'10,5 - 9세,1998,665,358,307
'1171072000,  잠실7동,'15,10 - 14세,1998,915,465,450
'1171072000,  잠실7동,'20,15 - 19세,1998,1394,637,757
'1171072000,  잠실7동,'25,20 - 24세,1998,1186,535,651
'1171072000,  잠실7동,'30,25 - 29세,1998,936,452,484
'1171072000,  잠실7동,'35,30 - 34세,1998,644,303,341
'1171072000,  잠실7동,'40,35 - 39세,1998,759,320,439
'1171072000,  잠실7동,'45,40 - 44세,1998,1137,474,663
'1171072000,  잠실7동,'50,45 - 49세,1998,1122,526,596
'1171072000,  잠실7동,'55,50 - 54세,1998,935,497,438
'1171072000,  잠실7동,'60,55 - 59세,1998,604,357,247
'1171072000,  잠실7동,'65,60 - 64세,1998,447,232,215
'1171072000,  잠실7동,'70,65 - 69세,1998,324,153,171
'1171072000,  잠실7동,'75,70 - 74세,1998,205,75,130
'1171072000,  잠실7동,'80,75 - 79세,1998,162,78,84
'1171072000,  잠실7동,'85,80 - 84세,1998,88,27,61
'1171072000,  잠실7동,'90,85+ ,1998,51,21,30
'11740, 강동구,'00,계,1998,488585,246330,242255
'11740, 강동구,'05,0 - 4세,1998,30339,15839,14500
'11740, 강동구,'10,5 - 9세,1998,33601,17854,15747
'11740, 강동구,'15,10 - 14세,1998,36871,20019,16852
'11740, 강동구,'20,15 - 19세,1998,51006,27186,23820
'11740, 강동구,'25,20 - 24세,1998,41530,21052,20478
'11740, 강동구,'30,25 - 29세,1998,45289,22911,22378
'11740, 강동구,'35,30 - 34세,1998,42102,21158,20944
'11740, 강동구,'40,35 - 39세,1998,48407,23028,25379
'11740, 강동구,'45,40 - 44세,1998,49021,23239,25782
'11740, 강동구,'50,45 - 49세,1998,35417,18399,17018
'11740, 강동구,'55,50 - 54세,1998,25081,13889,11192
'11740, 강동구,'60,55 - 59세,1998,17333,9367,7966
'11740, 강동구,'65,60 - 64세,1998,11222,5379,5843
'11740, 강동구,'70,65 - 69세,1998,7669,2835,4834
'11740, 강동구,'75,70 - 74세,1998,5839,1870,3969
'11740, 강동구,'80,75 - 79세,1998,4297,1380,2917
'11740, 강동구,'85,80 - 84세,1998,2234,611,1623
'11740, 강동구,'90,85+ ,1998,1327,314,1013
'1174051000,  하일동,'00,계,1998,5766,3017,2749
'1174051000,  하일동,'05,0 - 4세,1998,202,109,93
'1174051000,  하일동,'10,5 - 9세,1998,303,157,146
'1174051000,  하일동,'15,10 - 14세,1998,399,209,190
'1174051000,  하일동,'20,15 - 19세,1998,625,333,292
'1174051000,  하일동,'25,20 - 24세,1998,563,316,247
'1174051000,  하일동,'30,25 - 29세,1998,483,300,183
'1174051000,  하일동,'35,30 - 34세,1998,429,234,195
'1174051000,  하일동,'40,35 - 39세,1998,535,278,257
'1174051000,  하일동,'45,40 - 44세,1998,490,257,233
'1174051000,  하일동,'50,45 - 49세,1998,387,219,168
'1174051000,  하일동,'55,50 - 54세,1998,352,176,176
'1174051000,  하일동,'60,55 - 59세,1998,351,176,175
'1174051000,  하일동,'65,60 - 64세,1998,244,110,134
'1174051000,  하일동,'70,65 - 69세,1998,161,65,96
'1174051000,  하일동,'75,70 - 74세,1998,109,41,68
'1174051000,  하일동,'80,75 - 79세,1998,87,26,61
'1174051000,  하일동,'85,80 - 84세,1998,26,5,21
'1174051000,  하일동,'90,85+ ,1998,20,6,14
'1174052000,  상일동,'00,계,1998,33980,17146,16834
'1174052000,  상일동,'05,0 - 4세,1998,1974,1014,960
'1174052000,  상일동,'10,5 - 9세,1998,2683,1483,1200
'1174052000,  상일동,'15,10 - 14세,1998,3220,1770,1450
'1174052000,  상일동,'20,15 - 19세,1998,4046,2188,1858
'1174052000,  상일동,'25,20 - 24세,1998,2369,1269,1100
'1174052000,  상일동,'30,25 - 29세,1998,2121,1032,1089
'1174052000,  상일동,'35,30 - 34세,1998,2558,1154,1404
'1174052000,  상일동,'40,35 - 39세,1998,3683,1642,2041
'1174052000,  상일동,'45,40 - 44세,1998,4008,1867,2141
'1174052000,  상일동,'50,45 - 49세,1998,2702,1488,1214
'1174052000,  상일동,'55,50 - 54세,1998,1578,953,625
'1174052000,  상일동,'60,55 - 59세,1998,933,513,420
'1174052000,  상일동,'65,60 - 64세,1998,620,305,315
'1174052000,  상일동,'70,65 - 69세,1998,522,175,347
'1174052000,  상일동,'75,70 - 74세,1998,377,122,255
'1174052000,  상일동,'80,75 - 79세,1998,313,100,213
'1174052000,  상일동,'85,80 - 84세,1998,180,49,131
'1174052000,  상일동,'90,85+ ,1998,93,22,71
'1174053000,  명일1동,'00,계,1998,31473,15611,15862
'1174053000,  명일1동,'05,0 - 4세,1998,1628,863,765
'1174053000,  명일1동,'10,5 - 9세,1998,2077,1118,959
'1174053000,  명일1동,'15,10 - 14세,1998,2879,1552,1327
'1174053000,  명일1동,'20,15 - 19세,1998,3856,2013,1843
'1174053000,  명일1동,'25,20 - 24세,1998,2523,1282,1241
'1174053000,  명일1동,'30,25 - 29세,1998,2184,1058,1126
'1174053000,  명일1동,'35,30 - 34세,1998,2095,1010,1085
'1174053000,  명일1동,'40,35 - 39세,1998,3047,1291,1756
'1174053000,  명일1동,'45,40 - 44세,1998,3845,1720,2125
'1174053000,  명일1동,'50,45 - 49세,1998,2708,1451,1257
'1174053000,  명일1동,'55,50 - 54세,1998,1644,996,648
'1174053000,  명일1동,'60,55 - 59세,1998,877,490,387
'1174053000,  명일1동,'65,60 - 64세,1998,625,291,334
'1174053000,  명일1동,'70,65 - 69세,1998,466,152,314
'1174053000,  명일1동,'75,70 - 74세,1998,452,140,312
'1174053000,  명일1동,'80,75 - 79세,1998,321,117,204
'1174053000,  명일1동,'85,80 - 84세,1998,161,46,115
'1174053000,  명일1동,'90,85+ ,1998,85,21,64
'1174054000,  명일2동,'00,계,1998,20926,10551,10375
'1174054000,  명일2동,'05,0 - 4세,1998,532,296,236
'1174054000,  명일2동,'10,5 - 9세,1998,1206,649,557
'1174054000,  명일2동,'15,10 - 14세,1998,2282,1306,976
'1174054000,  명일2동,'20,15 - 19세,1998,3432,1889,1543
'1174054000,  명일2동,'25,20 - 24세,1998,1717,895,822
'1174054000,  명일2동,'30,25 - 29세,1998,846,452,394
'1174054000,  명일2동,'35,30 - 34세,1998,694,291,403
'1174054000,  명일2동,'40,35 - 39세,1998,1742,616,1126
'1174054000,  명일2동,'45,40 - 44세,1998,2947,1213,1734
'1174054000,  명일2동,'50,45 - 49세,1998,2377,1334,1043
'1174054000,  명일2동,'55,50 - 54세,1998,1209,788,421
'1174054000,  명일2동,'60,55 - 59세,1998,555,338,217
'1174054000,  명일2동,'65,60 - 64세,1998,343,160,183
'1174054000,  명일2동,'70,65 - 69세,1998,330,114,216
'1174054000,  명일2동,'75,70 - 74세,1998,323,98,225
'1174054000,  명일2동,'80,75 - 79세,1998,223,80,143
'1174054000,  명일2동,'85,80 - 84세,1998,100,21,79
'1174054000,  명일2동,'90,85+ ,1998,68,11,57
'1174055000,  고덕1동,'00,계,1998,27902,14229,13673
'1174055000,  고덕1동,'05,0 - 4세,1998,2063,1072,991
'1174055000,  고덕1동,'10,5 - 9세,1998,2506,1307,1199
'1174055000,  고덕1동,'15,10 - 14세,1998,2741,1623,1118
'1174055000,  고덕1동,'20,15 - 19세,1998,2757,1572,1185
'1174055000,  고덕1동,'25,20 - 24세,1998,1480,794,686
'1174055000,  고덕1동,'30,25 - 29세,1998,1852,861,991
'1174055000,  고덕1동,'35,30 - 34세,1998,2588,1205,1383
'1174055000,  고덕1동,'40,35 - 39세,1998,3589,1662,1927
'1174055000,  고덕1동,'45,40 - 44세,1998,3231,1650,1581
'1174055000,  고덕1동,'50,45 - 49세,1998,1777,992,785
'1174055000,  고덕1동,'55,50 - 54세,1998,994,591,403
'1174055000,  고덕1동,'60,55 - 59세,1998,587,319,268
'1174055000,  고덕1동,'65,60 - 64세,1998,453,181,272
'1174055000,  고덕1동,'70,65 - 69세,1998,378,120,258
'1174055000,  고덕1동,'75,70 - 74세,1998,340,101,239
'1174055000,  고덕1동,'80,75 - 79세,1998,307,99,208
'1174055000,  고덕1동,'85,80 - 84세,1998,159,51,108
'1174055000,  고덕1동,'90,85+ ,1998,100,29,71
'1174056000,  고덕2동,'00,계,1998,23170,11824,11346
'1174056000,  고덕2동,'05,0 - 4세,1998,1717,929,788
'1174056000,  고덕2동,'10,5 - 9세,1998,1904,1035,869
'1174056000,  고덕2동,'15,10 - 14세,1998,1950,1050,900
'1174056000,  고덕2동,'20,15 - 19세,1998,2315,1224,1091
'1174056000,  고덕2동,'25,20 - 24세,1998,1676,852,824
'1174056000,  고덕2동,'30,25 - 29세,1998,1941,965,976
'1174056000,  고덕2동,'35,30 - 34세,1998,2207,1053,1154
'1174056000,  고덕2동,'40,35 - 39세,1998,2707,1337,1370
'1174056000,  고덕2동,'45,40 - 44세,1998,2399,1199,1200
'1174056000,  고덕2동,'50,45 - 49세,1998,1517,826,691
'1174056000,  고덕2동,'55,50 - 54세,1998,972,587,385
'1174056000,  고덕2동,'60,55 - 59세,1998,594,323,271
'1174056000,  고덕2동,'65,60 - 64세,1998,404,189,215
'1174056000,  고덕2동,'70,65 - 69세,1998,283,87,196
'1174056000,  고덕2동,'75,70 - 74세,1998,241,76,165
'1174056000,  고덕2동,'80,75 - 79세,1998,183,48,135
'1174056000,  고덕2동,'85,80 - 84세,1998,101,26,75
'1174056000,  고덕2동,'90,85+ ,1998,59,18,41
'1174057000,  암사1동,'00,계,1998,25101,12698,12403
'1174057000,  암사1동,'05,0 - 4세,1998,1801,935,866
'1174057000,  암사1동,'10,5 - 9세,1998,1665,868,797
'1174057000,  암사1동,'15,10 - 14세,1998,1378,736,642
'1174057000,  암사1동,'20,15 - 19세,1998,2224,1168,1056
'1174057000,  암사1동,'25,20 - 24세,1998,2429,1217,1212
'1174057000,  암사1동,'30,25 - 29세,1998,2989,1546,1443
'1174057000,  암사1동,'35,30 - 34세,1998,2571,1380,1191
'1174057000,  암사1동,'40,35 - 39세,1998,2334,1188,1146
'1174057000,  암사1동,'45,40 - 44세,1998,1994,956,1038
'1174057000,  암사1동,'50,45 - 49세,1998,1582,781,801
'1174057000,  암사1동,'55,50 - 54세,1998,1372,673,699
'1174057000,  암사1동,'60,55 - 59세,1998,1029,580,449
'1174057000,  암사1동,'65,60 - 64세,1998,652,323,329
'1174057000,  암사1동,'70,65 - 69세,1998,435,166,269
'1174057000,  암사1동,'75,70 - 74세,1998,295,82,213
'1174057000,  암사1동,'80,75 - 79세,1998,185,61,124
'1174057000,  암사1동,'85,80 - 84세,1998,105,27,78
'1174057000,  암사1동,'90,85+ ,1998,61,11,50
'1174058000,  암사2동,'00,계,1998,6414,3210,3204
'1174058000,  암사2동,'05,0 - 4세,1998,430,217,213
'1174058000,  암사2동,'10,5 - 9세,1998,460,237,223
'1174058000,  암사2동,'15,10 - 14세,1998,427,228,199
'1174058000,  암사2동,'20,15 - 19세,1998,614,298,316
'1174058000,  암사2동,'25,20 - 24세,1998,580,283,297
'1174058000,  암사2동,'30,25 - 29세,1998,601,317,284
'1174058000,  암사2동,'35,30 - 34세,1998,610,287,323
'1174058000,  암사2동,'40,35 - 39세,1998,677,340,337
'1174058000,  암사2동,'45,40 - 44세,1998,577,290,287
'1174058000,  암사2동,'50,45 - 49세,1998,422,203,219
'1174058000,  암사2동,'55,50 - 54세,1998,350,204,146
'1174058000,  암사2동,'60,55 - 59세,1998,226,125,101
'1174058000,  암사2동,'65,60 - 64세,1998,164,79,85
'1174058000,  암사2동,'70,65 - 69세,1998,105,44,61
'1174058000,  암사2동,'75,70 - 74세,1998,64,21,43
'1174058000,  암사2동,'80,75 - 79세,1998,59,21,38
'1174058000,  암사2동,'85,80 - 84세,1998,35,11,24
'1174058000,  암사2동,'90,85+ ,1998,13,5,8
'1174059000,  암사3동,'00,계,1998,16301,8221,8080
'1174059000,  암사3동,'05,0 - 4세,1998,1213,642,571
'1174059000,  암사3동,'10,5 - 9세,1998,1179,620,559
'1174059000,  암사3동,'15,10 - 14세,1998,1012,529,483
'1174059000,  암사3동,'20,15 - 19세,1998,1483,782,701
'1174059000,  암사3동,'25,20 - 24세,1998,1425,739,686
'1174059000,  암사3동,'30,25 - 29세,1998,1597,771,826
'1174059000,  암사3동,'35,30 - 34세,1998,1597,810,787
'1174059000,  암사3동,'40,35 - 39세,1998,1627,828,799
'1174059000,  암사3동,'45,40 - 44세,1998,1502,717,785
'1174059000,  암사3동,'50,45 - 49세,1998,1163,582,581
'1174059000,  암사3동,'55,50 - 54세,1998,809,469,340
'1174059000,  암사3동,'60,55 - 59세,1998,578,307,271
'1174059000,  암사3동,'65,60 - 64세,1998,412,184,228
'1174059000,  암사3동,'70,65 - 69세,1998,246,84,162
'1174059000,  암사3동,'75,70 - 74세,1998,194,59,135
'1174059000,  암사3동,'80,75 - 79세,1998,149,62,87
'1174059000,  암사3동,'85,80 - 84세,1998,81,32,49
'1174059000,  암사3동,'90,85+ ,1998,34,4,30
'1174059100,  암사4동,'00,계,1998,17365,8766,8599
'1174059100,  암사4동,'05,0 - 4세,1998,1121,582,539
'1174059100,  암사4동,'10,5 - 9세,1998,1116,605,511
'1174059100,  암사4동,'15,10 - 14세,1998,1075,571,504
'1174059100,  암사4동,'20,15 - 19세,1998,1755,922,833
'1174059100,  암사4동,'25,20 - 24세,1998,1673,849,824
'1174059100,  암사4동,'30,25 - 29세,1998,1825,936,889
'1174059100,  암사4동,'35,30 - 34세,1998,1542,795,747
'1174059100,  암사4동,'40,35 - 39세,1998,1563,747,816
'1174059100,  암사4동,'45,40 - 44세,1998,1569,767,802
'1174059100,  암사4동,'50,45 - 49세,1998,1210,593,617
'1174059100,  암사4동,'55,50 - 54세,1998,993,557,436
'1174059100,  암사4동,'60,55 - 59세,1998,729,398,331
'1174059100,  암사4동,'65,60 - 64세,1998,442,204,238
'1174059100,  암사4동,'70,65 - 69세,1998,277,106,171
'1174059100,  암사4동,'75,70 - 74세,1998,207,56,151
'1174059100,  암사4동,'80,75 - 79세,1998,169,56,113
'1174059100,  암사4동,'85,80 - 84세,1998,62,16,46
'1174059100,  암사4동,'90,85+ ,1998,37,6,31
'1174060000,  천호1동,'00,계,1998,33704,17036,16668
'1174060000,  천호1동,'05,0 - 4세,1998,2185,1156,1029
'1174060000,  천호1동,'10,5 - 9세,1998,2072,1093,979
'1174060000,  천호1동,'15,10 - 14세,1998,1993,1088,905
'1174060000,  천호1동,'20,15 - 19세,1998,3271,1667,1604
'1174060000,  천호1동,'25,20 - 24세,1998,3358,1650,1708
'1174060000,  천호1동,'30,25 - 29세,1998,3858,2003,1855
'1174060000,  천호1동,'35,30 - 34세,1998,3210,1700,1510
'1174060000,  천호1동,'40,35 - 39세,1998,3055,1540,1515
'1174060000,  천호1동,'45,40 - 44세,1998,2937,1422,1515
'1174060000,  천호1동,'50,45 - 49세,1998,2234,1097,1137
'1174060000,  천호1동,'55,50 - 54세,1998,1862,972,890
'1174060000,  천호1동,'60,55 - 59세,1998,1392,730,662
'1174060000,  천호1동,'65,60 - 64세,1998,881,450,431
'1174060000,  천호1동,'70,65 - 69세,1998,567,205,362
'1174060000,  천호1동,'75,70 - 74세,1998,360,117,243
'1174060000,  천호1동,'80,75 - 79세,1998,253,76,177
'1174060000,  천호1동,'85,80 - 84세,1998,144,49,95
'1174060000,  천호1동,'90,85+ ,1998,72,21,51
'1174061000,  천호2동,'00,계,1998,18629,9391,9238
'1174061000,  천호2동,'05,0 - 4세,1998,1194,596,598
'1174061000,  천호2동,'10,5 - 9세,1998,1266,622,644
'1174061000,  천호2동,'15,10 - 14세,1998,1114,596,518
'1174061000,  천호2동,'20,15 - 19세,1998,1584,814,770
'1174061000,  천호2동,'25,20 - 24세,1998,1755,858,897
'1174061000,  천호2동,'30,25 - 29세,1998,2195,1150,1045
'1174061000,  천호2동,'35,30 - 34세,1998,1911,1039,872
'1174061000,  천호2동,'40,35 - 39세,1998,1808,934,874
'1174061000,  천호2동,'45,40 - 44세,1998,1505,746,759
'1174061000,  천호2동,'50,45 - 49세,1998,1123,562,561
'1174061000,  천호2동,'55,50 - 54세,1998,973,482,491
'1174061000,  천호2동,'60,55 - 59세,1998,862,443,419
'1174061000,  천호2동,'65,60 - 64세,1998,549,280,269
'1174061000,  천호2동,'70,65 - 69세,1998,278,101,177
'1174061000,  천호2동,'75,70 - 74세,1998,237,83,154
'1174061000,  천호2동,'80,75 - 79세,1998,158,55,103
'1174061000,  천호2동,'85,80 - 84세,1998,71,14,57
'1174061000,  천호2동,'90,85+ ,1998,46,16,30
'1174062000,  천호3동,'00,계,1998,29906,15078,14828
'1174062000,  천호3동,'05,0 - 4세,1998,2081,1031,1050
'1174062000,  천호3동,'10,5 - 9세,1998,1852,972,880
'1174062000,  천호3동,'15,10 - 14세,1998,1664,861,803
'1174062000,  천호3동,'20,15 - 19세,1998,2493,1322,1171
'1174062000,  천호3동,'25,20 - 24세,1998,2856,1385,1471
'1174062000,  천호3동,'30,25 - 29세,1998,3727,1907,1820
'1174062000,  천호3동,'35,30 - 34세,1998,3152,1690,1462
'1174062000,  천호3동,'40,35 - 39세,1998,2774,1455,1319
'1174062000,  천호3동,'45,40 - 44세,1998,2414,1207,1207
'1174062000,  천호3동,'50,45 - 49세,1998,1818,873,945
'1174062000,  천호3동,'55,50 - 54세,1998,1604,798,806
'1174062000,  천호3동,'60,55 - 59세,1998,1354,711,643
'1174062000,  천호3동,'65,60 - 64세,1998,823,425,398
'1174062000,  천호3동,'70,65 - 69세,1998,485,185,300
'1174062000,  천호3동,'75,70 - 74세,1998,331,118,213
'1174062000,  천호3동,'80,75 - 79세,1998,239,71,168
'1174062000,  천호3동,'85,80 - 84세,1998,150,44,106
'1174062000,  천호3동,'90,85+ ,1998,89,23,66
'1174063000,  천호4동,'00,계,1998,23577,11918,11659
'1174063000,  천호4동,'05,0 - 4세,1998,1627,854,773
'1174063000,  천호4동,'10,5 - 9세,1998,1618,867,751
'1174063000,  천호4동,'15,10 - 14세,1998,1503,780,723
'1174063000,  천호4동,'20,15 - 19세,1998,2023,1064,959
'1174063000,  천호4동,'25,20 - 24세,1998,2072,1017,1055
'1174063000,  천호4동,'30,25 - 29세,1998,2665,1393,1272
'1174063000,  천호4동,'35,30 - 34세,1998,2427,1251,1176
'1174063000,  천호4동,'40,35 - 39세,1998,2381,1230,1151
'1174063000,  천호4동,'45,40 - 44세,1998,1934,958,976
'1174063000,  천호4동,'50,45 - 49세,1998,1431,713,718
'1174063000,  천호4동,'55,50 - 54세,1998,1208,624,584
'1174063000,  천호4동,'60,55 - 59세,1998,1057,517,540
'1174063000,  천호4동,'65,60 - 64세,1998,678,309,369
'1174063000,  천호4동,'70,65 - 69세,1998,392,182,210
'1174063000,  천호4동,'75,70 - 74세,1998,248,77,171
'1174063000,  천호4동,'80,75 - 79세,1998,171,58,113
'1174063000,  천호4동,'85,80 - 84세,1998,77,15,62
'1174063000,  천호4동,'90,85+ ,1998,65,9,56
'1174064000,  성내1동,'00,계,1998,15542,7805,7737
'1174064000,  성내1동,'05,0 - 4세,1998,921,506,415
'1174064000,  성내1동,'10,5 - 9세,1998,947,494,453
'1174064000,  성내1동,'15,10 - 14세,1998,1065,567,498
'1174064000,  성내1동,'20,15 - 19세,1998,1671,858,813
'1174064000,  성내1동,'25,20 - 24세,1998,1448,718,730
'1174064000,  성내1동,'30,25 - 29세,1998,1577,794,783
'1174064000,  성내1동,'35,30 - 34세,1998,1376,706,670
'1174064000,  성내1동,'40,35 - 39세,1998,1474,702,772
'1174064000,  성내1동,'45,40 - 44세,1998,1450,695,755
'1174064000,  성내1동,'50,45 - 49세,1998,1133,570,563
'1174064000,  성내1동,'55,50 - 54세,1998,855,474,381
'1174064000,  성내1동,'60,55 - 59세,1998,566,304,262
'1174064000,  성내1동,'65,60 - 64세,1998,409,201,208
'1174064000,  성내1동,'70,65 - 69세,1998,260,106,154
'1174064000,  성내1동,'75,70 - 74세,1998,162,50,112
'1174064000,  성내1동,'80,75 - 79세,1998,118,29,89
'1174064000,  성내1동,'85,80 - 84세,1998,69,21,48
'1174064000,  성내1동,'90,85+ ,1998,41,10,31
'1174065000,  성내2동,'00,계,1998,30094,15093,15001
'1174065000,  성내2동,'05,0 - 4세,1998,2092,1050,1042
'1174065000,  성내2동,'10,5 - 9세,1998,1890,974,916
'1174065000,  성내2동,'15,10 - 14세,1998,1717,888,829
'1174065000,  성내2동,'20,15 - 19세,1998,2584,1360,1224
'1174065000,  성내2동,'25,20 - 24세,1998,2914,1437,1477
'1174065000,  성내2동,'30,25 - 29세,1998,3786,1962,1824
'1174065000,  성내2동,'35,30 - 34세,1998,2993,1578,1415
'1174065000,  성내2동,'40,35 - 39세,1998,2843,1476,1367
'1174065000,  성내2동,'45,40 - 44세,1998,2447,1198,1249
'1174065000,  성내2동,'50,45 - 49세,1998,1771,804,967
'1174065000,  성내2동,'55,50 - 54세,1998,1626,801,825
'1174065000,  성내2동,'60,55 - 59세,1998,1348,698,650
'1174065000,  성내2동,'65,60 - 64세,1998,882,444,438
'1174065000,  성내2동,'70,65 - 69세,1998,485,219,266
'1174065000,  성내2동,'75,70 - 74세,1998,306,105,201
'1174065000,  성내2동,'80,75 - 79세,1998,211,58,153
'1174065000,  성내2동,'85,80 - 84세,1998,117,26,91
'1174065000,  성내2동,'90,85+ ,1998,82,15,67
'1174066000,  성내3동,'00,계,1998,23669,11861,11808
'1174066000,  성내3동,'05,0 - 4세,1998,1652,867,785
'1174066000,  성내3동,'10,5 - 9세,1998,1372,705,667
'1174066000,  성내3동,'15,10 - 14세,1998,1372,731,641
'1174066000,  성내3동,'20,15 - 19세,1998,2362,1272,1090
'1174066000,  성내3동,'25,20 - 24세,1998,2327,1181,1146
'1174066000,  성내3동,'30,25 - 29세,1998,2739,1359,1380
'1174066000,  성내3동,'35,30 - 34세,1998,2251,1186,1065
'1174066000,  성내3동,'40,35 - 39세,1998,2069,1040,1029
'1174066000,  성내3동,'45,40 - 44세,1998,2027,892,1135
'1174066000,  성내3동,'50,45 - 49세,1998,1665,831,834
'1174066000,  성내3동,'55,50 - 54세,1998,1345,701,644
'1174066000,  성내3동,'60,55 - 59세,1998,934,492,442
'1174066000,  성내3동,'65,60 - 64세,1998,581,281,300
'1174066000,  성내3동,'70,65 - 69세,1998,367,142,225
'1174066000,  성내3동,'75,70 - 74세,1998,251,89,162
'1174066000,  성내3동,'80,75 - 79세,1998,183,56,127
'1174066000,  성내3동,'85,80 - 84세,1998,104,22,82
'1174066000,  성내3동,'90,85+ ,1998,68,14,54
'1174067000,  길1동,'00,계,1998,22654,11312,11342
'1174067000,  길1동,'05,0 - 4세,1998,1431,749,682
'1174067000,  길1동,'10,5 - 9세,1998,1423,731,692
'1174067000,  길1동,'15,10 - 14세,1998,1435,749,686
'1174067000,  길1동,'20,15 - 19세,1998,2229,1165,1064
'1174067000,  길1동,'25,20 - 24세,1998,2183,1068,1115
'1174067000,  길1동,'30,25 - 29세,1998,2425,1193,1232
'1174067000,  길1동,'35,30 - 34세,1998,1987,1035,952
'1174067000,  길1동,'40,35 - 39세,1998,2060,1019,1041
'1174067000,  길1동,'45,40 - 44세,1998,2062,975,1087
'1174067000,  길1동,'50,45 - 49세,1998,1593,792,801
'1174067000,  길1동,'55,50 - 54세,1998,1275,658,617
'1174067000,  길1동,'60,55 - 59세,1998,994,549,445
'1174067000,  길1동,'65,60 - 64세,1998,595,298,297
'1174067000,  길1동,'70,65 - 69세,1998,352,144,208
'1174067000,  길1동,'75,70 - 74세,1998,245,94,151
'1174067000,  길1동,'80,75 - 79세,1998,193,49,144
'1174067000,  길1동,'85,80 - 84세,1998,105,30,75
'1174067000,  길1동,'90,85+ ,1998,67,14,53
'1174068000,  길2동,'00,계,1998,28350,14151,14199
'1174068000,  길2동,'05,0 - 4세,1998,1917,997,920
'1174068000,  길2동,'10,5 - 9세,1998,2205,1175,1030
'1174068000,  길2동,'15,10 - 14세,1998,2348,1250,1098
'1174068000,  길2동,'20,15 - 19세,1998,2850,1498,1352
'1174068000,  길2동,'25,20 - 24세,1998,2173,1086,1087
'1174068000,  길2동,'30,25 - 29세,1998,2432,1175,1257
'1174068000,  길2동,'35,30 - 34세,1998,2509,1191,1318
'1174068000,  길2동,'40,35 - 39세,1998,3079,1445,1634
'1174068000,  길2동,'45,40 - 44세,1998,2924,1406,1518
'1174068000,  길2동,'50,45 - 49세,1998,2015,1074,941
'1174068000,  길2동,'55,50 - 54세,1998,1348,754,594
'1174068000,  길2동,'60,55 - 59세,1998,814,471,343
'1174068000,  길2동,'65,60 - 64세,1998,493,226,267
'1174068000,  길2동,'70,65 - 69세,1998,430,140,290
'1174068000,  길2동,'75,70 - 74세,1998,381,123,258
'1174068000,  길2동,'80,75 - 79세,1998,237,87,150
'1174068000,  길2동,'85,80 - 84세,1998,121,33,88
'1174068000,  길2동,'90,85+ ,1998,74,20,54
'1174069000,  둔촌1동,'00,계,1998,23469,11978,11491
'1174069000,  둔촌1동,'05,0 - 4세,1998,884,493,391
'1174069000,  둔촌1동,'10,5 - 9세,1998,1754,1011,743
'1174069000,  둔촌1동,'15,10 - 14세,1998,2732,1593,1139
'1174069000,  둔촌1동,'20,15 - 19세,1998,3286,1911,1375
'1174069000,  둔촌1동,'25,20 - 24세,1998,1517,807,710
'1174069000,  둔촌1동,'30,25 - 29세,1998,937,440,497
'1174069000,  둔촌1동,'35,30 - 34세,1998,1146,463,683
'1174069000,  둔촌1동,'40,35 - 39세,1998,2368,907,1461
'1174069000,  둔촌1동,'45,40 - 44세,1998,3421,1529,1892
'1174069000,  둔촌1동,'50,45 - 49세,1998,2294,1286,1008
'1174069000,  둔촌1동,'55,50 - 54세,1998,1185,754,431
'1174069000,  둔촌1동,'60,55 - 59세,1998,526,330,196
'1174069000,  둔촌1동,'65,60 - 64세,1998,315,139,176
'1174069000,  둔촌1동,'70,65 - 69세,1998,296,80,216
'1174069000,  둔촌1동,'75,70 - 74세,1998,343,90,253
'1174069000,  둔촌1동,'80,75 - 79세,1998,264,87,177
'1174069000,  둔촌1동,'85,80 - 84세,1998,129,35,94
'1174069000,  둔촌1동,'90,85+ ,1998,72,23,49
'1174070000,  둔촌2동,'00,계,1998,30593,15434,15159
'1174070000,  둔촌2동,'05,0 - 4세,1998,1674,881,793
'1174070000,  둔촌2동,'10,5 - 9세,1998,2103,1131,972
'1174070000,  둔촌2동,'15,10 - 14세,1998,2565,1342,1223
'1174070000,  둔촌2동,'20,15 - 19세,1998,3546,1866,1680
'1174070000,  둔촌2동,'25,20 - 24세,1998,2492,1349,1143
'1174070000,  둔촌2동,'30,25 - 29세,1998,2509,1297,1212
'1174070000,  둔촌2동,'35,30 - 34세,1998,2249,1100,1149
'1174070000,  둔촌2동,'40,35 - 39세,1998,2992,1351,1641
'1174070000,  둔촌2동,'45,40 - 44세,1998,3338,1575,1763
'1174070000,  둔촌2동,'50,45 - 49세,1998,2495,1328,1167
'1174070000,  둔촌2동,'55,50 - 54세,1998,1527,877,650
'1174070000,  둔촌2동,'60,55 - 59세,1998,1027,553,474
'1174070000,  둔촌2동,'65,60 - 64세,1998,657,300,357
'1174070000,  둔촌2동,'70,65 - 69세,1998,554,218,336
'1174070000,  둔촌2동,'75,70 - 74세,1998,373,128,245
'1174070000,  둔촌2동,'80,75 - 79세,1998,274,84,190
'1174070000,  둔촌2동,'85,80 - 84세,1998,137,38,99
'1174070000,  둔촌2동,'90,85+ ,1998,81,16,65
'26,부산광역시,'00,계,1998,3829098,1914196,1914902
'26,부산광역시,'05,0 - 4세,1998,231562,123990,107572
'26,부산광역시,'10,5 - 9세,1998,250792,135003,115789
'26,부산광역시,'15,10 - 14세,1998,258464,135409,123055
'26,부산광역시,'20,15 - 19세,1998,373300,192697,180603
'26,부산광역시,'25,20 - 24세,1998,345495,176970,168525
'26,부산광역시,'30,25 - 29세,1998,360552,183279,177273
'26,부산광역시,'35,30 - 34세,1998,320182,160451,159731
'26,부산광역시,'40,35 - 39세,1998,363325,178386,184939
'26,부산광역시,'45,40 - 44세,1998,344275,171281,172994
'26,부산광역시,'50,45 - 49세,1998,258740,129487,129253
'26,부산광역시,'55,50 - 54세,1998,203128,102418,100710
'26,부산광역시,'60,55 - 59세,1998,185154,91763,93391
'26,부산광역시,'65,60 - 64세,1998,129891,60926,68965
'26,부산광역시,'70,65 - 69세,1998,85651,35103,50548
'26,부산광역시,'75,70 - 74세,1998,57442,19813,37629
'26,부산광역시,'80,75 - 79세,1998,34842,11122,23720
'26,부산광역시,'85,80 - 84세,1998,16591,4296,12295
'26,부산광역시,'90,85+ ,1998,9712,1802,7910
'26110, 중구,'00,계,1998,60344,29566,30778
'26110, 중구,'05,0 - 4세,1998,2949,1523,1426
'26110, 중구,'10,5 - 9세,1998,2832,1486,1346
'26110, 중구,'15,10 - 14세,1998,3064,1568,1496
'26110, 중구,'20,15 - 19세,1998,5325,2734,2591
'26110, 중구,'25,20 - 24세,1998,5536,2839,2697
'26110, 중구,'30,25 - 29세,1998,6268,3333,2935
'26110, 중구,'35,30 - 34세,1998,4594,2412,2182
'26110, 중구,'40,35 - 39세,1998,4909,2369,2540
'26110, 중구,'45,40 - 44세,1998,5204,2434,2770
'26110, 중구,'50,45 - 49세,1998,4349,2053,2296
'26110, 중구,'55,50 - 54세,1998,3907,1862,2045
'26110, 중구,'60,55 - 59세,1998,3926,1892,2034
'26110, 중구,'65,60 - 64세,1998,2760,1278,1482
'26110, 중구,'70,65 - 69세,1998,1828,748,1080
'26110, 중구,'75,70 - 74세,1998,1428,474,954
'26110, 중구,'80,75 - 79세,1998,923,373,550
'26110, 중구,'85,80 - 84세,1998,342,116,226
'26110, 중구,'90,85+ ,1998,200,72,128
'2611051000,  중앙동,'00,계,1998,2746,1359,1387
'2611051000,  중앙동,'05,0 - 4세,1998,109,55,54
'2611051000,  중앙동,'10,5 - 9세,1998,108,52,56
'2611051000,  중앙동,'15,10 - 14세,1998,108,54,54
'2611051000,  중앙동,'20,15 - 19세,1998,238,112,126
'2611051000,  중앙동,'25,20 - 24세,1998,248,129,119
'2611051000,  중앙동,'30,25 - 29세,1998,254,143,111
'2611051000,  중앙동,'35,30 - 34세,1998,183,100,83
'2611051000,  중앙동,'40,35 - 39세,1998,208,110,98
'2611051000,  중앙동,'45,40 - 44세,1998,224,106,118
'2611051000,  중앙동,'50,45 - 49세,1998,253,119,134
'2611051000,  중앙동,'55,50 - 54세,1998,223,125,98
'2611051000,  중앙동,'60,55 - 59세,1998,216,102,114
'2611051000,  중앙동,'65,60 - 64세,1998,141,73,68
'2611051000,  중앙동,'70,65 - 69세,1998,89,32,57
'2611051000,  중앙동,'75,70 - 74세,1998,69,22,47
'2611051000,  중앙동,'80,75 - 79세,1998,54,20,34
'2611051000,  중앙동,'85,80 - 84세,1998,14,3,11
'2611051000,  중앙동,'90,85+ ,1998,7,2,5
'2611052000,  동광동,'00,계,1998,4912,2363,2549
'2611052000,  동광동,'05,0 - 4세,1998,173,78,95
'2611052000,  동광동,'10,5 - 9세,1998,202,116,86
'2611052000,  동광동,'15,10 - 14세,1998,209,105,104
'2611052000,  동광동,'20,15 - 19세,1998,395,186,209
'2611052000,  동광동,'25,20 - 24세,1998,488,242,246
'2611052000,  동광동,'30,25 - 29세,1998,512,272,240
'2611052000,  동광동,'35,30 - 34세,1998,374,208,166
'2611052000,  동광동,'40,35 - 39세,1998,375,180,195
'2611052000,  동광동,'45,40 - 44세,1998,427,205,222
'2611052000,  동광동,'50,45 - 49세,1998,403,177,226
'2611052000,  동광동,'55,50 - 54세,1998,336,169,167
'2611052000,  동광동,'60,55 - 59세,1998,335,159,176
'2611052000,  동광동,'65,60 - 64세,1998,263,119,144
'2611052000,  동광동,'70,65 - 69세,1998,152,53,99
'2611052000,  동광동,'75,70 - 74세,1998,139,43,96
'2611052000,  동광동,'80,75 - 79세,1998,79,29,50
'2611052000,  동광동,'85,80 - 84세,1998,36,14,22
'2611052000,  동광동,'90,85+ ,1998,14,8,6
'2611053000,  대청동,'00,계,1998,9711,4773,4938
'2611053000,  대청동,'05,0 - 4세,1998,576,299,277
'2611053000,  대청동,'10,5 - 9세,1998,514,274,240
'2611053000,  대청동,'15,10 - 14세,1998,538,280,258
'2611053000,  대청동,'20,15 - 19세,1998,851,438,413
'2611053000,  대청동,'25,20 - 24세,1998,826,425,401
'2611053000,  대청동,'30,25 - 29세,1998,1063,541,522
'2611053000,  대청동,'35,30 - 34세,1998,806,401,405
'2611053000,  대청동,'40,35 - 39세,1998,815,405,410
'2611053000,  대청동,'45,40 - 44세,1998,818,396,422
'2611053000,  대청동,'50,45 - 49세,1998,652,314,338
'2611053000,  대청동,'55,50 - 54세,1998,573,252,321
'2611053000,  대청동,'60,55 - 59세,1998,560,289,271
'2611053000,  대청동,'65,60 - 64세,1998,376,172,204
'2611053000,  대청동,'70,65 - 69세,1998,269,104,165
'2611053000,  대청동,'75,70 - 74세,1998,228,76,152
'2611053000,  대청동,'80,75 - 79세,1998,150,70,80
'2611053000,  대청동,'85,80 - 84세,1998,55,26,29
'2611053000,  대청동,'90,85+ ,1998,41,11,30
'2611054000,  보수1동,'00,계,1998,11435,5604,5831
'2611054000,  보수1동,'05,0 - 4세,1998,639,327,312
'2611054000,  보수1동,'10,5 - 9세,1998,631,327,304
'2611054000,  보수1동,'15,10 - 14세,1998,610,283,327
'2611054000,  보수1동,'20,15 - 19세,1998,1059,539,520
'2611054000,  보수1동,'25,20 - 24세,1998,1061,545,516
'2611054000,  보수1동,'30,25 - 29세,1998,1175,605,570
'2611054000,  보수1동,'35,30 - 34세,1998,930,484,446
'2611054000,  보수1동,'40,35 - 39세,1998,999,511,488
'2611054000,  보수1동,'45,40 - 44세,1998,954,459,495
'2611054000,  보수1동,'50,45 - 49세,1998,751,368,383
'2611054000,  보수1동,'55,50 - 54세,1998,604,291,313
'2611054000,  보수1동,'60,55 - 59세,1998,681,323,358
'2611054000,  보수1동,'65,60 - 64세,1998,522,231,291
'2611054000,  보수1동,'70,65 - 69세,1998,324,137,187
'2611054000,  보수1동,'75,70 - 74세,1998,248,86,162
'2611054000,  보수1동,'80,75 - 79세,1998,160,59,101
'2611054000,  보수1동,'85,80 - 84세,1998,52,15,37
'2611054000,  보수1동,'90,85+ ,1998,35,14,21
'2611055000,  보수2동,'00,계,1998,3478,1648,1830
'2611055000,  보수2동,'05,0 - 4세,1998,132,65,67
'2611055000,  보수2동,'10,5 - 9세,1998,113,54,59
'2611055000,  보수2동,'15,10 - 14세,1998,184,92,92
'2611055000,  보수2동,'20,15 - 19세,1998,324,176,148
'2611055000,  보수2동,'25,20 - 24세,1998,324,168,156
'2611055000,  보수2동,'30,25 - 29세,1998,378,210,168
'2611055000,  보수2동,'35,30 - 34세,1998,226,116,110
'2611055000,  보수2동,'40,35 - 39세,1998,239,107,132
'2611055000,  보수2동,'45,40 - 44세,1998,349,137,212
'2611055000,  보수2동,'50,45 - 49세,1998,278,128,150
'2611055000,  보수2동,'55,50 - 54세,1998,219,87,132
'2611055000,  보수2동,'60,55 - 59세,1998,247,110,137
'2611055000,  보수2동,'65,60 - 64세,1998,179,89,90
'2611055000,  보수2동,'70,65 - 69세,1998,126,55,71
'2611055000,  보수2동,'75,70 - 74세,1998,74,25,49
'2611055000,  보수2동,'80,75 - 79세,1998,57,21,36
'2611055000,  보수2동,'85,80 - 84세,1998,19,4,15
'2611055000,  보수2동,'90,85+ ,1998,10,4,6
'2611056000,  부평동,'00,계,1998,6494,3170,3324
'2611056000,  부평동,'05,0 - 4세,1998,252,139,113
'2611056000,  부평동,'10,5 - 9세,1998,305,165,140
'2611056000,  부평동,'15,10 - 14세,1998,351,184,167
'2611056000,  부평동,'20,15 - 19세,1998,554,288,266
'2611056000,  부평동,'25,20 - 24세,1998,602,321,281
'2611056000,  부평동,'30,25 - 29세,1998,599,345,254
'2611056000,  부평동,'35,30 - 34세,1998,418,210,208
'2611056000,  부평동,'40,35 - 39세,1998,526,238,288
'2611056000,  부평동,'45,40 - 44세,1998,600,262,338
'2611056000,  부평동,'50,45 - 49세,1998,510,241,269
'2611056000,  부평동,'55,50 - 54세,1998,492,245,247
'2611056000,  부평동,'60,55 - 59세,1998,454,216,238
'2611056000,  부평동,'65,60 - 64세,1998,288,124,164
'2611056000,  부평동,'70,65 - 69세,1998,191,68,123
'2611056000,  부평동,'75,70 - 74세,1998,166,56,110
'2611056000,  부평동,'80,75 - 79세,1998,117,44,73
'2611056000,  부평동,'85,80 - 84세,1998,46,15,31
'2611056000,  부평동,'90,85+ ,1998,23,9,14
'2611057000,  광복동,'00,계,1998,2086,1061,1025
'2611057000,  광복동,'05,0 - 4세,1998,75,49,26
'2611057000,  광복동,'10,5 - 9세,1998,92,42,50
'2611057000,  광복동,'15,10 - 14세,1998,127,72,55
'2611057000,  광복동,'20,15 - 19세,1998,157,80,77
'2611057000,  광복동,'25,20 - 24세,1998,171,99,72
'2611057000,  광복동,'30,25 - 29세,1998,163,92,71
'2611057000,  광복동,'35,30 - 34세,1998,120,63,57
'2611057000,  광복동,'40,35 - 39세,1998,167,74,93
'2611057000,  광복동,'45,40 - 44세,1998,212,113,99
'2611057000,  광복동,'50,45 - 49세,1998,165,87,78
'2611057000,  광복동,'55,50 - 54세,1998,152,69,83
'2611057000,  광복동,'60,55 - 59세,1998,147,76,71
'2611057000,  광복동,'65,60 - 64세,1998,103,53,50
'2611057000,  광복동,'70,65 - 69세,1998,73,27,46
'2611057000,  광복동,'75,70 - 74세,1998,78,24,54
'2611057000,  광복동,'80,75 - 79세,1998,55,29,26
'2611057000,  광복동,'85,80 - 84세,1998,20,8,12
'2611057000,  광복동,'90,85+ ,1998,9,4,5
'2611058000,  남포동,'00,계,1998,1945,1030,915
'2611058000,  남포동,'05,0 - 4세,1998,55,35,20
'2611058000,  남포동,'10,5 - 9세,1998,79,49,30
'2611058000,  남포동,'15,10 - 14세,1998,92,48,44
'2611058000,  남포동,'20,15 - 19세,1998,176,92,84
'2611058000,  남포동,'25,20 - 24세,1998,171,85,86
'2611058000,  남포동,'30,25 - 29세,1998,167,102,65
'2611058000,  남포동,'35,30 - 34세,1998,115,69,46
'2611058000,  남포동,'40,35 - 39세,1998,166,90,76
'2611058000,  남포동,'45,40 - 44세,1998,181,105,76
'2611058000,  남포동,'50,45 - 49세,1998,139,69,70
'2611058000,  남포동,'55,50 - 54세,1998,153,76,77
'2611058000,  남포동,'60,55 - 59세,1998,139,71,68
'2611058000,  남포동,'65,60 - 64세,1998,113,57,56
'2611058000,  남포동,'70,65 - 69세,1998,72,33,39
'2611058000,  남포동,'75,70 - 74세,1998,64,22,42
'2611058000,  남포동,'80,75 - 79세,1998,38,14,24
'2611058000,  남포동,'85,80 - 84세,1998,16,9,7
'2611058000,  남포동,'90,85+ ,1998,9,4,5
'2611059000,  영주1동,'00,계,1998,5905,2871,3034
'2611059000,  영주1동,'05,0 - 4세,1998,293,160,133
'2611059000,  영주1동,'10,5 - 9세,1998,251,129,122
'2611059000,  영주1동,'15,10 - 14세,1998,285,148,137
'2611059000,  영주1동,'20,15 - 19세,1998,512,272,240
'2611059000,  영주1동,'25,20 - 24세,1998,553,284,269
'2611059000,  영주1동,'30,25 - 29세,1998,691,353,338
'2611059000,  영주1동,'35,30 - 34세,1998,455,256,199
'2611059000,  영주1동,'40,35 - 39세,1998,432,186,246
'2611059000,  영주1동,'45,40 - 44세,1998,508,234,274
'2611059000,  영주1동,'50,45 - 49세,1998,415,181,234
'2611059000,  영주1동,'55,50 - 54세,1998,392,199,193
'2611059000,  영주1동,'60,55 - 59세,1998,399,179,220
'2611059000,  영주1동,'65,60 - 64세,1998,249,117,132
'2611059000,  영주1동,'70,65 - 69세,1998,184,71,113
'2611059000,  영주1동,'75,70 - 74세,1998,150,51,99
'2611059000,  영주1동,'80,75 - 79세,1998,74,32,42
'2611059000,  영주1동,'85,80 - 84세,1998,37,10,27
'2611059000,  영주1동,'90,85+ ,1998,25,9,16
'2611060000,  영주2동,'00,계,1998,11632,5687,5945
'2611060000,  영주2동,'05,0 - 4세,1998,645,316,329
'2611060000,  영주2동,'10,5 - 9세,1998,537,278,259
'2611060000,  영주2동,'15,10 - 14세,1998,560,302,258
'2611060000,  영주2동,'20,15 - 19세,1998,1059,551,508
'2611060000,  영주2동,'25,20 - 24세,1998,1092,541,551
'2611060000,  영주2동,'30,25 - 29세,1998,1266,670,596
'2611060000,  영주2동,'35,30 - 34세,1998,967,505,462
'2611060000,  영주2동,'40,35 - 39세,1998,982,468,514
'2611060000,  영주2동,'45,40 - 44세,1998,931,417,514
'2611060000,  영주2동,'50,45 - 49세,1998,783,369,414
'2611060000,  영주2동,'55,50 - 54세,1998,763,349,414
'2611060000,  영주2동,'60,55 - 59세,1998,748,367,381
'2611060000,  영주2동,'65,60 - 64세,1998,526,243,283
'2611060000,  영주2동,'70,65 - 69세,1998,348,168,180
'2611060000,  영주2동,'75,70 - 74세,1998,212,69,143
'2611060000,  영주2동,'80,75 - 79세,1998,139,55,84
'2611060000,  영주2동,'85,80 - 84세,1998,47,12,35
'2611060000,  영주2동,'90,85+ ,1998,27,7,20
'26140, 서구,'00,계,1998,163027,80654,82373
'26140, 서구,'05,0 - 4세,1998,8078,4283,3795
'26140, 서구,'10,5 - 9세,1998,8240,4364,3876
'26140, 서구,'15,10 - 14세,1998,9309,4818,4491
'26140, 서구,'20,15 - 19세,1998,15694,8202,7492
'26140, 서구,'25,20 - 24세,1998,15583,7916,7667
'26140, 서구,'30,25 - 29세,1998,16425,8704,7721
'26140, 서구,'35,30 - 34세,1998,12091,6420,5671
'26140, 서구,'40,35 - 39세,1998,13668,6751,6917
'26140, 서구,'45,40 - 44세,1998,13734,6731,7003
'26140, 서구,'50,45 - 49세,1998,11307,5532,5775
'26140, 서구,'55,50 - 54세,1998,9653,4586,5067
'26140, 서구,'60,55 - 59세,1998,9981,4654,5327
'26140, 서구,'65,60 - 64세,1998,7328,3433,3895
'26140, 서구,'70,65 - 69세,1998,4878,1968,2910
'26140, 서구,'75,70 - 74세,1998,3479,1218,2261
'26140, 서구,'80,75 - 79세,1998,2060,666,1394
'26140, 서구,'85,80 - 84세,1998,983,293,690
'26140, 서구,'90,85+ ,1998,536,115,421
'2614051000,  동대신1동,'00,계,1998,7767,3844,3923
'2614051000,  동대신1동,'05,0 - 4세,1998,382,215,167
'2614051000,  동대신1동,'10,5 - 9세,1998,433,226,207
'2614051000,  동대신1동,'15,10 - 14세,1998,449,246,203
'2614051000,  동대신1동,'20,15 - 19세,1998,762,406,356
'2614051000,  동대신1동,'25,20 - 24세,1998,743,371,372
'2614051000,  동대신1동,'30,25 - 29세,1998,781,407,374
'2614051000,  동대신1동,'35,30 - 34세,1998,516,273,243
'2614051000,  동대신1동,'40,35 - 39세,1998,640,305,335
'2614051000,  동대신1동,'45,40 - 44세,1998,669,320,349
'2614051000,  동대신1동,'50,45 - 49세,1998,533,275,258
'2614051000,  동대신1동,'55,50 - 54세,1998,440,204,236
'2614051000,  동대신1동,'60,55 - 59세,1998,452,222,230
'2614051000,  동대신1동,'65,60 - 64세,1998,358,165,193
'2614051000,  동대신1동,'70,65 - 69세,1998,246,91,155
'2614051000,  동대신1동,'75,70 - 74세,1998,156,59,97
'2614051000,  동대신1동,'80,75 - 79세,1998,109,28,81
'2614051000,  동대신1동,'85,80 - 84세,1998,64,20,44
'2614051000,  동대신1동,'90,85+ ,1998,34,11,23
'2614052000,  동대신2동,'00,계,1998,13456,6625,6831
'2614052000,  동대신2동,'05,0 - 4세,1998,636,334,302
'2614052000,  동대신2동,'10,5 - 9세,1998,672,349,323
'2614052000,  동대신2동,'15,10 - 14세,1998,764,405,359
'2614052000,  동대신2동,'20,15 - 19세,1998,1262,670,592
'2614052000,  동대신2동,'25,20 - 24세,1998,1283,629,654
'2614052000,  동대신2동,'30,25 - 29세,1998,1427,720,707
'2614052000,  동대신2동,'35,30 - 34세,1998,903,494,409
'2614052000,  동대신2동,'40,35 - 39세,1998,1102,529,573
'2614052000,  동대신2동,'45,40 - 44세,1998,1120,553,567
'2614052000,  동대신2동,'50,45 - 49세,1998,907,450,457
'2614052000,  동대신2동,'55,50 - 54세,1998,805,396,409
'2614052000,  동대신2동,'60,55 - 59세,1998,839,398,441
'2614052000,  동대신2동,'65,60 - 64세,1998,659,310,349
'2614052000,  동대신2동,'70,65 - 69세,1998,450,183,267
'2614052000,  동대신2동,'75,70 - 74세,1998,308,116,192
'2614052000,  동대신2동,'80,75 - 79세,1998,193,55,138
'2614052000,  동대신2동,'85,80 - 84세,1998,70,21,49
'2614052000,  동대신2동,'90,85+ ,1998,56,13,43
'2614053000,  동대신3동,'00,계,1998,9617,4749,4868
'2614053000,  동대신3동,'05,0 - 4세,1998,469,260,209
'2614053000,  동대신3동,'10,5 - 9세,1998,445,248,197
'2614053000,  동대신3동,'15,10 - 14세,1998,574,298,276
'2614053000,  동대신3동,'20,15 - 19세,1998,903,480,423
'2614053000,  동대신3동,'25,20 - 24세,1998,919,473,446
'2614053000,  동대신3동,'30,25 - 29세,1998,985,529,456
'2614053000,  동대신3동,'35,30 - 34세,1998,641,338,303
'2614053000,  동대신3동,'40,35 - 39세,1998,729,326,403
'2614053000,  동대신3동,'45,40 - 44세,1998,779,364,415
'2614053000,  동대신3동,'50,45 - 49세,1998,747,347,400
'2614053000,  동대신3동,'55,50 - 54세,1998,589,286,303
'2614053000,  동대신3동,'60,55 - 59세,1998,602,301,301
'2614053000,  동대신3동,'65,60 - 64세,1998,455,206,249
'2614053000,  동대신3동,'70,65 - 69세,1998,322,140,182
'2614053000,  동대신3동,'75,70 - 74세,1998,226,84,142
'2614053000,  동대신3동,'80,75 - 79세,1998,130,43,87
'2614053000,  동대신3동,'85,80 - 84세,1998,68,20,48
'2614053000,  동대신3동,'90,85+ ,1998,34,6,28
'2614054000,  서대신1동,'00,계,1998,5503,2710,2793
'2614054000,  서대신1동,'05,0 - 4세,1998,289,146,143
'2614054000,  서대신1동,'10,5 - 9세,1998,293,150,143
'2614054000,  서대신1동,'15,10 - 14세,1998,274,149,125
'2614054000,  서대신1동,'20,15 - 19세,1998,511,270,241
'2614054000,  서대신1동,'25,20 - 24세,1998,522,273,249
'2614054000,  서대신1동,'30,25 - 29세,1998,559,284,275
'2614054000,  서대신1동,'35,30 - 34세,1998,408,224,184
'2614054000,  서대신1동,'40,35 - 39세,1998,436,212,224
'2614054000,  서대신1동,'45,40 - 44세,1998,467,231,236
'2614054000,  서대신1동,'50,45 - 49세,1998,380,182,198
'2614054000,  서대신1동,'55,50 - 54세,1998,309,158,151
'2614054000,  서대신1동,'60,55 - 59세,1998,349,153,196
'2614054000,  서대신1동,'65,60 - 64세,1998,267,120,147
'2614054000,  서대신1동,'70,65 - 69세,1998,168,69,99
'2614054000,  서대신1동,'75,70 - 74세,1998,131,50,81
'2614054000,  서대신1동,'80,75 - 79세,1998,85,26,59
'2614054000,  서대신1동,'85,80 - 84세,1998,35,9,26
'2614054000,  서대신1동,'90,85+ ,1998,20,4,16
'2614055000,  서대신2동,'00,계,1998,10696,5271,5425
'2614055000,  서대신2동,'05,0 - 4세,1998,579,299,280
'2614055000,  서대신2동,'10,5 - 9세,1998,518,281,237
'2614055000,  서대신2동,'15,10 - 14세,1998,599,305,294
'2614055000,  서대신2동,'20,15 - 19세,1998,994,508,486
'2614055000,  서대신2동,'25,20 - 24세,1998,1044,520,524
'2614055000,  서대신2동,'30,25 - 29세,1998,1185,619,566
'2614055000,  서대신2동,'35,30 - 34세,1998,819,426,393
'2614055000,  서대신2동,'40,35 - 39세,1998,834,419,415
'2614055000,  서대신2동,'45,40 - 44세,1998,814,391,423
'2614055000,  서대신2동,'50,45 - 49세,1998,774,374,400
'2614055000,  서대신2동,'55,50 - 54세,1998,692,328,364
'2614055000,  서대신2동,'60,55 - 59세,1998,631,289,342
'2614055000,  서대신2동,'65,60 - 64세,1998,474,232,242
'2614055000,  서대신2동,'70,65 - 69세,1998,306,126,180
'2614055000,  서대신2동,'75,70 - 74세,1998,217,81,136
'2614055000,  서대신2동,'80,75 - 79세,1998,127,50,77
'2614055000,  서대신2동,'85,80 - 84세,1998,53,17,36
'2614055000,  서대신2동,'90,85+ ,1998,36,6,30
'2614056000,  서대신3동,'00,계,1998,8011,3948,4063
'2614056000,  서대신3동,'05,0 - 4세,1998,373,200,173
'2614056000,  서대신3동,'10,5 - 9세,1998,375,191,184
'2614056000,  서대신3동,'15,10 - 14세,1998,502,277,225
'2614056000,  서대신3동,'20,15 - 19세,1998,763,398,365
'2614056000,  서대신3동,'25,20 - 24세,1998,762,385,377
'2614056000,  서대신3동,'30,25 - 29세,1998,741,387,354
'2614056000,  서대신3동,'35,30 - 34세,1998,565,293,272
'2614056000,  서대신3동,'40,35 - 39세,1998,657,317,340
'2614056000,  서대신3동,'45,40 - 44세,1998,653,308,345
'2614056000,  서대신3동,'50,45 - 49세,1998,592,295,297
'2614056000,  서대신3동,'55,50 - 54세,1998,460,227,233
'2614056000,  서대신3동,'60,55 - 59세,1998,496,245,251
'2614056000,  서대신3동,'65,60 - 64세,1998,393,164,229
'2614056000,  서대신3동,'70,65 - 69세,1998,273,116,157
'2614056000,  서대신3동,'75,70 - 74세,1998,202,74,128
'2614056000,  서대신3동,'80,75 - 79세,1998,117,40,77
'2614056000,  서대신3동,'85,80 - 84세,1998,54,26,28
'2614056000,  서대신3동,'90,85+ ,1998,33,5,28
'2614057000,  서대신4동,'00,계,1998,9257,4540,4717
'2614057000,  서대신4동,'05,0 - 4세,1998,489,256,233
'2614057000,  서대신4동,'10,5 - 9세,1998,542,281,261
'2614057000,  서대신4동,'15,10 - 14세,1998,680,357,323
'2614057000,  서대신4동,'20,15 - 19세,1998,895,484,411
'2614057000,  서대신4동,'25,20 - 24세,1998,794,429,365
'2614057000,  서대신4동,'30,25 - 29세,1998,775,400,375
'2614057000,  서대신4동,'35,30 - 34세,1998,689,337,352
'2614057000,  서대신4동,'40,35 - 39세,1998,841,384,457
'2614057000,  서대신4동,'45,40 - 44세,1998,876,423,453
'2614057000,  서대신4동,'50,45 - 49세,1998,659,322,337
'2614057000,  서대신4동,'55,50 - 54세,1998,503,242,261
'2614057000,  서대신4동,'60,55 - 59세,1998,460,210,250
'2614057000,  서대신4동,'65,60 - 64세,1998,392,182,210
'2614057000,  서대신4동,'70,65 - 69세,1998,256,111,145
'2614057000,  서대신4동,'75,70 - 74세,1998,199,60,139
'2614057000,  서대신4동,'80,75 - 79세,1998,112,38,74
'2614057000,  서대신4동,'85,80 - 84세,1998,59,13,46
'2614057000,  서대신4동,'90,85+ ,1998,36,11,25
'2614059000,  부민동,'00,계,1998,8518,4241,4277
'2614059000,  부민동,'05,0 - 4세,1998,420,227,193
'2614059000,  부민동,'10,5 - 9세,1998,428,229,199
'2614059000,  부민동,'15,10 - 14세,1998,489,257,232
'2614059000,  부민동,'20,15 - 19세,1998,755,379,376
'2614059000,  부민동,'25,20 - 24세,1998,822,438,384
'2614059000,  부민동,'30,25 - 29세,1998,827,457,370
'2614059000,  부민동,'35,30 - 34세,1998,640,357,283
'2614059000,  부민동,'40,35 - 39세,1998,682,339,343
'2614059000,  부민동,'45,40 - 44세,1998,756,348,408
'2614059000,  부민동,'50,45 - 49세,1998,583,290,293
'2614059000,  부민동,'55,50 - 54세,1998,509,243,266
'2614059000,  부민동,'60,55 - 59세,1998,561,261,300
'2614059000,  부민동,'65,60 - 64세,1998,383,191,192
'2614059000,  부민동,'70,65 - 69세,1998,252,95,157
'2614059000,  부민동,'75,70 - 74세,1998,206,68,138
'2614059000,  부민동,'80,75 - 79세,1998,133,38,95
'2614059000,  부민동,'85,80 - 84세,1998,50,21,29
'2614059000,  부민동,'90,85+ ,1998,22,3,19
'2614061500,  아미동,'00,계,1998,17546,8760,8786
'2614061500,  아미동,'05,0 - 4세,1998,876,446,430
'2614061500,  아미동,'10,5 - 9세,1998,860,446,414
'2614061500,  아미동,'15,10 - 14세,1998,955,480,475
'2614061500,  아미동,'20,15 - 19세,1998,1675,860,815
'2614061500,  아미동,'25,20 - 24세,1998,1709,868,841
'2614061500,  아미동,'30,25 - 29세,1998,1787,1008,779
'2614061500,  아미동,'35,30 - 34세,1998,1353,748,605
'2614061500,  아미동,'40,35 - 39세,1998,1490,785,705
'2614061500,  아미동,'45,40 - 44세,1998,1398,717,681
'2614061500,  아미동,'50,45 - 49세,1998,1186,606,580
'2614061500,  아미동,'55,50 - 54세,1998,971,463,508
'2614061500,  아미동,'60,55 - 59세,1998,1098,478,620
'2614061500,  아미동,'65,60 - 64세,1998,837,404,433
'2614061500,  아미동,'70,65 - 69세,1998,611,223,388
'2614061500,  아미동,'75,70 - 74세,1998,370,114,256
'2614061500,  아미동,'80,75 - 79세,1998,224,70,154
'2614061500,  아미동,'85,80 - 84세,1998,101,34,67
'2614061500,  아미동,'90,85+ ,1998,45,10,35
'2614063000,  초장동,'00,계,1998,10308,5088,5220
'2614063000,  초장동,'05,0 - 4세,1998,492,258,234
'2614063000,  초장동,'10,5 - 9세,1998,531,288,243
'2614063000,  초장동,'15,10 - 14세,1998,561,287,274
'2614063000,  초장동,'20,15 - 19세,1998,933,499,434
'2614063000,  초장동,'25,20 - 24세,1998,1027,499,528
'2614063000,  초장동,'30,25 - 29세,1998,1101,589,512
'2614063000,  초장동,'35,30 - 34세,1998,763,408,355
'2614063000,  초장동,'40,35 - 39세,1998,826,395,431
'2614063000,  초장동,'45,40 - 44세,1998,844,436,408
'2614063000,  초장동,'50,45 - 49세,1998,713,341,372
'2614063000,  초장동,'55,50 - 54세,1998,616,300,316
'2614063000,  초장동,'60,55 - 59세,1998,677,305,372
'2614063000,  초장동,'65,60 - 64세,1998,464,212,252
'2614063000,  초장동,'70,65 - 69세,1998,320,139,181
'2614063000,  초장동,'75,70 - 74세,1998,239,76,163
'2614063000,  초장동,'80,75 - 79세,1998,121,37,84
'2614063000,  초장동,'85,80 - 84세,1998,56,13,43
'2614063000,  초장동,'90,85+ ,1998,24,6,18
'2614064000,  충무동,'00,계,1998,9822,4837,4985
'2614064000,  충무동,'05,0 - 4세,1998,365,195,170
'2614064000,  충무동,'10,5 - 9세,1998,425,230,195
'2614064000,  충무동,'15,10 - 14세,1998,513,258,255
'2614064000,  충무동,'20,15 - 19세,1998,895,499,396
'2614064000,  충무동,'25,20 - 24세,1998,899,467,432
'2614064000,  충무동,'30,25 - 29세,1998,961,534,427
'2614064000,  충무동,'35,30 - 34세,1998,680,349,331
'2614064000,  충무동,'40,35 - 39세,1998,791,396,395
'2614064000,  충무동,'45,40 - 44세,1998,859,424,435
'2614064000,  충무동,'50,45 - 49세,1998,767,347,420
'2614064000,  충무동,'55,50 - 54세,1998,642,287,355
'2614064000,  충무동,'60,55 - 59세,1998,741,348,393
'2614064000,  충무동,'65,60 - 64세,1998,488,223,265
'2614064000,  충무동,'70,65 - 69세,1998,326,132,194
'2614064000,  충무동,'75,70 - 74세,1998,225,79,146
'2614064000,  충무동,'80,75 - 79세,1998,133,41,92
'2614064000,  충무동,'85,80 - 84세,1998,73,22,51
'2614064000,  충무동,'90,85+ ,1998,39,6,33
'2614065000,  남부민1동,'00,계,1998,9190,4608,4582
'2614065000,  남부민1동,'05,0 - 4세,1998,420,234,186
'2614065000,  남부민1동,'10,5 - 9세,1998,406,223,183
'2614065000,  남부민1동,'15,10 - 14세,1998,468,248,220
'2614065000,  남부민1동,'20,15 - 19세,1998,845,437,408
'2614065000,  남부민1동,'25,20 - 24세,1998,897,480,417
'2614065000,  남부민1동,'30,25 - 29세,1998,979,525,454
'2614065000,  남부민1동,'35,30 - 34세,1998,656,359,297
'2614065000,  남부민1동,'40,35 - 39세,1998,764,391,373
'2614065000,  남부민1동,'45,40 - 44세,1998,781,385,396
'2614065000,  남부민1동,'50,45 - 49세,1998,674,339,335
'2614065000,  남부민1동,'55,50 - 54세,1998,556,250,306
'2614065000,  남부민1동,'60,55 - 59세,1998,651,298,353
'2614065000,  남부민1동,'65,60 - 64세,1998,424,212,212
'2614065000,  남부민1동,'70,65 - 69세,1998,256,100,156
'2614065000,  남부민1동,'75,70 - 74세,1998,204,67,137
'2614065000,  남부민1동,'80,75 - 79세,1998,122,43,79
'2614065000,  남부민1동,'85,80 - 84세,1998,53,11,42
'2614065000,  남부민1동,'90,85+ ,1998,34,6,28
'2614066000,  남부민2동,'00,계,1998,11054,5574,5480
'2614066000,  남부민2동,'05,0 - 4세,1998,527,278,249
'2614066000,  남부민2동,'10,5 - 9세,1998,558,294,264
'2614066000,  남부민2동,'15,10 - 14세,1998,560,279,281
'2614066000,  남부민2동,'20,15 - 19세,1998,1028,547,481
'2614066000,  남부민2동,'25,20 - 24세,1998,1159,593,566
'2614066000,  남부민2동,'30,25 - 29세,1998,1128,622,506
'2614066000,  남부민2동,'35,30 - 34세,1998,897,497,400
'2614066000,  남부민2동,'40,35 - 39세,1998,913,497,416
'2614066000,  남부민2동,'45,40 - 44세,1998,907,467,440
'2614066000,  남부민2동,'50,45 - 49세,1998,693,343,350
'2614066000,  남부민2동,'55,50 - 54세,1998,694,321,373
'2614066000,  남부민2동,'60,55 - 59세,1998,682,315,367
'2614066000,  남부민2동,'65,60 - 64세,1998,520,241,279
'2614066000,  남부민2동,'70,65 - 69세,1998,328,133,195
'2614066000,  남부민2동,'75,70 - 74세,1998,219,70,149
'2614066000,  남부민2동,'80,75 - 79세,1998,129,45,84
'2614066000,  남부민2동,'85,80 - 84세,1998,75,22,53
'2614066000,  남부민2동,'90,85+ ,1998,37,10,27
'2614067000,  남부민3동,'00,계,1998,8522,4309,4213
'2614067000,  남부민3동,'05,0 - 4세,1998,455,246,209
'2614067000,  남부민3동,'10,5 - 9세,1998,432,237,195
'2614067000,  남부민3동,'15,10 - 14세,1998,488,234,254
'2614067000,  남부민3동,'20,15 - 19세,1998,839,440,399
'2614067000,  남부민3동,'25,20 - 24세,1998,743,385,358
'2614067000,  남부민3동,'30,25 - 29세,1998,834,447,387
'2614067000,  남부민3동,'35,30 - 34세,1998,682,365,317
'2614067000,  남부민3동,'40,35 - 39세,1998,790,407,383
'2614067000,  남부민3동,'45,40 - 44세,1998,765,389,376
'2614067000,  남부민3동,'50,45 - 49세,1998,575,317,258
'2614067000,  남부민3동,'55,50 - 54세,1998,488,229,259
'2614067000,  남부민3동,'60,55 - 59세,1998,520,240,280
'2614067000,  남부민3동,'65,60 - 64세,1998,356,170,186
'2614067000,  남부민3동,'70,65 - 69세,1998,200,77,123
'2614067000,  남부민3동,'75,70 - 74세,1998,180,64,116
'2614067000,  남부민3동,'80,75 - 79세,1998,99,41,58
'2614067000,  남부민3동,'85,80 - 84세,1998,50,15,35
'2614067000,  남부민3동,'90,85+ ,1998,26,6,20
'2614068000,  암남동,'00,계,1998,23760,11550,12210
'2614068000,  암남동,'05,0 - 4세,1998,1306,689,617
'2614068000,  암남동,'10,5 - 9세,1998,1322,691,631
'2614068000,  암남동,'15,10 - 14세,1998,1433,738,695
'2614068000,  암남동,'20,15 - 19세,1998,2634,1325,1309
'2614068000,  암남동,'25,20 - 24세,1998,2260,1106,1154
'2614068000,  암남동,'30,25 - 29세,1998,2355,1176,1179
'2614068000,  암남동,'35,30 - 34세,1998,1879,952,927
'2614068000,  암남동,'40,35 - 39세,1998,2173,1049,1124
'2614068000,  암남동,'45,40 - 44세,1998,2046,975,1071
'2614068000,  암남동,'50,45 - 49세,1998,1524,704,820
'2614068000,  암남동,'55,50 - 54세,1998,1379,652,727
'2614068000,  암남동,'60,55 - 59세,1998,1222,591,631
'2614068000,  암남동,'65,60 - 64세,1998,858,401,457
'2614068000,  암남동,'70,65 - 69세,1998,564,233,331
'2614068000,  암남동,'75,70 - 74세,1998,397,156,241
'2614068000,  암남동,'80,75 - 79세,1998,226,71,155
'2614068000,  암남동,'85,80 - 84세,1998,122,29,93
'2614068000,  암남동,'90,85+ ,1998,60,12,48
'26170, 동구,'00,계,1998,135154,67320,67834
'26170, 동구,'05,0 - 4세,1998,6747,3575,3172
'26170, 동구,'10,5 - 9세,1998,6709,3575,3134
'26170, 동구,'15,10 - 14세,1998,7249,3831,3418
'26170, 동구,'20,15 - 19세,1998,12590,6605,5985
'26170, 동구,'25,20 - 24세,1998,13227,6828,6399
'26170, 동구,'30,25 - 29세,1998,14110,7634,6476
'26170, 동구,'35,30 - 34세,1998,9934,5325,4609
'26170, 동구,'40,35 - 39세,1998,10632,5279,5353
'26170, 동구,'45,40 - 44세,1998,11098,5384,5714
'26170, 동구,'50,45 - 49세,1998,9365,4503,4862
'26170, 동구,'55,50 - 54세,1998,8455,3994,4461
'26170, 동구,'60,55 - 59세,1998,8583,4018,4565
'26170, 동구,'65,60 - 64세,1998,6605,3074,3531
'26170, 동구,'70,65 - 69세,1998,4259,1820,2439
'26170, 동구,'75,70 - 74세,1998,2838,1013,1825
'26170, 동구,'80,75 - 79세,1998,1587,577,1010
'26170, 동구,'85,80 - 84세,1998,740,222,518
'26170, 동구,'90,85+ ,1998,426,63,363
'2617051000,  초량1동,'00,계,1998,7129,3495,3634
'2617051000,  초량1동,'05,0 - 4세,1998,325,181,144
'2617051000,  초량1동,'10,5 - 9세,1998,338,176,162
'2617051000,  초량1동,'15,10 - 14세,1998,382,195,187
'2617051000,  초량1동,'20,15 - 19세,1998,611,325,286
'2617051000,  초량1동,'25,20 - 24세,1998,673,333,340
'2617051000,  초량1동,'30,25 - 29세,1998,750,422,328
'2617051000,  초량1동,'35,30 - 34세,1998,521,274,247
'2617051000,  초량1동,'40,35 - 39세,1998,569,273,296
'2617051000,  초량1동,'45,40 - 44세,1998,615,300,315
'2617051000,  초량1동,'50,45 - 49세,1998,497,221,276
'2617051000,  초량1동,'55,50 - 54세,1998,512,253,259
'2617051000,  초량1동,'60,55 - 59세,1998,445,203,242
'2617051000,  초량1동,'65,60 - 64세,1998,328,151,177
'2617051000,  초량1동,'70,65 - 69세,1998,235,97,138
'2617051000,  초량1동,'75,70 - 74세,1998,158,49,109
'2617051000,  초량1동,'80,75 - 79세,1998,103,27,76
'2617051000,  초량1동,'85,80 - 84세,1998,42,12,30
'2617051000,  초량1동,'90,85+ ,1998,25,3,22
'2617052000,  초량2동,'00,계,1998,10224,5048,5176
'2617052000,  초량2동,'05,0 - 4세,1998,507,275,232
'2617052000,  초량2동,'10,5 - 9세,1998,504,252,252
'2617052000,  초량2동,'15,10 - 14세,1998,535,284,251
'2617052000,  초량2동,'20,15 - 19세,1998,931,485,446
'2617052000,  초량2동,'25,20 - 24세,1998,973,519,454
'2617052000,  초량2동,'30,25 - 29세,1998,1003,522,481
'2617052000,  초량2동,'35,30 - 34세,1998,714,388,326
'2617052000,  초량2동,'40,35 - 39세,1998,829,385,444
'2617052000,  초량2동,'45,40 - 44세,1998,886,423,463
'2617052000,  초량2동,'50,45 - 49세,1998,763,341,422
'2617052000,  초량2동,'55,50 - 54세,1998,702,345,357
'2617052000,  초량2동,'60,55 - 59세,1998,628,291,337
'2617052000,  초량2동,'65,60 - 64세,1998,459,220,239
'2617052000,  초량2동,'70,65 - 69세,1998,347,153,194
'2617052000,  초량2동,'75,70 - 74세,1998,223,80,143
'2617052000,  초량2동,'80,75 - 79세,1998,118,58,60
'2617052000,  초량2동,'85,80 - 84세,1998,69,21,48
'2617052000,  초량2동,'90,85+ ,1998,33,6,27
'2617053000,  초량3동,'00,계,1998,5821,2872,2949
'2617053000,  초량3동,'05,0 - 4세,1998,209,91,118
'2617053000,  초량3동,'10,5 - 9세,1998,259,148,111
'2617053000,  초량3동,'15,10 - 14세,1998,307,168,139
'2617053000,  초량3동,'20,15 - 19세,1998,489,254,235
'2617053000,  초량3동,'25,20 - 24세,1998,563,303,260
'2617053000,  초량3동,'30,25 - 29세,1998,630,355,275
'2617053000,  초량3동,'35,30 - 34세,1998,388,200,188
'2617053000,  초량3동,'40,35 - 39세,1998,434,191,243
'2617053000,  초량3동,'45,40 - 44세,1998,484,230,254
'2617053000,  초량3동,'50,45 - 49세,1998,409,197,212
'2617053000,  초량3동,'55,50 - 54세,1998,409,174,235
'2617053000,  초량3동,'60,55 - 59세,1998,389,195,194
'2617053000,  초량3동,'65,60 - 64세,1998,327,153,174
'2617053000,  초량3동,'70,65 - 69세,1998,235,99,136
'2617053000,  초량3동,'75,70 - 74세,1998,152,63,89
'2617053000,  초량3동,'80,75 - 79세,1998,80,35,45
'2617053000,  초량3동,'85,80 - 84세,1998,31,13,18
'2617053000,  초량3동,'90,85+ ,1998,26,3,23
'2617054000,  초량4동,'00,계,1998,6086,3058,3028
'2617054000,  초량4동,'05,0 - 4세,1998,327,174,153
'2617054000,  초량4동,'10,5 - 9세,1998,248,131,117
'2617054000,  초량4동,'15,10 - 14세,1998,289,159,130
'2617054000,  초량4동,'20,15 - 19세,1998,563,316,247
'2617054000,  초량4동,'25,20 - 24세,1998,612,308,304
'2617054000,  초량4동,'30,25 - 29세,1998,704,375,329
'2617054000,  초량4동,'35,30 - 34세,1998,462,245,217
'2617054000,  초량4동,'40,35 - 39세,1998,431,220,211
'2617054000,  초량4동,'45,40 - 44세,1998,475,222,253
'2617054000,  초량4동,'50,45 - 49세,1998,413,187,226
'2617054000,  초량4동,'55,50 - 54세,1998,401,197,204
'2617054000,  초량4동,'60,55 - 59세,1998,428,204,224
'2617054000,  초량4동,'65,60 - 64세,1998,301,154,147
'2617054000,  초량4동,'70,65 - 69세,1998,182,77,105
'2617054000,  초량4동,'75,70 - 74세,1998,126,45,81
'2617054000,  초량4동,'80,75 - 79세,1998,71,29,42
'2617054000,  초량4동,'85,80 - 84세,1998,34,10,24
'2617054000,  초량4동,'90,85+ ,1998,19,5,14
'2617055000,  초량6동,'00,계,1998,6258,3113,3145
'2617055000,  초량6동,'05,0 - 4세,1998,302,176,126
'2617055000,  초량6동,'10,5 - 9세,1998,313,166,147
'2617055000,  초량6동,'15,10 - 14세,1998,317,164,153
'2617055000,  초량6동,'20,15 - 19세,1998,579,287,292
'2617055000,  초량6동,'25,20 - 24세,1998,629,325,304
'2617055000,  초량6동,'30,25 - 29세,1998,664,354,310
'2617055000,  초량6동,'35,30 - 34세,1998,467,260,207
'2617055000,  초량6동,'40,35 - 39세,1998,502,265,237
'2617055000,  초량6동,'45,40 - 44세,1998,440,215,225
'2617055000,  초량6동,'50,45 - 49세,1998,424,202,222
'2617055000,  초량6동,'55,50 - 54세,1998,356,163,193
'2617055000,  초량6동,'60,55 - 59세,1998,435,200,235
'2617055000,  초량6동,'65,60 - 64세,1998,340,147,193
'2617055000,  초량6동,'70,65 - 69세,1998,221,93,128
'2617055000,  초량6동,'75,70 - 74세,1998,146,52,94
'2617055000,  초량6동,'80,75 - 79세,1998,70,31,39
'2617055000,  초량6동,'85,80 - 84세,1998,24,8,16
'2617055000,  초량6동,'90,85+ ,1998,29,5,24
'2617056000,  수정1동,'00,계,1998,6159,3078,3081
'2617056000,  수정1동,'05,0 - 4세,1998,296,149,147
'2617056000,  수정1동,'10,5 - 9세,1998,298,155,143
'2617056000,  수정1동,'15,10 - 14세,1998,340,195,145
'2617056000,  수정1동,'20,15 - 19세,1998,579,311,268
'2617056000,  수정1동,'25,20 - 24세,1998,605,310,295
'2617056000,  수정1동,'30,25 - 29세,1998,636,354,282
'2617056000,  수정1동,'35,30 - 34세,1998,431,221,210
'2617056000,  수정1동,'40,35 - 39세,1998,476,240,236
'2617056000,  수정1동,'45,40 - 44세,1998,520,256,264
'2617056000,  수정1동,'50,45 - 49세,1998,444,204,240
'2617056000,  수정1동,'55,50 - 54세,1998,401,183,218
'2617056000,  수정1동,'60,55 - 59세,1998,373,181,192
'2617056000,  수정1동,'65,60 - 64세,1998,299,142,157
'2617056000,  수정1동,'70,65 - 69세,1998,186,75,111
'2617056000,  수정1동,'75,70 - 74세,1998,147,62,85
'2617056000,  수정1동,'80,75 - 79세,1998,80,26,54
'2617056000,  수정1동,'85,80 - 84세,1998,30,11,19
'2617056000,  수정1동,'90,85+ ,1998,18,3,15
'2617057000,  수정2동,'00,계,1998,5130,2486,2644
'2617057000,  수정2동,'05,0 - 4세,1998,248,137,111
'2617057000,  수정2동,'10,5 - 9세,1998,244,118,126
'2617057000,  수정2동,'15,10 - 14세,1998,287,146,141
'2617057000,  수정2동,'20,15 - 19세,1998,459,244,215
'2617057000,  수정2동,'25,20 - 24세,1998,499,253,246
'2617057000,  수정2동,'30,25 - 29세,1998,467,260,207
'2617057000,  수정2동,'35,30 - 34세,1998,342,170,172
'2617057000,  수정2동,'40,35 - 39세,1998,413,204,209
'2617057000,  수정2동,'45,40 - 44세,1998,444,216,228
'2617057000,  수정2동,'50,45 - 49세,1998,360,163,197
'2617057000,  수정2동,'55,50 - 54세,1998,376,155,221
'2617057000,  수정2동,'60,55 - 59세,1998,291,136,155
'2617057000,  수정2동,'65,60 - 64세,1998,282,126,156
'2617057000,  수정2동,'70,65 - 69세,1998,173,76,97
'2617057000,  수정2동,'75,70 - 74세,1998,120,41,79
'2617057000,  수정2동,'80,75 - 79세,1998,72,27,45
'2617057000,  수정2동,'85,80 - 84세,1998,28,11,17
'2617057000,  수정2동,'90,85+ ,1998,25,3,22
'2617058000,  수정3동,'00,계,1998,10970,5453,5517
'2617058000,  수정3동,'05,0 - 4세,1998,555,292,263
'2617058000,  수정3동,'10,5 - 9세,1998,538,287,251
'2617058000,  수정3동,'15,10 - 14세,1998,627,327,300
'2617058000,  수정3동,'20,15 - 19세,1998,1021,536,485
'2617058000,  수정3동,'25,20 - 24세,1998,1084,572,512
'2617058000,  수정3동,'30,25 - 29세,1998,1170,632,538
'2617058000,  수정3동,'35,30 - 34세,1998,816,437,379
'2617058000,  수정3동,'40,35 - 39세,1998,881,418,463
'2617058000,  수정3동,'45,40 - 44세,1998,901,425,476
'2617058000,  수정3동,'50,45 - 49세,1998,768,387,381
'2617058000,  수정3동,'55,50 - 54세,1998,636,301,335
'2617058000,  수정3동,'60,55 - 59세,1998,678,317,361
'2617058000,  수정3동,'65,60 - 64세,1998,544,237,307
'2617058000,  수정3동,'70,65 - 69세,1998,343,154,189
'2617058000,  수정3동,'75,70 - 74세,1998,211,78,133
'2617058000,  수정3동,'80,75 - 79세,1998,112,32,80
'2617058000,  수정3동,'85,80 - 84세,1998,56,15,41
'2617058000,  수정3동,'90,85+ ,1998,29,6,23
'2617059000,  수정4동,'00,계,1998,9313,4706,4607
'2617059000,  수정4동,'05,0 - 4세,1998,492,272,220
'2617059000,  수정4동,'10,5 - 9세,1998,451,244,207
'2617059000,  수정4동,'15,10 - 14세,1998,475,275,200
'2617059000,  수정4동,'20,15 - 19세,1998,865,465,400
'2617059000,  수정4동,'25,20 - 24세,1998,955,486,469
'2617059000,  수정4동,'30,25 - 29세,1998,1069,580,489
'2617059000,  수정4동,'35,30 - 34세,1998,691,392,299
'2617059000,  수정4동,'40,35 - 39세,1998,693,355,338
'2617059000,  수정4동,'45,40 - 44세,1998,669,327,342
'2617059000,  수정4동,'50,45 - 49세,1998,627,281,346
'2617059000,  수정4동,'55,50 - 54세,1998,600,259,341
'2617059000,  수정4동,'60,55 - 59세,1998,631,292,339
'2617059000,  수정4동,'65,60 - 64세,1998,476,227,249
'2617059000,  수정4동,'70,65 - 69세,1998,270,135,135
'2617059000,  수정4동,'75,70 - 74세,1998,189,66,123
'2617059000,  수정4동,'80,75 - 79세,1998,97,35,62
'2617059000,  수정4동,'85,80 - 84세,1998,49,14,35
'2617059000,  수정4동,'90,85+ ,1998,14,1,13
'2617060000,  수정5동,'00,계,1998,11112,5528,5584
'2617060000,  수정5동,'05,0 - 4세,1998,636,334,302
'2617060000,  수정5동,'10,5 - 9세,1998,598,327,271
'2617060000,  수정5동,'15,10 - 14세,1998,627,298,329
'2617060000,  수정5동,'20,15 - 19세,1998,989,529,460
'2617060000,  수정5동,'25,20 - 24세,1998,1071,539,532
'2617060000,  수정5동,'30,25 - 29세,1998,1184,620,564
'2617060000,  수정5동,'35,30 - 34세,1998,853,463,390
'2617060000,  수정5동,'40,35 - 39세,1998,868,431,437
'2617060000,  수정5동,'45,40 - 44세,1998,873,425,448
'2617060000,  수정5동,'50,45 - 49세,1998,715,354,361
'2617060000,  수정5동,'55,50 - 54세,1998,660,323,337
'2617060000,  수정5동,'60,55 - 59세,1998,697,330,367
'2617060000,  수정5동,'65,60 - 64세,1998,541,249,292
'2617060000,  수정5동,'70,65 - 69세,1998,346,144,202
'2617060000,  수정5동,'75,70 - 74세,1998,240,86,154
'2617060000,  수정5동,'80,75 - 79세,1998,134,54,80
'2617060000,  수정5동,'85,80 - 84세,1998,56,19,37
'2617060000,  수정5동,'90,85+ ,1998,24,3,21
'2617061000,  좌천1동,'00,계,1998,10198,5129,5069
'2617061000,  좌천1동,'05,0 - 4세,1998,520,269,251
'2617061000,  좌천1동,'10,5 - 9세,1998,490,278,212
'2617061000,  좌천1동,'15,10 - 14세,1998,478,259,219
'2617061000,  좌천1동,'20,15 - 19세,1998,986,507,479
'2617061000,  좌천1동,'25,20 - 24세,1998,1074,569,505
'2617061000,  좌천1동,'30,25 - 29세,1998,1078,575,503
'2617061000,  좌천1동,'35,30 - 34세,1998,737,400,337
'2617061000,  좌천1동,'40,35 - 39세,1998,729,374,355
'2617061000,  좌천1동,'45,40 - 44세,1998,846,381,465
'2617061000,  좌천1동,'50,45 - 49세,1998,742,371,371
'2617061000,  좌천1동,'55,50 - 54세,1998,631,301,330
'2617061000,  좌천1동,'60,55 - 59세,1998,668,337,331
'2617061000,  좌천1동,'65,60 - 64세,1998,486,230,256
'2617061000,  좌천1동,'70,65 - 69세,1998,300,142,158
'2617061000,  좌천1동,'75,70 - 74세,1998,201,76,125
'2617061000,  좌천1동,'80,75 - 79세,1998,127,44,83
'2617061000,  좌천1동,'85,80 - 84세,1998,62,13,49
'2617061000,  좌천1동,'90,85+ ,1998,43,3,40
'2617064000,  좌천4동,'00,계,1998,7265,3620,3645
'2617064000,  좌천4동,'05,0 - 4세,1998,383,203,180
'2617064000,  좌천4동,'10,5 - 9세,1998,352,189,163
'2617064000,  좌천4동,'15,10 - 14세,1998,402,215,187
'2617064000,  좌천4동,'20,15 - 19세,1998,707,351,356
'2617064000,  좌천4동,'25,20 - 24세,1998,748,397,351
'2617064000,  좌천4동,'30,25 - 29세,1998,776,411,365
'2617064000,  좌천4동,'35,30 - 34세,1998,545,294,251
'2617064000,  좌천4동,'40,35 - 39세,1998,560,275,285
'2617064000,  좌천4동,'45,40 - 44세,1998,556,280,276
'2617064000,  좌천4동,'50,45 - 49세,1998,528,261,267
'2617064000,  좌천4동,'55,50 - 54세,1998,458,219,239
'2617064000,  좌천4동,'60,55 - 59세,1998,455,206,249
'2617064000,  좌천4동,'65,60 - 64세,1998,327,151,176
'2617064000,  좌천4동,'70,65 - 69세,1998,196,89,107
'2617064000,  좌천4동,'75,70 - 74세,1998,136,42,94
'2617064000,  좌천4동,'80,75 - 79세,1998,80,24,56
'2617064000,  좌천4동,'85,80 - 84세,1998,35,9,26
'2617064000,  좌천4동,'90,85+ ,1998,21,4,17
'2617065000,  범일1동,'00,계,1998,6664,3301,3363
'2617065000,  범일1동,'05,0 - 4세,1998,355,191,164
'2617065000,  범일1동,'10,5 - 9세,1998,413,228,185
'2617065000,  범일1동,'15,10 - 14세,1998,371,199,172
'2617065000,  범일1동,'20,15 - 19세,1998,624,318,306
'2617065000,  범일1동,'25,20 - 24세,1998,644,325,319
'2617065000,  범일1동,'30,25 - 29세,1998,714,371,343
'2617065000,  범일1동,'35,30 - 34세,1998,563,288,275
'2617065000,  범일1동,'40,35 - 39세,1998,571,291,280
'2617065000,  범일1동,'45,40 - 44세,1998,540,256,284
'2617065000,  범일1동,'50,45 - 49세,1998,421,194,227
'2617065000,  범일1동,'55,50 - 54세,1998,394,190,204
'2617065000,  범일1동,'60,55 - 59세,1998,399,186,213
'2617065000,  범일1동,'65,60 - 64세,1998,273,133,140
'2617065000,  범일1동,'70,65 - 69세,1998,169,69,100
'2617065000,  범일1동,'75,70 - 74세,1998,102,33,69
'2617065000,  범일1동,'80,75 - 79세,1998,57,17,40
'2617065000,  범일1동,'85,80 - 84세,1998,30,8,22
'2617065000,  범일1동,'90,85+ ,1998,24,4,20
'2617066000,  범일2동,'00,계,1998,7576,3733,3843
'2617066000,  범일2동,'05,0 - 4세,1998,372,197,175
'2617066000,  범일2동,'10,5 - 9세,1998,421,212,209
'2617066000,  범일2동,'15,10 - 14세,1998,436,235,201
'2617066000,  범일2동,'20,15 - 19세,1998,677,368,309
'2617066000,  범일2동,'25,20 - 24세,1998,700,356,344
'2617066000,  범일2동,'30,25 - 29세,1998,736,386,350
'2617066000,  범일2동,'35,30 - 34세,1998,566,296,270
'2617066000,  범일2동,'40,35 - 39세,1998,628,291,337
'2617066000,  범일2동,'45,40 - 44세,1998,706,355,351
'2617066000,  범일2동,'50,45 - 49세,1998,521,245,276
'2617066000,  범일2동,'55,50 - 54세,1998,480,228,252
'2617066000,  범일2동,'60,55 - 59세,1998,460,215,245
'2617066000,  범일2동,'65,60 - 64세,1998,344,163,181
'2617066000,  범일2동,'70,65 - 69세,1998,206,82,124
'2617066000,  범일2동,'75,70 - 74세,1998,137,46,91
'2617066000,  범일2동,'80,75 - 79세,1998,97,35,62
'2617066000,  범일2동,'85,80 - 84세,1998,57,18,39
'2617066000,  범일2동,'90,85+ ,1998,32,5,27
'2617067000,  범일4동,'00,계,1998,6052,3036,3016
'2617067000,  범일4동,'05,0 - 4세,1998,336,162,174
'2617067000,  범일4동,'10,5 - 9세,1998,290,157,133
'2617067000,  범일4동,'15,10 - 14세,1998,344,162,182
'2617067000,  범일4동,'20,15 - 19세,1998,612,313,299
'2617067000,  범일4동,'25,20 - 24세,1998,569,300,269
'2617067000,  범일4동,'30,25 - 29세,1998,615,322,293
'2617067000,  범일4동,'35,30 - 34세,1998,506,293,213
'2617067000,  범일4동,'40,35 - 39세,1998,471,245,226
'2617067000,  범일4동,'45,40 - 44세,1998,497,242,255
'2617067000,  범일4동,'50,45 - 49세,1998,425,221,204
'2617067000,  범일4동,'55,50 - 54세,1998,319,160,159
'2617067000,  범일4동,'60,55 - 59세,1998,394,179,215
'2617067000,  범일4동,'65,60 - 64세,1998,287,144,143
'2617067000,  범일4동,'70,65 - 69세,1998,180,74,106
'2617067000,  범일4동,'75,70 - 74세,1998,99,29,70
'2617067000,  범일4동,'80,75 - 79세,1998,60,26,34
'2617067000,  범일4동,'85,80 - 84세,1998,31,6,25
'2617067000,  범일4동,'90,85+ ,1998,17,1,16
'2617068000,  범일5동,'00,계,1998,8737,4365,4372
'2617068000,  범일5동,'05,0 - 4세,1998,351,179,172
'2617068000,  범일5동,'10,5 - 9세,1998,410,221,189
'2617068000,  범일5동,'15,10 - 14세,1998,443,244,199
'2617068000,  범일5동,'20,15 - 19세,1998,858,440,418
'2617068000,  범일5동,'25,20 - 24세,1998,776,408,368
'2617068000,  범일5동,'30,25 - 29세,1998,787,447,340
'2617068000,  범일5동,'35,30 - 34세,1998,561,298,263
'2617068000,  범일5동,'40,35 - 39세,1998,720,377,343
'2617068000,  범일5동,'45,40 - 44세,1998,775,411,364
'2617068000,  범일5동,'50,45 - 49세,1998,605,317,288
'2617068000,  범일5동,'55,50 - 54세,1998,521,259,262
'2617068000,  범일5동,'60,55 - 59세,1998,573,253,320
'2617068000,  범일5동,'65,60 - 64세,1998,468,202,266
'2617068000,  범일5동,'70,65 - 69세,1998,388,137,251
'2617068000,  범일5동,'75,70 - 74세,1998,279,97,182
'2617068000,  범일5동,'80,75 - 79세,1998,134,44,90
'2617068000,  범일5동,'85,80 - 84세,1998,58,25,33
'2617068000,  범일5동,'90,85+ ,1998,30,6,24
'2617069000,  범일6동,'00,계,1998,10460,5299,5161
'2617069000,  범일6동,'05,0 - 4세,1998,533,293,240
'2617069000,  범일6동,'10,5 - 9세,1998,542,286,256
'2617069000,  범일6동,'15,10 - 14세,1998,589,306,283
'2617069000,  범일6동,'20,15 - 19세,1998,1040,556,484
'2617069000,  범일6동,'25,20 - 24세,1998,1052,525,527
'2617069000,  범일6동,'30,25 - 29세,1998,1127,648,479
'2617069000,  범일6동,'35,30 - 34세,1998,771,406,365
'2617069000,  범일6동,'40,35 - 39세,1998,857,444,413
'2617069000,  범일6동,'45,40 - 44세,1998,871,420,451
'2617069000,  범일6동,'50,45 - 49세,1998,703,357,346
'2617069000,  범일6동,'55,50 - 54세,1998,599,284,315
'2617069000,  범일6동,'60,55 - 59세,1998,639,293,346
'2617069000,  범일6동,'65,60 - 64세,1998,523,245,278
'2617069000,  범일6동,'70,65 - 69세,1998,282,124,158
'2617069000,  범일6동,'75,70 - 74세,1998,172,68,104
'2617069000,  범일6동,'80,75 - 79세,1998,95,33,62
'2617069000,  범일6동,'85,80 - 84세,1998,48,9,39
'2617069000,  범일6동,'90,85+ ,1998,17,2,15
'26200, 영도구,'00,계,1998,193174,96536,96638
'26200, 영도구,'05,0 - 4세,1998,10036,5288,4748
'26200, 영도구,'10,5 - 9세,1998,11161,5911,5250
'26200, 영도구,'15,10 - 14세,1998,11983,6269,5714
'26200, 영도구,'20,15 - 19세,1998,18677,9465,9212
'26200, 영도구,'25,20 - 24세,1998,18690,9652,9038
'26200, 영도구,'30,25 - 29세,1998,18357,9763,8594
'26200, 영도구,'35,30 - 34세,1998,14996,7876,7120
'26200, 영도구,'40,35 - 39세,1998,17254,8611,8643
'26200, 영도구,'45,40 - 44세,1998,16827,8520,8307
'26200, 영도구,'50,45 - 49세,1998,13120,6532,6588
'26200, 영도구,'55,50 - 54세,1998,11308,5482,5826
'26200, 영도구,'60,55 - 59세,1998,11075,5361,5714
'26200, 영도구,'65,60 - 64세,1998,7721,3637,4084
'26200, 영도구,'70,65 - 69세,1998,5099,2064,3035
'26200, 영도구,'75,70 - 74세,1998,3300,1101,2199
'26200, 영도구,'80,75 - 79세,1998,2108,670,1438
'26200, 영도구,'85,80 - 84세,1998,910,230,680
'26200, 영도구,'90,85+ ,1998,552,104,448
'2620053000,  남항동,'00,계,1998,16657,8407,8250
'2620053000,  남항동,'05,0 - 4세,1998,650,342,308
'2620053000,  남항동,'10,5 - 9세,1998,746,402,344
'2620053000,  남항동,'15,10 - 14세,1998,895,471,424
'2620053000,  남항동,'20,15 - 19세,1998,1528,756,772
'2620053000,  남항동,'25,20 - 24세,1998,1640,842,798
'2620053000,  남항동,'30,25 - 29세,1998,1603,908,695
'2620053000,  남항동,'35,30 - 34세,1998,1168,671,497
'2620053000,  남항동,'40,35 - 39세,1998,1377,739,638
'2620053000,  남항동,'45,40 - 44세,1998,1405,719,686
'2620053000,  남항동,'50,45 - 49세,1998,1221,591,630
'2620053000,  남항동,'55,50 - 54세,1998,1107,532,575
'2620053000,  남항동,'60,55 - 59세,1998,1142,535,607
'2620053000,  남항동,'65,60 - 64세,1998,866,432,434
'2620053000,  남항동,'70,65 - 69세,1998,524,211,313
'2620053000,  남항동,'75,70 - 74세,1998,373,127,246
'2620053000,  남항동,'80,75 - 79세,1998,256,90,166
'2620053000,  남항동,'85,80 - 84세,1998,90,23,67
'2620053000,  남항동,'90,85+ ,1998,66,16,50
'2620054000,  영선1동,'00,계,1998,5898,2880,3018
'2620054000,  영선1동,'05,0 - 4세,1998,232,123,109
'2620054000,  영선1동,'10,5 - 9세,1998,294,139,155
'2620054000,  영선1동,'15,10 - 14세,1998,343,180,163
'2620054000,  영선1동,'20,15 - 19세,1998,606,319,287
'2620054000,  영선1동,'25,20 - 24세,1998,635,337,298
'2620054000,  영선1동,'30,25 - 29세,1998,520,281,239
'2620054000,  영선1동,'35,30 - 34세,1998,394,192,202
'2620054000,  영선1동,'40,35 - 39세,1998,434,211,223
'2620054000,  영선1동,'45,40 - 44세,1998,492,212,280
'2620054000,  영선1동,'50,45 - 49세,1998,475,237,238
'2620054000,  영선1동,'55,50 - 54세,1998,406,190,216
'2620054000,  영선1동,'60,55 - 59세,1998,365,181,184
'2620054000,  영선1동,'65,60 - 64세,1998,238,113,125
'2620054000,  영선1동,'70,65 - 69세,1998,192,72,120
'2620054000,  영선1동,'75,70 - 74세,1998,147,56,91
'2620054000,  영선1동,'80,75 - 79세,1998,72,25,47
'2620054000,  영선1동,'85,80 - 84세,1998,32,8,24
'2620054000,  영선1동,'90,85+ ,1998,21,4,17
'2620055000,  영선2동,'00,계,1998,13032,6473,6559
'2620055000,  영선2동,'05,0 - 4세,1998,578,307,271
'2620055000,  영선2동,'10,5 - 9세,1998,628,337,291
'2620055000,  영선2동,'15,10 - 14세,1998,725,364,361
'2620055000,  영선2동,'20,15 - 19세,1998,1238,622,616
'2620055000,  영선2동,'25,20 - 24세,1998,1309,671,638
'2620055000,  영선2동,'30,25 - 29세,1998,1292,702,590
'2620055000,  영선2동,'35,30 - 34세,1998,928,493,435
'2620055000,  영선2동,'40,35 - 39세,1998,1013,523,490
'2620055000,  영선2동,'45,40 - 44세,1998,1054,510,544
'2620055000,  영선2동,'50,45 - 49세,1998,924,447,477
'2620055000,  영선2동,'55,50 - 54세,1998,862,418,444
'2620055000,  영선2동,'60,55 - 59세,1998,876,440,436
'2620055000,  영선2동,'65,60 - 64세,1998,638,290,348
'2620055000,  영선2동,'70,65 - 69세,1998,396,175,221
'2620055000,  영선2동,'75,70 - 74세,1998,263,83,180
'2620055000,  영선2동,'80,75 - 79세,1998,181,61,120
'2620055000,  영선2동,'85,80 - 84세,1998,72,20,52
'2620055000,  영선2동,'90,85+ ,1998,55,10,45
'2620056000,  신선1동,'00,계,1998,5232,2605,2627
'2620056000,  신선1동,'05,0 - 4세,1998,288,141,147
'2620056000,  신선1동,'10,5 - 9세,1998,288,138,150
'2620056000,  신선1동,'15,10 - 14세,1998,258,142,116
'2620056000,  신선1동,'20,15 - 19세,1998,439,225,214
'2620056000,  신선1동,'25,20 - 24세,1998,551,286,265
'2620056000,  신선1동,'30,25 - 29세,1998,596,306,290
'2620056000,  신선1동,'35,30 - 34세,1998,415,223,192
'2620056000,  신선1동,'40,35 - 39세,1998,434,244,190
'2620056000,  신선1동,'45,40 - 44세,1998,365,192,173
'2620056000,  신선1동,'50,45 - 49세,1998,312,142,170
'2620056000,  신선1동,'55,50 - 54세,1998,365,156,209
'2620056000,  신선1동,'60,55 - 59세,1998,355,181,174
'2620056000,  신선1동,'65,60 - 64세,1998,233,109,124
'2620056000,  신선1동,'70,65 - 69세,1998,158,63,95
'2620056000,  신선1동,'75,70 - 74세,1998,85,27,58
'2620056000,  신선1동,'80,75 - 79세,1998,52,16,36
'2620056000,  신선1동,'85,80 - 84세,1998,27,9,18
'2620056000,  신선1동,'90,85+ ,1998,11,5,6
'2620057000,  신선2동,'00,계,1998,10189,5129,5060
'2620057000,  신선2동,'05,0 - 4세,1998,452,238,214
'2620057000,  신선2동,'10,5 - 9세,1998,539,304,235
'2620057000,  신선2동,'15,10 - 14세,1998,615,339,276
'2620057000,  신선2동,'20,15 - 19세,1998,980,476,504
'2620057000,  신선2동,'25,20 - 24세,1998,1036,522,514
'2620057000,  신선2동,'30,25 - 29세,1998,1016,567,449
'2620057000,  신선2동,'35,30 - 34세,1998,737,417,320
'2620057000,  신선2동,'40,35 - 39세,1998,899,449,450
'2620057000,  신선2동,'45,40 - 44세,1998,778,406,372
'2620057000,  신선2동,'50,45 - 49세,1998,718,361,357
'2620057000,  신선2동,'55,50 - 54세,1998,575,282,293
'2620057000,  신선2동,'60,55 - 59세,1998,673,306,367
'2620057000,  신선2동,'65,60 - 64세,1998,489,238,251
'2620057000,  신선2동,'70,65 - 69세,1998,280,108,172
'2620057000,  신선2동,'75,70 - 74세,1998,207,65,142
'2620057000,  신선2동,'80,75 - 79세,1998,104,28,76
'2620057000,  신선2동,'85,80 - 84세,1998,54,17,37
'2620057000,  신선2동,'90,85+ ,1998,37,6,31
'2620058000,  신선3동,'00,계,1998,7562,3846,3716
'2620058000,  신선3동,'05,0 - 4세,1998,353,198,155
'2620058000,  신선3동,'10,5 - 9세,1998,345,167,178
'2620058000,  신선3동,'15,10 - 14세,1998,428,229,199
'2620058000,  신선3동,'20,15 - 19세,1998,736,395,341
'2620058000,  신선3동,'25,20 - 24세,1998,745,382,363
'2620058000,  신선3동,'30,25 - 29세,1998,771,426,345
'2620058000,  신선3동,'35,30 - 34세,1998,596,378,218
'2620058000,  신선3동,'40,35 - 39세,1998,637,318,319
'2620058000,  신선3동,'45,40 - 44세,1998,610,315,295
'2620058000,  신선3동,'50,45 - 49세,1998,477,244,233
'2620058000,  신선3동,'55,50 - 54세,1998,462,228,234
'2620058000,  신선3동,'60,55 - 59세,1998,501,228,273
'2620058000,  신선3동,'65,60 - 64세,1998,357,166,191
'2620058000,  신선3동,'70,65 - 69세,1998,230,89,141
'2620058000,  신선3동,'75,70 - 74세,1998,153,38,115
'2620058000,  신선3동,'80,75 - 79세,1998,102,34,68
'2620058000,  신선3동,'85,80 - 84세,1998,39,7,32
'2620058000,  신선3동,'90,85+ ,1998,20,4,16
'2620059000,  봉래1동,'00,계,1998,9418,4658,4760
'2620059000,  봉래1동,'05,0 - 4세,1998,404,210,194
'2620059000,  봉래1동,'10,5 - 9세,1998,508,265,243
'2620059000,  봉래1동,'15,10 - 14세,1998,557,278,279
'2620059000,  봉래1동,'20,15 - 19세,1998,864,444,420
'2620059000,  봉래1동,'25,20 - 24세,1998,856,455,401
'2620059000,  봉래1동,'30,25 - 29세,1998,814,449,365
'2620059000,  봉래1동,'35,30 - 34세,1998,658,340,318
'2620059000,  봉래1동,'40,35 - 39세,1998,771,398,373
'2620059000,  봉래1동,'45,40 - 44세,1998,915,455,460
'2620059000,  봉래1동,'50,45 - 49세,1998,698,340,358
'2620059000,  봉래1동,'55,50 - 54세,1998,575,283,292
'2620059000,  봉래1동,'60,55 - 59세,1998,578,263,315
'2620059000,  봉래1동,'65,60 - 64세,1998,470,230,240
'2620059000,  봉래1동,'70,65 - 69세,1998,319,121,198
'2620059000,  봉래1동,'75,70 - 74세,1998,194,66,128
'2620059000,  봉래1동,'80,75 - 79세,1998,141,41,100
'2620059000,  봉래1동,'85,80 - 84세,1998,63,16,47
'2620059000,  봉래1동,'90,85+ ,1998,33,4,29
'2620061000,  봉래3동,'00,계,1998,7428,3776,3652
'2620061000,  봉래3동,'05,0 - 4세,1998,345,173,172
'2620061000,  봉래3동,'10,5 - 9세,1998,384,223,161
'2620061000,  봉래3동,'15,10 - 14세,1998,429,239,190
'2620061000,  봉래3동,'20,15 - 19세,1998,692,368,324
'2620061000,  봉래3동,'25,20 - 24세,1998,695,353,342
'2620061000,  봉래3동,'30,25 - 29세,1998,757,420,337
'2620061000,  봉래3동,'35,30 - 34세,1998,617,338,279
'2620061000,  봉래3동,'40,35 - 39세,1998,638,317,321
'2620061000,  봉래3동,'45,40 - 44세,1998,641,324,317
'2620061000,  봉래3동,'50,45 - 49세,1998,497,264,233
'2620061000,  봉래3동,'55,50 - 54세,1998,447,209,238
'2620061000,  봉래3동,'60,55 - 59세,1998,459,219,240
'2620061000,  봉래3동,'65,60 - 64세,1998,340,164,176
'2620061000,  봉래3동,'70,65 - 69세,1998,212,74,138
'2620061000,  봉래3동,'75,70 - 74세,1998,132,50,82
'2620061000,  봉래3동,'80,75 - 79세,1998,89,29,60
'2620061000,  봉래3동,'85,80 - 84세,1998,36,8,28
'2620061000,  봉래3동,'90,85+ ,1998,18,4,14
'2620062000,  봉래4동,'00,계,1998,8272,4196,4076
'2620062000,  봉래4동,'05,0 - 4세,1998,406,221,185
'2620062000,  봉래4동,'10,5 - 9세,1998,378,197,181
'2620062000,  봉래4동,'15,10 - 14세,1998,429,227,202
'2620062000,  봉래4동,'20,15 - 19세,1998,835,443,392
'2620062000,  봉래4동,'25,20 - 24세,1998,880,446,434
'2620062000,  봉래4동,'30,25 - 29세,1998,912,513,399
'2620062000,  봉래4동,'35,30 - 34세,1998,619,341,278
'2620062000,  봉래4동,'40,35 - 39세,1998,647,323,324
'2620062000,  봉래4동,'45,40 - 44세,1998,638,325,313
'2620062000,  봉래4동,'50,45 - 49세,1998,579,287,292
'2620062000,  봉래4동,'55,50 - 54세,1998,530,242,288
'2620062000,  봉래4동,'60,55 - 59세,1998,596,287,309
'2620062000,  봉래4동,'65,60 - 64세,1998,357,178,179
'2620062000,  봉래4동,'70,65 - 69세,1998,223,94,129
'2620062000,  봉래4동,'75,70 - 74세,1998,130,43,87
'2620062000,  봉래4동,'80,75 - 79세,1998,71,21,50
'2620062000,  봉래4동,'85,80 - 84세,1998,28,5,23
'2620062000,  봉래4동,'90,85+ ,1998,14,3,11
'2620063000,  청학1동,'00,계,1998,13593,6830,6763
'2620063000,  청학1동,'05,0 - 4세,1998,646,322,324
'2620063000,  청학1동,'10,5 - 9세,1998,736,403,333
'2620063000,  청학1동,'15,10 - 14세,1998,707,379,328
'2620063000,  청학1동,'20,15 - 19세,1998,1274,669,605
'2620063000,  청학1동,'25,20 - 24세,1998,1454,749,705
'2620063000,  청학1동,'30,25 - 29세,1998,1361,764,597
'2620063000,  청학1동,'35,30 - 34세,1998,995,554,441
'2620063000,  청학1동,'40,35 - 39세,1998,1101,558,543
'2620063000,  청학1동,'45,40 - 44세,1998,1101,582,519
'2620063000,  청학1동,'50,45 - 49세,1998,881,416,465
'2620063000,  청학1동,'55,50 - 54세,1998,848,381,467
'2620063000,  청학1동,'60,55 - 59세,1998,920,463,457
'2620063000,  청학1동,'65,60 - 64세,1998,581,258,323
'2620063000,  청학1동,'70,65 - 69세,1998,413,152,261
'2620063000,  청학1동,'75,70 - 74세,1998,286,87,199
'2620063000,  청학1동,'80,75 - 79세,1998,171,71,100
'2620063000,  청학1동,'85,80 - 84세,1998,73,18,55
'2620063000,  청학1동,'90,85+ ,1998,45,4,41
'2620064000,  청학2동,'00,계,1998,25638,12843,12795
'2620064000,  청학2동,'05,0 - 4세,1998,1408,711,697
'2620064000,  청학2동,'10,5 - 9세,1998,1429,766,663
'2620064000,  청학2동,'15,10 - 14세,1998,1647,867,780
'2620064000,  청학2동,'20,15 - 19세,1998,2529,1269,1260
'2620064000,  청학2동,'25,20 - 24세,1998,2517,1282,1235
'2620064000,  청학2동,'30,25 - 29세,1998,2510,1314,1196
'2620064000,  청학2동,'35,30 - 34세,1998,2005,1063,942
'2620064000,  청학2동,'40,35 - 39세,1998,2284,1127,1157
'2620064000,  청학2동,'45,40 - 44세,1998,2214,1116,1098
'2620064000,  청학2동,'50,45 - 49세,1998,1754,876,878
'2620064000,  청학2동,'55,50 - 54세,1998,1498,741,757
'2620064000,  청학2동,'60,55 - 59세,1998,1423,706,717
'2620064000,  청학2동,'65,60 - 64세,1998,985,471,514
'2620064000,  청학2동,'70,65 - 69세,1998,587,261,326
'2620064000,  청학2동,'75,70 - 74세,1998,397,146,251
'2620064000,  청학2동,'80,75 - 79세,1998,251,82,169
'2620064000,  청학2동,'85,80 - 84세,1998,127,31,96
'2620064000,  청학2동,'90,85+ ,1998,73,14,59
'2620065000,  동삼1동,'00,계,1998,43136,21359,21777
'2620065000,  동삼1동,'05,0 - 4세,1998,2724,1479,1245
'2620065000,  동삼1동,'10,5 - 9세,1998,3025,1584,1441
'2620065000,  동삼1동,'15,10 - 14세,1998,3049,1560,1489
'2620065000,  동삼1동,'20,15 - 19세,1998,4234,2094,2140
'2620065000,  동삼1동,'25,20 - 24세,1998,3734,1904,1830
'2620065000,  동삼1동,'30,25 - 29세,1998,3773,1846,1927
'2620065000,  동삼1동,'35,30 - 34세,1998,3689,1796,1893
'2620065000,  동삼1동,'40,35 - 39세,1998,4274,2032,2242
'2620065000,  동삼1동,'45,40 - 44세,1998,4119,2099,2020
'2620065000,  동삼1동,'50,45 - 49세,1998,2825,1446,1379
'2620065000,  동삼1동,'55,50 - 54세,1998,2291,1173,1118
'2620065000,  동삼1동,'60,55 - 59세,1998,1933,975,958
'2620065000,  동삼1동,'65,60 - 64세,1998,1332,640,692
'2620065000,  동삼1동,'70,65 - 69세,1998,926,381,545
'2620065000,  동삼1동,'75,70 - 74세,1998,567,182,385
'2620065000,  동삼1동,'80,75 - 79세,1998,370,105,265
'2620065000,  동삼1동,'85,80 - 84세,1998,176,47,129
'2620065000,  동삼1동,'90,85+ ,1998,95,16,79
'2620066000,  동삼2동,'00,계,1998,6541,3355,3186
'2620066000,  동삼2동,'05,0 - 4세,1998,359,195,164
'2620066000,  동삼2동,'10,5 - 9세,1998,326,187,139
'2620066000,  동삼2동,'15,10 - 14세,1998,380,191,189
'2620066000,  동삼2동,'20,15 - 19세,1998,632,316,316
'2620066000,  동삼2동,'25,20 - 24세,1998,699,397,302
'2620066000,  동삼2동,'30,25 - 29세,1998,756,417,339
'2620066000,  동삼2동,'35,30 - 34세,1998,508,293,215
'2620066000,  동삼2동,'40,35 - 39세,1998,504,247,257
'2620066000,  동삼2동,'45,40 - 44세,1998,570,276,294
'2620066000,  동삼2동,'50,45 - 49세,1998,428,230,198
'2620066000,  동삼2동,'55,50 - 54세,1998,398,188,210
'2620066000,  동삼2동,'60,55 - 59세,1998,383,180,203
'2620066000,  동삼2동,'65,60 - 64세,1998,230,104,126
'2620066000,  동삼2동,'70,65 - 69세,1998,176,78,98
'2620066000,  동삼2동,'75,70 - 74세,1998,86,29,57
'2620066000,  동삼2동,'80,75 - 79세,1998,66,20,46
'2620066000,  동삼2동,'85,80 - 84세,1998,20,3,17
'2620066000,  동삼2동,'90,85+ ,1998,20,4,16
'2620067000,  동삼3동,'00,계,1998,20578,10179,10399
'2620067000,  동삼3동,'05,0 - 4세,1998,1191,628,563
'2620067000,  동삼3동,'10,5 - 9세,1998,1535,799,736
'2620067000,  동삼3동,'15,10 - 14세,1998,1521,803,718
'2620067000,  동삼3동,'20,15 - 19세,1998,2090,1069,1021
'2620067000,  동삼3동,'25,20 - 24세,1998,1939,1026,913
'2620067000,  동삼3동,'30,25 - 29세,1998,1676,850,826
'2620067000,  동삼3동,'35,30 - 34세,1998,1667,777,890
'2620067000,  동삼3동,'40,35 - 39세,1998,2241,1125,1116
'2620067000,  동삼3동,'45,40 - 44세,1998,1925,989,936
'2620067000,  동삼3동,'50,45 - 49세,1998,1331,651,680
'2620067000,  동삼3동,'55,50 - 54세,1998,944,459,485
'2620067000,  동삼3동,'60,55 - 59세,1998,871,397,474
'2620067000,  동삼3동,'65,60 - 64세,1998,605,244,361
'2620067000,  동삼3동,'70,65 - 69세,1998,463,185,278
'2620067000,  동삼3동,'75,70 - 74세,1998,280,102,178
'2620067000,  동삼3동,'80,75 - 79세,1998,182,47,135
'2620067000,  동삼3동,'85,80 - 84세,1998,73,18,55
'2620067000,  동삼3동,'90,85+ ,1998,44,10,34
'26230, 부산진구,'00,계,1998,436290,218569,217721
'26230, 부산진구,'05,0 - 4세,1998,24434,12950,11484
'26230, 부산진구,'10,5 - 9세,1998,26615,14342,12273
'26230, 부산진구,'15,10 - 14세,1998,28490,14945,13545
'26230, 부산진구,'20,15 - 19세,1998,42654,22121,20533
'26230, 부산진구,'25,20 - 24세,1998,40650,20933,19717
'26230, 부산진구,'30,25 - 29세,1998,41941,21965,19976
'26230, 부산진구,'35,30 - 34세,1998,35264,17988,17276
'26230, 부산진구,'40,35 - 39세,1998,39962,19698,20264
'26230, 부산진구,'45,40 - 44세,1998,38412,19101,19311
'26230, 부산진구,'50,45 - 49세,1998,29400,14622,14778
'26230, 부산진구,'55,50 - 54세,1998,23999,11745,12254
'26230, 부산진구,'60,55 - 59세,1998,23400,11413,11987
'26230, 부산진구,'65,60 - 64세,1998,16750,7756,8994
'26230, 부산진구,'70,65 - 69세,1998,10688,4556,6132
'26230, 부산진구,'75,70 - 74세,1998,6746,2475,4271
'26230, 부산진구,'80,75 - 79세,1998,3891,1258,2633
'26230, 부산진구,'85,80 - 84세,1998,1881,502,1379
'26230, 부산진구,'90,85+ ,1998,1113,199,914
'2623051000,  부전1동,'00,계,1998,7827,3885,3942
'2623051000,  부전1동,'05,0 - 4세,1998,268,143,125
'2623051000,  부전1동,'10,5 - 9세,1998,343,189,154
'2623051000,  부전1동,'15,10 - 14세,1998,401,221,180
'2623051000,  부전1동,'20,15 - 19세,1998,747,381,366
'2623051000,  부전1동,'25,20 - 24세,1998,799,390,409
'2623051000,  부전1동,'30,25 - 29세,1998,768,434,334
'2623051000,  부전1동,'35,30 - 34세,1998,480,266,214
'2623051000,  부전1동,'40,35 - 39세,1998,613,274,339
'2623051000,  부전1동,'45,40 - 44세,1998,647,309,338
'2623051000,  부전1동,'50,45 - 49세,1998,608,276,332
'2623051000,  부전1동,'55,50 - 54세,1998,582,284,298
'2623051000,  부전1동,'60,55 - 59세,1998,586,273,313
'2623051000,  부전1동,'65,60 - 64세,1998,387,197,190
'2623051000,  부전1동,'70,65 - 69세,1998,281,127,154
'2623051000,  부전1동,'75,70 - 74세,1998,177,76,101
'2623051000,  부전1동,'80,75 - 79세,1998,76,31,45
'2623051000,  부전1동,'85,80 - 84세,1998,42,10,32
'2623051000,  부전1동,'90,85+ ,1998,22,4,18
'2623052000,  부전2동,'00,계,1998,5354,2676,2678
'2623052000,  부전2동,'05,0 - 4세,1998,178,102,76
'2623052000,  부전2동,'10,5 - 9세,1998,222,114,108
'2623052000,  부전2동,'15,10 - 14세,1998,258,126,132
'2623052000,  부전2동,'20,15 - 19세,1998,517,272,245
'2623052000,  부전2동,'25,20 - 24세,1998,576,299,277
'2623052000,  부전2동,'30,25 - 29세,1998,489,277,212
'2623052000,  부전2동,'35,30 - 34세,1998,321,181,140
'2623052000,  부전2동,'40,35 - 39세,1998,386,186,200
'2623052000,  부전2동,'45,40 - 44세,1998,477,226,251
'2623052000,  부전2동,'50,45 - 49세,1998,423,191,232
'2623052000,  부전2동,'55,50 - 54세,1998,392,190,202
'2623052000,  부전2동,'60,55 - 59세,1998,383,184,199
'2623052000,  부전2동,'65,60 - 64세,1998,266,131,135
'2623052000,  부전2동,'70,65 - 69세,1998,184,92,92
'2623052000,  부전2동,'75,70 - 74세,1998,138,43,95
'2623052000,  부전2동,'80,75 - 79세,1998,99,44,55
'2623052000,  부전2동,'85,80 - 84세,1998,30,14,16
'2623052000,  부전2동,'90,85+ ,1998,15,4,11
'2623053000,  범전동,'00,계,1998,12755,6389,6366
'2623053000,  범전동,'05,0 - 4세,1998,552,293,259
'2623053000,  범전동,'10,5 - 9세,1998,602,335,267
'2623053000,  범전동,'15,10 - 14세,1998,693,368,325
'2623053000,  범전동,'20,15 - 19세,1998,1280,659,621
'2623053000,  범전동,'25,20 - 24세,1998,1282,663,619
'2623053000,  범전동,'30,25 - 29세,1998,1263,704,559
'2623053000,  범전동,'35,30 - 34세,1998,911,497,414
'2623053000,  범전동,'40,35 - 39세,1998,1024,498,526
'2623053000,  범전동,'45,40 - 44세,1998,1056,512,544
'2623053000,  범전동,'50,45 - 49세,1998,931,458,473
'2623053000,  범전동,'55,50 - 54세,1998,827,384,443
'2623053000,  범전동,'60,55 - 59세,1998,841,407,434
'2623053000,  범전동,'65,60 - 64세,1998,616,281,335
'2623053000,  범전동,'70,65 - 69세,1998,409,182,227
'2623053000,  범전동,'75,70 - 74세,1998,246,86,160
'2623053000,  범전동,'80,75 - 79세,1998,121,41,80
'2623053000,  범전동,'85,80 - 84세,1998,67,16,51
'2623053000,  범전동,'90,85+ ,1998,34,5,29
'2623054000,  연지동,'00,계,1998,23796,11866,11930
'2623054000,  연지동,'05,0 - 4세,1998,1282,674,608
'2623054000,  연지동,'10,5 - 9세,1998,1429,779,650
'2623054000,  연지동,'15,10 - 14세,1998,1517,843,674
'2623054000,  연지동,'20,15 - 19세,1998,2310,1192,1118
'2623054000,  연지동,'25,20 - 24세,1998,2173,1105,1068
'2623054000,  연지동,'30,25 - 29세,1998,2362,1258,1104
'2623054000,  연지동,'35,30 - 34세,1998,1822,904,918
'2623054000,  연지동,'40,35 - 39세,1998,2141,1010,1131
'2623054000,  연지동,'45,40 - 44세,1998,2084,1035,1049
'2623054000,  연지동,'50,45 - 49세,1998,1616,797,819
'2623054000,  연지동,'55,50 - 54세,1998,1370,633,737
'2623054000,  연지동,'60,55 - 59세,1998,1362,676,686
'2623054000,  연지동,'65,60 - 64세,1998,987,459,528
'2623054000,  연지동,'70,65 - 69세,1998,618,261,357
'2623054000,  연지동,'75,70 - 74세,1998,370,135,235
'2623054000,  연지동,'80,75 - 79세,1998,187,63,124
'2623054000,  연지동,'85,80 - 84세,1998,101,29,72
'2623054000,  연지동,'90,85+ ,1998,65,13,52
'2623055000,  초읍동,'00,계,1998,30201,15049,15152
'2623055000,  초읍동,'05,0 - 4세,1998,1576,798,778
'2623055000,  초읍동,'10,5 - 9세,1998,1612,861,751
'2623055000,  초읍동,'15,10 - 14세,1998,1872,1017,855
'2623055000,  초읍동,'20,15 - 19세,1998,3060,1565,1495
'2623055000,  초읍동,'25,20 - 24세,1998,3003,1572,1431
'2623055000,  초읍동,'30,25 - 29세,1998,2945,1536,1409
'2623055000,  초읍동,'35,30 - 34세,1998,2192,1145,1047
'2623055000,  초읍동,'40,35 - 39세,1998,2500,1182,1318
'2623055000,  초읍동,'45,40 - 44세,1998,2670,1263,1407
'2623055000,  초읍동,'50,45 - 49세,1998,2245,1076,1169
'2623055000,  초읍동,'55,50 - 54세,1998,1874,930,944
'2623055000,  초읍동,'60,55 - 59세,1998,1760,891,869
'2623055000,  초읍동,'65,60 - 64세,1998,1167,569,598
'2623055000,  초읍동,'70,65 - 69세,1998,688,295,393
'2623055000,  초읍동,'75,70 - 74세,1998,483,172,311
'2623055000,  초읍동,'80,75 - 79세,1998,296,108,188
'2623055000,  초읍동,'85,80 - 84세,1998,159,51,108
'2623055000,  초읍동,'90,85+ ,1998,99,18,81
'2623056000,  양정1동,'00,계,1998,23903,11803,12100
'2623056000,  양정1동,'05,0 - 4세,1998,1776,930,846
'2623056000,  양정1동,'10,5 - 9세,1998,1585,818,767
'2623056000,  양정1동,'15,10 - 14세,1998,1426,750,676
'2623056000,  양정1동,'20,15 - 19세,1998,2052,1056,996
'2623056000,  양정1동,'25,20 - 24세,1998,2072,1058,1014
'2623056000,  양정1동,'30,25 - 29세,1998,2399,1143,1256
'2623056000,  양정1동,'35,30 - 34세,1998,2314,1125,1189
'2623056000,  양정1동,'40,35 - 39세,1998,2273,1168,1105
'2623056000,  양정1동,'45,40 - 44세,1998,2017,992,1025
'2623056000,  양정1동,'50,45 - 49세,1998,1473,740,733
'2623056000,  양정1동,'55,50 - 54세,1998,1235,620,615
'2623056000,  양정1동,'60,55 - 59세,1998,1162,534,628
'2623056000,  양정1동,'65,60 - 64세,1998,888,405,483
'2623056000,  양정1동,'70,65 - 69세,1998,559,252,307
'2623056000,  양정1동,'75,70 - 74세,1998,314,123,191
'2623056000,  양정1동,'80,75 - 79세,1998,197,62,135
'2623056000,  양정1동,'85,80 - 84세,1998,103,18,85
'2623056000,  양정1동,'90,85+ ,1998,58,9,49
'2623057000,  양정2동,'00,계,1998,18625,9285,9340
'2623057000,  양정2동,'05,0 - 4세,1998,902,480,422
'2623057000,  양정2동,'10,5 - 9세,1998,953,522,431
'2623057000,  양정2동,'15,10 - 14세,1998,996,535,461
'2623057000,  양정2동,'20,15 - 19세,1998,1837,959,878
'2623057000,  양정2동,'25,20 - 24세,1998,1942,941,1001
'2623057000,  양정2동,'30,25 - 29세,1998,2011,1098,913
'2623057000,  양정2동,'35,30 - 34세,1998,1358,721,637
'2623057000,  양정2동,'40,35 - 39세,1998,1428,686,742
'2623057000,  양정2동,'45,40 - 44세,1998,1533,705,828
'2623057000,  양정2동,'50,45 - 49세,1998,1357,649,708
'2623057000,  양정2동,'55,50 - 54세,1998,1194,543,651
'2623057000,  양정2동,'60,55 - 59세,1998,1144,563,581
'2623057000,  양정2동,'65,60 - 64세,1998,854,423,431
'2623057000,  양정2동,'70,65 - 69세,1998,494,245,249
'2623057000,  양정2동,'75,70 - 74세,1998,311,123,188
'2623057000,  양정2동,'80,75 - 79세,1998,156,61,95
'2623057000,  양정2동,'85,80 - 84세,1998,84,22,62
'2623057000,  양정2동,'90,85+ ,1998,71,9,62
'2623060000,  전포1동,'00,계,1998,12399,6245,6154
'2623060000,  전포1동,'05,0 - 4세,1998,555,289,266
'2623060000,  전포1동,'10,5 - 9세,1998,554,289,265
'2623060000,  전포1동,'15,10 - 14세,1998,713,362,351
'2623060000,  전포1동,'20,15 - 19세,1998,1213,673,540
'2623060000,  전포1동,'25,20 - 24세,1998,1294,669,625
'2623060000,  전포1동,'30,25 - 29세,1998,1277,725,552
'2623060000,  전포1동,'35,30 - 34세,1998,855,457,398
'2623060000,  전포1동,'40,35 - 39세,1998,960,477,483
'2623060000,  전포1동,'45,40 - 44세,1998,988,447,541
'2623060000,  전포1동,'50,45 - 49세,1998,875,434,441
'2623060000,  전포1동,'55,50 - 54세,1998,769,384,385
'2623060000,  전포1동,'60,55 - 59세,1998,864,420,444
'2623060000,  전포1동,'65,60 - 64세,1998,635,299,336
'2623060000,  전포1동,'70,65 - 69세,1998,362,151,211
'2623060000,  전포1동,'75,70 - 74세,1998,233,91,142
'2623060000,  전포1동,'80,75 - 79세,1998,140,47,93
'2623060000,  전포1동,'85,80 - 84세,1998,69,19,50
'2623060000,  전포1동,'90,85+ ,1998,43,12,31
'2623061000,  전포2동,'00,계,1998,19752,9967,9785
'2623061000,  전포2동,'05,0 - 4세,1998,941,499,442
'2623061000,  전포2동,'10,5 - 9세,1998,1064,559,505
'2623061000,  전포2동,'15,10 - 14세,1998,1128,609,519
'2623061000,  전포2동,'20,15 - 19세,1998,1918,972,946
'2623061000,  전포2동,'25,20 - 24세,1998,1977,1048,929
'2623061000,  전포2동,'30,25 - 29세,1998,1934,1050,884
'2623061000,  전포2동,'35,30 - 34세,1998,1488,807,681
'2623061000,  전포2동,'40,35 - 39세,1998,1635,814,821
'2623061000,  전포2동,'45,40 - 44세,1998,1682,824,858
'2623061000,  전포2동,'50,45 - 49세,1998,1384,674,710
'2623061000,  전포2동,'55,50 - 54세,1998,1152,553,599
'2623061000,  전포2동,'60,55 - 59세,1998,1229,597,632
'2623061000,  전포2동,'65,60 - 64세,1998,928,433,495
'2623061000,  전포2동,'70,65 - 69세,1998,589,273,316
'2623061000,  전포2동,'75,70 - 74세,1998,356,153,203
'2623061000,  전포2동,'80,75 - 79세,1998,215,74,141
'2623061000,  전포2동,'85,80 - 84세,1998,73,22,51
'2623061000,  전포2동,'90,85+ ,1998,59,6,53
'2623062000,  전포3동,'00,계,1998,10220,5148,5072
'2623062000,  전포3동,'05,0 - 4세,1998,469,241,228
'2623062000,  전포3동,'10,5 - 9세,1998,572,311,261
'2623062000,  전포3동,'15,10 - 14세,1998,548,296,252
'2623062000,  전포3동,'20,15 - 19세,1998,1025,545,480
'2623062000,  전포3동,'25,20 - 24세,1998,1033,530,503
'2623062000,  전포3동,'30,25 - 29세,1998,1043,569,474
'2623062000,  전포3동,'35,30 - 34세,1998,792,430,362
'2623062000,  전포3동,'40,35 - 39세,1998,774,408,366
'2623062000,  전포3동,'45,40 - 44세,1998,804,393,411
'2623062000,  전포3동,'50,45 - 49세,1998,731,363,368
'2623062000,  전포3동,'55,50 - 54세,1998,609,285,324
'2623062000,  전포3동,'60,55 - 59세,1998,658,305,353
'2623062000,  전포3동,'65,60 - 64세,1998,488,222,266
'2623062000,  전포3동,'70,65 - 69세,1998,298,136,162
'2623062000,  전포3동,'75,70 - 74세,1998,186,67,119
'2623062000,  전포3동,'80,75 - 79세,1998,115,28,87
'2623062000,  전포3동,'85,80 - 84세,1998,44,12,32
'2623062000,  전포3동,'90,85+ ,1998,31,7,24
'2623064000,  부암1동,'00,계,1998,24807,12430,12377
'2623064000,  부암1동,'05,0 - 4세,1998,1259,666,593
'2623064000,  부암1동,'10,5 - 9세,1998,1182,623,559
'2623064000,  부암1동,'15,10 - 14세,1998,1379,702,677
'2623064000,  부암1동,'20,15 - 19세,1998,2415,1245,1170
'2623064000,  부암1동,'25,20 - 24세,1998,2547,1341,1206
'2623064000,  부암1동,'30,25 - 29세,1998,2706,1486,1220
'2623064000,  부암1동,'35,30 - 34세,1998,1958,1057,901
'2623064000,  부암1동,'40,35 - 39세,1998,1974,1020,954
'2623064000,  부암1동,'45,40 - 44세,1998,1981,951,1030
'2623064000,  부암1동,'50,45 - 49세,1998,1693,827,866
'2623064000,  부암1동,'55,50 - 54세,1998,1532,717,815
'2623064000,  부암1동,'60,55 - 59세,1998,1550,737,813
'2623064000,  부암1동,'65,60 - 64세,1998,1130,505,625
'2623064000,  부암1동,'70,65 - 69세,1998,652,294,358
'2623064000,  부암1동,'75,70 - 74세,1998,419,144,275
'2623064000,  부암1동,'80,75 - 79세,1998,236,81,155
'2623064000,  부암1동,'85,80 - 84세,1998,123,25,98
'2623064000,  부암1동,'90,85+ ,1998,71,9,62
'2623066000,  부암3동,'00,계,1998,26083,13136,12947
'2623066000,  부암3동,'05,0 - 4세,1998,1791,956,835
'2623066000,  부암3동,'10,5 - 9세,1998,1937,1037,900
'2623066000,  부암3동,'15,10 - 14세,1998,1859,965,894
'2623066000,  부암3동,'20,15 - 19세,1998,2450,1269,1181
'2623066000,  부암3동,'25,20 - 24세,1998,2301,1157,1144
'2623066000,  부암3동,'30,25 - 29세,1998,2442,1234,1208
'2623066000,  부암3동,'35,30 - 34세,1998,2402,1153,1249
'2623066000,  부암3동,'40,35 - 39세,1998,2722,1412,1310
'2623066000,  부암3동,'45,40 - 44세,1998,2215,1151,1064
'2623066000,  부암3동,'50,45 - 49세,1998,1605,820,785
'2623066000,  부암3동,'55,50 - 54세,1998,1214,610,604
'2623066000,  부암3동,'60,55 - 59세,1998,1161,605,556
'2623066000,  부암3동,'65,60 - 64세,1998,829,361,468
'2623066000,  부암3동,'70,65 - 69세,1998,484,203,281
'2623066000,  부암3동,'75,70 - 74세,1998,330,115,215
'2623066000,  부암3동,'80,75 - 79세,1998,201,56,145
'2623066000,  부암3동,'85,80 - 84세,1998,89,20,69
'2623066000,  부암3동,'90,85+ ,1998,51,12,39
'2623067000,  당감1동,'00,계,1998,8492,4231,4261
'2623067000,  당감1동,'05,0 - 4세,1998,401,226,175
'2623067000,  당감1동,'10,5 - 9세,1998,579,289,290
'2623067000,  당감1동,'15,10 - 14세,1998,554,307,247
'2623067000,  당감1동,'20,15 - 19세,1998,827,417,410
'2623067000,  당감1동,'25,20 - 24세,1998,775,391,384
'2623067000,  당감1동,'30,25 - 29세,1998,804,437,367
'2623067000,  당감1동,'35,30 - 34세,1998,688,345,343
'2623067000,  당감1동,'40,35 - 39세,1998,767,389,378
'2623067000,  당감1동,'45,40 - 44세,1998,737,371,366
'2623067000,  당감1동,'50,45 - 49세,1998,553,280,273
'2623067000,  당감1동,'55,50 - 54세,1998,445,204,241
'2623067000,  당감1동,'60,55 - 59세,1998,423,191,232
'2623067000,  당감1동,'65,60 - 64세,1998,351,162,189
'2623067000,  당감1동,'70,65 - 69세,1998,239,99,140
'2623067000,  당감1동,'75,70 - 74세,1998,177,65,112
'2623067000,  당감1동,'80,75 - 79세,1998,99,38,61
'2623067000,  당감1동,'85,80 - 84세,1998,52,18,34
'2623067000,  당감1동,'90,85+ ,1998,21,2,19
'2623068000,  당감2동,'00,계,1998,12258,6174,6084
'2623068000,  당감2동,'05,0 - 4세,1998,660,362,298
'2623068000,  당감2동,'10,5 - 9세,1998,751,425,326
'2623068000,  당감2동,'15,10 - 14세,1998,862,448,414
'2623068000,  당감2동,'20,15 - 19세,1998,1225,645,580
'2623068000,  당감2동,'25,20 - 24세,1998,1116,571,545
'2623068000,  당감2동,'30,25 - 29세,1998,1123,588,535
'2623068000,  당감2동,'35,30 - 34세,1998,973,493,480
'2623068000,  당감2동,'40,35 - 39세,1998,1169,586,583
'2623068000,  당감2동,'45,40 - 44세,1998,1101,549,552
'2623068000,  당감2동,'50,45 - 49세,1998,826,399,427
'2623068000,  당감2동,'55,50 - 54세,1998,709,354,355
'2623068000,  당감2동,'60,55 - 59세,1998,671,333,338
'2623068000,  당감2동,'65,60 - 64세,1998,428,203,225
'2623068000,  당감2동,'70,65 - 69세,1998,301,104,197
'2623068000,  당감2동,'75,70 - 74세,1998,179,62,117
'2623068000,  당감2동,'80,75 - 79세,1998,99,32,67
'2623068000,  당감2동,'85,80 - 84세,1998,41,17,24
'2623068000,  당감2동,'90,85+ ,1998,24,3,21
'2623069000,  당감3동,'00,계,1998,26920,13337,13583
'2623069000,  당감3동,'05,0 - 4세,1998,1972,1056,916
'2623069000,  당감3동,'10,5 - 9세,1998,2178,1205,973
'2623069000,  당감3동,'15,10 - 14세,1998,2053,1044,1009
'2623069000,  당감3동,'20,15 - 19세,1998,2443,1278,1165
'2623069000,  당감3동,'25,20 - 24세,1998,1787,921,866
'2623069000,  당감3동,'30,25 - 29세,1998,2348,1069,1279
'2623069000,  당감3동,'35,30 - 34세,1998,2605,1263,1342
'2623069000,  당감3동,'40,35 - 39세,1998,3065,1470,1595
'2623069000,  당감3동,'45,40 - 44세,1998,2684,1359,1325
'2623069000,  당감3동,'50,45 - 49세,1998,1627,849,778
'2623069000,  당감3동,'55,50 - 54세,1998,1106,596,510
'2623069000,  당감3동,'60,55 - 59세,1998,1009,471,538
'2623069000,  당감3동,'65,60 - 64세,1998,743,334,409
'2623069000,  당감3동,'70,65 - 69세,1998,535,197,338
'2623069000,  당감3동,'75,70 - 74세,1998,354,107,247
'2623069000,  당감3동,'80,75 - 79세,1998,236,71,165
'2623069000,  당감3동,'85,80 - 84세,1998,113,32,81
'2623069000,  당감3동,'90,85+ ,1998,62,15,47
'2623070000,  당감4동,'00,계,1998,12217,6136,6081
'2623070000,  당감4동,'05,0 - 4세,1998,629,330,299
'2623070000,  당감4동,'10,5 - 9세,1998,776,411,365
'2623070000,  당감4동,'15,10 - 14세,1998,799,436,363
'2623070000,  당감4동,'20,15 - 19세,1998,1386,698,688
'2623070000,  당감4동,'25,20 - 24세,1998,1186,590,596
'2623070000,  당감4동,'30,25 - 29세,1998,1070,576,494
'2623070000,  당감4동,'35,30 - 34세,1998,944,484,460
'2623070000,  당감4동,'40,35 - 39세,1998,1211,598,613
'2623070000,  당감4동,'45,40 - 44세,1998,1128,579,549
'2623070000,  당감4동,'50,45 - 49세,1998,819,409,410
'2623070000,  당감4동,'55,50 - 54세,1998,615,306,309
'2623070000,  당감4동,'60,55 - 59세,1998,621,308,313
'2623070000,  당감4동,'65,60 - 64세,1998,402,175,227
'2623070000,  당감4동,'70,65 - 69세,1998,286,124,162
'2623070000,  당감4동,'75,70 - 74세,1998,172,66,106
'2623070000,  당감4동,'80,75 - 79세,1998,100,32,68
'2623070000,  당감4동,'85,80 - 84세,1998,41,8,33
'2623070000,  당감4동,'90,85+ ,1998,32,6,26
'2623071000,  가야1동,'00,계,1998,13284,6732,6552
'2623071000,  가야1동,'05,0 - 4세,1998,729,399,330
'2623071000,  가야1동,'10,5 - 9세,1998,732,407,325
'2623071000,  가야1동,'15,10 - 14세,1998,815,428,387
'2623071000,  가야1동,'20,15 - 19세,1998,1374,705,669
'2623071000,  가야1동,'25,20 - 24세,1998,1402,728,674
'2623071000,  가야1동,'30,25 - 29세,1998,1429,770,659
'2623071000,  가야1동,'35,30 - 34세,1998,1069,563,506
'2623071000,  가야1동,'40,35 - 39세,1998,1170,604,566
'2623071000,  가야1동,'45,40 - 44세,1998,1078,538,540
'2623071000,  가야1동,'50,45 - 49세,1998,900,436,464
'2623071000,  가야1동,'55,50 - 54세,1998,762,365,397
'2623071000,  가야1동,'60,55 - 59세,1998,710,346,364
'2623071000,  가야1동,'65,60 - 64세,1998,449,208,241
'2623071000,  가야1동,'70,65 - 69세,1998,307,121,186
'2623071000,  가야1동,'75,70 - 74세,1998,177,64,113
'2623071000,  가야1동,'80,75 - 79세,1998,108,36,72
'2623071000,  가야1동,'85,80 - 84세,1998,45,9,36
'2623071000,  가야1동,'90,85+ ,1998,28,5,23
'2623072000,  가야2동,'00,계,1998,21439,10796,10643
'2623072000,  가야2동,'05,0 - 4세,1998,1089,569,520
'2623072000,  가야2동,'10,5 - 9세,1998,1297,704,593
'2623072000,  가야2동,'15,10 - 14세,1998,1585,849,736
'2623072000,  가야2동,'20,15 - 19세,1998,2259,1169,1090
'2623072000,  가야2동,'25,20 - 24세,1998,2077,1068,1009
'2623072000,  가야2동,'30,25 - 29세,1998,1959,1044,915
'2623072000,  가야2동,'35,30 - 34세,1998,1546,782,764
'2623072000,  가야2동,'40,35 - 39세,1998,1867,871,996
'2623072000,  가야2동,'45,40 - 44세,1998,2021,984,1037
'2623072000,  가야2동,'50,45 - 49세,1998,1628,812,816
'2623072000,  가야2동,'55,50 - 54세,1998,1295,666,629
'2623072000,  가야2동,'60,55 - 59세,1998,1099,585,514
'2623072000,  가야2동,'65,60 - 64세,1998,719,354,365
'2623072000,  가야2동,'70,65 - 69세,1998,402,164,238
'2623072000,  가야2동,'75,70 - 74세,1998,280,101,179
'2623072000,  가야2동,'80,75 - 79세,1998,173,39,134
'2623072000,  가야2동,'85,80 - 84세,1998,95,29,66
'2623072000,  가야2동,'90,85+ ,1998,48,6,42
'2623073000,  가야3동,'00,계,1998,14181,7272,6909
'2623073000,  가야3동,'05,0 - 4세,1998,631,349,282
'2623073000,  가야3동,'10,5 - 9세,1998,803,423,380
'2623073000,  가야3동,'15,10 - 14세,1998,944,474,470
'2623073000,  가야3동,'20,15 - 19세,1998,1500,785,715
'2623073000,  가야3동,'25,20 - 24세,1998,1560,842,718
'2623073000,  가야3동,'30,25 - 29세,1998,1420,794,626
'2623073000,  가야3동,'35,30 - 34세,1998,1039,551,488
'2623073000,  가야3동,'40,35 - 39세,1998,1216,616,600
'2623073000,  가야3동,'45,40 - 44세,1998,1224,600,624
'2623073000,  가야3동,'50,45 - 49세,1998,986,507,479
'2623073000,  가야3동,'55,50 - 54세,1998,850,421,429
'2623073000,  가야3동,'60,55 - 59세,1998,811,404,407
'2623073000,  가야3동,'65,60 - 64세,1998,514,258,256
'2623073000,  가야3동,'70,65 - 69세,1998,313,132,181
'2623073000,  가야3동,'75,70 - 74세,1998,184,69,115
'2623073000,  가야3동,'80,75 - 79세,1998,106,27,79
'2623073000,  가야3동,'85,80 - 84세,1998,52,14,38
'2623073000,  가야3동,'90,85+ ,1998,28,6,22
'2623074000,  개금1동,'00,계,1998,17170,8657,8513
'2623074000,  개금1동,'05,0 - 4세,1998,1069,574,495
'2623074000,  개금1동,'10,5 - 9세,1998,1077,597,480
'2623074000,  개금1동,'15,10 - 14세,1998,1082,538,544
'2623074000,  개금1동,'20,15 - 19세,1998,1667,897,770
'2623074000,  개금1동,'25,20 - 24세,1998,1695,843,852
'2623074000,  개금1동,'30,25 - 29세,1998,1785,901,884
'2623074000,  개금1동,'35,30 - 34세,1998,1455,746,709
'2623074000,  개금1동,'40,35 - 39세,1998,1544,806,738
'2623074000,  개금1동,'45,40 - 44세,1998,1388,681,707
'2623074000,  개금1동,'50,45 - 49세,1998,1145,553,592
'2623074000,  개금1동,'55,50 - 54세,1998,956,462,494
'2623074000,  개금1동,'60,55 - 59세,1998,926,466,460
'2623074000,  개금1동,'65,60 - 64세,1998,618,313,305
'2623074000,  개금1동,'70,65 - 69세,1998,352,156,196
'2623074000,  개금1동,'75,70 - 74세,1998,190,71,119
'2623074000,  개금1동,'80,75 - 79세,1998,122,38,84
'2623074000,  개금1동,'85,80 - 84세,1998,62,13,49
'2623074000,  개금1동,'90,85+ ,1998,37,2,35
'2623075000,  개금2동,'00,계,1998,14099,7134,6965
'2623075000,  개금2동,'05,0 - 4세,1998,688,374,314
'2623075000,  개금2동,'10,5 - 9세,1998,863,483,380
'2623075000,  개금2동,'15,10 - 14세,1998,1004,499,505
'2623075000,  개금2동,'20,15 - 19세,1998,1413,744,669
'2623075000,  개금2동,'25,20 - 24세,1998,1330,709,621
'2623075000,  개금2동,'30,25 - 29세,1998,1313,720,593
'2623075000,  개금2동,'35,30 - 34세,1998,1070,563,507
'2623075000,  개금2동,'40,35 - 39세,1998,1238,610,628
'2623075000,  개금2동,'45,40 - 44세,1998,1253,645,608
'2623075000,  개금2동,'50,45 - 49세,1998,936,473,463
'2623075000,  개금2동,'55,50 - 54세,1998,765,377,388
'2623075000,  개금2동,'60,55 - 59세,1998,829,392,437
'2623075000,  개금2동,'65,60 - 64세,1998,586,268,318
'2623075000,  개금2동,'70,65 - 69세,1998,374,152,222
'2623075000,  개금2동,'75,70 - 74세,1998,217,68,149
'2623075000,  개금2동,'80,75 - 79세,1998,132,36,96
'2623075000,  개금2동,'85,80 - 84세,1998,53,15,38
'2623075000,  개금2동,'90,85+ ,1998,35,6,29
'2623076000,  개금3동,'00,계,1998,39533,19625,19908
'2623076000,  개금3동,'05,0 - 4세,1998,3031,1598,1433
'2623076000,  개금3동,'10,5 - 9세,1998,3353,1813,1540
'2623076000,  개금3동,'15,10 - 14세,1998,3500,1833,1667
'2623076000,  개금3동,'20,15 - 19세,1998,3700,1910,1790
'2623076000,  개금3동,'25,20 - 24세,1998,2722,1384,1338
'2623076000,  개금3동,'30,25 - 29세,1998,3050,1402,1648
'2623076000,  개금3동,'35,30 - 34세,1998,3863,1774,2089
'2623076000,  개금3동,'40,35 - 39세,1998,4746,2253,2493
'2623076000,  개금3동,'45,40 - 44세,1998,4051,2160,1891
'2623076000,  개금3동,'50,45 - 49세,1998,2340,1248,1092
'2623076000,  개금3동,'55,50 - 54세,1998,1402,740,662
'2623076000,  개금3동,'60,55 - 59세,1998,1197,587,610
'2623076000,  개금3동,'65,60 - 64세,1998,906,372,534
'2623076000,  개금3동,'70,65 - 69세,1998,709,255,454
'2623076000,  개금3동,'75,70 - 74세,1998,475,161,314
'2623076000,  개금3동,'80,75 - 79세,1998,290,83,207
'2623076000,  개금3동,'85,80 - 84세,1998,135,38,97
'2623076000,  개금3동,'90,85+ ,1998,63,14,49
'2623077000,  범천1동,'00,계,1998,10945,5434,5511
'2623077000,  범천1동,'05,0 - 4세,1998,453,238,215
'2623077000,  범천1동,'10,5 - 9세,1998,525,283,242
'2623077000,  범천1동,'15,10 - 14세,1998,642,323,319
'2623077000,  범천1동,'20,15 - 19세,1998,1041,521,520
'2623077000,  범천1동,'25,20 - 24세,1998,1092,570,522
'2623077000,  범천1동,'30,25 - 29세,1998,1104,605,499
'2623077000,  범천1동,'35,30 - 34세,1998,743,395,348
'2623077000,  범천1동,'40,35 - 39세,1998,902,432,470
'2623077000,  범천1동,'45,40 - 44세,1998,949,465,484
'2623077000,  범천1동,'50,45 - 49세,1998,774,377,397
'2623077000,  범천1동,'55,50 - 54세,1998,646,305,341
'2623077000,  범천1동,'60,55 - 59세,1998,685,320,365
'2623077000,  범천1동,'65,60 - 64세,1998,568,248,320
'2623077000,  범천1동,'70,65 - 69세,1998,379,178,201
'2623077000,  범천1동,'75,70 - 74세,1998,224,92,132
'2623077000,  범천1동,'80,75 - 79세,1998,126,59,67
'2623077000,  범천1동,'85,80 - 84세,1998,63,16,47
'2623077000,  범천1동,'90,85+ ,1998,29,7,22
'2623078000,  범천2동,'00,계,1998,17261,8726,8535
'2623078000,  범천2동,'05,0 - 4세,1998,924,487,437
'2623078000,  범천2동,'10,5 - 9세,1998,976,512,464
'2623078000,  범천2동,'15,10 - 14세,1998,1085,582,503
'2623078000,  범천2동,'20,15 - 19세,1998,1772,936,836
'2623078000,  범천2동,'25,20 - 24세,1998,1607,834,773
'2623078000,  범천2동,'30,25 - 29세,1998,1649,869,780
'2623078000,  범천2동,'35,30 - 34세,1998,1395,746,649
'2623078000,  범천2동,'40,35 - 39세,1998,1559,783,776
'2623078000,  범천2동,'45,40 - 44세,1998,1560,800,760
'2623078000,  범천2동,'50,45 - 49세,1998,1116,576,540
'2623078000,  범천2동,'55,50 - 54세,1998,944,462,482
'2623078000,  범천2동,'60,55 - 59세,1998,930,431,499
'2623078000,  범천2동,'65,60 - 64세,1998,718,338,380
'2623078000,  범천2동,'70,65 - 69세,1998,479,197,282
'2623078000,  범천2동,'75,70 - 74세,1998,295,107,188
'2623078000,  범천2동,'80,75 - 79세,1998,139,41,98
'2623078000,  범천2동,'85,80 - 84세,1998,66,15,51
'2623078000,  범천2동,'90,85+ ,1998,47,10,37
'2623079000,  범천4동,'00,계,1998,12769,6436,6333
'2623079000,  범천4동,'05,0 - 4세,1998,609,317,292
'2623079000,  범천4동,'10,5 - 9세,1998,650,353,297
'2623079000,  범천4동,'15,10 - 14세,1998,775,390,385
'2623079000,  범천4동,'20,15 - 19세,1998,1223,628,595
'2623079000,  범천4동,'25,20 - 24세,1998,1302,709,593
'2623079000,  범천4동,'30,25 - 29세,1998,1248,676,572
'2623079000,  범천4동,'35,30 - 34세,1998,981,540,441
'2623079000,  범천4동,'40,35 - 39세,1998,1078,545,533
'2623079000,  범천4동,'45,40 - 44세,1998,1084,562,522
'2623079000,  범천4동,'50,45 - 49세,1998,809,398,411
'2623079000,  범천4동,'55,50 - 54세,1998,754,354,400
'2623079000,  범천4동,'60,55 - 59세,1998,789,387,402
'2623079000,  범천4동,'65,60 - 64세,1998,573,238,335
'2623079000,  범천4동,'70,65 - 69세,1998,394,166,228
'2623079000,  범천4동,'75,70 - 74세,1998,259,114,145
'2623079000,  범천4동,'80,75 - 79세,1998,122,30,92
'2623079000,  범천4동,'85,80 - 84세,1998,79,20,59
'2623079000,  범천4동,'90,85+ ,1998,40,9,31
'26260, 동래구,'00,계,1998,300275,149600,150675
'26260, 동래구,'05,0 - 4세,1998,15747,8496,7251
'26260, 동래구,'10,5 - 9세,1998,18035,9878,8157
'26260, 동래구,'15,10 - 14세,1998,21394,11446,9948
'26260, 동래구,'20,15 - 19세,1998,32707,17160,15547
'26260, 동래구,'25,20 - 24세,1998,28758,14748,14010
'26260, 동래구,'30,25 - 29세,1998,26477,13415,13062
'26260, 동래구,'35,30 - 34세,1998,22148,10823,11325
'26260, 동래구,'40,35 - 39세,1998,26919,12252,14667
'26260, 동래구,'45,40 - 44세,1998,28799,13639,15160
'26260, 동래구,'50,45 - 49세,1998,22874,11285,11589
'26260, 동래구,'55,50 - 54세,1998,17118,8977,8141
'26260, 동래구,'60,55 - 59세,1998,14515,7432,7083
'26260, 동래구,'65,60 - 64세,1998,9500,4748,4752
'26260, 동래구,'70,65 - 69세,1998,6258,2540,3718
'26260, 동래구,'75,70 - 74세,1998,4207,1436,2771
'26260, 동래구,'80,75 - 79세,1998,2712,845,1867
'26260, 동래구,'85,80 - 84세,1998,1287,323,964
'26260, 동래구,'90,85+ ,1998,820,157,663
'2626051000,  수민동,'00,계,1998,35120,17506,17614
'2626051000,  수민동,'05,0 - 4세,1998,2169,1166,1003
'2626051000,  수민동,'10,5 - 9세,1998,2364,1281,1083
'2626051000,  수민동,'15,10 - 14세,1998,2579,1407,1172
'2626051000,  수민동,'20,15 - 19세,1998,3457,1861,1596
'2626051000,  수민동,'25,20 - 24세,1998,3013,1518,1495
'2626051000,  수민동,'30,25 - 29세,1998,3063,1446,1617
'2626051000,  수민동,'35,30 - 34세,1998,2969,1457,1512
'2626051000,  수민동,'40,35 - 39세,1998,3266,1503,1763
'2626051000,  수민동,'45,40 - 44세,1998,3347,1642,1705
'2626051000,  수민동,'50,45 - 49세,1998,2493,1234,1259
'2626051000,  수민동,'55,50 - 54세,1998,1917,997,920
'2626051000,  수민동,'60,55 - 59세,1998,1660,846,814
'2626051000,  수민동,'65,60 - 64세,1998,1045,516,529
'2626051000,  수민동,'70,65 - 69세,1998,750,314,436
'2626051000,  수민동,'75,70 - 74세,1998,497,174,323
'2626051000,  수민동,'80,75 - 79세,1998,307,85,222
'2626051000,  수민동,'85,80 - 84세,1998,142,42,100
'2626051000,  수민동,'90,85+ ,1998,82,17,65
'2626052000,  복산동,'00,계,1998,19055,9489,9566
'2626052000,  복산동,'05,0 - 4세,1998,831,430,401
'2626052000,  복산동,'10,5 - 9세,1998,1044,549,495
'2626052000,  복산동,'15,10 - 14세,1998,1341,702,639
'2626052000,  복산동,'20,15 - 19세,1998,2021,1081,940
'2626052000,  복산동,'25,20 - 24세,1998,1856,986,870
'2626052000,  복산동,'30,25 - 29세,1998,1750,928,822
'2626052000,  복산동,'35,30 - 34세,1998,1286,642,644
'2626052000,  복산동,'40,35 - 39세,1998,1593,723,870
'2626052000,  복산동,'45,40 - 44세,1998,1744,838,906
'2626052000,  복산동,'50,45 - 49세,1998,1477,731,746
'2626052000,  복산동,'55,50 - 54세,1998,1095,547,548
'2626052000,  복산동,'60,55 - 59세,1998,1122,550,572
'2626052000,  복산동,'65,60 - 64세,1998,788,389,399
'2626052000,  복산동,'70,65 - 69세,1998,469,201,268
'2626052000,  복산동,'75,70 - 74세,1998,286,103,183
'2626052000,  복산동,'80,75 - 79세,1998,202,61,141
'2626052000,  복산동,'85,80 - 84세,1998,93,21,72
'2626052000,  복산동,'90,85+ ,1998,57,7,50
'2626053000,  명륜1동,'00,계,1998,8795,4327,4468
'2626053000,  명륜1동,'05,0 - 4세,1998,392,208,184
'2626053000,  명륜1동,'10,5 - 9세,1998,392,225,167
'2626053000,  명륜1동,'15,10 - 14세,1998,497,256,241
'2626053000,  명륜1동,'20,15 - 19세,1998,942,501,441
'2626053000,  명륜1동,'25,20 - 24세,1998,937,463,474
'2626053000,  명륜1동,'30,25 - 29세,1998,935,481,454
'2626053000,  명륜1동,'35,30 - 34세,1998,569,301,268
'2626053000,  명륜1동,'40,35 - 39세,1998,677,292,385
'2626053000,  명륜1동,'45,40 - 44세,1998,749,359,390
'2626053000,  명륜1동,'50,45 - 49세,1998,690,318,372
'2626053000,  명륜1동,'55,50 - 54세,1998,575,288,287
'2626053000,  명륜1동,'60,55 - 59세,1998,497,241,256
'2626053000,  명륜1동,'65,60 - 64세,1998,362,184,178
'2626053000,  명륜1동,'70,65 - 69세,1998,239,94,145
'2626053000,  명륜1동,'75,70 - 74세,1998,163,58,105
'2626053000,  명륜1동,'80,75 - 79세,1998,102,38,64
'2626053000,  명륜1동,'85,80 - 84세,1998,54,16,38
'2626053000,  명륜1동,'90,85+ ,1998,23,4,19
'2626054000,  명륜2동,'00,계,1998,14501,7239,7262
'2626054000,  명륜2동,'05,0 - 4세,1998,790,433,357
'2626054000,  명륜2동,'10,5 - 9세,1998,774,416,358
'2626054000,  명륜2동,'15,10 - 14세,1998,838,444,394
'2626054000,  명륜2동,'20,15 - 19세,1998,1493,816,677
'2626054000,  명륜2동,'25,20 - 24세,1998,1505,800,705
'2626054000,  명륜2동,'30,25 - 29세,1998,1528,769,759
'2626054000,  명륜2동,'35,30 - 34세,1998,1102,569,533
'2626054000,  명륜2동,'40,35 - 39세,1998,1148,536,612
'2626054000,  명륜2동,'45,40 - 44세,1998,1233,555,678
'2626054000,  명륜2동,'50,45 - 49세,1998,1084,523,561
'2626054000,  명륜2동,'55,50 - 54세,1998,860,408,452
'2626054000,  명륜2동,'60,55 - 59세,1998,810,424,386
'2626054000,  명륜2동,'65,60 - 64세,1998,517,254,263
'2626054000,  명륜2동,'70,65 - 69세,1998,336,137,199
'2626054000,  명륜2동,'75,70 - 74세,1998,233,83,150
'2626054000,  명륜2동,'80,75 - 79세,1998,139,47,92
'2626054000,  명륜2동,'85,80 - 84세,1998,69,15,54
'2626054000,  명륜2동,'90,85+ ,1998,42,10,32
'2626055000,  온천1동,'00,계,1998,14400,6901,7499
'2626055000,  온천1동,'05,0 - 4세,1998,557,301,256
'2626055000,  온천1동,'10,5 - 9세,1998,614,350,264
'2626055000,  온천1동,'15,10 - 14세,1998,707,355,352
'2626055000,  온천1동,'20,15 - 19세,1998,1337,682,655
'2626055000,  온천1동,'25,20 - 24세,1998,1463,756,707
'2626055000,  온천1동,'30,25 - 29세,1998,1412,795,617
'2626055000,  온천1동,'35,30 - 34세,1998,954,468,486
'2626055000,  온천1동,'40,35 - 39세,1998,1061,471,590
'2626055000,  온천1동,'45,40 - 44세,1998,1186,511,675
'2626055000,  온천1동,'50,45 - 49세,1998,1112,473,639
'2626055000,  온천1동,'55,50 - 54세,1998,1006,460,546
'2626055000,  온천1동,'60,55 - 59세,1998,1058,482,576
'2626055000,  온천1동,'65,60 - 64세,1998,731,349,382
'2626055000,  온천1동,'70,65 - 69세,1998,473,207,266
'2626055000,  온천1동,'75,70 - 74세,1998,335,129,206
'2626055000,  온천1동,'80,75 - 79세,1998,233,75,158
'2626055000,  온천1동,'85,80 - 84세,1998,96,20,76
'2626055000,  온천1동,'90,85+ ,1998,65,17,48
'2626056000,  온천2동,'00,계,1998,26351,13056,13295
'2626056000,  온천2동,'05,0 - 4세,1998,1177,616,561
'2626056000,  온천2동,'10,5 - 9세,1998,1441,782,659
'2626056000,  온천2동,'15,10 - 14세,1998,1963,1044,919
'2626056000,  온천2동,'20,15 - 19세,1998,2906,1530,1376
'2626056000,  온천2동,'25,20 - 24세,1998,2526,1336,1190
'2626056000,  온천2동,'30,25 - 29세,1998,2274,1143,1131
'2626056000,  온천2동,'35,30 - 34세,1998,1596,790,806
'2626056000,  온천2동,'40,35 - 39세,1998,2186,937,1249
'2626056000,  온천2동,'45,40 - 44세,1998,2482,1151,1331
'2626056000,  온천2동,'50,45 - 49세,1998,2078,966,1112
'2626056000,  온천2동,'55,50 - 54세,1998,1647,851,796
'2626056000,  온천2동,'60,55 - 59세,1998,1480,764,716
'2626056000,  온천2동,'65,60 - 64세,1998,997,524,473
'2626056000,  온천2동,'70,65 - 69세,1998,625,279,346
'2626056000,  온천2동,'75,70 - 74세,1998,439,175,264
'2626056000,  온천2동,'80,75 - 79세,1998,298,106,192
'2626056000,  온천2동,'85,80 - 84세,1998,144,41,103
'2626056000,  온천2동,'90,85+ ,1998,92,21,71
'2626057000,  온천3동,'00,계,1998,30995,15414,15581
'2626057000,  온천3동,'05,0 - 4세,1998,1602,870,732
'2626057000,  온천3동,'10,5 - 9세,1998,1875,1076,799
'2626057000,  온천3동,'15,10 - 14세,1998,2284,1214,1070
'2626057000,  온천3동,'20,15 - 19세,1998,3297,1711,1586
'2626057000,  온천3동,'25,20 - 24세,1998,3055,1550,1505
'2626057000,  온천3동,'30,25 - 29세,1998,2799,1399,1400
'2626057000,  온천3동,'35,30 - 34세,1998,2288,1110,1178
'2626057000,  온천3동,'40,35 - 39세,1998,2822,1260,1562
'2626057000,  온천3동,'45,40 - 44세,1998,3018,1451,1567
'2626057000,  온천3동,'50,45 - 49세,1998,2331,1133,1198
'2626057000,  온천3동,'55,50 - 54세,1998,1722,894,828
'2626057000,  온천3동,'60,55 - 59세,1998,1499,768,731
'2626057000,  온천3동,'65,60 - 64세,1998,930,461,469
'2626057000,  온천3동,'70,65 - 69세,1998,635,266,369
'2626057000,  온천3동,'75,70 - 74세,1998,390,135,255
'2626057000,  온천3동,'80,75 - 79세,1998,239,77,162
'2626057000,  온천3동,'85,80 - 84세,1998,118,24,94
'2626057000,  온천3동,'90,85+ ,1998,91,15,76
'2626058000,  사직1동,'00,계,1998,10913,5453,5460
'2626058000,  사직1동,'05,0 - 4세,1998,520,288,232
'2626058000,  사직1동,'10,5 - 9세,1998,618,357,261
'2626058000,  사직1동,'15,10 - 14세,1998,724,374,350
'2626058000,  사직1동,'20,15 - 19세,1998,1151,588,563
'2626058000,  사직1동,'25,20 - 24세,1998,1095,599,496
'2626058000,  사직1동,'30,25 - 29세,1998,1061,542,519
'2626058000,  사직1동,'35,30 - 34세,1998,728,357,371
'2626058000,  사직1동,'40,35 - 39세,1998,884,405,479
'2626058000,  사직1동,'45,40 - 44세,1998,998,460,538
'2626058000,  사직1동,'50,45 - 49세,1998,899,417,482
'2626058000,  사직1동,'55,50 - 54세,1998,691,361,330
'2626058000,  사직1동,'60,55 - 59세,1998,591,294,297
'2626058000,  사직1동,'65,60 - 64세,1998,369,205,164
'2626058000,  사직1동,'70,65 - 69세,1998,226,94,132
'2626058000,  사직1동,'75,70 - 74세,1998,150,53,97
'2626058000,  사직1동,'80,75 - 79세,1998,97,31,66
'2626058000,  사직1동,'85,80 - 84세,1998,62,17,45
'2626058000,  사직1동,'90,85+ ,1998,49,11,38
'2626059000,  사직2동,'00,계,1998,28194,14071,14123
'2626059000,  사직2동,'05,0 - 4세,1998,1863,1013,850
'2626059000,  사직2동,'10,5 - 9세,1998,1979,1095,884
'2626059000,  사직2동,'15,10 - 14세,1998,2228,1228,1000
'2626059000,  사직2동,'20,15 - 19세,1998,3057,1618,1439
'2626059000,  사직2동,'25,20 - 24세,1998,2371,1210,1161
'2626059000,  사직2동,'30,25 - 29세,1998,2301,1083,1218
'2626059000,  사직2동,'35,30 - 34세,1998,2316,1074,1242
'2626059000,  사직2동,'40,35 - 39세,1998,2921,1298,1623
'2626059000,  사직2동,'45,40 - 44세,1998,2925,1444,1481
'2626059000,  사직2동,'50,45 - 49세,1998,2079,1079,1000
'2626059000,  사직2동,'55,50 - 54세,1998,1399,779,620
'2626059000,  사직2동,'60,55 - 59세,1998,988,526,462
'2626059000,  사직2동,'65,60 - 64세,1998,634,292,342
'2626059000,  사직2동,'70,65 - 69세,1998,474,158,316
'2626059000,  사직2동,'75,70 - 74세,1998,314,81,233
'2626059000,  사직2동,'80,75 - 79세,1998,205,59,146
'2626059000,  사직2동,'85,80 - 84세,1998,91,28,63
'2626059000,  사직2동,'90,85+ ,1998,49,6,43
'2626060000,  사직3동,'00,계,1998,22812,11550,11262
'2626060000,  사직3동,'05,0 - 4세,1998,1203,633,570
'2626060000,  사직3동,'10,5 - 9세,1998,1331,726,605
'2626060000,  사직3동,'15,10 - 14세,1998,1521,861,660
'2626060000,  사직3동,'20,15 - 19세,1998,2564,1353,1211
'2626060000,  사직3동,'25,20 - 24세,1998,2275,1185,1090
'2626060000,  사직3동,'30,25 - 29세,1998,2146,1133,1013
'2626060000,  사직3동,'35,30 - 34세,1998,1765,883,882
'2626060000,  사직3동,'40,35 - 39세,1998,1987,930,1057
'2626060000,  사직3동,'45,40 - 44세,1998,2144,997,1147
'2626060000,  사직3동,'50,45 - 49세,1998,1680,847,833
'2626060000,  사직3동,'55,50 - 54세,1998,1341,699,642
'2626060000,  사직3동,'60,55 - 59세,1998,1098,581,517
'2626060000,  사직3동,'65,60 - 64세,1998,697,355,342
'2626060000,  사직3동,'70,65 - 69세,1998,418,177,241
'2626060000,  사직3동,'75,70 - 74세,1998,292,94,198
'2626060000,  사직3동,'80,75 - 79세,1998,195,64,131
'2626060000,  사직3동,'85,80 - 84세,1998,95,22,73
'2626060000,  사직3동,'90,85+ ,1998,60,10,50
'2626074000,  안락1동,'00,계,1998,20601,10354,10247
'2626074000,  안락1동,'05,0 - 4세,1998,999,538,461
'2626074000,  안락1동,'10,5 - 9세,1998,1080,587,493
'2626074000,  안락1동,'15,10 - 14세,1998,1322,729,593
'2626074000,  안락1동,'20,15 - 19세,1998,2415,1307,1108
'2626074000,  안락1동,'25,20 - 24세,1998,2147,1068,1079
'2626074000,  안락1동,'30,25 - 29세,1998,1833,970,863
'2626074000,  안락1동,'35,30 - 34세,1998,1465,749,716
'2626074000,  안락1동,'40,35 - 39세,1998,1716,789,927
'2626074000,  안락1동,'45,40 - 44세,1998,1944,870,1074
'2626074000,  안락1동,'50,45 - 49세,1998,1713,857,856
'2626074000,  안락1동,'55,50 - 54세,1998,1245,652,593
'2626074000,  안락1동,'60,55 - 59세,1998,1035,535,500
'2626074000,  안락1동,'65,60 - 64세,1998,689,363,326
'2626074000,  안락1동,'70,65 - 69세,1998,430,171,259
'2626074000,  안락1동,'75,70 - 74세,1998,264,81,183
'2626074000,  안락1동,'80,75 - 79세,1998,157,58,99
'2626074000,  안락1동,'85,80 - 84세,1998,85,18,67
'2626074000,  안락1동,'90,85+ ,1998,62,12,50
'2626075000,  안락2동,'00,계,1998,23685,11950,11735
'2626075000,  안락2동,'05,0 - 4세,1998,1316,712,604
'2626075000,  안락2동,'10,5 - 9세,1998,1552,839,713
'2626075000,  안락2동,'15,10 - 14세,1998,1738,938,800
'2626075000,  안락2동,'20,15 - 19세,1998,2611,1401,1210
'2626075000,  안락2동,'25,20 - 24세,1998,2328,1175,1153
'2626075000,  안락2동,'30,25 - 29세,1998,2059,1072,987
'2626075000,  안락2동,'35,30 - 34세,1998,1853,899,954
'2626075000,  안락2동,'40,35 - 39세,1998,2187,1052,1135
'2626075000,  안락2동,'45,40 - 44세,1998,2286,1068,1218
'2626075000,  안락2동,'50,45 - 49세,1998,1774,915,859
'2626075000,  안락2동,'55,50 - 54세,1998,1281,712,569
'2626075000,  안락2동,'60,55 - 59세,1998,973,506,467
'2626075000,  안락2동,'65,60 - 64세,1998,613,299,314
'2626075000,  안락2동,'70,65 - 69세,1998,444,176,268
'2626075000,  안락2동,'75,70 - 74세,1998,324,108,216
'2626075000,  안락2동,'80,75 - 79세,1998,198,51,147
'2626075000,  안락2동,'85,80 - 84세,1998,84,16,68
'2626075000,  안락2동,'90,85+ ,1998,64,11,53
'2626076100,  명장1동,'00,계,1998,23845,11817,12028
'2626076100,  명장1동,'05,0 - 4세,1998,1199,652,547
'2626076100,  명장1동,'10,5 - 9세,1998,1642,869,773
'2626076100,  명장1동,'15,10 - 14세,1998,1923,1005,918
'2626076100,  명장1동,'20,15 - 19세,1998,2845,1419,1426
'2626076100,  명장1동,'25,20 - 24세,1998,2275,1127,1148
'2626076100,  명장1동,'30,25 - 29세,1998,1819,877,942
'2626076100,  명장1동,'35,30 - 34세,1998,1737,807,930
'2626076100,  명장1동,'40,35 - 39세,1998,2397,1136,1261
'2626076100,  명장1동,'45,40 - 44세,1998,2467,1182,1285
'2626076100,  명장1동,'50,45 - 49세,1998,1847,931,916
'2626076100,  명장1동,'55,50 - 54세,1998,1272,720,552
'2626076100,  명장1동,'60,55 - 59세,1998,901,502,399
'2626076100,  명장1동,'65,60 - 64세,1998,591,282,309
'2626076100,  명장1동,'70,65 - 69세,1998,373,135,238
'2626076100,  명장1동,'75,70 - 74세,1998,267,87,180
'2626076100,  명장1동,'80,75 - 79세,1998,173,54,119
'2626076100,  명장1동,'85,80 - 84세,1998,74,23,51
'2626076100,  명장1동,'90,85+ ,1998,43,9,34
'2626076200,  명장2동,'00,계,1998,21008,10473,10535
'2626076200,  명장2동,'05,0 - 4세,1998,1129,636,493
'2626076200,  명장2동,'10,5 - 9세,1998,1329,726,603
'2626076200,  명장2동,'15,10 - 14세,1998,1729,889,840
'2626076200,  명장2동,'20,15 - 19세,1998,2611,1292,1319
'2626076200,  명장2동,'25,20 - 24세,1998,1912,975,937
'2626076200,  명장2동,'30,25 - 29세,1998,1497,777,720
'2626076200,  명장2동,'35,30 - 34세,1998,1520,717,803
'2626076200,  명장2동,'40,35 - 39세,1998,2074,920,1154
'2626076200,  명장2동,'45,40 - 44세,1998,2276,1111,1165
'2626076200,  명장2동,'50,45 - 49세,1998,1617,861,756
'2626076200,  명장2동,'55,50 - 54세,1998,1067,609,458
'2626076200,  명장2동,'60,55 - 59세,1998,803,413,390
'2626076200,  명장2동,'65,60 - 64세,1998,537,275,262
'2626076200,  명장2동,'70,65 - 69세,1998,366,131,235
'2626076200,  명장2동,'75,70 - 74세,1998,253,75,178
'2626076200,  명장2동,'80,75 - 79세,1998,167,39,128
'2626076200,  명장2동,'85,80 - 84세,1998,80,20,60
'2626076200,  명장2동,'90,85+ ,1998,41,7,34
'26290, 남구,'00,계,1998,304978,153130,151848
'26290, 남구,'05,0 - 4세,1998,17050,9106,7944
'26290, 남구,'10,5 - 9세,1998,17521,9344,8177
'26290, 남구,'15,10 - 14세,1998,18939,9945,8994
'26290, 남구,'20,15 - 19세,1998,30420,15830,14590
'26290, 남구,'25,20 - 24세,1998,29898,15623,14275
'26290, 남구,'30,25 - 29세,1998,30508,15970,14538
'26290, 남구,'35,30 - 34세,1998,23834,12286,11548
'26290, 남구,'40,35 - 39세,1998,26355,12706,13649
'26290, 남구,'45,40 - 44세,1998,26982,13067,13915
'26290, 남구,'50,45 - 49세,1998,21712,10669,11043
'26290, 남구,'55,50 - 54세,1998,17945,8992,8953
'26290, 남구,'60,55 - 59세,1998,16601,8527,8074
'26290, 남구,'65,60 - 64세,1998,11034,5332,5702
'26290, 남구,'70,65 - 69세,1998,6737,2884,3853
'26290, 남구,'75,70 - 74세,1998,4479,1498,2981
'26290, 남구,'80,75 - 79세,1998,2762,893,1869
'26290, 남구,'85,80 - 84세,1998,1397,324,1073
'26290, 남구,'90,85+ ,1998,804,134,670
'2629051000,  대연1동,'00,계,1998,12376,6196,6180
'2629051000,  대연1동,'05,0 - 4세,1998,670,370,300
'2629051000,  대연1동,'10,5 - 9세,1998,640,341,299
'2629051000,  대연1동,'15,10 - 14세,1998,763,437,326
'2629051000,  대연1동,'20,15 - 19세,1998,1157,628,529
'2629051000,  대연1동,'25,20 - 24세,1998,1257,627,630
'2629051000,  대연1동,'30,25 - 29세,1998,1288,648,640
'2629051000,  대연1동,'35,30 - 34세,1998,894,491,403
'2629051000,  대연1동,'40,35 - 39세,1998,984,455,529
'2629051000,  대연1동,'45,40 - 44세,1998,1054,466,588
'2629051000,  대연1동,'50,45 - 49세,1998,871,424,447
'2629051000,  대연1동,'55,50 - 54세,1998,793,370,423
'2629051000,  대연1동,'60,55 - 59세,1998,730,392,338
'2629051000,  대연1동,'65,60 - 64세,1998,524,256,268
'2629051000,  대연1동,'70,65 - 69세,1998,298,133,165
'2629051000,  대연1동,'75,70 - 74세,1998,224,87,137
'2629051000,  대연1동,'80,75 - 79세,1998,123,46,77
'2629051000,  대연1동,'85,80 - 84세,1998,56,15,41
'2629051000,  대연1동,'90,85+ ,1998,50,10,40
'2629052000,  대연2동,'00,계,1998,10930,5506,5424
'2629052000,  대연2동,'05,0 - 4세,1998,620,332,288
'2629052000,  대연2동,'10,5 - 9세,1998,616,349,267
'2629052000,  대연2동,'15,10 - 14세,1998,594,314,280
'2629052000,  대연2동,'20,15 - 19세,1998,1002,555,447
'2629052000,  대연2동,'25,20 - 24세,1998,1159,601,558
'2629052000,  대연2동,'30,25 - 29세,1998,1254,663,591
'2629052000,  대연2동,'35,30 - 34세,1998,911,468,443
'2629052000,  대연2동,'40,35 - 39세,1998,835,415,420
'2629052000,  대연2동,'45,40 - 44세,1998,901,431,470
'2629052000,  대연2동,'50,45 - 49세,1998,732,353,379
'2629052000,  대연2동,'55,50 - 54세,1998,611,291,320
'2629052000,  대연2동,'60,55 - 59세,1998,634,307,327
'2629052000,  대연2동,'65,60 - 64세,1998,436,198,238
'2629052000,  대연2동,'70,65 - 69세,1998,269,117,152
'2629052000,  대연2동,'75,70 - 74세,1998,177,68,109
'2629052000,  대연2동,'80,75 - 79세,1998,97,26,71
'2629052000,  대연2동,'85,80 - 84세,1998,62,15,47
'2629052000,  대연2동,'90,85+ ,1998,20,3,17
'2629053000,  대연3동,'00,계,1998,24434,12194,12240
'2629053000,  대연3동,'05,0 - 4세,1998,1306,719,587
'2629053000,  대연3동,'10,5 - 9세,1998,1484,799,685
'2629053000,  대연3동,'15,10 - 14세,1998,1584,840,744
'2629053000,  대연3동,'20,15 - 19세,1998,2367,1275,1092
'2629053000,  대연3동,'25,20 - 24세,1998,2290,1201,1089
'2629053000,  대연3동,'30,25 - 29세,1998,2415,1257,1158
'2629053000,  대연3동,'35,30 - 34세,1998,1851,901,950
'2629053000,  대연3동,'40,35 - 39세,1998,2174,1016,1158
'2629053000,  대연3동,'45,40 - 44세,1998,2258,1046,1212
'2629053000,  대연3동,'50,45 - 49세,1998,1783,856,927
'2629053000,  대연3동,'55,50 - 54세,1998,1481,757,724
'2629053000,  대연3동,'60,55 - 59세,1998,1246,648,598
'2629053000,  대연3동,'65,60 - 64세,1998,827,387,440
'2629053000,  대연3동,'70,65 - 69세,1998,580,249,331
'2629053000,  대연3동,'75,70 - 74세,1998,385,138,247
'2629053000,  대연3동,'80,75 - 79세,1998,223,72,151
'2629053000,  대연3동,'85,80 - 84세,1998,106,23,83
'2629053000,  대연3동,'90,85+ ,1998,74,10,64
'2629054000,  대연4동,'00,계,1998,19639,9949,9690
'2629054000,  대연4동,'05,0 - 4세,1998,1156,627,529
'2629054000,  대연4동,'10,5 - 9세,1998,1084,579,505
'2629054000,  대연4동,'15,10 - 14세,1998,1119,608,511
'2629054000,  대연4동,'20,15 - 19세,1998,1956,1024,932
'2629054000,  대연4동,'25,20 - 24세,1998,2053,1077,976
'2629054000,  대연4동,'30,25 - 29세,1998,2050,1097,953
'2629054000,  대연4동,'35,30 - 34세,1998,1530,810,720
'2629054000,  대연4동,'40,35 - 39세,1998,1625,785,840
'2629054000,  대연4동,'45,40 - 44세,1998,1665,762,903
'2629054000,  대연4동,'50,45 - 49세,1998,1449,710,739
'2629054000,  대연4동,'55,50 - 54세,1998,1218,609,609
'2629054000,  대연4동,'60,55 - 59세,1998,1160,617,543
'2629054000,  대연4동,'65,60 - 64세,1998,656,338,318
'2629054000,  대연4동,'70,65 - 69세,1998,401,162,239
'2629054000,  대연4동,'75,70 - 74세,1998,224,66,158
'2629054000,  대연4동,'80,75 - 79세,1998,163,52,111
'2629054000,  대연4동,'85,80 - 84세,1998,83,19,64
'2629054000,  대연4동,'90,85+ ,1998,47,7,40
'2629055000,  대연5동,'00,계,1998,14695,7303,7392
'2629055000,  대연5동,'05,0 - 4세,1998,755,396,359
'2629055000,  대연5동,'10,5 - 9세,1998,858,473,385
'2629055000,  대연5동,'15,10 - 14세,1998,870,439,431
'2629055000,  대연5동,'20,15 - 19세,1998,1443,750,693
'2629055000,  대연5동,'25,20 - 24세,1998,1467,805,662
'2629055000,  대연5동,'30,25 - 29세,1998,1455,777,678
'2629055000,  대연5동,'35,30 - 34세,1998,1076,524,552
'2629055000,  대연5동,'40,35 - 39세,1998,1181,549,632
'2629055000,  대연5동,'45,40 - 44세,1998,1296,603,693
'2629055000,  대연5동,'50,45 - 49세,1998,1082,512,570
'2629055000,  대연5동,'55,50 - 54세,1998,900,434,466
'2629055000,  대연5동,'60,55 - 59세,1998,872,436,436
'2629055000,  대연5동,'65,60 - 64세,1998,553,296,257
'2629055000,  대연5동,'70,65 - 69세,1998,377,162,215
'2629055000,  대연5동,'75,70 - 74세,1998,225,80,145
'2629055000,  대연5동,'80,75 - 79세,1998,150,50,100
'2629055000,  대연5동,'85,80 - 84세,1998,87,13,74
'2629055000,  대연5동,'90,85+ ,1998,48,4,44
'2629056000,  대연6동,'00,계,1998,13954,7000,6954
'2629056000,  대연6동,'05,0 - 4세,1998,702,381,321
'2629056000,  대연6동,'10,5 - 9세,1998,678,350,328
'2629056000,  대연6동,'15,10 - 14세,1998,819,427,392
'2629056000,  대연6동,'20,15 - 19세,1998,1436,775,661
'2629056000,  대연6동,'25,20 - 24세,1998,1511,759,752
'2629056000,  대연6동,'30,25 - 29세,1998,1507,807,700
'2629056000,  대연6동,'35,30 - 34세,1998,1035,563,472
'2629056000,  대연6동,'40,35 - 39세,1998,1083,502,581
'2629056000,  대연6동,'45,40 - 44세,1998,1125,515,610
'2629056000,  대연6동,'50,45 - 49세,1998,1061,479,582
'2629056000,  대연6동,'55,50 - 54세,1998,965,499,466
'2629056000,  대연6동,'60,55 - 59세,1998,788,409,379
'2629056000,  대연6동,'65,60 - 64세,1998,559,290,269
'2629056000,  대연6동,'70,65 - 69세,1998,291,124,167
'2629056000,  대연6동,'75,70 - 74세,1998,186,61,125
'2629056000,  대연6동,'80,75 - 79세,1998,117,37,80
'2629056000,  대연6동,'85,80 - 84세,1998,54,16,38
'2629056000,  대연6동,'90,85+ ,1998,37,6,31
'2629057000,  용호1동,'00,계,1998,23875,11909,11966
'2629057000,  용호1동,'05,0 - 4세,1998,1450,745,705
'2629057000,  용호1동,'10,5 - 9세,1998,1608,846,762
'2629057000,  용호1동,'15,10 - 14세,1998,1581,792,789
'2629057000,  용호1동,'20,15 - 19세,1998,2409,1211,1198
'2629057000,  용호1동,'25,20 - 24세,1998,2253,1181,1072
'2629057000,  용호1동,'30,25 - 29세,1998,2208,1108,1100
'2629057000,  용호1동,'35,30 - 34세,1998,2048,997,1051
'2629057000,  용호1동,'40,35 - 39세,1998,2243,1096,1147
'2629057000,  용호1동,'45,40 - 44세,1998,2275,1148,1127
'2629057000,  용호1동,'50,45 - 49세,1998,1680,852,828
'2629057000,  용호1동,'55,50 - 54세,1998,1301,647,654
'2629057000,  용호1동,'60,55 - 59세,1998,1144,618,526
'2629057000,  용호1동,'65,60 - 64세,1998,705,361,344
'2629057000,  용호1동,'70,65 - 69세,1998,378,153,225
'2629057000,  용호1동,'75,70 - 74세,1998,271,74,197
'2629057000,  용호1동,'80,75 - 79세,1998,197,54,143
'2629057000,  용호1동,'85,80 - 84세,1998,76,18,58
'2629057000,  용호1동,'90,85+ ,1998,48,8,40
'2629058000,  용호2동,'00,계,1998,16565,8228,8337
'2629058000,  용호2동,'05,0 - 4세,1998,735,399,336
'2629058000,  용호2동,'10,5 - 9세,1998,926,506,420
'2629058000,  용호2동,'15,10 - 14세,1998,1119,593,526
'2629058000,  용호2동,'20,15 - 19세,1998,1788,942,846
'2629058000,  용호2동,'25,20 - 24세,1998,1611,848,763
'2629058000,  용호2동,'30,25 - 29세,1998,1371,742,629
'2629058000,  용호2동,'35,30 - 34세,1998,1052,508,544
'2629058000,  용호2동,'40,35 - 39세,1998,1354,620,734
'2629058000,  용호2동,'45,40 - 44세,1998,1556,761,795
'2629058000,  용호2동,'50,45 - 49세,1998,1257,659,598
'2629058000,  용호2동,'55,50 - 54세,1998,1002,523,479
'2629058000,  용호2동,'60,55 - 59세,1998,901,411,490
'2629058000,  용호2동,'65,60 - 64세,1998,716,307,409
'2629058000,  용호2동,'70,65 - 69세,1998,460,189,271
'2629058000,  용호2동,'75,70 - 74세,1998,326,107,219
'2629058000,  용호2동,'80,75 - 79세,1998,232,83,149
'2629058000,  용호2동,'85,80 - 84세,1998,103,22,81
'2629058000,  용호2동,'90,85+ ,1998,56,8,48
'2629059000,  용호3동,'00,계,1998,21473,10780,10693
'2629059000,  용호3동,'05,0 - 4세,1998,1202,624,578
'2629059000,  용호3동,'10,5 - 9세,1998,1388,753,635
'2629059000,  용호3동,'15,10 - 14세,1998,1537,802,735
'2629059000,  용호3동,'20,15 - 19세,1998,2335,1218,1117
'2629059000,  용호3동,'25,20 - 24세,1998,1923,1014,909
'2629059000,  용호3동,'30,25 - 29세,1998,1855,953,902
'2629059000,  용호3동,'35,30 - 34세,1998,1657,784,873
'2629059000,  용호3동,'40,35 - 39세,1998,2091,968,1123
'2629059000,  용호3동,'45,40 - 44세,1998,2226,1081,1145
'2629059000,  용호3동,'50,45 - 49세,1998,1609,838,771
'2629059000,  용호3동,'55,50 - 54세,1998,1176,648,528
'2629059000,  용호3동,'60,55 - 59세,1998,938,498,440
'2629059000,  용호3동,'65,60 - 64세,1998,595,300,295
'2629059000,  용호3동,'70,65 - 69세,1998,378,144,234
'2629059000,  용호3동,'75,70 - 74세,1998,271,84,187
'2629059000,  용호3동,'80,75 - 79세,1998,162,49,113
'2629059000,  용호3동,'85,80 - 84세,1998,83,16,67
'2629059000,  용호3동,'90,85+ ,1998,47,6,41
'2629060000,  용호4동,'00,계,1998,12301,6169,6132
'2629060000,  용호4동,'05,0 - 4세,1998,754,382,372
'2629060000,  용호4동,'10,5 - 9세,1998,696,379,317
'2629060000,  용호4동,'15,10 - 14세,1998,852,451,401
'2629060000,  용호4동,'20,15 - 19세,1998,1279,655,624
'2629060000,  용호4동,'25,20 - 24세,1998,1178,616,562
'2629060000,  용호4동,'30,25 - 29세,1998,1120,546,574
'2629060000,  용호4동,'35,30 - 34세,1998,1030,520,510
'2629060000,  용호4동,'40,35 - 39세,1998,1105,549,556
'2629060000,  용호4동,'45,40 - 44세,1998,1166,570,596
'2629060000,  용호4동,'50,45 - 49세,1998,929,455,474
'2629060000,  용호4동,'55,50 - 54세,1998,668,374,294
'2629060000,  용호4동,'60,55 - 59세,1998,549,283,266
'2629060000,  용호4동,'65,60 - 64세,1998,383,182,201
'2629060000,  용호4동,'70,65 - 69세,1998,223,100,123
'2629060000,  용호4동,'75,70 - 74세,1998,170,50,120
'2629060000,  용호4동,'80,75 - 79세,1998,99,33,66
'2629060000,  용호4동,'85,80 - 84세,1998,68,18,50
'2629060000,  용호4동,'90,85+ ,1998,32,6,26
'2629061000,  용당동,'00,계,1998,7920,4100,3820
'2629061000,  용당동,'05,0 - 4세,1998,492,268,224
'2629061000,  용당동,'10,5 - 9세,1998,398,209,189
'2629061000,  용당동,'15,10 - 14세,1998,480,259,221
'2629061000,  용당동,'20,15 - 19세,1998,835,450,385
'2629061000,  용당동,'25,20 - 24세,1998,785,435,350
'2629061000,  용당동,'30,25 - 29세,1998,849,477,372
'2629061000,  용당동,'35,30 - 34세,1998,607,330,277
'2629061000,  용당동,'40,35 - 39세,1998,649,306,343
'2629061000,  용당동,'45,40 - 44세,1998,672,344,328
'2629061000,  용당동,'50,45 - 49세,1998,571,283,288
'2629061000,  용당동,'55,50 - 54세,1998,501,231,270
'2629061000,  용당동,'60,55 - 59세,1998,471,266,205
'2629061000,  용당동,'65,60 - 64세,1998,232,112,120
'2629061000,  용당동,'70,65 - 69세,1998,161,70,91
'2629061000,  용당동,'75,70 - 74세,1998,98,34,64
'2629061000,  용당동,'80,75 - 79세,1998,63,14,49
'2629061000,  용당동,'85,80 - 84세,1998,32,7,25
'2629061000,  용당동,'90,85+ ,1998,24,5,19
'2629062000,  감만1동,'00,계,1998,24500,12341,12159
'2629062000,  감만1동,'05,0 - 4세,1998,1600,831,769
'2629062000,  감만1동,'10,5 - 9세,1998,1656,856,800
'2629062000,  감만1동,'15,10 - 14세,1998,1618,855,763
'2629062000,  감만1동,'20,15 - 19세,1998,2316,1207,1109
'2629062000,  감만1동,'25,20 - 24세,1998,2240,1156,1084
'2629062000,  감만1동,'30,25 - 29세,1998,2575,1271,1304
'2629062000,  감만1동,'35,30 - 34세,1998,2143,1100,1043
'2629062000,  감만1동,'40,35 - 39세,1998,2317,1143,1174
'2629062000,  감만1동,'45,40 - 44세,1998,2138,1102,1036
'2629062000,  감만1동,'50,45 - 49세,1998,1595,818,777
'2629062000,  감만1동,'55,50 - 54세,1998,1226,605,621
'2629062000,  감만1동,'60,55 - 59세,1998,1257,632,625
'2629062000,  감만1동,'65,60 - 64세,1998,747,366,381
'2629062000,  감만1동,'70,65 - 69세,1998,466,214,252
'2629062000,  감만1동,'75,70 - 74세,1998,283,90,193
'2629062000,  감만1동,'80,75 - 79세,1998,171,62,109
'2629062000,  감만1동,'85,80 - 84세,1998,101,23,78
'2629062000,  감만1동,'90,85+ ,1998,51,10,41
'2629063000,  감만2동,'00,계,1998,12168,6088,6080
'2629063000,  감만2동,'05,0 - 4세,1998,819,426,393
'2629063000,  감만2동,'10,5 - 9세,1998,689,338,351
'2629063000,  감만2동,'15,10 - 14세,1998,631,339,292
'2629063000,  감만2동,'20,15 - 19세,1998,1201,618,583
'2629063000,  감만2동,'25,20 - 24세,1998,1247,629,618
'2629063000,  감만2동,'30,25 - 29세,1998,1342,692,650
'2629063000,  감만2동,'35,30 - 34세,1998,1074,590,484
'2629063000,  감만2동,'40,35 - 39세,1998,1001,482,519
'2629063000,  감만2동,'45,40 - 44세,1998,984,496,488
'2629063000,  감만2동,'50,45 - 49세,1998,808,385,423
'2629063000,  감만2동,'55,50 - 54세,1998,696,339,357
'2629063000,  감만2동,'60,55 - 59세,1998,652,354,298
'2629063000,  감만2동,'65,60 - 64세,1998,448,203,245
'2629063000,  감만2동,'70,65 - 69세,1998,242,90,152
'2629063000,  감만2동,'75,70 - 74세,1998,154,62,92
'2629063000,  감만2동,'80,75 - 79세,1998,99,28,71
'2629063000,  감만2동,'85,80 - 84세,1998,52,15,37
'2629063000,  감만2동,'90,85+ ,1998,29,2,27
'2629064000,  우암1동,'00,계,1998,17914,9067,8847
'2629064000,  우암1동,'05,0 - 4세,1998,1042,577,465
'2629064000,  우암1동,'10,5 - 9세,1998,1085,604,481
'2629064000,  우암1동,'15,10 - 14세,1998,1257,659,598
'2629064000,  우암1동,'20,15 - 19세,1998,1866,952,914
'2629064000,  우암1동,'25,20 - 24세,1998,1727,912,815
'2629064000,  우암1동,'30,25 - 29세,1998,1637,858,779
'2629064000,  우암1동,'35,30 - 34세,1998,1341,659,682
'2629064000,  우암1동,'40,35 - 39세,1998,1687,794,893
'2629064000,  우암1동,'45,40 - 44세,1998,1704,833,871
'2629064000,  우암1동,'50,45 - 49세,1998,1290,633,657
'2629064000,  우암1동,'55,50 - 54세,1998,1007,547,460
'2629064000,  우암1동,'60,55 - 59세,1998,904,478,426
'2629064000,  우암1동,'65,60 - 64세,1998,560,284,276
'2629064000,  우암1동,'70,65 - 69세,1998,309,131,178
'2629064000,  우암1동,'75,70 - 74세,1998,219,64,155
'2629064000,  우암1동,'80,75 - 79세,1998,152,48,104
'2629064000,  우암1동,'85,80 - 84세,1998,88,24,64
'2629064000,  우암1동,'90,85+ ,1998,39,10,29
'2629065000,  우암2동,'00,계,1998,10346,5175,5171
'2629065000,  우암2동,'05,0 - 4세,1998,444,245,199
'2629065000,  우암2동,'10,5 - 9세,1998,514,256,258
'2629065000,  우암2동,'15,10 - 14세,1998,548,249,299
'2629065000,  우암2동,'20,15 - 19세,1998,1043,532,511
'2629065000,  우암2동,'25,20 - 24세,1998,1020,546,474
'2629065000,  우암2동,'30,25 - 29세,1998,1033,599,434
'2629065000,  우암2동,'35,30 - 34세,1998,710,399,311
'2629065000,  우암2동,'40,35 - 39세,1998,920,476,444
'2629065000,  우암2동,'45,40 - 44세,1998,870,421,449
'2629065000,  우암2동,'50,45 - 49세,1998,715,345,370
'2629065000,  우암2동,'55,50 - 54세,1998,619,305,314
'2629065000,  우암2동,'60,55 - 59세,1998,632,304,328
'2629065000,  우암2동,'65,60 - 64세,1998,476,211,265
'2629065000,  우암2동,'70,65 - 69세,1998,286,129,157
'2629065000,  우암2동,'75,70 - 74세,1998,262,76,186
'2629065000,  우암2동,'80,75 - 79세,1998,159,51,108
'2629065000,  우암2동,'85,80 - 84세,1998,63,24,39
'2629065000,  우암2동,'90,85+ ,1998,32,7,25
'2629068000,  문현1동,'00,계,1998,19443,9779,9664
'2629068000,  문현1동,'05,0 - 4세,1998,1076,586,490
'2629068000,  문현1동,'10,5 - 9세,1998,1122,611,511
'2629068000,  문현1동,'15,10 - 14세,1998,1206,629,577
'2629068000,  문현1동,'20,15 - 19세,1998,1900,925,975
'2629068000,  문현1동,'25,20 - 24세,1998,1905,959,946
'2629068000,  문현1동,'30,25 - 29세,1998,1991,1049,942
'2629068000,  문현1동,'35,30 - 34세,1998,1543,829,714
'2629068000,  문현1동,'40,35 - 39세,1998,1636,821,815
'2629068000,  문현1동,'45,40 - 44세,1998,1614,807,807
'2629068000,  문현1동,'50,45 - 49세,1998,1332,648,684
'2629068000,  문현1동,'55,50 - 54세,1998,1170,569,601
'2629068000,  문현1동,'60,55 - 59세,1998,1140,589,551
'2629068000,  문현1동,'65,60 - 64세,1998,763,373,390
'2629068000,  문현1동,'70,65 - 69세,1998,478,213,265
'2629068000,  문현1동,'75,70 - 74세,1998,268,90,178
'2629068000,  문현1동,'80,75 - 79세,1998,157,53,104
'2629068000,  문현1동,'85,80 - 84세,1998,99,22,77
'2629068000,  문현1동,'90,85+ ,1998,43,6,37
'2629069000,  문현2동,'00,계,1998,8574,4336,4238
'2629069000,  문현2동,'05,0 - 4세,1998,421,223,198
'2629069000,  문현2동,'10,5 - 9세,1998,401,218,183
'2629069000,  문현2동,'15,10 - 14세,1998,469,255,214
'2629069000,  문현2동,'20,15 - 19세,1998,805,413,392
'2629069000,  문현2동,'25,20 - 24세,1998,850,461,389
'2629069000,  문현2동,'30,25 - 29세,1998,903,496,407
'2629069000,  문현2동,'35,30 - 34세,1998,664,375,289
'2629069000,  문현2동,'40,35 - 39세,1998,698,367,331
'2629069000,  문현2동,'45,40 - 44세,1998,714,360,354
'2629069000,  문현2동,'50,45 - 49세,1998,545,267,278
'2629069000,  문현2동,'55,50 - 54세,1998,523,245,278
'2629069000,  문현2동,'60,55 - 59세,1998,517,243,274
'2629069000,  문현2동,'65,60 - 64세,1998,440,180,260
'2629069000,  문현2동,'70,65 - 69세,1998,281,131,150
'2629069000,  문현2동,'75,70 - 74세,1998,181,61,120
'2629069000,  문현2동,'80,75 - 79세,1998,80,25,55
'2629069000,  문현2동,'85,80 - 84세,1998,51,11,40
'2629069000,  문현2동,'90,85+ ,1998,31,5,26
'2629070000,  문현3동,'00,계,1998,22241,11155,11086
'2629070000,  문현3동,'05,0 - 4세,1998,1249,667,582
'2629070000,  문현3동,'10,5 - 9세,1998,1072,568,504
'2629070000,  문현3동,'15,10 - 14세,1998,1211,638,573
'2629070000,  문현3동,'20,15 - 19세,1998,2191,1143,1048
'2629070000,  문현3동,'25,20 - 24세,1998,2285,1189,1096
'2629070000,  문현3동,'30,25 - 29세,1998,2438,1275,1163
'2629070000,  문현3동,'35,30 - 34세,1998,1751,942,809
'2629070000,  문현3동,'40,35 - 39세,1998,1760,839,921
'2629070000,  문현3동,'45,40 - 44세,1998,1807,860,947
'2629070000,  문현3동,'50,45 - 49세,1998,1596,746,850
'2629070000,  문현3동,'55,50 - 54세,1998,1360,664,696
'2629070000,  문현3동,'60,55 - 59세,1998,1385,705,680
'2629070000,  문현3동,'65,60 - 64세,1998,894,440,454
'2629070000,  문현3동,'70,65 - 69세,1998,535,240,295
'2629070000,  문현3동,'75,70 - 74세,1998,343,129,214
'2629070000,  문현3동,'80,75 - 79세,1998,209,73,136
'2629070000,  문현3동,'85,80 - 84세,1998,90,20,70
'2629070000,  문현3동,'90,85+ ,1998,65,17,48
'2629071000,  문현4동,'00,계,1998,6937,3448,3489
'2629071000,  문현4동,'05,0 - 4세,1998,369,198,171
'2629071000,  문현4동,'10,5 - 9세,1998,364,177,187
'2629071000,  문현4동,'15,10 - 14세,1998,448,240,208
'2629071000,  문현4동,'20,15 - 19세,1998,655,339,316
'2629071000,  문현4동,'25,20 - 24세,1998,643,331,312
'2629071000,  문현4동,'30,25 - 29세,1998,730,373,357
'2629071000,  문현4동,'35,30 - 34세,1998,570,304,266
'2629071000,  문현4동,'40,35 - 39세,1998,619,311,308
'2629071000,  문현4동,'45,40 - 44세,1998,596,284,312
'2629071000,  문현4동,'50,45 - 49세,1998,481,231,250
'2629071000,  문현4동,'55,50 - 54세,1998,412,185,227
'2629071000,  문현4동,'60,55 - 59세,1998,384,203,181
'2629071000,  문현4동,'65,60 - 64세,1998,289,137,152
'2629071000,  문현4동,'70,65 - 69세,1998,159,69,90
'2629071000,  문현4동,'75,70 - 74세,1998,123,41,82
'2629071000,  문현4동,'80,75 - 79세,1998,51,22,29
'2629071000,  문현4동,'85,80 - 84세,1998,24,2,22
'2629071000,  문현4동,'90,85+ ,1998,20,1,19
'2629072000,  문현5동,'00,계,1998,4693,2407,2286
'2629072000,  문현5동,'05,0 - 4세,1998,188,110,78
'2629072000,  문현5동,'10,5 - 9세,1998,242,132,110
'2629072000,  문현5동,'15,10 - 14세,1998,233,119,114
'2629072000,  문현5동,'20,15 - 19세,1998,436,218,218
'2629072000,  문현5동,'25,20 - 24세,1998,494,276,218
'2629072000,  문현5동,'30,25 - 29세,1998,487,282,205
'2629072000,  문현5동,'35,30 - 34세,1998,347,192,155
'2629072000,  문현5동,'40,35 - 39세,1998,393,212,181
'2629072000,  문현5동,'45,40 - 44세,1998,361,177,184
'2629072000,  문현5동,'50,45 - 49세,1998,326,175,151
'2629072000,  문현5동,'55,50 - 54세,1998,316,150,166
'2629072000,  문현5동,'60,55 - 59세,1998,297,134,163
'2629072000,  문현5동,'65,60 - 64세,1998,231,111,120
'2629072000,  문현5동,'70,65 - 69세,1998,165,64,101
'2629072000,  문현5동,'75,70 - 74세,1998,89,36,53
'2629072000,  문현5동,'80,75 - 79세,1998,58,15,43
'2629072000,  문현5동,'85,80 - 84세,1998,19,1,18
'2629072000,  문현5동,'90,85+ ,1998,11,3,8
'26320, 북구,'00,계,1998,296335,148748,147587
'26320, 북구,'05,0 - 4세,1998,22965,12333,10632
'26320, 북구,'10,5 - 9세,1998,25161,13465,11696
'26320, 북구,'15,10 - 14세,1998,22776,11817,10959
'26320, 북구,'20,15 - 19세,1998,27164,13842,13322
'26320, 북구,'25,20 - 24세,1998,22811,11560,11251
'26320, 북구,'30,25 - 29세,1998,26240,12353,13887
'26320, 북구,'35,30 - 34세,1998,29877,14332,15545
'26320, 북구,'40,35 - 39세,1998,33770,17338,16432
'26320, 북구,'45,40 - 44세,1998,26581,14098,12483
'26320, 북구,'50,45 - 49세,1998,17221,9075,8146
'26320, 북구,'55,50 - 54세,1998,11998,6217,5781
'26320, 북구,'60,55 - 59세,1998,10452,5194,5258
'26320, 북구,'65,60 - 64세,1998,7299,3196,4103
'26320, 북구,'70,65 - 69세,1998,5223,1969,3254
'26320, 북구,'75,70 - 74세,1998,3381,1089,2292
'26320, 북구,'80,75 - 79세,1998,1978,545,1433
'26320, 북구,'85,80 - 84세,1998,903,218,685
'26320, 북구,'90,85+ ,1998,535,107,428
'2632051000,  구포1동,'00,계,1998,20437,10221,10216
'2632051000,  구포1동,'05,0 - 4세,1998,1373,734,639
'2632051000,  구포1동,'10,5 - 9세,1998,1461,756,705
'2632051000,  구포1동,'15,10 - 14세,1998,1313,663,650
'2632051000,  구포1동,'20,15 - 19세,1998,2034,1025,1009
'2632051000,  구포1동,'25,20 - 24세,1998,1826,916,910
'2632051000,  구포1동,'30,25 - 29세,1998,1984,987,997
'2632051000,  구포1동,'35,30 - 34세,1998,1881,969,912
'2632051000,  구포1동,'40,35 - 39세,1998,1989,1035,954
'2632051000,  구포1동,'45,40 - 44세,1998,1778,917,861
'2632051000,  구포1동,'50,45 - 49세,1998,1290,659,631
'2632051000,  구포1동,'55,50 - 54세,1998,984,472,512
'2632051000,  구포1동,'60,55 - 59세,1998,914,462,452
'2632051000,  구포1동,'65,60 - 64세,1998,643,295,348
'2632051000,  구포1동,'70,65 - 69세,1998,390,165,225
'2632051000,  구포1동,'75,70 - 74세,1998,282,95,187
'2632051000,  구포1동,'80,75 - 79세,1998,163,45,118
'2632051000,  구포1동,'85,80 - 84세,1998,85,18,67
'2632051000,  구포1동,'90,85+ ,1998,47,8,39
'2632052000,  구포2동,'00,계,1998,31170,15838,15332
'2632052000,  구포2동,'05,0 - 4세,1998,2108,1148,960
'2632052000,  구포2동,'10,5 - 9세,1998,2401,1296,1105
'2632052000,  구포2동,'15,10 - 14세,1998,2321,1195,1126
'2632052000,  구포2동,'20,15 - 19세,1998,2985,1537,1448
'2632052000,  구포2동,'25,20 - 24세,1998,2702,1378,1324
'2632052000,  구포2동,'30,25 - 29세,1998,2852,1465,1387
'2632052000,  구포2동,'35,30 - 34세,1998,2916,1459,1457
'2632052000,  구포2동,'40,35 - 39세,1998,3339,1689,1650
'2632052000,  구포2동,'45,40 - 44세,1998,2761,1445,1316
'2632052000,  구포2동,'50,45 - 49세,1998,1981,1037,944
'2632052000,  구포2동,'55,50 - 54세,1998,1409,731,678
'2632052000,  구포2동,'60,55 - 59세,1998,1324,678,646
'2632052000,  구포2동,'65,60 - 64세,1998,827,392,435
'2632052000,  구포2동,'70,65 - 69세,1998,555,216,339
'2632052000,  구포2동,'75,70 - 74세,1998,348,103,245
'2632052000,  구포2동,'80,75 - 79세,1998,193,43,150
'2632052000,  구포2동,'85,80 - 84세,1998,94,19,75
'2632052000,  구포2동,'90,85+ ,1998,54,7,47
'2632052100,  구포3동,'00,계,1998,32830,16561,16269
'2632052100,  구포3동,'05,0 - 4세,1998,3105,1672,1433
'2632052100,  구포3동,'10,5 - 9세,1998,3091,1683,1408
'2632052100,  구포3동,'15,10 - 14세,1998,2585,1347,1238
'2632052100,  구포3동,'20,15 - 19세,1998,2598,1267,1331
'2632052100,  구포3동,'25,20 - 24세,1998,2363,1123,1240
'2632052100,  구포3동,'30,25 - 29세,1998,3298,1488,1810
'2632052100,  구포3동,'35,30 - 34세,1998,3942,1905,2037
'2632052100,  구포3동,'40,35 - 39세,1998,3982,2144,1838
'2632052100,  구포3동,'45,40 - 44세,1998,2675,1489,1186
'2632052100,  구포3동,'50,45 - 49세,1998,1580,850,730
'2632052100,  구포3동,'55,50 - 54세,1998,1167,596,571
'2632052100,  구포3동,'60,55 - 59세,1998,984,502,482
'2632052100,  구포3동,'65,60 - 64세,1998,567,247,320
'2632052100,  구포3동,'70,65 - 69세,1998,387,139,248
'2632052100,  구포3동,'75,70 - 74세,1998,236,59,177
'2632052100,  구포3동,'80,75 - 79세,1998,149,32,117
'2632052100,  구포3동,'85,80 - 84세,1998,82,12,70
'2632052100,  구포3동,'90,85+ ,1998,39,6,33
'2632053000,  금곡동,'00,계,1998,43270,21765,21505
'2632053000,  금곡동,'05,0 - 4세,1998,3783,2051,1732
'2632053000,  금곡동,'10,5 - 9세,1998,4966,2705,2261
'2632053000,  금곡동,'15,10 - 14세,1998,3625,1848,1777
'2632053000,  금곡동,'20,15 - 19세,1998,3081,1605,1476
'2632053000,  금곡동,'25,20 - 24세,1998,2225,1131,1094
'2632053000,  금곡동,'30,25 - 29세,1998,3377,1488,1889
'2632053000,  금곡동,'35,30 - 34세,1998,5248,2309,2939
'2632053000,  금곡동,'40,35 - 39세,1998,6065,3262,2803
'2632053000,  금곡동,'45,40 - 44세,1998,3708,2165,1543
'2632053000,  금곡동,'50,45 - 49세,1998,1825,969,856
'2632053000,  금곡동,'55,50 - 54세,1998,1270,673,597
'2632053000,  금곡동,'60,55 - 59세,1998,1293,573,720
'2632053000,  금곡동,'65,60 - 64세,1998,1061,420,641
'2632053000,  금곡동,'70,65 - 69세,1998,789,278,511
'2632053000,  금곡동,'75,70 - 74세,1998,515,172,343
'2632053000,  금곡동,'80,75 - 79세,1998,266,81,185
'2632053000,  금곡동,'85,80 - 84세,1998,108,22,86
'2632053000,  금곡동,'90,85+ ,1998,65,13,52
'2632054000,  화명동,'00,계,1998,43955,22115,21840
'2632054000,  화명동,'05,0 - 4세,1998,4397,2333,2064
'2632054000,  화명동,'10,5 - 9세,1998,4263,2253,2010
'2632054000,  화명동,'15,10 - 14세,1998,3510,1858,1652
'2632054000,  화명동,'20,15 - 19세,1998,3358,1721,1637
'2632054000,  화명동,'25,20 - 24세,1998,2613,1318,1295
'2632054000,  화명동,'30,25 - 29세,1998,3935,1665,2270
'2632054000,  화명동,'35,30 - 34세,1998,5423,2575,2848
'2632054000,  화명동,'40,35 - 39세,1998,5556,2967,2589
'2632054000,  화명동,'45,40 - 44세,1998,3717,2057,1660
'2632054000,  화명동,'50,45 - 49세,1998,2163,1220,943
'2632054000,  화명동,'55,50 - 54세,1998,1316,698,618
'2632054000,  화명동,'60,55 - 59세,1998,1134,543,591
'2632054000,  화명동,'65,60 - 64세,1998,899,375,524
'2632054000,  화명동,'70,65 - 69세,1998,729,249,480
'2632054000,  화명동,'75,70 - 74세,1998,478,149,329
'2632054000,  화명동,'80,75 - 79세,1998,289,80,209
'2632054000,  화명동,'85,80 - 84세,1998,116,40,76
'2632054000,  화명동,'90,85+ ,1998,59,14,45
'2632055000,  덕천1동,'00,계,1998,23266,11687,11579
'2632055000,  덕천1동,'05,0 - 4세,1998,1550,848,702
'2632055000,  덕천1동,'10,5 - 9세,1998,1630,870,760
'2632055000,  덕천1동,'15,10 - 14세,1998,1734,888,846
'2632055000,  덕천1동,'20,15 - 19세,1998,2442,1290,1152
'2632055000,  덕천1동,'25,20 - 24세,1998,2053,1070,983
'2632055000,  덕천1동,'30,25 - 29세,1998,2050,1037,1013
'2632055000,  덕천1동,'35,30 - 34세,1998,1988,1001,987
'2632055000,  덕천1동,'40,35 - 39세,1998,2423,1186,1237
'2632055000,  덕천1동,'45,40 - 44세,1998,2137,1066,1071
'2632055000,  덕천1동,'50,45 - 49세,1998,1524,754,770
'2632055000,  덕천1동,'55,50 - 54세,1998,1059,578,481
'2632055000,  덕천1동,'60,55 - 59세,1998,895,427,468
'2632055000,  덕천1동,'65,60 - 64세,1998,658,284,374
'2632055000,  덕천1동,'70,65 - 69세,1998,513,194,319
'2632055000,  덕천1동,'75,70 - 74세,1998,288,95,193
'2632055000,  덕천1동,'80,75 - 79세,1998,188,64,124
'2632055000,  덕천1동,'85,80 - 84세,1998,88,26,62
'2632055000,  덕천1동,'90,85+ ,1998,46,9,37
'2632056000,  덕천2동,'00,계,1998,20946,10507,10439
'2632056000,  덕천2동,'05,0 - 4세,1998,1334,704,630
'2632056000,  덕천2동,'10,5 - 9세,1998,1516,822,694
'2632056000,  덕천2동,'15,10 - 14세,1998,1574,834,740
'2632056000,  덕천2동,'20,15 - 19세,1998,2135,1059,1076
'2632056000,  덕천2동,'25,20 - 24세,1998,1855,940,915
'2632056000,  덕천2동,'30,25 - 29세,1998,2021,955,1066
'2632056000,  덕천2동,'35,30 - 34세,1998,1808,935,873
'2632056000,  덕천2동,'40,35 - 39세,1998,2143,1060,1083
'2632056000,  덕천2동,'45,40 - 44세,1998,2006,1009,997
'2632056000,  덕천2동,'50,45 - 49세,1998,1413,744,669
'2632056000,  덕천2동,'55,50 - 54세,1998,937,491,446
'2632056000,  덕천2동,'60,55 - 59세,1998,804,409,395
'2632056000,  덕천2동,'65,60 - 64세,1998,536,255,281
'2632056000,  덕천2동,'70,65 - 69세,1998,392,137,255
'2632056000,  덕천2동,'75,70 - 74세,1998,231,80,151
'2632056000,  덕천2동,'80,75 - 79세,1998,149,53,96
'2632056000,  덕천2동,'85,80 - 84세,1998,56,12,44
'2632056000,  덕천2동,'90,85+ ,1998,36,8,28
'2632056100,  덕천3동,'00,계,1998,16580,8134,8446
'2632056100,  덕천3동,'05,0 - 4세,1998,815,441,374
'2632056100,  덕천3동,'10,5 - 9세,1998,919,485,434
'2632056100,  덕천3동,'15,10 - 14세,1998,1001,541,460
'2632056100,  덕천3동,'20,15 - 19세,1998,1949,993,956
'2632056100,  덕천3동,'25,20 - 24세,1998,2256,1133,1123
'2632056100,  덕천3동,'30,25 - 29세,1998,1628,869,759
'2632056100,  덕천3동,'35,30 - 34세,1998,1132,566,566
'2632056100,  덕천3동,'40,35 - 39세,1998,1272,603,669
'2632056100,  덕천3동,'45,40 - 44세,1998,1273,576,697
'2632056100,  덕천3동,'50,45 - 49세,1998,1208,538,670
'2632056100,  덕천3동,'55,50 - 54세,1998,1018,465,553
'2632056100,  덕천3동,'60,55 - 59세,1998,856,436,420
'2632056100,  덕천3동,'65,60 - 64세,1998,536,245,291
'2632056100,  덕천3동,'70,65 - 69세,1998,315,146,169
'2632056100,  덕천3동,'75,70 - 74세,1998,185,63,122
'2632056100,  덕천3동,'80,75 - 79세,1998,121,18,103
'2632056100,  덕천3동,'85,80 - 84세,1998,59,11,48
'2632056100,  덕천3동,'90,85+ ,1998,37,5,32
'2632057100,  만덕1동,'00,계,1998,16281,8207,8074
'2632057100,  만덕1동,'05,0 - 4세,1998,954,496,458
'2632057100,  만덕1동,'10,5 - 9세,1998,1079,555,524
'2632057100,  만덕1동,'15,10 - 14세,1998,1159,601,558
'2632057100,  만덕1동,'20,15 - 19세,1998,1742,911,831
'2632057100,  만덕1동,'25,20 - 24세,1998,1477,795,682
'2632057100,  만덕1동,'30,25 - 29세,1998,1363,691,672
'2632057100,  만덕1동,'35,30 - 34세,1998,1360,697,663
'2632057100,  만덕1동,'40,35 - 39세,1998,1643,836,807
'2632057100,  만덕1동,'45,40 - 44세,1998,1445,730,715
'2632057100,  만덕1동,'50,45 - 49세,1998,1078,559,519
'2632057100,  만덕1동,'55,50 - 54세,1998,807,407,400
'2632057100,  만덕1동,'60,55 - 59세,1998,764,409,355
'2632057100,  만덕1동,'65,60 - 64세,1998,531,208,323
'2632057100,  만덕1동,'70,65 - 69세,1998,369,152,217
'2632057100,  만덕1동,'75,70 - 74세,1998,260,83,177
'2632057100,  만덕1동,'80,75 - 79세,1998,134,42,92
'2632057100,  만덕1동,'85,80 - 84세,1998,73,21,52
'2632057100,  만덕1동,'90,85+ ,1998,43,14,29
'2632057200,  만덕2동,'00,계,1998,25232,12599,12633
'2632057200,  만덕2동,'05,0 - 4세,1998,2064,1094,970
'2632057200,  만덕2동,'10,5 - 9세,1998,2012,1087,925
'2632057200,  만덕2동,'15,10 - 14세,1998,1925,1007,918
'2632057200,  만덕2동,'20,15 - 19세,1998,2411,1210,1201
'2632057200,  만덕2동,'25,20 - 24세,1998,1883,941,942
'2632057200,  만덕2동,'30,25 - 29세,1998,2211,1015,1196
'2632057200,  만덕2동,'35,30 - 34세,1998,2420,1146,1274
'2632057200,  만덕2동,'40,35 - 39세,1998,2749,1390,1359
'2632057200,  만덕2동,'45,40 - 44세,1998,2456,1275,1181
'2632057200,  만덕2동,'50,45 - 49세,1998,1603,857,746
'2632057200,  만덕2동,'55,50 - 54세,1998,1069,584,485
'2632057200,  만덕2동,'60,55 - 59세,1998,796,395,401
'2632057200,  만덕2동,'65,60 - 64세,1998,584,261,323
'2632057200,  만덕2동,'70,65 - 69세,1998,435,164,271
'2632057200,  만덕2동,'75,70 - 74세,1998,307,94,213
'2632057200,  만덕2동,'80,75 - 79세,1998,174,47,127
'2632057200,  만덕2동,'85,80 - 84세,1998,79,23,56
'2632057200,  만덕2동,'90,85+ ,1998,54,9,45
'2632057300,  만덕3동,'00,계,1998,22368,11114,11254
'2632057300,  만덕3동,'05,0 - 4세,1998,1482,812,670
'2632057300,  만덕3동,'10,5 - 9세,1998,1823,953,870
'2632057300,  만덕3동,'15,10 - 14세,1998,2029,1035,994
'2632057300,  만덕3동,'20,15 - 19세,1998,2429,1224,1205
'2632057300,  만덕3동,'25,20 - 24세,1998,1558,815,743
'2632057300,  만덕3동,'30,25 - 29세,1998,1521,693,828
'2632057300,  만덕3동,'35,30 - 34세,1998,1759,770,989
'2632057300,  만덕3동,'40,35 - 39세,1998,2609,1166,1443
'2632057300,  만덕3동,'45,40 - 44세,1998,2625,1369,1256
'2632057300,  만덕3동,'50,45 - 49세,1998,1556,888,668
'2632057300,  만덕3동,'55,50 - 54세,1998,962,522,440
'2632057300,  만덕3동,'60,55 - 59세,1998,688,360,328
'2632057300,  만덕3동,'65,60 - 64세,1998,457,214,243
'2632057300,  만덕3동,'70,65 - 69세,1998,349,129,220
'2632057300,  만덕3동,'75,70 - 74세,1998,251,96,155
'2632057300,  만덕3동,'80,75 - 79세,1998,152,40,112
'2632057300,  만덕3동,'85,80 - 84세,1998,63,14,49
'2632057300,  만덕3동,'90,85+ ,1998,55,14,41
'26350, 해운대구,'00,계,1998,402154,199723,202431
'26350, 해운대구,'05,0 - 4세,1998,29613,15955,13658
'26350, 해운대구,'10,5 - 9세,1998,31681,17167,14514
'26350, 해운대구,'15,10 - 14세,1998,28697,14936,13761
'26350, 해운대구,'20,15 - 19세,1998,35406,18069,17337
'26350, 해운대구,'25,20 - 24세,1998,31445,15888,15557
'26350, 해운대구,'30,25 - 29세,1998,36943,17443,19500
'26350, 해운대구,'35,30 - 34세,1998,38762,18486,20276
'26350, 해운대구,'40,35 - 39세,1998,42390,21013,21377
'26350, 해운대구,'45,40 - 44세,1998,36212,18480,17732
'26350, 해운대구,'50,45 - 49세,1998,24776,12565,12211
'26350, 해운대구,'55,50 - 54세,1998,18624,9506,9118
'26350, 해운대구,'60,55 - 59세,1998,16687,8117,8570
'26350, 해운대구,'65,60 - 64세,1998,11855,5421,6434
'26350, 해운대구,'70,65 - 69세,1998,8078,3247,4831
'26350, 해운대구,'75,70 - 74세,1998,5383,1813,3570
'26350, 해운대구,'80,75 - 79세,1998,3262,1079,2183
'26350, 해운대구,'85,80 - 84세,1998,1456,393,1063
'26350, 해운대구,'90,85+ ,1998,884,145,739
'2635051000,  우1동,'00,계,1998,36814,18055,18759
'2635051000,  우1동,'05,0 - 4세,1998,2162,1153,1009
'2635051000,  우1동,'10,5 - 9세,1998,2518,1347,1171
'2635051000,  우1동,'15,10 - 14세,1998,2514,1299,1215
'2635051000,  우1동,'20,15 - 19세,1998,3358,1687,1671
'2635051000,  우1동,'25,20 - 24세,1998,3173,1607,1566
'2635051000,  우1동,'30,25 - 29세,1998,3241,1585,1656
'2635051000,  우1동,'35,30 - 34세,1998,2741,1293,1448
'2635051000,  우1동,'40,35 - 39세,1998,3465,1598,1867
'2635051000,  우1동,'45,40 - 44세,1998,3476,1731,1745
'2635051000,  우1동,'50,45 - 49세,1998,2636,1268,1368
'2635051000,  우1동,'55,50 - 54세,1998,2146,1095,1051
'2635051000,  우1동,'60,55 - 59세,1998,1978,985,993
'2635051000,  우1동,'65,60 - 64세,1998,1337,656,681
'2635051000,  우1동,'70,65 - 69세,1998,872,388,484
'2635051000,  우1동,'75,70 - 74세,1998,558,181,377
'2635051000,  우1동,'80,75 - 79세,1998,349,119,230
'2635051000,  우1동,'85,80 - 84세,1998,155,38,117
'2635051000,  우1동,'90,85+ ,1998,135,25,110
'2635052000,  우2동,'00,계,1998,18459,9144,9315
'2635052000,  우2동,'05,0 - 4세,1998,1073,602,471
'2635052000,  우2동,'10,5 - 9세,1998,1263,687,576
'2635052000,  우2동,'15,10 - 14세,1998,1335,706,629
'2635052000,  우2동,'20,15 - 19세,1998,1706,855,851
'2635052000,  우2동,'25,20 - 24세,1998,1527,774,753
'2635052000,  우2동,'30,25 - 29세,1998,1583,796,787
'2635052000,  우2동,'35,30 - 34세,1998,1436,683,753
'2635052000,  우2동,'40,35 - 39세,1998,1749,809,940
'2635052000,  우2동,'45,40 - 44세,1998,1740,890,850
'2635052000,  우2동,'50,45 - 49세,1998,1330,663,667
'2635052000,  우2동,'55,50 - 54세,1998,993,490,503
'2635052000,  우2동,'60,55 - 59세,1998,939,469,470
'2635052000,  우2동,'65,60 - 64세,1998,682,318,364
'2635052000,  우2동,'70,65 - 69세,1998,466,198,268
'2635052000,  우2동,'75,70 - 74세,1998,314,106,208
'2635052000,  우2동,'80,75 - 79세,1998,171,65,106
'2635052000,  우2동,'85,80 - 84세,1998,83,22,61
'2635052000,  우2동,'90,85+ ,1998,69,11,58
'2635053000,  중1동,'00,계,1998,16020,7926,8094
'2635053000,  중1동,'05,0 - 4세,1998,855,435,420
'2635053000,  중1동,'10,5 - 9세,1998,956,510,446
'2635053000,  중1동,'15,10 - 14세,1998,944,473,471
'2635053000,  중1동,'20,15 - 19세,1998,1459,769,690
'2635053000,  중1동,'25,20 - 24세,1998,1464,758,706
'2635053000,  중1동,'30,25 - 29세,1998,1627,850,777
'2635053000,  중1동,'35,30 - 34세,1998,1325,675,650
'2635053000,  중1동,'40,35 - 39세,1998,1328,635,693
'2635053000,  중1동,'45,40 - 44세,1998,1331,656,675
'2635053000,  중1동,'50,45 - 49세,1998,1054,501,553
'2635053000,  중1동,'55,50 - 54세,1998,978,489,489
'2635053000,  중1동,'60,55 - 59세,1998,949,429,520
'2635053000,  중1동,'65,60 - 64세,1998,675,323,352
'2635053000,  중1동,'70,65 - 69세,1998,446,198,248
'2635053000,  중1동,'75,70 - 74세,1998,300,125,175
'2635053000,  중1동,'80,75 - 79세,1998,198,67,131
'2635053000,  중1동,'85,80 - 84세,1998,85,21,64
'2635053000,  중1동,'90,85+ ,1998,46,12,34
'2635054000,  중2동,'00,계,1998,15345,7432,7913
'2635054000,  중2동,'05,0 - 4세,1998,1023,551,472
'2635054000,  중2동,'10,5 - 9세,1998,902,504,398
'2635054000,  중2동,'15,10 - 14세,1998,905,495,410
'2635054000,  중2동,'20,15 - 19세,1998,1309,679,630
'2635054000,  중2동,'25,20 - 24세,1998,1235,631,604
'2635054000,  중2동,'30,25 - 29세,1998,1671,769,902
'2635054000,  중2동,'35,30 - 34세,1998,1404,681,723
'2635054000,  중2동,'40,35 - 39세,1998,1509,705,804
'2635054000,  중2동,'45,40 - 44세,1998,1430,660,770
'2635054000,  중2동,'50,45 - 49세,1998,1029,495,534
'2635054000,  중2동,'55,50 - 54세,1998,851,404,447
'2635054000,  중2동,'60,55 - 59세,1998,701,338,363
'2635054000,  중2동,'65,60 - 64세,1998,474,223,251
'2635054000,  중2동,'70,65 - 69세,1998,362,137,225
'2635054000,  중2동,'75,70 - 74세,1998,270,80,190
'2635054000,  중2동,'80,75 - 79세,1998,156,51,105
'2635054000,  중2동,'85,80 - 84세,1998,80,23,57
'2635054000,  중2동,'90,85+ ,1998,34,6,28
'2635055000,  좌동,'00,계,1998,98921,48311,50610
'2635055000,  좌동,'05,0 - 4세,1998,9124,4921,4203
'2635055000,  좌동,'10,5 - 9세,1998,10000,5341,4659
'2635055000,  좌동,'15,10 - 14세,1998,8268,4317,3951
'2635055000,  좌동,'20,15 - 19세,1998,6729,3338,3391
'2635055000,  좌동,'25,20 - 24세,1998,5144,2516,2628
'2635055000,  좌동,'30,25 - 29세,1998,8297,3340,4957
'2635055000,  좌동,'35,30 - 34세,1998,11436,5084,6352
'2635055000,  좌동,'40,35 - 39세,1998,12394,6086,6308
'2635055000,  좌동,'45,40 - 44세,1998,9479,5061,4418
'2635055000,  좌동,'50,45 - 49세,1998,4988,2622,2366
'2635055000,  좌동,'55,50 - 54세,1998,3475,1773,1702
'2635055000,  좌동,'60,55 - 59세,1998,3033,1435,1598
'2635055000,  좌동,'65,60 - 64세,1998,2438,1048,1390
'2635055000,  좌동,'70,65 - 69세,1998,1790,680,1110
'2635055000,  좌동,'75,70 - 74세,1998,1159,399,760
'2635055000,  좌동,'80,75 - 79세,1998,692,238,454
'2635055000,  좌동,'85,80 - 84세,1998,304,83,221
'2635055000,  좌동,'90,85+ ,1998,171,29,142
'2635056000,  송정동,'00,계,1998,5860,2985,2875
'2635056000,  송정동,'05,0 - 4세,1998,340,187,153
'2635056000,  송정동,'10,5 - 9세,1998,397,219,178
'2635056000,  송정동,'15,10 - 14세,1998,352,178,174
'2635056000,  송정동,'20,15 - 19세,1998,551,285,266
'2635056000,  송정동,'25,20 - 24세,1998,503,273,230
'2635056000,  송정동,'30,25 - 29세,1998,531,307,224
'2635056000,  송정동,'35,30 - 34세,1998,440,202,238
'2635056000,  송정동,'40,35 - 39세,1998,559,293,266
'2635056000,  송정동,'45,40 - 44세,1998,478,252,226
'2635056000,  송정동,'50,45 - 49세,1998,377,178,199
'2635056000,  송정동,'55,50 - 54세,1998,338,175,163
'2635056000,  송정동,'60,55 - 59세,1998,315,155,160
'2635056000,  송정동,'65,60 - 64세,1998,243,116,127
'2635056000,  송정동,'70,65 - 69세,1998,188,70,118
'2635056000,  송정동,'75,70 - 74세,1998,125,51,74
'2635056000,  송정동,'80,75 - 79세,1998,75,33,42
'2635056000,  송정동,'85,80 - 84세,1998,33,8,25
'2635056000,  송정동,'90,85+ ,1998,15,3,12
'2635057000,  반여1동,'00,계,1998,36197,18316,17881
'2635057000,  반여1동,'05,0 - 4세,1998,2538,1355,1183
'2635057000,  반여1동,'10,5 - 9세,1998,2963,1644,1319
'2635057000,  반여1동,'15,10 - 14세,1998,2631,1371,1260
'2635057000,  반여1동,'20,15 - 19세,1998,3474,1793,1681
'2635057000,  반여1동,'25,20 - 24세,1998,2897,1445,1452
'2635057000,  반여1동,'30,25 - 29세,1998,3182,1563,1619
'2635057000,  반여1동,'35,30 - 34세,1998,3443,1665,1778
'2635057000,  반여1동,'40,35 - 39세,1998,3920,2005,1915
'2635057000,  반여1동,'45,40 - 44세,1998,3326,1704,1622
'2635057000,  반여1동,'50,45 - 49세,1998,2331,1220,1111
'2635057000,  반여1동,'55,50 - 54세,1998,1612,876,736
'2635057000,  반여1동,'60,55 - 59세,1998,1404,715,689
'2635057000,  반여1동,'65,60 - 64세,1998,945,450,495
'2635057000,  반여1동,'70,65 - 69세,1998,616,242,374
'2635057000,  반여1동,'75,70 - 74세,1998,464,156,308
'2635057000,  반여1동,'80,75 - 79세,1998,250,72,178
'2635057000,  반여1동,'85,80 - 84세,1998,117,28,89
'2635057000,  반여1동,'90,85+ ,1998,84,12,72
'2635058000,  반여2동,'00,계,1998,25001,12590,12411
'2635058000,  반여2동,'05,0 - 4세,1998,2112,1160,952
'2635058000,  반여2동,'10,5 - 9세,1998,1862,1019,843
'2635058000,  반여2동,'15,10 - 14세,1998,1492,793,699
'2635058000,  반여2동,'20,15 - 19세,1998,2183,1107,1076
'2635058000,  반여2동,'25,20 - 24세,1998,2152,1112,1040
'2635058000,  반여2동,'30,25 - 29세,1998,2735,1280,1455
'2635058000,  반여2동,'35,30 - 34세,1998,2531,1294,1237
'2635058000,  반여2동,'40,35 - 39세,1998,2488,1290,1198
'2635058000,  반여2동,'45,40 - 44세,1998,1982,1005,977
'2635058000,  반여2동,'50,45 - 49세,1998,1456,741,715
'2635058000,  반여2동,'55,50 - 54세,1998,1156,591,565
'2635058000,  반여2동,'60,55 - 59세,1998,1064,491,573
'2635058000,  반여2동,'65,60 - 64세,1998,714,323,391
'2635058000,  반여2동,'70,65 - 69세,1998,494,216,278
'2635058000,  반여2동,'75,70 - 74세,1998,289,81,208
'2635058000,  반여2동,'80,75 - 79세,1998,181,59,122
'2635058000,  반여2동,'85,80 - 84세,1998,73,22,51
'2635058000,  반여2동,'90,85+ ,1998,37,6,31
'2635059000,  반여3동,'00,계,1998,18126,9109,9017
'2635059000,  반여3동,'05,0 - 4세,1998,1283,720,563
'2635059000,  반여3동,'10,5 - 9세,1998,1244,663,581
'2635059000,  반여3동,'15,10 - 14세,1998,1167,615,552
'2635059000,  반여3동,'20,15 - 19세,1998,1777,933,844
'2635059000,  반여3동,'25,20 - 24세,1998,1631,790,841
'2635059000,  반여3동,'30,25 - 29세,1998,1829,854,975
'2635059000,  반여3동,'35,30 - 34세,1998,1743,870,873
'2635059000,  반여3동,'40,35 - 39세,1998,1780,935,845
'2635059000,  반여3동,'45,40 - 44세,1998,1502,773,729
'2635059000,  반여3동,'50,45 - 49세,1998,1123,559,564
'2635059000,  반여3동,'55,50 - 54세,1998,823,439,384
'2635059000,  반여3동,'60,55 - 59세,1998,849,404,445
'2635059000,  반여3동,'65,60 - 64세,1998,566,265,301
'2635059000,  반여3동,'70,65 - 69세,1998,366,150,216
'2635059000,  반여3동,'75,70 - 74세,1998,215,72,143
'2635059000,  반여3동,'80,75 - 79세,1998,129,37,92
'2635059000,  반여3동,'85,80 - 84세,1998,67,24,43
'2635059000,  반여3동,'90,85+ ,1998,32,6,26
'2635061000,  반송1동,'00,계,1998,18438,9431,9007
'2635061000,  반송1동,'05,0 - 4세,1998,1315,708,607
'2635061000,  반송1동,'10,5 - 9세,1998,1270,695,575
'2635061000,  반송1동,'15,10 - 14세,1998,1149,600,549
'2635061000,  반송1동,'20,15 - 19세,1998,1653,864,789
'2635061000,  반송1동,'25,20 - 24세,1998,1719,883,836
'2635061000,  반송1동,'30,25 - 29세,1998,1953,1025,928
'2635061000,  반송1동,'35,30 - 34세,1998,1771,934,837
'2635061000,  반송1동,'40,35 - 39세,1998,1665,898,767
'2635061000,  반송1동,'45,40 - 44세,1998,1439,732,707
'2635061000,  반송1동,'50,45 - 49세,1998,1082,548,534
'2635061000,  반송1동,'55,50 - 54세,1998,940,460,480
'2635061000,  반송1동,'60,55 - 59세,1998,923,467,456
'2635061000,  반송1동,'65,60 - 64세,1998,666,298,368
'2635061000,  반송1동,'70,65 - 69세,1998,406,174,232
'2635061000,  반송1동,'75,70 - 74세,1998,236,94,142
'2635061000,  반송1동,'80,75 - 79세,1998,134,27,107
'2635061000,  반송1동,'85,80 - 84세,1998,66,17,49
'2635061000,  반송1동,'90,85+ ,1998,51,7,44
'2635062000,  반송2동,'00,계,1998,43236,21523,21713
'2635062000,  반송2동,'05,0 - 4세,1998,2781,1501,1280
'2635062000,  반송2동,'10,5 - 9세,1998,3078,1704,1374
'2635062000,  반송2동,'15,10 - 14세,1998,2923,1516,1407
'2635062000,  반송2동,'20,15 - 19세,1998,4458,2266,2192
'2635062000,  반송2동,'25,20 - 24세,1998,4383,2267,2116
'2635062000,  반송2동,'30,25 - 29세,1998,3884,2002,1882
'2635062000,  반송2동,'35,30 - 34세,1998,3852,1835,2017
'2635062000,  반송2동,'40,35 - 39세,1998,4232,2187,2045
'2635062000,  반송2동,'45,40 - 44세,1998,3518,1742,1776
'2635062000,  반송2동,'50,45 - 49세,1998,2782,1315,1467
'2635062000,  반송2동,'55,50 - 54세,1998,2173,1057,1116
'2635062000,  반송2동,'60,55 - 59세,1998,1917,947,970
'2635062000,  반송2동,'65,60 - 64세,1998,1201,522,679
'2635062000,  반송2동,'70,65 - 69세,1998,793,286,507
'2635062000,  반송2동,'75,70 - 74세,1998,596,172,424
'2635062000,  반송2동,'80,75 - 79세,1998,421,148,273
'2635062000,  반송2동,'85,80 - 84세,1998,166,47,119
'2635062000,  반송2동,'90,85+ ,1998,78,9,69
'2635063000,  반송3동,'00,계,1998,14332,7188,7144
'2635063000,  반송3동,'05,0 - 4세,1998,1141,586,555
'2635063000,  반송3동,'10,5 - 9세,1998,987,523,464
'2635063000,  반송3동,'15,10 - 14세,1998,784,389,395
'2635063000,  반송3동,'20,15 - 19세,1998,1238,642,596
'2635063000,  반송3동,'25,20 - 24세,1998,1338,662,676
'2635063000,  반송3동,'30,25 - 29세,1998,1646,839,807
'2635063000,  반송3동,'35,30 - 34세,1998,1465,771,694
'2635063000,  반송3동,'40,35 - 39세,1998,1294,711,583
'2635063000,  반송3동,'45,40 - 44세,1998,1002,531,471
'2635063000,  반송3동,'50,45 - 49세,1998,842,421,421
'2635063000,  반송3동,'55,50 - 54세,1998,685,309,376
'2635063000,  반송3동,'60,55 - 59세,1998,663,325,338
'2635063000,  반송3동,'65,60 - 64세,1998,541,235,306
'2635063000,  반송3동,'70,65 - 69세,1998,316,129,187
'2635063000,  반송3동,'75,70 - 74세,1998,193,72,121
'2635063000,  반송3동,'80,75 - 79세,1998,114,29,85
'2635063000,  반송3동,'85,80 - 84세,1998,50,10,40
'2635063000,  반송3동,'90,85+ ,1998,33,4,29
'2635065000,  재송1동,'00,계,1998,16862,8507,8355
'2635065000,  재송1동,'05,0 - 4세,1998,1094,586,508
'2635065000,  재송1동,'10,5 - 9세,1998,1225,667,558
'2635065000,  재송1동,'15,10 - 14세,1998,1267,652,615
'2635065000,  재송1동,'20,15 - 19세,1998,1671,885,786
'2635065000,  재송1동,'25,20 - 24세,1998,1437,763,674
'2635065000,  재송1동,'30,25 - 29세,1998,1517,725,792
'2635065000,  재송1동,'35,30 - 34세,1998,1455,707,748
'2635065000,  재송1동,'40,35 - 39세,1998,1742,837,905
'2635065000,  재송1동,'45,40 - 44세,1998,1601,812,789
'2635065000,  재송1동,'50,45 - 49세,1998,1216,647,569
'2635065000,  재송1동,'55,50 - 54세,1998,815,423,392
'2635065000,  재송1동,'60,55 - 59세,1998,656,338,318
'2635065000,  재송1동,'65,60 - 64세,1998,436,216,220
'2635065000,  재송1동,'70,65 - 69세,1998,285,106,179
'2635065000,  재송1동,'75,70 - 74세,1998,195,66,129
'2635065000,  재송1동,'80,75 - 79세,1998,144,54,90
'2635065000,  재송1동,'85,80 - 84세,1998,66,19,47
'2635065000,  재송1동,'90,85+ ,1998,40,4,36
'2635066000,  재송2동,'00,계,1998,38543,19206,19337
'2635066000,  재송2동,'05,0 - 4세,1998,2772,1490,1282
'2635066000,  재송2동,'10,5 - 9세,1998,3016,1644,1372
'2635066000,  재송2동,'15,10 - 14세,1998,2966,1532,1434
'2635066000,  재송2동,'20,15 - 19세,1998,3840,1966,1874
'2635066000,  재송2동,'25,20 - 24세,1998,2842,1407,1435
'2635066000,  재송2동,'30,25 - 29세,1998,3247,1508,1739
'2635066000,  재송2동,'35,30 - 34세,1998,3720,1792,1928
'2635066000,  재송2동,'40,35 - 39세,1998,4265,2024,2241
'2635066000,  재송2동,'45,40 - 44세,1998,3908,1931,1977
'2635066000,  재송2동,'50,45 - 49세,1998,2530,1387,1143
'2635066000,  재송2동,'55,50 - 54세,1998,1639,925,714
'2635066000,  재송2동,'60,55 - 59세,1998,1296,619,677
'2635066000,  재송2동,'65,60 - 64세,1998,937,428,509
'2635066000,  재송2동,'70,65 - 69세,1998,678,273,405
'2635066000,  재송2동,'75,70 - 74세,1998,469,158,311
'2635066000,  재송2동,'80,75 - 79세,1998,248,80,168
'2635066000,  재송2동,'85,80 - 84세,1998,111,31,80
'2635066000,  재송2동,'90,85+ ,1998,59,11,48
'26380, 사하구,'00,계,1998,391758,196453,195305
'26380, 사하구,'05,0 - 4세,1998,26498,14064,12434
'26380, 사하구,'10,5 - 9세,1998,28132,15002,13130
'26380, 사하구,'15,10 - 14세,1998,28531,14874,13657
'26380, 사하구,'20,15 - 19세,1998,38087,19578,18509
'26380, 사하구,'25,20 - 24세,1998,33090,16723,16367
'26380, 사하구,'30,25 - 29세,1998,36720,18268,18452
'26380, 사하구,'35,30 - 34세,1998,34807,17331,17476
'26380, 사하구,'40,35 - 39세,1998,39986,19652,20334
'26380, 사하구,'45,40 - 44세,1998,36708,18695,18013
'26380, 사하구,'50,45 - 49세,1998,25563,13244,12319
'26380, 사하구,'55,50 - 54세,1998,18712,9651,9061
'26380, 사하구,'60,55 - 59세,1998,15895,8067,7828
'26380, 사하구,'65,60 - 64세,1998,11104,5181,5923
'26380, 사하구,'70,65 - 69세,1998,7333,2900,4433
'26380, 사하구,'75,70 - 74세,1998,5143,1714,3429
'26380, 사하구,'80,75 - 79세,1998,3190,990,2200
'26380, 사하구,'85,80 - 84세,1998,1480,371,1109
'26380, 사하구,'90,85+ ,1998,779,148,631
'2638051000,  괴정1동,'00,계,1998,25072,12431,12641
'2638051000,  괴정1동,'05,0 - 4세,1998,1363,717,646
'2638051000,  괴정1동,'10,5 - 9세,1998,1519,842,677
'2638051000,  괴정1동,'15,10 - 14세,1998,1733,867,866
'2638051000,  괴정1동,'20,15 - 19세,1998,2532,1357,1175
'2638051000,  괴정1동,'25,20 - 24세,1998,2372,1219,1153
'2638051000,  괴정1동,'30,25 - 29세,1998,2241,1147,1094
'2638051000,  괴정1동,'35,30 - 34세,1998,1912,928,984
'2638051000,  괴정1동,'40,35 - 39세,1998,2194,1002,1192
'2638051000,  괴정1동,'45,40 - 44세,1998,2328,1111,1217
'2638051000,  괴정1동,'50,45 - 49세,1998,1855,903,952
'2638051000,  괴정1동,'55,50 - 54세,1998,1518,762,756
'2638051000,  괴정1동,'60,55 - 59세,1998,1254,671,583
'2638051000,  괴정1동,'65,60 - 64세,1998,804,392,412
'2638051000,  괴정1동,'70,65 - 69세,1998,566,231,335
'2638051000,  괴정1동,'75,70 - 74세,1998,392,135,257
'2638051000,  괴정1동,'80,75 - 79세,1998,272,98,174
'2638051000,  괴정1동,'85,80 - 84세,1998,140,34,106
'2638051000,  괴정1동,'90,85+ ,1998,77,15,62
'2638052000,  괴정2동,'00,계,1998,21722,10757,10965
'2638052000,  괴정2동,'05,0 - 4세,1998,1286,705,581
'2638052000,  괴정2동,'10,5 - 9세,1998,1270,664,606
'2638052000,  괴정2동,'15,10 - 14세,1998,1448,741,707
'2638052000,  괴정2동,'20,15 - 19세,1998,2231,1124,1107
'2638052000,  괴정2동,'25,20 - 24세,1998,2059,989,1070
'2638052000,  괴정2동,'30,25 - 29세,1998,2201,1159,1042
'2638052000,  괴정2동,'35,30 - 34세,1998,1704,891,813
'2638052000,  괴정2동,'40,35 - 39세,1998,1909,880,1029
'2638052000,  괴정2동,'45,40 - 44세,1998,1981,972,1009
'2638052000,  괴정2동,'50,45 - 49세,1998,1547,783,764
'2638052000,  괴정2동,'55,50 - 54세,1998,1209,620,589
'2638052000,  괴정2동,'60,55 - 59세,1998,1063,531,532
'2638052000,  괴정2동,'65,60 - 64세,1998,683,329,354
'2638052000,  괴정2동,'70,65 - 69세,1998,459,189,270
'2638052000,  괴정2동,'75,70 - 74세,1998,333,93,240
'2638052000,  괴정2동,'80,75 - 79세,1998,208,59,149
'2638052000,  괴정2동,'85,80 - 84세,1998,89,22,67
'2638052000,  괴정2동,'90,85+ ,1998,42,6,36
'2638053000,  괴정3동,'00,계,1998,18497,9175,9322
'2638053000,  괴정3동,'05,0 - 4세,1998,932,489,443
'2638053000,  괴정3동,'10,5 - 9세,1998,995,537,458
'2638053000,  괴정3동,'15,10 - 14세,1998,1109,612,497
'2638053000,  괴정3동,'20,15 - 19세,1998,1878,956,922
'2638053000,  괴정3동,'25,20 - 24세,1998,1810,888,922
'2638053000,  괴정3동,'30,25 - 29세,1998,1779,950,829
'2638053000,  괴정3동,'35,30 - 34세,1998,1414,731,683
'2638053000,  괴정3동,'40,35 - 39세,1998,1569,760,809
'2638053000,  괴정3동,'45,40 - 44세,1998,1749,863,886
'2638053000,  괴정3동,'50,45 - 49세,1998,1400,662,738
'2638053000,  괴정3동,'55,50 - 54세,1998,1081,553,528
'2638053000,  괴정3동,'60,55 - 59세,1998,944,475,469
'2638053000,  괴정3동,'65,60 - 64세,1998,667,296,371
'2638053000,  괴정3동,'70,65 - 69세,1998,450,175,275
'2638053000,  괴정3동,'75,70 - 74세,1998,334,118,216
'2638053000,  괴정3동,'80,75 - 79세,1998,229,71,158
'2638053000,  괴정3동,'85,80 - 84세,1998,94,21,73
'2638053000,  괴정3동,'90,85+ ,1998,63,18,45
'2638054000,  괴정4동,'00,계,1998,19324,9736,9588
'2638054000,  괴정4동,'05,0 - 4세,1998,1098,597,501
'2638054000,  괴정4동,'10,5 - 9세,1998,1142,632,510
'2638054000,  괴정4동,'15,10 - 14세,1998,1297,708,589
'2638054000,  괴정4동,'20,15 - 19세,1998,1957,1030,927
'2638054000,  괴정4동,'25,20 - 24세,1998,1908,967,941
'2638054000,  괴정4동,'30,25 - 29세,1998,1923,955,968
'2638054000,  괴정4동,'35,30 - 34세,1998,1502,775,727
'2638054000,  괴정4동,'40,35 - 39세,1998,1755,837,918
'2638054000,  괴정4동,'45,40 - 44세,1998,1693,809,884
'2638054000,  괴정4동,'50,45 - 49세,1998,1436,667,769
'2638054000,  괴정4동,'55,50 - 54세,1998,1102,587,515
'2638054000,  괴정4동,'60,55 - 59세,1998,935,499,436
'2638054000,  괴정4동,'65,60 - 64세,1998,627,328,299
'2638054000,  괴정4동,'70,65 - 69세,1998,422,182,240
'2638054000,  괴정4동,'75,70 - 74세,1998,254,88,166
'2638054000,  괴정4동,'80,75 - 79세,1998,157,53,104
'2638054000,  괴정4동,'85,80 - 84세,1998,77,16,61
'2638054000,  괴정4동,'90,85+ ,1998,39,6,33
'2638055000,  당리동,'00,계,1998,32794,16474,16320
'2638055000,  당리동,'05,0 - 4세,1998,1853,1017,836
'2638055000,  당리동,'10,5 - 9세,1998,2251,1262,989
'2638055000,  당리동,'15,10 - 14세,1998,2596,1367,1229
'2638055000,  당리동,'20,15 - 19세,1998,3507,1817,1690
'2638055000,  당리동,'25,20 - 24세,1998,2868,1468,1400
'2638055000,  당리동,'30,25 - 29세,1998,2825,1415,1410
'2638055000,  당리동,'35,30 - 34세,1998,2483,1193,1290
'2638055000,  당리동,'40,35 - 39세,1998,3171,1442,1729
'2638055000,  당리동,'45,40 - 44세,1998,3316,1608,1708
'2638055000,  당리동,'50,45 - 49세,1998,2488,1274,1214
'2638055000,  당리동,'55,50 - 54세,1998,1717,942,775
'2638055000,  당리동,'60,55 - 59세,1998,1382,713,669
'2638055000,  당리동,'65,60 - 64세,1998,917,444,473
'2638055000,  당리동,'70,65 - 69세,1998,577,251,326
'2638055000,  당리동,'75,70 - 74세,1998,421,148,273
'2638055000,  당리동,'80,75 - 79세,1998,250,80,170
'2638055000,  당리동,'85,80 - 84세,1998,113,24,89
'2638055000,  당리동,'90,85+ ,1998,59,9,50
'2638056100,  하단1동,'00,계,1998,25194,12515,12679
'2638056100,  하단1동,'05,0 - 4세,1998,1512,822,690
'2638056100,  하단1동,'10,5 - 9세,1998,2018,1051,967
'2638056100,  하단1동,'15,10 - 14세,1998,2221,1155,1066
'2638056100,  하단1동,'20,15 - 19세,1998,2674,1361,1313
'2638056100,  하단1동,'25,20 - 24세,1998,1957,983,974
'2638056100,  하단1동,'30,25 - 29세,1998,1919,965,954
'2638056100,  하단1동,'35,30 - 34세,1998,1909,835,1074
'2638056100,  하단1동,'40,35 - 39세,1998,2787,1300,1487
'2638056100,  하단1동,'45,40 - 44세,1998,2671,1350,1321
'2638056100,  하단1동,'50,45 - 49세,1998,1752,933,819
'2638056100,  하단1동,'55,50 - 54세,1998,1139,598,541
'2638056100,  하단1동,'60,55 - 59세,1998,907,486,421
'2638056100,  하단1동,'65,60 - 64세,1998,630,297,333
'2638056100,  하단1동,'70,65 - 69세,1998,430,180,250
'2638056100,  하단1동,'75,70 - 74세,1998,287,89,198
'2638056100,  하단1동,'80,75 - 79세,1998,213,64,149
'2638056100,  하단1동,'85,80 - 84세,1998,106,30,76
'2638056100,  하단1동,'90,85+ ,1998,62,16,46
'2638056200,  하단2동,'00,계,1998,25154,12574,12580
'2638056200,  하단2동,'05,0 - 4세,1998,1590,838,752
'2638056200,  하단2동,'10,5 - 9세,1998,1721,924,797
'2638056200,  하단2동,'15,10 - 14세,1998,1823,960,863
'2638056200,  하단2동,'20,15 - 19세,1998,2541,1307,1234
'2638056200,  하단2동,'25,20 - 24세,1998,2157,1077,1080
'2638056200,  하단2동,'30,25 - 29세,1998,2448,1269,1179
'2638056200,  하단2동,'35,30 - 34세,1998,2123,1064,1059
'2638056200,  하단2동,'40,35 - 39세,1998,2371,1099,1272
'2638056200,  하단2동,'45,40 - 44세,1998,2426,1165,1261
'2638056200,  하단2동,'50,45 - 49세,1998,1775,932,843
'2638056200,  하단2동,'55,50 - 54세,1998,1293,650,643
'2638056200,  하단2동,'60,55 - 59세,1998,1019,533,486
'2638056200,  하단2동,'65,60 - 64세,1998,720,347,373
'2638056200,  하단2동,'70,65 - 69세,1998,510,194,316
'2638056200,  하단2동,'75,70 - 74세,1998,309,122,187
'2638056200,  하단2동,'80,75 - 79세,1998,178,59,119
'2638056200,  하단2동,'85,80 - 84세,1998,93,28,65
'2638056200,  하단2동,'90,85+ ,1998,57,6,51
'2638057100,  신평1동,'00,계,1998,24970,12717,12253
'2638057100,  신평1동,'05,0 - 4세,1998,1799,943,856
'2638057100,  신평1동,'10,5 - 9세,1998,1764,933,831
'2638057100,  신평1동,'15,10 - 14세,1998,1666,872,794
'2638057100,  신평1동,'20,15 - 19세,1998,2209,1119,1090
'2638057100,  신평1동,'25,20 - 24세,1998,2295,1174,1121
'2638057100,  신평1동,'30,25 - 29세,1998,2756,1410,1346
'2638057100,  신평1동,'35,30 - 34세,1998,2398,1306,1092
'2638057100,  신평1동,'40,35 - 39세,1998,2510,1306,1204
'2638057100,  신평1동,'45,40 - 44세,1998,2083,1109,974
'2638057100,  신평1동,'50,45 - 49세,1998,1422,730,692
'2638057100,  신평1동,'55,50 - 54세,1998,1171,580,591
'2638057100,  신평1동,'60,55 - 59세,1998,1105,539,566
'2638057100,  신평1동,'65,60 - 64세,1998,737,332,405
'2638057100,  신평1동,'70,65 - 69세,1998,455,188,267
'2638057100,  신평1동,'75,70 - 74세,1998,285,82,203
'2638057100,  신평1동,'80,75 - 79세,1998,178,54,124
'2638057100,  신평1동,'85,80 - 84세,1998,88,28,60
'2638057100,  신평1동,'90,85+ ,1998,49,12,37
'2638057200,  신평2동,'00,계,1998,20837,10410,10427
'2638057200,  신평2동,'05,0 - 4세,1998,1747,893,854
'2638057200,  신평2동,'10,5 - 9세,1998,1701,912,789
'2638057200,  신평2동,'15,10 - 14세,1998,1723,900,823
'2638057200,  신평2동,'20,15 - 19세,1998,1869,938,931
'2638057200,  신평2동,'25,20 - 24세,1998,1425,704,721
'2638057200,  신평2동,'30,25 - 29세,1998,2023,938,1085
'2638057200,  신평2동,'35,30 - 34세,1998,2050,1029,1021
'2638057200,  신평2동,'40,35 - 39세,1998,2346,1080,1266
'2638057200,  신평2동,'45,40 - 44세,1998,2128,1134,994
'2638057200,  신평2동,'50,45 - 49세,1998,1215,659,556
'2638057200,  신평2동,'55,50 - 54세,1998,748,413,335
'2638057200,  신평2동,'60,55 - 59세,1998,635,329,306
'2638057200,  신평2동,'65,60 - 64세,1998,452,209,243
'2638057200,  신평2동,'70,65 - 69세,1998,315,122,193
'2638057200,  신평2동,'75,70 - 74세,1998,225,86,139
'2638057200,  신평2동,'80,75 - 79세,1998,135,39,96
'2638057200,  신평2동,'85,80 - 84세,1998,60,14,46
'2638057200,  신평2동,'90,85+ ,1998,40,11,29
'2638058000,  장림1동,'00,계,1998,13183,6807,6376
'2638058000,  장림1동,'05,0 - 4세,1998,799,415,384
'2638058000,  장림1동,'10,5 - 9세,1998,850,421,429
'2638058000,  장림1동,'15,10 - 14세,1998,851,449,402
'2638058000,  장림1동,'20,15 - 19세,1998,1325,688,637
'2638058000,  장림1동,'25,20 - 24세,1998,1324,694,630
'2638058000,  장림1동,'30,25 - 29세,1998,1313,725,588
'2638058000,  장림1동,'35,30 - 34세,1998,1151,634,517
'2638058000,  장림1동,'40,35 - 39세,1998,1324,720,604
'2638058000,  장림1동,'45,40 - 44세,1998,1083,581,502
'2638058000,  장림1동,'50,45 - 49세,1998,859,451,408
'2638058000,  장림1동,'55,50 - 54세,1998,684,326,358
'2638058000,  장림1동,'60,55 - 59세,1998,588,290,298
'2638058000,  장림1동,'65,60 - 64세,1998,455,213,242
'2638058000,  장림1동,'70,65 - 69세,1998,243,93,150
'2638058000,  장림1동,'75,70 - 74세,1998,160,61,99
'2638058000,  장림1동,'80,75 - 79세,1998,93,28,65
'2638058000,  장림1동,'85,80 - 84세,1998,52,16,36
'2638058000,  장림1동,'90,85+ ,1998,29,2,27
'2638059000,  장림2동,'00,계,1998,30007,15215,14792
'2638059000,  장림2동,'05,0 - 4세,1998,2079,1089,990
'2638059000,  장림2동,'10,5 - 9세,1998,2298,1213,1085
'2638059000,  장림2동,'15,10 - 14세,1998,2378,1256,1122
'2638059000,  장림2동,'20,15 - 19세,1998,3035,1556,1479
'2638059000,  장림2동,'25,20 - 24세,1998,2443,1211,1232
'2638059000,  장림2동,'30,25 - 29세,1998,2604,1317,1287
'2638059000,  장림2동,'35,30 - 34세,1998,2687,1300,1387
'2638059000,  장림2동,'40,35 - 39세,1998,3404,1692,1712
'2638059000,  장림2동,'45,40 - 44세,1998,2985,1573,1412
'2638059000,  장림2동,'50,45 - 49세,1998,1923,1065,858
'2638059000,  장림2동,'55,50 - 54세,1998,1330,715,615
'2638059000,  장림2동,'60,55 - 59세,1998,1041,541,500
'2638059000,  장림2동,'65,60 - 64세,1998,717,351,366
'2638059000,  장림2동,'70,65 - 69세,1998,452,174,278
'2638059000,  장림2동,'75,70 - 74세,1998,285,79,206
'2638059000,  장림2동,'80,75 - 79세,1998,197,55,142
'2638059000,  장림2동,'85,80 - 84세,1998,104,20,84
'2638059000,  장림2동,'90,85+ ,1998,45,8,37
'2638060100,  다대1동,'00,계,1998,41954,21131,20823
'2638060100,  다대1동,'05,0 - 4세,1998,4339,2340,1999
'2638060100,  다대1동,'10,5 - 9세,1998,3605,1874,1731
'2638060100,  다대1동,'15,10 - 14세,1998,2826,1504,1322
'2638060100,  다대1동,'20,15 - 19세,1998,3141,1622,1519
'2638060100,  다대1동,'25,20 - 24세,1998,2627,1299,1328
'2638060100,  다대1동,'30,25 - 29세,1998,4456,1922,2534
'2638060100,  다대1동,'35,30 - 34세,1998,5164,2646,2518
'2638060100,  다대1동,'40,35 - 39세,1998,4813,2567,2246
'2638060100,  다대1동,'45,40 - 44세,1998,3495,1895,1600
'2638060100,  다대1동,'50,45 - 49세,1998,2080,1142,938
'2638060100,  다대1동,'55,50 - 54세,1998,1395,720,675
'2638060100,  다대1동,'60,55 - 59세,1998,1288,587,701
'2638060100,  다대1동,'65,60 - 64세,1998,999,446,553
'2638060100,  다대1동,'70,65 - 69세,1998,698,254,444
'2638060100,  다대1동,'75,70 - 74세,1998,554,193,361
'2638060100,  다대1동,'80,75 - 79세,1998,283,86,197
'2638060100,  다대1동,'85,80 - 84세,1998,123,22,101
'2638060100,  다대1동,'90,85+ ,1998,68,12,56
'2638060200,  다대2동,'00,계,1998,38502,18986,19516
'2638060200,  다대2동,'05,0 - 4세,1998,3074,1644,1430
'2638060200,  다대2동,'10,5 - 9세,1998,3528,1918,1610
'2638060200,  다대2동,'15,10 - 14세,1998,3202,1585,1617
'2638060200,  다대2동,'20,15 - 19세,1998,3520,1794,1726
'2638060200,  다대2동,'25,20 - 24세,1998,2528,1296,1232
'2638060200,  다대2동,'30,25 - 29세,1998,3122,1376,1746
'2638060200,  다대2동,'35,30 - 34세,1998,3870,1753,2117
'2638060200,  다대2동,'40,35 - 39세,1998,4724,2380,2344
'2638060200,  다대2동,'45,40 - 44세,1998,3863,2015,1848
'2638060200,  다대2동,'50,45 - 49세,1998,2158,1161,997
'2638060200,  다대2동,'55,50 - 54세,1998,1350,673,677
'2638060200,  다대2동,'60,55 - 59세,1998,1036,547,489
'2638060200,  다대2동,'65,60 - 64세,1998,860,334,526
'2638060200,  다대2동,'70,65 - 69세,1998,668,218,450
'2638060200,  다대2동,'75,70 - 74세,1998,515,142,373
'2638060200,  다대2동,'80,75 - 79세,1998,301,101,200
'2638060200,  다대2동,'85,80 - 84세,1998,111,37,74
'2638060200,  다대2동,'90,85+ ,1998,72,12,60
'2638061000,  구평동,'00,계,1998,7036,3645,3391
'2638061000,  구평동,'05,0 - 4세,1998,362,183,179
'2638061000,  구평동,'10,5 - 9세,1998,439,243,196
'2638061000,  구평동,'15,10 - 14세,1998,498,270,228
'2638061000,  구평동,'20,15 - 19세,1998,755,393,362
'2638061000,  구평동,'25,20 - 24세,1998,672,365,307
'2638061000,  구평동,'30,25 - 29세,1998,621,340,281
'2638061000,  구평동,'35,30 - 34세,1998,528,264,264
'2638061000,  구평동,'40,35 - 39세,1998,653,324,329
'2638061000,  구평동,'45,40 - 44세,1998,683,354,329
'2638061000,  구평동,'50,45 - 49세,1998,509,278,231
'2638061000,  구평동,'55,50 - 54세,1998,396,213,183
'2638061000,  구평동,'60,55 - 59세,1998,347,178,169
'2638061000,  구평동,'65,60 - 64세,1998,218,107,111
'2638061000,  구평동,'70,65 - 69세,1998,150,60,90
'2638061000,  구평동,'75,70 - 74세,1998,90,43,47
'2638061000,  구평동,'80,75 - 79세,1998,68,17,51
'2638061000,  구평동,'85,80 - 84세,1998,24,7,17
'2638061000,  구평동,'90,85+ ,1998,23,6,17
'2638062000,  감천1동,'00,계,1998,29335,14663,14672
'2638062000,  감천1동,'05,0 - 4세,1998,1721,883,838
'2638062000,  감천1동,'10,5 - 9세,1998,2022,1055,967
'2638062000,  감천1동,'15,10 - 14세,1998,2080,1060,1020
'2638062000,  감천1동,'20,15 - 19세,1998,3062,1556,1506
'2638062000,  감천1동,'25,20 - 24세,1998,2703,1389,1314
'2638062000,  감천1동,'30,25 - 29세,1998,2633,1366,1267
'2638062000,  감천1동,'35,30 - 34세,1998,2456,1191,1265
'2638062000,  감천1동,'40,35 - 39세,1998,2869,1398,1471
'2638062000,  감천1동,'45,40 - 44세,1998,2792,1395,1397
'2638062000,  감천1동,'50,45 - 49세,1998,2063,1044,1019
'2638062000,  감천1동,'55,50 - 54세,1998,1561,826,735
'2638062000,  감천1동,'60,55 - 59세,1998,1338,670,668
'2638062000,  감천1동,'65,60 - 64세,1998,870,422,448
'2638062000,  감천1동,'70,65 - 69세,1998,486,207,279
'2638062000,  감천1동,'75,70 - 74세,1998,346,122,224
'2638062000,  감천1동,'80,75 - 79세,1998,191,49,142
'2638062000,  감천1동,'85,80 - 84세,1998,97,23,74
'2638062000,  감천1동,'90,85+ ,1998,45,7,38
'2638063000,  감천2동,'00,계,1998,18177,9217,8960
'2638063000,  감천2동,'05,0 - 4세,1998,944,489,455
'2638063000,  감천2동,'10,5 - 9세,1998,1009,521,488
'2638063000,  감천2동,'15,10 - 14세,1998,1080,568,512
'2638063000,  감천2동,'20,15 - 19세,1998,1851,960,891
'2638063000,  감천2동,'25,20 - 24세,1998,1942,1000,942
'2638063000,  감천2동,'30,25 - 29세,1998,1856,1014,842
'2638063000,  감천2동,'35,30 - 34세,1998,1456,791,665
'2638063000,  감천2동,'40,35 - 39세,1998,1587,865,722
'2638063000,  감천2동,'45,40 - 44세,1998,1432,761,671
'2638063000,  감천2동,'50,45 - 49세,1998,1081,560,521
'2638063000,  감천2동,'55,50 - 54세,1998,1018,473,545
'2638063000,  감천2동,'60,55 - 59세,1998,1013,478,535
'2638063000,  감천2동,'65,60 - 64세,1998,748,334,414
'2638063000,  감천2동,'70,65 - 69세,1998,452,182,270
'2638063000,  감천2동,'75,70 - 74세,1998,353,113,240
'2638063000,  감천2동,'80,75 - 79세,1998,237,77,160
'2638063000,  감천2동,'85,80 - 84세,1998,109,29,80
'2638063000,  감천2동,'90,85+ ,1998,9,2,7
'26410, 금정구,'00,계,1998,297844,148570,149274
'26410, 금정구,'05,0 - 4세,1998,17193,9289,7904
'26410, 금정구,'10,5 - 9세,1998,18872,10276,8596
'26410, 금정구,'15,10 - 14세,1998,20706,10947,9759
'26410, 금정구,'20,15 - 19세,1998,31217,16212,15005
'26410, 금정구,'25,20 - 24세,1998,27594,14054,13540
'26410, 금정구,'30,25 - 29세,1998,27562,13949,13613
'26410, 금정구,'35,30 - 34세,1998,23982,11921,12061
'26410, 금정구,'40,35 - 39세,1998,27653,13159,14494
'26410, 금정구,'45,40 - 44세,1998,27375,13025,14350
'26410, 금정구,'50,45 - 49세,1998,21179,10575,10604
'26410, 금정구,'55,50 - 54세,1998,16021,8251,7770
'26410, 금정구,'60,55 - 59세,1998,13723,6949,6774
'26410, 금정구,'65,60 - 64세,1998,9506,4545,4961
'26410, 금정구,'70,65 - 69세,1998,6267,2633,3634
'26410, 금정구,'75,70 - 74세,1998,4238,1499,2739
'26410, 금정구,'80,75 - 79세,1998,2644,813,1831
'26410, 금정구,'85,80 - 84세,1998,1296,326,970
'26410, 금정구,'90,85+ ,1998,816,147,669
'2641051000,  서1동,'00,계,1998,15515,7800,7715
'2641051000,  서1동,'05,0 - 4세,1998,947,512,435
'2641051000,  서1동,'10,5 - 9세,1998,918,484,434
'2641051000,  서1동,'15,10 - 14세,1998,952,501,451
'2641051000,  서1동,'20,15 - 19세,1998,1561,806,755
'2641051000,  서1동,'25,20 - 24세,1998,1643,811,832
'2641051000,  서1동,'30,25 - 29세,1998,1636,853,783
'2641051000,  서1동,'35,30 - 34세,1998,1322,715,607
'2641051000,  서1동,'40,35 - 39세,1998,1399,731,668
'2641051000,  서1동,'45,40 - 44세,1998,1214,591,623
'2641051000,  서1동,'50,45 - 49세,1998,1030,495,535
'2641051000,  서1동,'55,50 - 54세,1998,830,410,420
'2641051000,  서1동,'60,55 - 59세,1998,774,362,412
'2641051000,  서1동,'65,60 - 64세,1998,574,275,299
'2641051000,  서1동,'70,65 - 69세,1998,329,134,195
'2641051000,  서1동,'75,70 - 74세,1998,181,70,111
'2641051000,  서1동,'80,75 - 79세,1998,114,33,81
'2641051000,  서1동,'85,80 - 84세,1998,64,14,50
'2641051000,  서1동,'90,85+ ,1998,27,3,24
'2641052000,  서2동,'00,계,1998,18489,9209,9280
'2641052000,  서2동,'05,0 - 4세,1998,1003,532,471
'2641052000,  서2동,'10,5 - 9세,1998,1192,643,549
'2641052000,  서2동,'15,10 - 14세,1998,1291,654,637
'2641052000,  서2동,'20,15 - 19세,1998,2003,986,1017
'2641052000,  서2동,'25,20 - 24세,1998,1872,964,908
'2641052000,  서2동,'30,25 - 29세,1998,1748,931,817
'2641052000,  서2동,'35,30 - 34세,1998,1474,717,757
'2641052000,  서2동,'40,35 - 39세,1998,1717,838,879
'2641052000,  서2동,'45,40 - 44세,1998,1649,768,881
'2641052000,  서2동,'50,45 - 49세,1998,1316,677,639
'2641052000,  서2동,'55,50 - 54세,1998,1007,514,493
'2641052000,  서2동,'60,55 - 59세,1998,870,438,432
'2641052000,  서2동,'65,60 - 64세,1998,575,269,306
'2641052000,  서2동,'70,65 - 69세,1998,360,167,193
'2641052000,  서2동,'75,70 - 74세,1998,206,69,137
'2641052000,  서2동,'80,75 - 79세,1998,115,25,90
'2641052000,  서2동,'85,80 - 84세,1998,63,16,47
'2641052000,  서2동,'90,85+ ,1998,28,1,27
'2641053000,  서3동,'00,계,1998,10759,5538,5221
'2641053000,  서3동,'05,0 - 4세,1998,551,297,254
'2641053000,  서3동,'10,5 - 9세,1998,729,409,320
'2641053000,  서3동,'15,10 - 14세,1998,788,429,359
'2641053000,  서3동,'20,15 - 19세,1998,1231,677,554
'2641053000,  서3동,'25,20 - 24세,1998,1064,561,503
'2641053000,  서3동,'30,25 - 29세,1998,946,488,458
'2641053000,  서3동,'35,30 - 34세,1998,834,409,425
'2641053000,  서3동,'40,35 - 39세,1998,1067,527,540
'2641053000,  서3동,'45,40 - 44세,1998,1012,501,511
'2641053000,  서3동,'50,45 - 49세,1998,790,377,413
'2641053000,  서3동,'55,50 - 54세,1998,648,361,287
'2641053000,  서3동,'60,55 - 59세,1998,457,257,200
'2641053000,  서3동,'65,60 - 64세,1998,254,130,124
'2641053000,  서3동,'70,65 - 69세,1998,166,55,111
'2641053000,  서3동,'75,70 - 74세,1998,109,29,80
'2641053000,  서3동,'80,75 - 79세,1998,68,24,44
'2641053000,  서3동,'85,80 - 84세,1998,27,4,23
'2641053000,  서3동,'90,85+ ,1998,18,3,15
'2641054000,  서4동,'00,계,1998,10453,5212,5241
'2641054000,  서4동,'05,0 - 4세,1998,515,267,248
'2641054000,  서4동,'10,5 - 9세,1998,667,342,325
'2641054000,  서4동,'15,10 - 14세,1998,694,372,322
'2641054000,  서4동,'20,15 - 19세,1998,1067,531,536
'2641054000,  서4동,'25,20 - 24세,1998,1052,558,494
'2641054000,  서4동,'30,25 - 29세,1998,957,533,424
'2641054000,  서4동,'35,30 - 34세,1998,831,422,409
'2641054000,  서4동,'40,35 - 39세,1998,1021,489,532
'2641054000,  서4동,'45,40 - 44세,1998,944,443,501
'2641054000,  서4동,'50,45 - 49세,1998,723,360,363
'2641054000,  서4동,'55,50 - 54세,1998,542,275,267
'2641054000,  서4동,'60,55 - 59세,1998,556,265,291
'2641054000,  서4동,'65,60 - 64세,1998,377,187,190
'2641054000,  서4동,'70,65 - 69세,1998,210,81,129
'2641054000,  서4동,'75,70 - 74세,1998,140,47,93
'2641054000,  서4동,'80,75 - 79세,1998,85,20,65
'2641054000,  서4동,'85,80 - 84세,1998,52,16,36
'2641054000,  서4동,'90,85+ ,1998,20,4,16
'2641055000,  금사동,'00,계,1998,16483,8449,8034
'2641055000,  금사동,'05,0 - 4세,1998,956,523,433
'2641055000,  금사동,'10,5 - 9세,1998,1031,565,466
'2641055000,  금사동,'15,10 - 14세,1998,1107,560,547
'2641055000,  금사동,'20,15 - 19세,1998,1833,944,889
'2641055000,  금사동,'25,20 - 24세,1998,1610,840,770
'2641055000,  금사동,'30,25 - 29세,1998,1499,763,736
'2641055000,  금사동,'35,30 - 34세,1998,1386,733,653
'2641055000,  금사동,'40,35 - 39세,1998,1572,831,741
'2641055000,  금사동,'45,40 - 44세,1998,1491,731,760
'2641055000,  금사동,'50,45 - 49세,1998,1169,619,550
'2641055000,  금사동,'55,50 - 54세,1998,899,500,399
'2641055000,  금사동,'60,55 - 59세,1998,727,360,367
'2641055000,  금사동,'65,60 - 64세,1998,458,226,232
'2641055000,  금사동,'70,65 - 69세,1998,301,127,174
'2641055000,  금사동,'75,70 - 74세,1998,206,66,140
'2641055000,  금사동,'80,75 - 79세,1998,126,36,90
'2641055000,  금사동,'85,80 - 84세,1998,63,13,50
'2641055000,  금사동,'90,85+ ,1998,49,12,37
'2641057000,  부곡1동,'00,계,1998,15129,7541,7588
'2641057000,  부곡1동,'05,0 - 4세,1998,739,419,320
'2641057000,  부곡1동,'10,5 - 9세,1998,765,431,334
'2641057000,  부곡1동,'15,10 - 14세,1998,908,476,432
'2641057000,  부곡1동,'20,15 - 19세,1998,1753,910,843
'2641057000,  부곡1동,'25,20 - 24세,1998,1827,947,880
'2641057000,  부곡1동,'30,25 - 29세,1998,1521,792,729
'2641057000,  부곡1동,'35,30 - 34세,1998,1081,554,527
'2641057000,  부곡1동,'40,35 - 39세,1998,1191,565,626
'2641057000,  부곡1동,'45,40 - 44세,1998,1200,554,646
'2641057000,  부곡1동,'50,45 - 49세,1998,1182,533,649
'2641057000,  부곡1동,'55,50 - 54세,1998,918,470,448
'2641057000,  부곡1동,'60,55 - 59세,1998,842,407,435
'2641057000,  부곡1동,'65,60 - 64세,1998,485,237,248
'2641057000,  부곡1동,'70,65 - 69세,1998,291,125,166
'2641057000,  부곡1동,'75,70 - 74세,1998,188,61,127
'2641057000,  부곡1동,'80,75 - 79세,1998,138,34,104
'2641057000,  부곡1동,'85,80 - 84세,1998,60,19,41
'2641057000,  부곡1동,'90,85+ ,1998,40,7,33
'2641058000,  부곡2동,'00,계,1998,16871,8454,8417
'2641058000,  부곡2동,'05,0 - 4세,1998,821,433,388
'2641058000,  부곡2동,'10,5 - 9세,1998,970,543,427
'2641058000,  부곡2동,'15,10 - 14세,1998,1255,686,569
'2641058000,  부곡2동,'20,15 - 19세,1998,2064,1076,988
'2641058000,  부곡2동,'25,20 - 24세,1998,1657,833,824
'2641058000,  부곡2동,'30,25 - 29세,1998,1517,802,715
'2641058000,  부곡2동,'35,30 - 34세,1998,1120,537,583
'2641058000,  부곡2동,'40,35 - 39세,1998,1516,663,853
'2641058000,  부곡2동,'45,40 - 44세,1998,1678,751,927
'2641058000,  부곡2동,'50,45 - 49세,1998,1345,714,631
'2641058000,  부곡2동,'55,50 - 54세,1998,946,500,446
'2641058000,  부곡2동,'60,55 - 59세,1998,746,403,343
'2641058000,  부곡2동,'65,60 - 64세,1998,474,233,241
'2641058000,  부곡2동,'70,65 - 69세,1998,321,131,190
'2641058000,  부곡2동,'75,70 - 74세,1998,210,79,131
'2641058000,  부곡2동,'80,75 - 79세,1998,129,43,86
'2641058000,  부곡2동,'85,80 - 84세,1998,65,18,47
'2641058000,  부곡2동,'90,85+ ,1998,37,9,28
'2641059000,  부곡3동,'00,계,1998,19081,9384,9697
'2641059000,  부곡3동,'05,0 - 4세,1998,1121,587,534
'2641059000,  부곡3동,'10,5 - 9세,1998,1320,746,574
'2641059000,  부곡3동,'15,10 - 14세,1998,1456,747,709
'2641059000,  부곡3동,'20,15 - 19세,1998,2122,1097,1025
'2641059000,  부곡3동,'25,20 - 24세,1998,1573,799,774
'2641059000,  부곡3동,'30,25 - 29세,1998,1584,762,822
'2641059000,  부곡3동,'35,30 - 34세,1998,1469,690,779
'2641059000,  부곡3동,'40,35 - 39세,1998,1906,843,1063
'2641059000,  부곡3동,'45,40 - 44세,1998,2003,958,1045
'2641059000,  부곡3동,'50,45 - 49세,1998,1425,748,677
'2641059000,  부곡3동,'55,50 - 54세,1998,950,498,452
'2641059000,  부곡3동,'60,55 - 59세,1998,727,381,346
'2641059000,  부곡3동,'65,60 - 64세,1998,518,235,283
'2641059000,  부곡3동,'70,65 - 69세,1998,357,135,222
'2641059000,  부곡3동,'75,70 - 74세,1998,278,98,180
'2641059000,  부곡3동,'80,75 - 79세,1998,151,42,109
'2641059000,  부곡3동,'85,80 - 84세,1998,71,12,59
'2641059000,  부곡3동,'90,85+ ,1998,50,6,44
'2641059100,  부곡4동,'00,계,1998,19570,9813,9757
'2641059100,  부곡4동,'05,0 - 4세,1998,1028,573,455
'2641059100,  부곡4동,'10,5 - 9세,1998,1074,585,489
'2641059100,  부곡4동,'15,10 - 14세,1998,1281,649,632
'2641059100,  부곡4동,'20,15 - 19세,1998,2301,1265,1036
'2641059100,  부곡4동,'25,20 - 24세,1998,1988,1019,969
'2641059100,  부곡4동,'30,25 - 29세,1998,1859,973,886
'2641059100,  부곡4동,'35,30 - 34세,1998,1449,767,682
'2641059100,  부곡4동,'40,35 - 39세,1998,1640,736,904
'2641059100,  부곡4동,'45,40 - 44세,1998,1894,848,1046
'2641059100,  부곡4동,'50,45 - 49세,1998,1527,773,754
'2641059100,  부곡4동,'55,50 - 54세,1998,1104,557,547
'2641059100,  부곡4동,'60,55 - 59세,1998,951,486,465
'2641059100,  부곡4동,'65,60 - 64세,1998,616,291,325
'2641059100,  부곡4동,'70,65 - 69세,1998,374,143,231
'2641059100,  부곡4동,'75,70 - 74세,1998,243,91,152
'2641059100,  부곡4동,'80,75 - 79세,1998,131,38,93
'2641059100,  부곡4동,'85,80 - 84세,1998,66,11,55
'2641059100,  부곡4동,'90,85+ ,1998,44,8,36
'2641060000,  장전1동,'00,계,1998,20231,10040,10191
'2641060000,  장전1동,'05,0 - 4세,1998,1257,681,576
'2641060000,  장전1동,'10,5 - 9세,1998,1180,622,558
'2641060000,  장전1동,'15,10 - 14세,1998,1184,645,539
'2641060000,  장전1동,'20,15 - 19세,1998,1890,958,932
'2641060000,  장전1동,'25,20 - 24세,1998,2074,1044,1030
'2641060000,  장전1동,'30,25 - 29세,1998,2134,1072,1062
'2641060000,  장전1동,'35,30 - 34세,1998,1778,915,863
'2641060000,  장전1동,'40,35 - 39세,1998,1719,850,869
'2641060000,  장전1동,'45,40 - 44세,1998,1624,736,888
'2641060000,  장전1동,'50,45 - 49세,1998,1418,654,764
'2641060000,  장전1동,'55,50 - 54세,1998,1148,586,562
'2641060000,  장전1동,'60,55 - 59세,1998,983,496,487
'2641060000,  장전1동,'65,60 - 64세,1998,730,360,370
'2641060000,  장전1동,'70,65 - 69세,1998,482,232,250
'2641060000,  장전1동,'75,70 - 74세,1998,307,88,219
'2641060000,  장전1동,'80,75 - 79세,1998,183,66,117
'2641060000,  장전1동,'85,80 - 84세,1998,91,25,66
'2641060000,  장전1동,'90,85+ ,1998,49,10,39
'2641061000,  장전2동,'00,계,1998,13331,6446,6885
'2641061000,  장전2동,'05,0 - 4세,1998,703,372,331
'2641061000,  장전2동,'10,5 - 9세,1998,723,382,341
'2641061000,  장전2동,'15,10 - 14세,1998,769,425,344
'2641061000,  장전2동,'20,15 - 19세,1998,1190,644,546
'2641061000,  장전2동,'25,20 - 24세,1998,1170,576,594
'2641061000,  장전2동,'30,25 - 29세,1998,1327,701,626
'2641061000,  장전2동,'35,30 - 34세,1998,1053,527,526
'2641061000,  장전2동,'40,35 - 39세,1998,1135,528,607
'2641061000,  장전2동,'45,40 - 44세,1998,1121,529,592
'2641061000,  장전2동,'50,45 - 49세,1998,862,401,461
'2641061000,  장전2동,'55,50 - 54세,1998,722,337,385
'2641061000,  장전2동,'60,55 - 59세,1998,723,346,377
'2641061000,  장전2동,'65,60 - 64세,1998,566,266,300
'2641061000,  장전2동,'70,65 - 69세,1998,415,163,252
'2641061000,  장전2동,'75,70 - 74세,1998,328,116,212
'2641061000,  장전2동,'80,75 - 79세,1998,259,67,192
'2641061000,  장전2동,'85,80 - 84세,1998,151,43,108
'2641061000,  장전2동,'90,85+ ,1998,114,23,91
'2641062000,  장전3동,'00,계,1998,12195,6061,6134
'2641062000,  장전3동,'05,0 - 4세,1998,560,293,267
'2641062000,  장전3동,'10,5 - 9세,1998,607,332,275
'2641062000,  장전3동,'15,10 - 14세,1998,643,361,282
'2641062000,  장전3동,'20,15 - 19세,1998,1192,627,565
'2641062000,  장전3동,'25,20 - 24세,1998,1286,691,595
'2641062000,  장전3동,'30,25 - 29세,1998,1254,682,572
'2641062000,  장전3동,'35,30 - 34세,1998,862,429,433
'2641062000,  장전3동,'40,35 - 39세,1998,949,443,506
'2641062000,  장전3동,'45,40 - 44세,1998,1007,455,552
'2641062000,  장전3동,'50,45 - 49세,1998,906,389,517
'2641062000,  장전3동,'55,50 - 54세,1998,804,389,415
'2641062000,  장전3동,'60,55 - 59세,1998,737,365,372
'2641062000,  장전3동,'65,60 - 64세,1998,552,262,290
'2641062000,  장전3동,'70,65 - 69세,1998,340,157,183
'2641062000,  장전3동,'75,70 - 74세,1998,226,90,136
'2641062000,  장전3동,'80,75 - 79세,1998,147,63,84
'2641062000,  장전3동,'85,80 - 84세,1998,80,27,53
'2641062000,  장전3동,'90,85+ ,1998,43,6,37
'2641063500,  선두구동,'00,계,1998,4377,2274,2103
'2641063500,  선두구동,'05,0 - 4세,1998,175,91,84
'2641063500,  선두구동,'10,5 - 9세,1998,263,141,122
'2641063500,  선두구동,'15,10 - 14세,1998,282,160,122
'2641063500,  선두구동,'20,15 - 19세,1998,432,217,215
'2641063500,  선두구동,'25,20 - 24세,1998,398,212,186
'2641063500,  선두구동,'30,25 - 29세,1998,343,208,135
'2641063500,  선두구동,'35,30 - 34세,1998,340,155,185
'2641063500,  선두구동,'40,35 - 39세,1998,395,226,169
'2641063500,  선두구동,'45,40 - 44세,1998,377,212,165
'2641063500,  선두구동,'50,45 - 49세,1998,284,155,129
'2641063500,  선두구동,'55,50 - 54세,1998,234,117,117
'2641063500,  선두구동,'60,55 - 59세,1998,243,124,119
'2641063500,  선두구동,'65,60 - 64세,1998,231,104,127
'2641063500,  선두구동,'70,65 - 69세,1998,153,69,84
'2641063500,  선두구동,'75,70 - 74세,1998,98,43,55
'2641063500,  선두구동,'80,75 - 79세,1998,72,26,46
'2641063500,  선두구동,'85,80 - 84세,1998,36,9,27
'2641063500,  선두구동,'90,85+ ,1998,21,5,16
'2641066000,  청룡동,'00,계,1998,10932,5525,5407
'2641066000,  청룡동,'05,0 - 4세,1998,648,343,305
'2641066000,  청룡동,'10,5 - 9세,1998,614,321,293
'2641066000,  청룡동,'15,10 - 14세,1998,739,399,340
'2641066000,  청룡동,'20,15 - 19세,1998,1008,537,471
'2641066000,  청룡동,'25,20 - 24세,1998,976,539,437
'2641066000,  청룡동,'30,25 - 29세,1998,1005,461,544
'2641066000,  청룡동,'35,30 - 34세,1998,939,517,422
'2641066000,  청룡동,'40,35 - 39세,1998,922,474,448
'2641066000,  청룡동,'45,40 - 44세,1998,924,446,478
'2641066000,  청룡동,'50,45 - 49세,1998,758,368,390
'2641066000,  청룡동,'55,50 - 54세,1998,665,331,334
'2641066000,  청룡동,'60,55 - 59세,1998,627,317,310
'2641066000,  청룡동,'65,60 - 64세,1998,415,199,216
'2641066000,  청룡동,'70,65 - 69세,1998,298,139,159
'2641066000,  청룡동,'75,70 - 74세,1998,200,85,115
'2641066000,  청룡동,'80,75 - 79세,1998,110,35,75
'2641066000,  청룡동,'85,80 - 84세,1998,51,8,43
'2641066000,  청룡동,'90,85+ ,1998,33,6,27
'2641067000,  남산동,'00,계,1998,39179,19515,19664
'2641067000,  남산동,'05,0 - 4세,1998,2830,1495,1335
'2641067000,  남산동,'10,5 - 9세,1998,2872,1577,1295
'2641067000,  남산동,'15,10 - 14세,1998,2951,1584,1367
'2641067000,  남산동,'20,15 - 19세,1998,3713,1922,1791
'2641067000,  남산동,'25,20 - 24세,1998,3048,1524,1524
'2641067000,  남산동,'30,25 - 29세,1998,3828,1819,2009
'2641067000,  남산동,'35,30 - 34세,1998,3702,1825,1877
'2641067000,  남산동,'40,35 - 39세,1998,4011,1908,2103
'2641067000,  남산동,'45,40 - 44세,1998,3570,1757,1813
'2641067000,  남산동,'50,45 - 49세,1998,2556,1305,1251
'2641067000,  남산동,'55,50 - 54세,1998,1865,950,915
'2641067000,  남산동,'60,55 - 59세,1998,1538,797,741
'2641067000,  남산동,'65,60 - 64세,1998,995,471,524
'2641067000,  남산동,'70,65 - 69세,1998,660,278,382
'2641067000,  남산동,'75,70 - 74세,1998,501,162,339
'2641067000,  남산동,'80,75 - 79세,1998,314,99,215
'2641067000,  남산동,'85,80 - 84세,1998,134,26,108
'2641067000,  남산동,'90,85+ ,1998,91,16,75
'2641068000,  구서1동,'00,계,1998,19734,9802,9932
'2641068000,  구서1동,'05,0 - 4세,1998,1231,680,551
'2641068000,  구서1동,'10,5 - 9세,1998,1354,758,596
'2641068000,  구서1동,'15,10 - 14세,1998,1330,684,646
'2641068000,  구서1동,'20,15 - 19세,1998,2104,1064,1040
'2641068000,  구서1동,'25,20 - 24세,1998,1775,845,930
'2641068000,  구서1동,'30,25 - 29세,1998,1747,835,912
'2641068000,  구서1동,'35,30 - 34세,1998,1653,790,863
'2641068000,  구서1동,'40,35 - 39세,1998,1837,917,920
'2641068000,  구서1동,'45,40 - 44세,1998,1854,871,983
'2641068000,  구서1동,'50,45 - 49세,1998,1384,702,682
'2641068000,  구서1동,'55,50 - 54세,1998,1047,573,474
'2641068000,  구서1동,'60,55 - 59세,1998,832,427,405
'2641068000,  구서1동,'65,60 - 64세,1998,621,298,323
'2641068000,  구서1동,'70,65 - 69세,1998,402,164,238
'2641068000,  구서1동,'75,70 - 74세,1998,267,108,159
'2641068000,  구서1동,'80,75 - 79세,1998,173,55,118
'2641068000,  구서1동,'85,80 - 84세,1998,71,18,53
'2641068000,  구서1동,'90,85+ ,1998,52,13,39
'2641069000,  구서2동,'00,계,1998,34006,16764,17242
'2641069000,  구서2동,'05,0 - 4세,1998,2052,1156,896
'2641069000,  구서2동,'10,5 - 9세,1998,2508,1354,1154
'2641069000,  구서2동,'15,10 - 14세,1998,2991,1571,1420
'2641069000,  구서2동,'20,15 - 19세,1998,3574,1864,1710
'2641069000,  구서2동,'25,20 - 24세,1998,2450,1224,1226
'2641069000,  구서2동,'30,25 - 29세,1998,2519,1201,1318
'2641069000,  구서2동,'35,30 - 34세,1998,2602,1171,1431
'2641069000,  구서2동,'40,35 - 39세,1998,3542,1537,2005
'2641069000,  구서2동,'45,40 - 44세,1998,3673,1805,1868
'2641069000,  구서2동,'50,45 - 49세,1998,2391,1246,1145
'2641069000,  구서2동,'55,50 - 54세,1998,1611,841,770
'2641069000,  구서2동,'60,55 - 59세,1998,1296,673,623
'2641069000,  구서2동,'65,60 - 64세,1998,1000,473,527
'2641069000,  구서2동,'70,65 - 69세,1998,747,310,437
'2641069000,  구서2동,'75,70 - 74세,1998,502,177,325
'2641069000,  구서2동,'80,75 - 79세,1998,311,102,209
'2641069000,  구서2동,'85,80 - 84세,1998,143,44,99
'2641069000,  구서2동,'90,85+ ,1998,94,15,79
'2641070000,  금성동,'00,계,1998,1509,743,766
'2641070000,  금성동,'05,0 - 4세,1998,56,35,21
'2641070000,  금성동,'10,5 - 9세,1998,85,41,44
'2641070000,  금성동,'15,10 - 14세,1998,85,44,41
'2641070000,  금성동,'20,15 - 19세,1998,179,87,92
'2641070000,  금성동,'25,20 - 24세,1998,131,67,64
'2641070000,  금성동,'30,25 - 29세,1998,138,73,65
'2641070000,  금성동,'35,30 - 34세,1998,87,48,39
'2641070000,  금성동,'40,35 - 39세,1998,114,53,61
'2641070000,  금성동,'45,40 - 44세,1998,140,69,71
'2641070000,  금성동,'50,45 - 49세,1998,113,59,54
'2641070000,  금성동,'55,50 - 54세,1998,81,42,39
'2641070000,  금성동,'60,55 - 59세,1998,94,45,49
'2641070000,  금성동,'65,60 - 64세,1998,65,29,36
'2641070000,  금성동,'70,65 - 69세,1998,61,23,38
'2641070000,  금성동,'75,70 - 74세,1998,48,20,28
'2641070000,  금성동,'80,75 - 79세,1998,18,5,13
'2641070000,  금성동,'85,80 - 84세,1998,8,3,5
'2641070000,  금성동,'90,85+ ,1998,6,0,6
'26440, 강서구,'00,계,1998,67244,34596,32648
'26440, 강서구,'05,0 - 4세,1998,3580,1893,1687
'26440, 강서구,'10,5 - 9세,1998,4019,2140,1879
'26440, 강서구,'15,10 - 14세,1998,4275,2214,2061
'26440, 강서구,'20,15 - 19세,1998,6292,3233,3059
'26440, 강서구,'25,20 - 24세,1998,6097,3314,2783
'26440, 강서구,'30,25 - 29세,1998,5989,3452,2537
'26440, 강서구,'35,30 - 34세,1998,5100,2781,2319
'26440, 강서구,'40,35 - 39세,1998,5887,3235,2652
'26440, 강서구,'45,40 - 44세,1998,5664,3092,2572
'26440, 강서구,'50,45 - 49세,1998,4238,2279,1959
'26440, 강서구,'55,50 - 54세,1998,3612,1948,1664
'26440, 강서구,'60,55 - 59세,1998,3679,1711,1968
'26440, 강서구,'65,60 - 64세,1998,2953,1283,1670
'26440, 강서구,'70,65 - 69세,1998,2393,901,1492
'26440, 강서구,'75,70 - 74세,1998,1711,604,1107
'26440, 강서구,'80,75 - 79세,1998,983,325,658
'26440, 강서구,'85,80 - 84세,1998,466,133,333
'26440, 강서구,'90,85+ ,1998,306,58,248
'2644051000,  대저1동,'00,계,1998,15995,8266,7729
'2644051000,  대저1동,'05,0 - 4세,1998,809,423,386
'2644051000,  대저1동,'10,5 - 9세,1998,993,537,456
'2644051000,  대저1동,'15,10 - 14세,1998,1131,574,557
'2644051000,  대저1동,'20,15 - 19세,1998,1562,787,775
'2644051000,  대저1동,'25,20 - 24세,1998,1469,792,677
'2644051000,  대저1동,'30,25 - 29세,1998,1368,764,604
'2644051000,  대저1동,'35,30 - 34세,1998,1155,634,521
'2644051000,  대저1동,'40,35 - 39세,1998,1452,806,646
'2644051000,  대저1동,'45,40 - 44세,1998,1413,763,650
'2644051000,  대저1동,'50,45 - 49세,1998,1131,610,521
'2644051000,  대저1동,'55,50 - 54세,1998,883,489,394
'2644051000,  대저1동,'60,55 - 59세,1998,834,393,441
'2644051000,  대저1동,'65,60 - 64세,1998,642,292,350
'2644051000,  대저1동,'70,65 - 69세,1998,486,197,289
'2644051000,  대저1동,'75,70 - 74세,1998,321,109,212
'2644051000,  대저1동,'80,75 - 79세,1998,193,59,134
'2644051000,  대저1동,'85,80 - 84세,1998,86,26,60
'2644051000,  대저1동,'90,85+ ,1998,67,11,56
'2644052000,  대저2동,'00,계,1998,12958,6692,6266
'2644052000,  대저2동,'05,0 - 4세,1998,856,457,399
'2644052000,  대저2동,'10,5 - 9세,1998,907,499,408
'2644052000,  대저2동,'15,10 - 14세,1998,858,434,424
'2644052000,  대저2동,'20,15 - 19세,1998,1164,585,579
'2644052000,  대저2동,'25,20 - 24세,1998,1050,569,481
'2644052000,  대저2동,'30,25 - 29세,1998,1190,649,541
'2644052000,  대저2동,'35,30 - 34세,1998,1201,649,552
'2644052000,  대저2동,'40,35 - 39세,1998,1242,678,564
'2644052000,  대저2동,'45,40 - 44세,1998,1108,635,473
'2644052000,  대저2동,'50,45 - 49세,1998,743,410,333
'2644052000,  대저2동,'55,50 - 54세,1998,589,322,267
'2644052000,  대저2동,'60,55 - 59세,1998,598,285,313
'2644052000,  대저2동,'65,60 - 64세,1998,467,205,262
'2644052000,  대저2동,'70,65 - 69세,1998,394,133,261
'2644052000,  대저2동,'75,70 - 74세,1998,277,96,181
'2644052000,  대저2동,'80,75 - 79세,1998,180,56,124
'2644052000,  대저2동,'85,80 - 84세,1998,89,25,64
'2644052000,  대저2동,'90,85+ ,1998,45,5,40
'2644053000,  강동동,'00,계,1998,10294,5215,5079
'2644053000,  강동동,'05,0 - 4세,1998,519,276,243
'2644053000,  강동동,'10,5 - 9세,1998,648,344,304
'2644053000,  강동동,'15,10 - 14세,1998,665,345,320
'2644053000,  강동동,'20,15 - 19세,1998,1039,524,515
'2644053000,  강동동,'25,20 - 24세,1998,879,479,400
'2644053000,  강동동,'30,25 - 29세,1998,802,424,378
'2644053000,  강동동,'35,30 - 34세,1998,805,439,366
'2644053000,  강동동,'40,35 - 39세,1998,916,494,422
'2644053000,  강동동,'45,40 - 44세,1998,896,476,420
'2644053000,  강동동,'50,45 - 49세,1998,648,354,294
'2644053000,  강동동,'55,50 - 54세,1998,538,273,265
'2644053000,  강동동,'60,55 - 59세,1998,563,267,296
'2644053000,  강동동,'65,60 - 64세,1998,459,197,262
'2644053000,  강동동,'70,65 - 69세,1998,403,149,254
'2644053000,  강동동,'75,70 - 74세,1998,272,97,175
'2644053000,  강동동,'80,75 - 79세,1998,138,47,91
'2644053000,  강동동,'85,80 - 84세,1998,66,21,45
'2644053000,  강동동,'90,85+ ,1998,38,9,29
'2644054000,  명지동,'00,계,1998,9613,4918,4695
'2644054000,  명지동,'05,0 - 4세,1998,477,250,227
'2644054000,  명지동,'10,5 - 9세,1998,511,268,243
'2644054000,  명지동,'15,10 - 14세,1998,625,327,298
'2644054000,  명지동,'20,15 - 19세,1998,967,504,463
'2644054000,  명지동,'25,20 - 24세,1998,931,476,455
'2644054000,  명지동,'30,25 - 29세,1998,839,495,344
'2644054000,  명지동,'35,30 - 34세,1998,644,353,291
'2644054000,  명지동,'40,35 - 39세,1998,817,425,392
'2644054000,  명지동,'45,40 - 44세,1998,877,459,418
'2644054000,  명지동,'50,45 - 49세,1998,617,333,284
'2644054000,  명지동,'55,50 - 54세,1998,572,296,276
'2644054000,  명지동,'60,55 - 59세,1998,572,280,292
'2644054000,  명지동,'65,60 - 64세,1998,388,184,204
'2644054000,  명지동,'70,65 - 69세,1998,312,109,203
'2644054000,  명지동,'75,70 - 74세,1998,217,83,134
'2644054000,  명지동,'80,75 - 79세,1998,134,52,82
'2644054000,  명지동,'85,80 - 84세,1998,61,12,49
'2644054000,  명지동,'90,85+ ,1998,52,12,40
'2644055000,  가락동,'00,계,1998,5003,2492,2511
'2644055000,  가락동,'05,0 - 4세,1998,266,137,129
'2644055000,  가락동,'10,5 - 9세,1998,287,148,139
'2644055000,  가락동,'15,10 - 14세,1998,271,148,123
'2644055000,  가락동,'20,15 - 19세,1998,418,219,199
'2644055000,  가락동,'25,20 - 24세,1998,472,240,232
'2644055000,  가락동,'30,25 - 29세,1998,454,244,210
'2644055000,  가락동,'35,30 - 34세,1998,361,195,166
'2644055000,  가락동,'40,35 - 39세,1998,369,193,176
'2644055000,  가락동,'45,40 - 44세,1998,366,209,157
'2644055000,  가락동,'50,45 - 49세,1998,332,180,152
'2644055000,  가락동,'55,50 - 54세,1998,290,152,138
'2644055000,  가락동,'60,55 - 59세,1998,317,140,177
'2644055000,  가락동,'65,60 - 64세,1998,277,101,176
'2644055000,  가락동,'70,65 - 69세,1998,210,84,126
'2644055000,  가락동,'75,70 - 74세,1998,174,64,110
'2644055000,  가락동,'80,75 - 79세,1998,80,24,56
'2644055000,  가락동,'85,80 - 84세,1998,32,11,21
'2644055000,  가락동,'90,85+ ,1998,27,3,24
'2644056000,  녹산동,'00,계,1998,9426,4980,4446
'2644056000,  녹산동,'05,0 - 4세,1998,481,260,221
'2644056000,  녹산동,'10,5 - 9세,1998,480,241,239
'2644056000,  녹산동,'15,10 - 14세,1998,487,264,223
'2644056000,  녹산동,'20,15 - 19세,1998,781,419,362
'2644056000,  녹산동,'25,20 - 24세,1998,921,551,370
'2644056000,  녹산동,'30,25 - 29세,1998,992,656,336
'2644056000,  녹산동,'35,30 - 34세,1998,688,374,314
'2644056000,  녹산동,'40,35 - 39세,1998,814,477,337
'2644056000,  녹산동,'45,40 - 44세,1998,710,396,314
'2644056000,  녹산동,'50,45 - 49세,1998,555,286,269
'2644056000,  녹산동,'55,50 - 54세,1998,510,271,239
'2644056000,  녹산동,'60,55 - 59세,1998,551,251,300
'2644056000,  녹산동,'65,60 - 64세,1998,469,203,266
'2644056000,  녹산동,'70,65 - 69세,1998,388,140,248
'2644056000,  녹산동,'75,70 - 74세,1998,308,108,200
'2644056000,  녹산동,'80,75 - 79세,1998,158,49,109
'2644056000,  녹산동,'85,80 - 84세,1998,80,22,58
'2644056000,  녹산동,'90,85+ ,1998,53,12,41
'2644057000,  천가동,'00,계,1998,3955,2033,1922
'2644057000,  천가동,'05,0 - 4세,1998,172,90,82
'2644057000,  천가동,'10,5 - 9세,1998,193,103,90
'2644057000,  천가동,'15,10 - 14세,1998,238,122,116
'2644057000,  천가동,'20,15 - 19세,1998,361,195,166
'2644057000,  천가동,'25,20 - 24세,1998,375,207,168
'2644057000,  천가동,'30,25 - 29세,1998,344,220,124
'2644057000,  천가동,'35,30 - 34세,1998,246,137,109
'2644057000,  천가동,'40,35 - 39세,1998,277,162,115
'2644057000,  천가동,'45,40 - 44세,1998,294,154,140
'2644057000,  천가동,'50,45 - 49세,1998,212,106,106
'2644057000,  천가동,'55,50 - 54세,1998,230,145,85
'2644057000,  천가동,'60,55 - 59세,1998,244,95,149
'2644057000,  천가동,'65,60 - 64세,1998,251,101,150
'2644057000,  천가동,'70,65 - 69세,1998,200,89,111
'2644057000,  천가동,'75,70 - 74세,1998,142,47,95
'2644057000,  천가동,'80,75 - 79세,1998,100,38,62
'2644057000,  천가동,'85,80 - 84세,1998,52,16,36
'2644057000,  천가동,'90,85+ ,1998,24,6,18
'26470, 연제구,'00,계,1998,225983,112921,113062
'26470, 연제구,'05,0 - 4세,1998,12000,6572,5428
'26470, 연제구,'10,5 - 9세,1998,13566,7373,6193
'26470, 연제구,'15,10 - 14세,1998,14802,7735,7067
'26470, 연제구,'20,15 - 19세,1998,23199,11896,11303
'26470, 연제구,'25,20 - 24세,1998,21856,11236,10620
'26470, 연제구,'30,25 - 29세,1998,21397,10999,10398
'26470, 연제구,'35,30 - 34세,1998,17394,8817,8577
'26470, 연제구,'40,35 - 39세,1998,19857,9306,10551
'26470, 연제구,'45,40 - 44세,1998,21086,10259,10827
'26470, 연제구,'50,45 - 49세,1998,16727,8197,8530
'26470, 연제구,'55,50 - 54세,1998,12937,6580,6357
'26470, 연제구,'60,55 - 59세,1998,11506,5834,5672
'26470, 연제구,'65,60 - 64세,1998,7936,3794,4142
'26470, 연제구,'70,65 - 69세,1998,5067,2157,2910
'26470, 연제구,'75,70 - 74세,1998,3239,1219,2020
'26470, 연제구,'80,75 - 79세,1998,1937,622,1315
'26470, 연제구,'85,80 - 84세,1998,925,236,689
'26470, 연제구,'90,85+ ,1998,552,89,463
'2647061000,  거제1동,'00,계,1998,15389,7657,7732
'2647061000,  거제1동,'05,0 - 4세,1998,711,393,318
'2647061000,  거제1동,'10,5 - 9세,1998,846,451,395
'2647061000,  거제1동,'15,10 - 14세,1998,952,486,466
'2647061000,  거제1동,'20,15 - 19세,1998,1628,806,822
'2647061000,  거제1동,'25,20 - 24세,1998,1608,807,801
'2647061000,  거제1동,'30,25 - 29세,1998,1469,787,682
'2647061000,  거제1동,'35,30 - 34세,1998,1136,577,559
'2647061000,  거제1동,'40,35 - 39세,1998,1292,643,649
'2647061000,  거제1동,'45,40 - 44세,1998,1332,620,712
'2647061000,  거제1동,'50,45 - 49세,1998,1187,571,616
'2647061000,  거제1동,'55,50 - 54세,1998,962,475,487
'2647061000,  거제1동,'60,55 - 59세,1998,889,443,446
'2647061000,  거제1동,'65,60 - 64세,1998,596,288,308
'2647061000,  거제1동,'70,65 - 69세,1998,341,153,188
'2647061000,  거제1동,'75,70 - 74세,1998,218,94,124
'2647061000,  거제1동,'80,75 - 79세,1998,121,43,78
'2647061000,  거제1동,'85,80 - 84세,1998,71,15,56
'2647061000,  거제1동,'90,85+ ,1998,30,5,25
'2647062000,  거제2동,'00,계,1998,20245,10218,10027
'2647062000,  거제2동,'05,0 - 4세,1998,1085,591,494
'2647062000,  거제2동,'10,5 - 9세,1998,1331,743,588
'2647062000,  거제2동,'15,10 - 14세,1998,1439,720,719
'2647062000,  거제2동,'20,15 - 19세,1998,2048,1052,996
'2647062000,  거제2동,'25,20 - 24세,1998,1867,983,884
'2647062000,  거제2동,'30,25 - 29세,1998,1836,983,853
'2647062000,  거제2동,'35,30 - 34세,1998,1584,790,794
'2647062000,  거제2동,'40,35 - 39세,1998,1975,936,1039
'2647062000,  거제2동,'45,40 - 44세,1998,1935,1008,927
'2647062000,  거제2동,'50,45 - 49세,1998,1443,737,706
'2647062000,  거제2동,'55,50 - 54세,1998,1039,551,488
'2647062000,  거제2동,'60,55 - 59세,1998,928,433,495
'2647062000,  거제2동,'65,60 - 64세,1998,686,321,365
'2647062000,  거제2동,'70,65 - 69세,1998,453,195,258
'2647062000,  거제2동,'75,70 - 74세,1998,280,101,179
'2647062000,  거제2동,'80,75 - 79세,1998,181,51,130
'2647062000,  거제2동,'85,80 - 84세,1998,79,15,64
'2647062000,  거제2동,'90,85+ ,1998,56,8,48
'2647063000,  거제3동,'00,계,1998,14247,7143,7104
'2647063000,  거제3동,'05,0 - 4세,1998,609,344,265
'2647063000,  거제3동,'10,5 - 9세,1998,784,422,362
'2647063000,  거제3동,'15,10 - 14세,1998,844,452,392
'2647063000,  거제3동,'20,15 - 19세,1998,1384,719,665
'2647063000,  거제3동,'25,20 - 24세,1998,1376,744,632
'2647063000,  거제3동,'30,25 - 29세,1998,1360,714,646
'2647063000,  거제3동,'35,30 - 34세,1998,1030,562,468
'2647063000,  거제3동,'40,35 - 39세,1998,1146,533,613
'2647063000,  거제3동,'45,40 - 44세,1998,1201,590,611
'2647063000,  거제3동,'50,45 - 49세,1998,1065,475,590
'2647063000,  거제3동,'55,50 - 54세,1998,925,465,460
'2647063000,  거제3동,'60,55 - 59세,1998,893,431,462
'2647063000,  거제3동,'65,60 - 64세,1998,652,313,339
'2647063000,  거제3동,'70,65 - 69세,1998,452,185,267
'2647063000,  거제3동,'75,70 - 74세,1998,275,121,154
'2647063000,  거제3동,'80,75 - 79세,1998,132,40,92
'2647063000,  거제3동,'85,80 - 84세,1998,79,28,51
'2647063000,  거제3동,'90,85+ ,1998,40,5,35
'2647064000,  거제4동,'00,계,1998,7962,3997,3965
'2647064000,  거제4동,'05,0 - 4세,1998,382,219,163
'2647064000,  거제4동,'10,5 - 9세,1998,474,229,245
'2647064000,  거제4동,'15,10 - 14세,1998,528,283,245
'2647064000,  거제4동,'20,15 - 19세,1998,856,422,434
'2647064000,  거제4동,'25,20 - 24세,1998,744,385,359
'2647064000,  거제4동,'30,25 - 29세,1998,724,400,324
'2647064000,  거제4동,'35,30 - 34세,1998,597,316,281
'2647064000,  거제4동,'40,35 - 39세,1998,706,341,365
'2647064000,  거제4동,'45,40 - 44세,1998,698,355,343
'2647064000,  거제4동,'50,45 - 49세,1998,556,280,276
'2647064000,  거제4동,'55,50 - 54세,1998,387,198,189
'2647064000,  거제4동,'60,55 - 59세,1998,441,201,240
'2647064000,  거제4동,'65,60 - 64세,1998,337,153,184
'2647064000,  거제4동,'70,65 - 69세,1998,237,106,131
'2647064000,  거제4동,'75,70 - 74세,1998,138,58,80
'2647064000,  거제4동,'80,75 - 79세,1998,106,39,67
'2647064000,  거제4동,'85,80 - 84세,1998,35,11,24
'2647064000,  거제4동,'90,85+ ,1998,16,1,15
'2647065000,  연산1동,'00,계,1998,21125,10631,10494
'2647065000,  연산1동,'05,0 - 4세,1998,1087,600,487
'2647065000,  연산1동,'10,5 - 9세,1998,1307,701,606
'2647065000,  연산1동,'15,10 - 14세,1998,1419,756,663
'2647065000,  연산1동,'20,15 - 19세,1998,2294,1220,1074
'2647065000,  연산1동,'25,20 - 24세,1998,2107,1069,1038
'2647065000,  연산1동,'30,25 - 29세,1998,1985,1059,926
'2647065000,  연산1동,'35,30 - 34세,1998,1540,758,782
'2647065000,  연산1동,'40,35 - 39세,1998,1837,829,1008
'2647065000,  연산1동,'45,40 - 44세,1998,2059,990,1069
'2647065000,  연산1동,'50,45 - 49세,1998,1658,803,855
'2647065000,  연산1동,'55,50 - 54세,1998,1247,649,598
'2647065000,  연산1동,'60,55 - 59세,1998,1028,543,485
'2647065000,  연산1동,'65,60 - 64세,1998,616,311,305
'2647065000,  연산1동,'70,65 - 69세,1998,416,184,232
'2647065000,  연산1동,'75,70 - 74세,1998,255,89,166
'2647065000,  연산1동,'80,75 - 79세,1998,152,45,107
'2647065000,  연산1동,'85,80 - 84세,1998,82,19,63
'2647065000,  연산1동,'90,85+ ,1998,36,6,30
'2647066000,  연산2동,'00,계,1998,19755,9869,9886
'2647066000,  연산2동,'05,0 - 4세,1998,987,545,442
'2647066000,  연산2동,'10,5 - 9세,1998,1113,618,495
'2647066000,  연산2동,'15,10 - 14세,1998,1073,554,519
'2647066000,  연산2동,'20,15 - 19세,1998,1931,949,982
'2647066000,  연산2동,'25,20 - 24세,1998,1978,1027,951
'2647066000,  연산2동,'30,25 - 29세,1998,2096,1103,993
'2647066000,  연산2동,'35,30 - 34세,1998,1571,824,747
'2647066000,  연산2동,'40,35 - 39세,1998,1555,756,799
'2647066000,  연산2동,'45,40 - 44세,1998,1690,803,887
'2647066000,  연산2동,'50,45 - 49세,1998,1406,666,740
'2647066000,  연산2동,'55,50 - 54세,1998,1204,604,600
'2647066000,  연산2동,'60,55 - 59세,1998,1190,579,611
'2647066000,  연산2동,'65,60 - 64세,1998,800,385,415
'2647066000,  연산2동,'70,65 - 69세,1998,521,242,279
'2647066000,  연산2동,'75,70 - 74세,1998,336,120,216
'2647066000,  연산2동,'80,75 - 79세,1998,176,66,110
'2647066000,  연산2동,'85,80 - 84세,1998,74,24,50
'2647066000,  연산2동,'90,85+ ,1998,54,4,50
'2647067000,  연산3동,'00,계,1998,17145,8555,8590
'2647067000,  연산3동,'05,0 - 4세,1998,1013,553,460
'2647067000,  연산3동,'10,5 - 9세,1998,935,504,431
'2647067000,  연산3동,'15,10 - 14세,1998,1066,567,499
'2647067000,  연산3동,'20,15 - 19세,1998,1644,876,768
'2647067000,  연산3동,'25,20 - 24세,1998,1705,845,860
'2647067000,  연산3동,'30,25 - 29세,1998,1767,854,913
'2647067000,  연산3동,'35,30 - 34세,1998,1410,736,674
'2647067000,  연산3동,'40,35 - 39세,1998,1449,694,755
'2647067000,  연산3동,'45,40 - 44세,1998,1554,786,768
'2647067000,  연산3동,'50,45 - 49세,1998,1175,594,581
'2647067000,  연산3동,'55,50 - 54세,1998,967,476,491
'2647067000,  연산3동,'60,55 - 59세,1998,900,464,436
'2647067000,  연산3동,'65,60 - 64세,1998,659,278,381
'2647067000,  연산3동,'70,65 - 69세,1998,394,165,229
'2647067000,  연산3동,'75,70 - 74세,1998,243,85,158
'2647067000,  연산3동,'80,75 - 79세,1998,165,52,113
'2647067000,  연산3동,'85,80 - 84세,1998,61,16,45
'2647067000,  연산3동,'90,85+ ,1998,38,10,28
'2647068000,  연산4동,'00,계,1998,19419,9632,9787
'2647068000,  연산4동,'05,0 - 4세,1998,1010,543,467
'2647068000,  연산4동,'10,5 - 9세,1998,1042,548,494
'2647068000,  연산4동,'15,10 - 14세,1998,1258,647,611
'2647068000,  연산4동,'20,15 - 19세,1998,1955,1014,941
'2647068000,  연산4동,'25,20 - 24세,1998,1997,1024,973
'2647068000,  연산4동,'30,25 - 29세,1998,1966,986,980
'2647068000,  연산4동,'35,30 - 34세,1998,1461,740,721
'2647068000,  연산4동,'40,35 - 39세,1998,1707,787,920
'2647068000,  연산4동,'45,40 - 44세,1998,1803,865,938
'2647068000,  연산4동,'50,45 - 49세,1998,1477,699,778
'2647068000,  연산4동,'55,50 - 54세,1998,1211,599,612
'2647068000,  연산4동,'60,55 - 59세,1998,993,542,451
'2647068000,  연산4동,'65,60 - 64세,1998,660,317,343
'2647068000,  연산4동,'70,65 - 69세,1998,363,161,202
'2647068000,  연산4동,'75,70 - 74세,1998,236,86,150
'2647068000,  연산4동,'80,75 - 79세,1998,161,50,111
'2647068000,  연산4동,'85,80 - 84세,1998,73,22,51
'2647068000,  연산4동,'90,85+ ,1998,46,2,44
'2647069000,  연산5동,'00,계,1998,11620,5814,5806
'2647069000,  연산5동,'05,0 - 4세,1998,513,282,231
'2647069000,  연산5동,'10,5 - 9세,1998,607,327,280
'2647069000,  연산5동,'15,10 - 14세,1998,622,331,291
'2647069000,  연산5동,'20,15 - 19세,1998,1099,571,528
'2647069000,  연산5동,'25,20 - 24세,1998,1188,589,599
'2647069000,  연산5동,'30,25 - 29세,1998,1251,682,569
'2647069000,  연산5동,'35,30 - 34세,1998,833,425,408
'2647069000,  연산5동,'40,35 - 39세,1998,939,441,498
'2647069000,  연산5동,'45,40 - 44세,1998,1015,485,530
'2647069000,  연산5동,'50,45 - 49세,1998,854,390,464
'2647069000,  연산5동,'55,50 - 54세,1998,746,362,384
'2647069000,  연산5동,'60,55 - 59세,1998,736,372,364
'2647069000,  연산5동,'65,60 - 64세,1998,509,255,254
'2647069000,  연산5동,'70,65 - 69세,1998,316,142,174
'2647069000,  연산5동,'75,70 - 74세,1998,201,97,104
'2647069000,  연산5동,'80,75 - 79세,1998,106,40,66
'2647069000,  연산5동,'85,80 - 84세,1998,49,14,35
'2647069000,  연산5동,'90,85+ ,1998,36,9,27
'2647070000,  연산6동,'00,계,1998,10791,5367,5424
'2647070000,  연산6동,'05,0 - 4세,1998,602,333,269
'2647070000,  연산6동,'10,5 - 9세,1998,537,292,245
'2647070000,  연산6동,'15,10 - 14세,1998,631,343,288
'2647070000,  연산6동,'20,15 - 19세,1998,1083,535,548
'2647070000,  연산6동,'25,20 - 24세,1998,1089,557,532
'2647070000,  연산6동,'30,25 - 29세,1998,1118,579,539
'2647070000,  연산6동,'35,30 - 34세,1998,868,458,410
'2647070000,  연산6동,'40,35 - 39세,1998,860,418,442
'2647070000,  연산6동,'45,40 - 44세,1998,937,434,503
'2647070000,  연산6동,'50,45 - 49세,1998,765,363,402
'2647070000,  연산6동,'55,50 - 54세,1998,643,309,334
'2647070000,  연산6동,'60,55 - 59세,1998,642,320,322
'2647070000,  연산6동,'65,60 - 64세,1998,408,184,224
'2647070000,  연산6동,'70,65 - 69세,1998,290,133,157
'2647070000,  연산6동,'75,70 - 74세,1998,157,68,89
'2647070000,  연산6동,'80,75 - 79세,1998,95,30,65
'2647070000,  연산6동,'85,80 - 84세,1998,41,7,34
'2647070000,  연산6동,'90,85+ ,1998,25,4,21
'2647071000,  연산7동,'00,계,1998,12435,6157,6278
'2647071000,  연산7동,'05,0 - 4세,1998,698,372,326
'2647071000,  연산7동,'10,5 - 9세,1998,723,395,328
'2647071000,  연산7동,'15,10 - 14세,1998,749,383,366
'2647071000,  연산7동,'20,15 - 19세,1998,1234,612,622
'2647071000,  연산7동,'25,20 - 24세,1998,1259,643,616
'2647071000,  연산7동,'30,25 - 29세,1998,1230,657,573
'2647071000,  연산7동,'35,30 - 34세,1998,950,472,478
'2647071000,  연산7동,'40,35 - 39세,1998,1055,504,551
'2647071000,  연산7동,'45,40 - 44세,1998,1118,546,572
'2647071000,  연산7동,'50,45 - 49세,1998,852,400,452
'2647071000,  연산7동,'55,50 - 54세,1998,718,371,347
'2647071000,  연산7동,'60,55 - 59세,1998,676,314,362
'2647071000,  연산7동,'65,60 - 64세,1998,508,254,254
'2647071000,  연산7동,'70,65 - 69세,1998,268,107,161
'2647071000,  연산7동,'75,70 - 74세,1998,186,68,118
'2647071000,  연산7동,'80,75 - 79세,1998,113,31,82
'2647071000,  연산7동,'85,80 - 84세,1998,64,21,43
'2647071000,  연산7동,'90,85+ ,1998,34,7,27
'2647072000,  연산8동,'00,계,1998,19392,9720,9672
'2647072000,  연산8동,'05,0 - 4세,1998,1206,673,533
'2647072000,  연산8동,'10,5 - 9세,1998,1283,720,563
'2647072000,  연산8동,'15,10 - 14세,1998,1387,684,703
'2647072000,  연산8동,'20,15 - 19세,1998,2011,1011,1000
'2647072000,  연산8동,'25,20 - 24세,1998,1867,982,885
'2647072000,  연산8동,'30,25 - 29세,1998,1754,871,883
'2647072000,  연산8동,'35,30 - 34세,1998,1655,825,830
'2647072000,  연산8동,'40,35 - 39세,1998,1810,870,940
'2647072000,  연산8동,'45,40 - 44세,1998,1849,899,950
'2647072000,  연산8동,'50,45 - 49세,1998,1415,735,680
'2647072000,  연산8동,'55,50 - 54세,1998,1016,503,513
'2647072000,  연산8동,'60,55 - 59세,1998,807,427,380
'2647072000,  연산8동,'65,60 - 64세,1998,553,266,287
'2647072000,  연산8동,'70,65 - 69세,1998,337,132,205
'2647072000,  연산8동,'75,70 - 74세,1998,215,79,136
'2647072000,  연산8동,'80,75 - 79세,1998,134,32,102
'2647072000,  연산8동,'85,80 - 84세,1998,57,7,50
'2647072000,  연산8동,'90,85+ ,1998,36,4,32
'2647073000,  연산9동,'00,계,1998,36458,18161,18297
'2647073000,  연산9동,'05,0 - 4세,1998,2097,1124,973
'2647073000,  연산9동,'10,5 - 9세,1998,2584,1423,1161
'2647073000,  연산9동,'15,10 - 14세,1998,2834,1529,1305
'2647073000,  연산9동,'20,15 - 19세,1998,4032,2109,1923
'2647073000,  연산9동,'25,20 - 24세,1998,3071,1581,1490
'2647073000,  연산9동,'30,25 - 29세,1998,2841,1324,1517
'2647073000,  연산9동,'35,30 - 34세,1998,2759,1334,1425
'2647073000,  연산9동,'40,35 - 39세,1998,3526,1554,1972
'2647073000,  연산9동,'45,40 - 44세,1998,3895,1878,2017
'2647073000,  연산9동,'50,45 - 49세,1998,2874,1484,1390
'2647073000,  연산9동,'55,50 - 54세,1998,1872,1018,854
'2647073000,  연산9동,'60,55 - 59세,1998,1383,765,618
'2647073000,  연산9동,'65,60 - 64세,1998,952,469,483
'2647073000,  연산9동,'70,65 - 69세,1998,679,252,427
'2647073000,  연산9동,'75,70 - 74세,1998,499,153,346
'2647073000,  연산9동,'80,75 - 79세,1998,295,103,192
'2647073000,  연산9동,'85,80 - 84세,1998,160,37,123
'2647073000,  연산9동,'90,85+ ,1998,105,24,81
'26500, 수영구,'00,계,1998,189461,93199,96262
'26500, 수영구,'05,0 - 4세,1998,9678,5169,4509
'26500, 수영구,'10,5 - 9세,1998,10773,5821,4952
'26500, 수영구,'15,10 - 14세,1998,11918,6261,5657
'26500, 수영구,'20,15 - 19세,1998,19423,10049,9374
'26500, 수영구,'25,20 - 24세,1998,18427,9351,9076
'26500, 수영구,'30,25 - 29세,1998,17934,9036,8898
'26500, 수영구,'35,30 - 34세,1998,13326,6493,6833
'26500, 수영구,'40,35 - 39세,1998,15778,7258,8520
'26500, 수영구,'45,40 - 44세,1998,17665,8076,9589
'26500, 수영구,'50,45 - 49세,1998,14770,7034,7736
'26500, 수영구,'55,50 - 54세,1998,12016,6085,5931
'26500, 수영구,'60,55 - 59세,1998,10047,5169,4878
'26500, 수영구,'65,60 - 64세,1998,6716,3381,3335
'26500, 수영구,'70,65 - 69세,1998,4479,1928,2551
'26500, 수영구,'75,70 - 74세,1998,3030,1083,1947
'26500, 수영구,'80,75 - 79세,1998,1876,623,1253
'26500, 수영구,'85,80 - 84세,1998,1033,264,769
'26500, 수영구,'90,85+ ,1998,572,118,454
'2650066000,  남천1동,'00,계,1998,15233,7375,7858
'2650066000,  남천1동,'05,0 - 4세,1998,694,366,328
'2650066000,  남천1동,'10,5 - 9세,1998,823,441,382
'2650066000,  남천1동,'15,10 - 14세,1998,919,484,435
'2650066000,  남천1동,'20,15 - 19세,1998,1577,823,754
'2650066000,  남천1동,'25,20 - 24세,1998,1389,679,710
'2650066000,  남천1동,'30,25 - 29세,1998,1428,720,708
'2650066000,  남천1동,'35,30 - 34세,1998,975,480,495
'2650066000,  남천1동,'40,35 - 39세,1998,1264,556,708
'2650066000,  남천1동,'45,40 - 44세,1998,1399,634,765
'2650066000,  남천1동,'50,45 - 49세,1998,1192,555,637
'2650066000,  남천1동,'55,50 - 54세,1998,997,478,519
'2650066000,  남천1동,'60,55 - 59세,1998,909,459,450
'2650066000,  남천1동,'65,60 - 64세,1998,617,313,304
'2650066000,  남천1동,'70,65 - 69세,1998,434,184,250
'2650066000,  남천1동,'75,70 - 74세,1998,297,117,180
'2650066000,  남천1동,'80,75 - 79세,1998,179,55,124
'2650066000,  남천1동,'85,80 - 84세,1998,94,23,71
'2650066000,  남천1동,'90,85+ ,1998,46,8,38
'2650067000,  남천2동,'00,계,1998,15671,7584,8087
'2650067000,  남천2동,'05,0 - 4세,1998,827,449,378
'2650067000,  남천2동,'10,5 - 9세,1998,1071,555,516
'2650067000,  남천2동,'15,10 - 14세,1998,1245,680,565
'2650067000,  남천2동,'20,15 - 19세,1998,1455,754,701
'2650067000,  남천2동,'25,20 - 24세,1998,1229,635,594
'2650067000,  남천2동,'30,25 - 29세,1998,1202,562,640
'2650067000,  남천2동,'35,30 - 34세,1998,1048,463,585
'2650067000,  남천2동,'40,35 - 39세,1998,1420,623,797
'2650067000,  남천2동,'45,40 - 44세,1998,1621,739,882
'2650067000,  남천2동,'50,45 - 49세,1998,1294,578,716
'2650067000,  남천2동,'55,50 - 54세,1998,1010,515,495
'2650067000,  남천2동,'60,55 - 59세,1998,725,396,329
'2650067000,  남천2동,'65,60 - 64세,1998,451,244,207
'2650067000,  남천2동,'70,65 - 69세,1998,380,140,240
'2650067000,  남천2동,'75,70 - 74세,1998,318,116,202
'2650067000,  남천2동,'80,75 - 79세,1998,228,84,144
'2650067000,  남천2동,'85,80 - 84세,1998,95,34,61
'2650067000,  남천2동,'90,85+ ,1998,52,17,35
'2650073000,  수영동,'00,계,1998,19515,9649,9866
'2650073000,  수영동,'05,0 - 4세,1998,1037,564,473
'2650073000,  수영동,'10,5 - 9세,1998,994,553,441
'2650073000,  수영동,'15,10 - 14세,1998,1117,595,522
'2650073000,  수영동,'20,15 - 19세,1998,2007,1031,976
'2650073000,  수영동,'25,20 - 24세,1998,2046,1045,1001
'2650073000,  수영동,'30,25 - 29세,1998,1927,965,962
'2650073000,  수영동,'35,30 - 34세,1998,1412,736,676
'2650073000,  수영동,'40,35 - 39세,1998,1521,717,804
'2650073000,  수영동,'45,40 - 44세,1998,1755,764,991
'2650073000,  수영동,'50,45 - 49세,1998,1558,731,827
'2650073000,  수영동,'55,50 - 54세,1998,1212,622,590
'2650073000,  수영동,'60,55 - 59세,1998,1109,533,576
'2650073000,  수영동,'65,60 - 64세,1998,734,412,322
'2650073000,  수영동,'70,65 - 69세,1998,436,171,265
'2650073000,  수영동,'75,70 - 74세,1998,305,101,204
'2650073000,  수영동,'80,75 - 79세,1998,179,70,109
'2650073000,  수영동,'85,80 - 84세,1998,102,26,76
'2650073000,  수영동,'90,85+ ,1998,64,13,51
'2650074000,  망미1동,'00,계,1998,35462,17514,17948
'2650074000,  망미1동,'05,0 - 4세,1998,1761,962,799
'2650074000,  망미1동,'10,5 - 9세,1998,2149,1199,950
'2650074000,  망미1동,'15,10 - 14세,1998,2447,1284,1163
'2650074000,  망미1동,'20,15 - 19세,1998,3876,2004,1872
'2650074000,  망미1동,'25,20 - 24세,1998,3414,1714,1700
'2650074000,  망미1동,'30,25 - 29세,1998,3095,1526,1569
'2650074000,  망미1동,'35,30 - 34세,1998,2298,1102,1196
'2650074000,  망미1동,'40,35 - 39세,1998,3033,1390,1643
'2650074000,  망미1동,'45,40 - 44세,1998,3517,1593,1924
'2650074000,  망미1동,'50,45 - 49세,1998,2853,1415,1438
'2650074000,  망미1동,'55,50 - 54세,1998,2133,1149,984
'2650074000,  망미1동,'60,55 - 59세,1998,1630,855,775
'2650074000,  망미1동,'65,60 - 64세,1998,1150,561,589
'2650074000,  망미1동,'70,65 - 69세,1998,863,360,503
'2650074000,  망미1동,'75,70 - 74세,1998,578,215,363
'2650074000,  망미1동,'80,75 - 79세,1998,370,114,256
'2650074000,  망미1동,'85,80 - 84세,1998,196,52,144
'2650074000,  망미1동,'90,85+ ,1998,99,19,80
'2650075000,  망미2동,'00,계,1998,14257,7155,7102
'2650075000,  망미2동,'05,0 - 4세,1998,742,395,347
'2650075000,  망미2동,'10,5 - 9세,1998,855,442,413
'2650075000,  망미2동,'15,10 - 14세,1998,871,449,422
'2650075000,  망미2동,'20,15 - 19세,1998,1530,781,749
'2650075000,  망미2동,'25,20 - 24세,1998,1492,771,721
'2650075000,  망미2동,'30,25 - 29세,1998,1382,731,651
'2650075000,  망미2동,'35,30 - 34세,1998,1033,528,505
'2650075000,  망미2동,'40,35 - 39세,1998,1202,567,635
'2650075000,  망미2동,'45,40 - 44세,1998,1296,618,678
'2650075000,  망미2동,'50,45 - 49세,1998,1089,531,558
'2650075000,  망미2동,'55,50 - 54세,1998,867,445,422
'2650075000,  망미2동,'60,55 - 59세,1998,756,406,350
'2650075000,  망미2동,'65,60 - 64세,1998,463,233,230
'2650075000,  망미2동,'70,65 - 69세,1998,288,137,151
'2650075000,  망미2동,'75,70 - 74세,1998,195,65,130
'2650075000,  망미2동,'80,75 - 79세,1998,102,28,74
'2650075000,  망미2동,'85,80 - 84세,1998,62,20,42
'2650075000,  망미2동,'90,85+ ,1998,32,8,24
'2650076000,  광안1동,'00,계,1998,26217,12954,13263
'2650076000,  광안1동,'05,0 - 4세,1998,1537,809,728
'2650076000,  광안1동,'10,5 - 9세,1998,1660,892,768
'2650076000,  광안1동,'15,10 - 14세,1998,1798,961,837
'2650076000,  광안1동,'20,15 - 19세,1998,2704,1428,1276
'2650076000,  광안1동,'25,20 - 24세,1998,2349,1204,1145
'2650076000,  광안1동,'30,25 - 29세,1998,2306,1117,1189
'2650076000,  광안1동,'35,30 - 34세,1998,1931,879,1052
'2650076000,  광안1동,'40,35 - 39세,1998,2378,1103,1275
'2650076000,  광안1동,'45,40 - 44세,1998,2580,1221,1359
'2650076000,  광안1동,'50,45 - 49세,1998,1910,947,963
'2650076000,  광안1동,'55,50 - 54세,1998,1581,799,782
'2650076000,  광안1동,'60,55 - 59세,1998,1273,679,594
'2650076000,  광안1동,'65,60 - 64세,1998,851,427,424
'2650076000,  광안1동,'70,65 - 69세,1998,538,237,301
'2650076000,  광안1동,'75,70 - 74세,1998,353,126,227
'2650076000,  광안1동,'80,75 - 79세,1998,238,76,162
'2650076000,  광안1동,'85,80 - 84세,1998,150,38,112
'2650076000,  광안1동,'90,85+ ,1998,80,11,69
'2650077000,  광안2동,'00,계,1998,16275,8016,8259
'2650077000,  광안2동,'05,0 - 4세,1998,743,410,333
'2650077000,  광안2동,'10,5 - 9세,1998,759,402,357
'2650077000,  광안2동,'15,10 - 14세,1998,865,440,425
'2650077000,  광안2동,'20,15 - 19세,1998,1608,840,768
'2650077000,  광안2동,'25,20 - 24세,1998,1748,867,881
'2650077000,  광안2동,'30,25 - 29세,1998,1777,935,842
'2650077000,  광안2동,'35,30 - 34세,1998,1166,597,569
'2650077000,  광안2동,'40,35 - 39세,1998,1188,553,635
'2650077000,  광안2동,'45,40 - 44세,1998,1377,623,754
'2650077000,  광안2동,'50,45 - 49세,1998,1248,568,680
'2650077000,  광안2동,'55,50 - 54세,1998,1161,568,593
'2650077000,  광안2동,'60,55 - 59세,1998,988,513,475
'2650077000,  광안2동,'65,60 - 64세,1998,659,317,342
'2650077000,  광안2동,'70,65 - 69세,1998,419,194,225
'2650077000,  광안2동,'75,70 - 74세,1998,259,101,158
'2650077000,  광안2동,'80,75 - 79세,1998,166,53,113
'2650077000,  광안2동,'85,80 - 84세,1998,86,23,63
'2650077000,  광안2동,'90,85+ ,1998,58,12,46
'2650078000,  광안3동,'00,계,1998,11926,5917,6009
'2650078000,  광안3동,'05,0 - 4세,1998,584,314,270
'2650078000,  광안3동,'10,5 - 9세,1998,603,322,281
'2650078000,  광안3동,'15,10 - 14세,1998,681,368,313
'2650078000,  광안3동,'20,15 - 19세,1998,1265,644,621
'2650078000,  광안3동,'25,20 - 24세,1998,1196,582,614
'2650078000,  광안3동,'30,25 - 29세,1998,1185,627,558
'2650078000,  광안3동,'35,30 - 34세,1998,861,444,417
'2650078000,  광안3동,'40,35 - 39세,1998,933,427,506
'2650078000,  광안3동,'45,40 - 44세,1998,1050,485,565
'2650078000,  광안3동,'50,45 - 49세,1998,965,490,475
'2650078000,  광안3동,'55,50 - 54세,1998,781,395,386
'2650078000,  광안3동,'60,55 - 59세,1998,658,323,335
'2650078000,  광안3동,'65,60 - 64세,1998,477,231,246
'2650078000,  광안3동,'70,65 - 69세,1998,309,142,167
'2650078000,  광안3동,'75,70 - 74세,1998,192,74,118
'2650078000,  광안3동,'80,75 - 79세,1998,96,35,61
'2650078000,  광안3동,'85,80 - 84세,1998,57,9,48
'2650078000,  광안3동,'90,85+ ,1998,33,5,28
'2650079000,  광안4동,'00,계,1998,14302,6882,7420
'2650079000,  광안4동,'05,0 - 4세,1998,762,402,360
'2650079000,  광안4동,'10,5 - 9세,1998,801,445,356
'2650079000,  광안4동,'15,10 - 14세,1998,867,448,419
'2650079000,  광안4동,'20,15 - 19세,1998,1398,739,659
'2650079000,  광안4동,'25,20 - 24세,1998,1339,705,634
'2650079000,  광안4동,'30,25 - 29세,1998,1409,665,744
'2650079000,  광안4동,'35,30 - 34세,1998,1089,478,611
'2650079000,  광안4동,'40,35 - 39세,1998,1242,563,679
'2650079000,  광안4동,'45,40 - 44세,1998,1268,572,696
'2650079000,  광안4동,'50,45 - 49세,1998,1100,511,589
'2650079000,  광안4동,'55,50 - 54세,1998,884,451,433
'2650079000,  광안4동,'60,55 - 59세,1998,774,370,404
'2650079000,  광안4동,'65,60 - 64세,1998,525,238,287
'2650079000,  광안4동,'70,65 - 69세,1998,351,145,206
'2650079000,  광안4동,'75,70 - 74세,1998,236,76,160
'2650079000,  광안4동,'80,75 - 79세,1998,129,40,89
'2650079000,  광안4동,'85,80 - 84세,1998,78,22,56
'2650079000,  광안4동,'90,85+ ,1998,50,12,38
'2650080000,  민락동,'00,계,1998,20603,10153,10450
'2650080000,  민락동,'05,0 - 4세,1998,991,498,493
'2650080000,  민락동,'10,5 - 9세,1998,1058,570,488
'2650080000,  민락동,'15,10 - 14세,1998,1108,552,556
'2650080000,  민락동,'20,15 - 19세,1998,2003,1005,998
'2650080000,  민락동,'25,20 - 24세,1998,2225,1149,1076
'2650080000,  민락동,'30,25 - 29세,1998,2223,1188,1035
'2650080000,  민락동,'35,30 - 34세,1998,1513,786,727
'2650080000,  민락동,'40,35 - 39세,1998,1597,759,838
'2650080000,  민락동,'45,40 - 44세,1998,1802,827,975
'2650080000,  민락동,'50,45 - 49세,1998,1561,708,853
'2650080000,  민락동,'55,50 - 54세,1998,1390,663,727
'2650080000,  민락동,'60,55 - 59세,1998,1225,635,590
'2650080000,  민락동,'65,60 - 64세,1998,789,405,384
'2650080000,  민락동,'70,65 - 69세,1998,461,218,243
'2650080000,  민락동,'75,70 - 74세,1998,297,92,205
'2650080000,  민락동,'80,75 - 79세,1998,189,68,121
'2650080000,  민락동,'85,80 - 84세,1998,113,17,96
'2650080000,  민락동,'90,85+ ,1998,58,13,45
'26530, 사상구,'00,계,1998,290621,147760,142861
'26530, 사상구,'05,0 - 4세,1998,19776,10704,9072
'26530, 사상구,'10,5 - 9세,1998,22099,11998,10101
'26530, 사상구,'15,10 - 14세,1998,21751,11442,10309
'26530, 사상구,'20,15 - 19세,1998,28475,14660,13815
'26530, 사상구,'25,20 - 24세,1998,25846,13187,12659
'26530, 사상구,'30,25 - 29세,1998,26944,13631,13313
'26530, 사상구,'35,30 - 34세,1998,27297,13693,13604
'26530, 사상구,'40,35 - 39세,1998,31401,16131,15270
'26530, 사상구,'45,40 - 44세,1998,26238,13695,12543
'26530, 사상구,'50,45 - 49세,1998,17979,9217,8762
'26530, 사상구,'55,50 - 54세,1998,13124,6673,6451
'26530, 사상구,'60,55 - 59세,1998,11257,5700,5557
'26530, 사상구,'65,60 - 64세,1998,7541,3456,4085
'26530, 사상구,'70,65 - 69세,1998,4675,1853,2822
'26530, 사상구,'75,70 - 74세,1998,3052,979,2073
'26530, 사상구,'80,75 - 79세,1998,1814,484,1330
'26530, 사상구,'85,80 - 84세,1998,895,178,717
'26530, 사상구,'90,85+ ,1998,457,79,378
'2653058000,  삼락동,'00,계,1998,12379,6489,5890
'2653058000,  삼락동,'05,0 - 4세,1998,866,460,406
'2653058000,  삼락동,'10,5 - 9세,1998,866,457,409
'2653058000,  삼락동,'15,10 - 14세,1998,843,441,402
'2653058000,  삼락동,'20,15 - 19세,1998,1120,592,528
'2653058000,  삼락동,'25,20 - 24세,1998,1192,615,577
'2653058000,  삼락동,'30,25 - 29세,1998,1370,768,602
'2653058000,  삼락동,'35,30 - 34세,1998,1262,687,575
'2653058000,  삼락동,'40,35 - 39세,1998,1218,675,543
'2653058000,  삼락동,'45,40 - 44세,1998,1001,544,457
'2653058000,  삼락동,'50,45 - 49세,1998,745,402,343
'2653058000,  삼락동,'55,50 - 54세,1998,619,321,298
'2653058000,  삼락동,'60,55 - 59세,1998,509,240,269
'2653058000,  삼락동,'65,60 - 64세,1998,328,140,188
'2653058000,  삼락동,'70,65 - 69세,1998,198,79,119
'2653058000,  삼락동,'75,70 - 74세,1998,118,44,74
'2653058000,  삼락동,'80,75 - 79세,1998,77,16,61
'2653058000,  삼락동,'85,80 - 84세,1998,30,6,24
'2653058000,  삼락동,'90,85+ ,1998,17,2,15
'2653059100,  모라1동,'00,계,1998,11670,6054,5616
'2653059100,  모라1동,'05,0 - 4세,1998,626,335,291
'2653059100,  모라1동,'10,5 - 9세,1998,734,419,315
'2653059100,  모라1동,'15,10 - 14세,1998,759,383,376
'2653059100,  모라1동,'20,15 - 19세,1998,1190,648,542
'2653059100,  모라1동,'25,20 - 24세,1998,1178,627,551
'2653059100,  모라1동,'30,25 - 29세,1998,1145,641,504
'2653059100,  모라1동,'35,30 - 34세,1998,1002,540,462
'2653059100,  모라1동,'40,35 - 39세,1998,1167,606,561
'2653059100,  모라1동,'45,40 - 44세,1998,999,527,472
'2653059100,  모라1동,'50,45 - 49세,1998,781,382,399
'2653059100,  모라1동,'55,50 - 54세,1998,613,297,316
'2653059100,  모라1동,'60,55 - 59세,1998,573,287,286
'2653059100,  모라1동,'65,60 - 64세,1998,401,190,211
'2653059100,  모라1동,'70,65 - 69세,1998,231,107,124
'2653059100,  모라1동,'75,70 - 74세,1998,129,45,84
'2653059100,  모라1동,'80,75 - 79세,1998,80,10,70
'2653059100,  모라1동,'85,80 - 84세,1998,39,8,31
'2653059100,  모라1동,'90,85+ ,1998,23,2,21
'2653059200,  모라2동,'00,계,1998,27587,13846,13741
'2653059200,  모라2동,'05,0 - 4세,1998,1706,931,775
'2653059200,  모라2동,'10,5 - 9세,1998,2091,1160,931
'2653059200,  모라2동,'15,10 - 14세,1998,2492,1288,1204
'2653059200,  모라2동,'20,15 - 19세,1998,3012,1541,1471
'2653059200,  모라2동,'25,20 - 24세,1998,2204,1116,1088
'2653059200,  모라2동,'30,25 - 29세,1998,2203,1030,1173
'2653059200,  모라2동,'35,30 - 34세,1998,2178,1017,1161
'2653059200,  모라2동,'40,35 - 39세,1998,3133,1418,1715
'2653059200,  모라2동,'45,40 - 44세,1998,3002,1569,1433
'2653059200,  모라2동,'50,45 - 49세,1998,1844,1029,815
'2653059200,  모라2동,'55,50 - 54세,1998,1179,648,531
'2653059200,  모라2동,'60,55 - 59세,1998,936,496,440
'2653059200,  모라2동,'65,60 - 64세,1998,630,298,332
'2653059200,  모라2동,'70,65 - 69세,1998,414,156,258
'2653059200,  모라2동,'75,70 - 74세,1998,284,85,199
'2653059200,  모라2동,'80,75 - 79세,1998,162,35,127
'2653059200,  모라2동,'85,80 - 84세,1998,78,16,62
'2653059200,  모라2동,'90,85+ ,1998,39,13,26
'2653059300,  모라3동,'00,계,1998,22527,10840,11687
'2653059300,  모라3동,'05,0 - 4세,1998,1170,630,540
'2653059300,  모라3동,'10,5 - 9세,1998,1550,839,711
'2653059300,  모라3동,'15,10 - 14세,1998,1406,723,683
'2653059300,  모라3동,'20,15 - 19세,1998,2654,1346,1308
'2653059300,  모라3동,'25,20 - 24세,1998,2879,1494,1385
'2653059300,  모라3동,'30,25 - 29세,1998,1805,928,877
'2653059300,  모라3동,'35,30 - 34세,1998,1671,762,909
'2653059300,  모라3동,'40,35 - 39세,1998,1973,1026,947
'2653059300,  모라3동,'45,40 - 44세,1998,1830,834,996
'2653059300,  모라3동,'50,45 - 49세,1998,1558,635,923
'2653059300,  모라3동,'55,50 - 54세,1998,1165,526,639
'2653059300,  모라3동,'60,55 - 59세,1998,960,443,517
'2653059300,  모라3동,'65,60 - 64세,1998,701,282,419
'2653059300,  모라3동,'70,65 - 69세,1998,488,178,310
'2653059300,  모라3동,'75,70 - 74세,1998,343,92,251
'2653059300,  모라3동,'80,75 - 79세,1998,231,74,157
'2653059300,  모라3동,'85,80 - 84세,1998,98,21,77
'2653059300,  모라3동,'90,85+ ,1998,45,7,38
'2653060000,  덕포1동,'00,계,1998,16159,8392,7767
'2653060000,  덕포1동,'05,0 - 4세,1998,1049,591,458
'2653060000,  덕포1동,'10,5 - 9세,1998,1208,682,526
'2653060000,  덕포1동,'15,10 - 14세,1998,1076,562,514
'2653060000,  덕포1동,'20,15 - 19세,1998,1556,799,757
'2653060000,  덕포1동,'25,20 - 24세,1998,1557,805,752
'2653060000,  덕포1동,'30,25 - 29세,1998,1656,854,802
'2653060000,  덕포1동,'35,30 - 34세,1998,1624,876,748
'2653060000,  덕포1동,'40,35 - 39세,1998,1618,905,713
'2653060000,  덕포1동,'45,40 - 44세,1998,1283,662,621
'2653060000,  덕포1동,'50,45 - 49세,1998,992,489,503
'2653060000,  덕포1동,'55,50 - 54세,1998,799,417,382
'2653060000,  덕포1동,'60,55 - 59세,1998,627,317,310
'2653060000,  덕포1동,'65,60 - 64세,1998,458,192,266
'2653060000,  덕포1동,'70,65 - 69세,1998,300,127,173
'2653060000,  덕포1동,'75,70 - 74세,1998,181,61,120
'2653060000,  덕포1동,'80,75 - 79세,1998,111,40,71
'2653060000,  덕포1동,'85,80 - 84세,1998,44,9,35
'2653060000,  덕포1동,'90,85+ ,1998,20,4,16
'2653061000,  덕포2동,'00,계,1998,19102,9678,9424
'2653061000,  덕포2동,'05,0 - 4세,1998,1372,751,621
'2653061000,  덕포2동,'10,5 - 9세,1998,1729,941,788
'2653061000,  덕포2동,'15,10 - 14세,1998,1574,816,758
'2653061000,  덕포2동,'20,15 - 19세,1998,1775,874,901
'2653061000,  덕포2동,'25,20 - 24세,1998,1471,711,760
'2653061000,  덕포2동,'30,25 - 29세,1998,1712,889,823
'2653061000,  덕포2동,'35,30 - 34세,1998,1939,914,1025
'2653061000,  덕포2동,'40,35 - 39세,1998,2256,1158,1098
'2653061000,  덕포2동,'45,40 - 44세,1998,1706,902,804
'2653061000,  덕포2동,'50,45 - 49세,1998,1094,597,497
'2653061000,  덕포2동,'55,50 - 54세,1998,791,402,389
'2653061000,  덕포2동,'60,55 - 59세,1998,633,320,313
'2653061000,  덕포2동,'65,60 - 64세,1998,425,199,226
'2653061000,  덕포2동,'70,65 - 69세,1998,267,114,153
'2653061000,  덕포2동,'75,70 - 74세,1998,174,43,131
'2653061000,  덕포2동,'80,75 - 79세,1998,109,29,80
'2653061000,  덕포2동,'85,80 - 84세,1998,52,14,38
'2653061000,  덕포2동,'90,85+ ,1998,23,4,19
'2653062000,  괘법동,'00,계,1998,24338,12643,11695
'2653062000,  괘법동,'05,0 - 4세,1998,1585,827,758
'2653062000,  괘법동,'10,5 - 9세,1998,1717,910,807
'2653062000,  괘법동,'15,10 - 14세,1998,1710,932,778
'2653062000,  괘법동,'20,15 - 19세,1998,2263,1211,1052
'2653062000,  괘법동,'25,20 - 24세,1998,2263,1186,1077
'2653062000,  괘법동,'30,25 - 29세,1998,2388,1231,1157
'2653062000,  괘법동,'35,30 - 34세,1998,2360,1295,1065
'2653062000,  괘법동,'40,35 - 39세,1998,2677,1417,1260
'2653062000,  괘법동,'45,40 - 44세,1998,2072,1128,944
'2653062000,  괘법동,'50,45 - 49세,1998,1485,759,726
'2653062000,  괘법동,'55,50 - 54세,1998,1197,583,614
'2653062000,  괘법동,'60,55 - 59세,1998,1027,521,506
'2653062000,  괘법동,'65,60 - 64세,1998,702,307,395
'2653062000,  괘법동,'70,65 - 69세,1998,398,181,217
'2653062000,  괘법동,'75,70 - 74세,1998,232,84,148
'2653062000,  괘법동,'80,75 - 79세,1998,146,45,101
'2653062000,  괘법동,'85,80 - 84세,1998,82,19,63
'2653062000,  괘법동,'90,85+ ,1998,34,7,27
'2653063000,  감전1동,'00,계,1998,11933,6207,5726
'2653063000,  감전1동,'05,0 - 4세,1998,861,470,391
'2653063000,  감전1동,'10,5 - 9세,1998,936,514,422
'2653063000,  감전1동,'15,10 - 14세,1998,801,380,421
'2653063000,  감전1동,'20,15 - 19세,1998,1062,542,520
'2653063000,  감전1동,'25,20 - 24세,1998,1172,583,589
'2653063000,  감전1동,'30,25 - 29세,1998,1231,659,572
'2653063000,  감전1동,'35,30 - 34세,1998,1174,630,544
'2653063000,  감전1동,'40,35 - 39세,1998,1222,728,494
'2653063000,  감전1동,'45,40 - 44세,1998,966,506,460
'2653063000,  감전1동,'50,45 - 49세,1998,745,385,360
'2653063000,  감전1동,'55,50 - 54세,1998,517,256,261
'2653063000,  감전1동,'60,55 - 59세,1998,540,267,273
'2653063000,  감전1동,'65,60 - 64세,1998,309,155,154
'2653063000,  감전1동,'70,65 - 69세,1998,169,73,96
'2653063000,  감전1동,'75,70 - 74세,1998,115,35,80
'2653063000,  감전1동,'80,75 - 79세,1998,59,11,48
'2653063000,  감전1동,'85,80 - 84세,1998,29,10,19
'2653063000,  감전1동,'90,85+ ,1998,25,3,22
'2653064000,  감전2동,'00,계,1998,9260,4826,4434
'2653064000,  감전2동,'05,0 - 4세,1998,467,239,228
'2653064000,  감전2동,'10,5 - 9세,1998,556,301,255
'2653064000,  감전2동,'15,10 - 14세,1998,640,361,279
'2653064000,  감전2동,'20,15 - 19세,1998,915,472,443
'2653064000,  감전2동,'25,20 - 24세,1998,910,474,436
'2653064000,  감전2동,'30,25 - 29세,1998,954,564,390
'2653064000,  감전2동,'35,30 - 34세,1998,790,405,385
'2653064000,  감전2동,'40,35 - 39세,1998,921,511,410
'2653064000,  감전2동,'45,40 - 44세,1998,834,433,401
'2653064000,  감전2동,'50,45 - 49세,1998,622,312,310
'2653064000,  감전2동,'55,50 - 54세,1998,505,249,256
'2653064000,  감전2동,'60,55 - 59세,1998,490,251,239
'2653064000,  감전2동,'65,60 - 64세,1998,285,140,145
'2653064000,  감전2동,'70,65 - 69세,1998,165,53,112
'2653064000,  감전2동,'75,70 - 74세,1998,98,35,63
'2653064000,  감전2동,'80,75 - 79세,1998,55,17,38
'2653064000,  감전2동,'85,80 - 84세,1998,37,6,31
'2653064000,  감전2동,'90,85+ ,1998,16,3,13
'2653065000,  주례1동,'00,계,1998,18483,9368,9115
'2653065000,  주례1동,'05,0 - 4세,1998,1392,735,657
'2653065000,  주례1동,'10,5 - 9세,1998,1467,796,671
'2653065000,  주례1동,'15,10 - 14세,1998,1416,738,678
'2653065000,  주례1동,'20,15 - 19세,1998,1766,892,874
'2653065000,  주례1동,'25,20 - 24세,1998,1502,747,755
'2653065000,  주례1동,'30,25 - 29세,1998,1770,857,913
'2653065000,  주례1동,'35,30 - 34세,1998,1724,876,848
'2653065000,  주례1동,'40,35 - 39세,1998,2004,1015,989
'2653065000,  주례1동,'45,40 - 44세,1998,1740,931,809
'2653065000,  주례1동,'50,45 - 49세,1998,1147,603,544
'2653065000,  주례1동,'55,50 - 54세,1998,792,405,387
'2653065000,  주례1동,'60,55 - 59세,1998,661,372,289
'2653065000,  주례1동,'65,60 - 64세,1998,446,196,250
'2653065000,  주례1동,'70,65 - 69세,1998,273,106,167
'2653065000,  주례1동,'75,70 - 74세,1998,190,64,126
'2653065000,  주례1동,'80,75 - 79세,1998,116,28,88
'2653065000,  주례1동,'85,80 - 84세,1998,50,4,46
'2653065000,  주례1동,'90,85+ ,1998,27,3,24
'2653066000,  주례2동,'00,계,1998,31948,16191,15757
'2653066000,  주례2동,'05,0 - 4세,1998,2530,1387,1143
'2653066000,  주례2동,'10,5 - 9세,1998,2611,1388,1223
'2653066000,  주례2동,'15,10 - 14세,1998,2213,1200,1013
'2653066000,  주례2동,'20,15 - 19세,1998,2844,1477,1367
'2653066000,  주례2동,'25,20 - 24세,1998,2736,1352,1384
'2653066000,  주례2동,'30,25 - 29세,1998,3113,1533,1580
'2653066000,  주례2동,'35,30 - 34세,1998,3269,1579,1690
'2653066000,  주례2동,'40,35 - 39세,1998,3533,1857,1676
'2653066000,  주례2동,'45,40 - 44세,1998,2628,1371,1257
'2653066000,  주례2동,'50,45 - 49세,1998,1850,906,944
'2653066000,  주례2동,'55,50 - 54세,1998,1400,739,661
'2653066000,  주례2동,'60,55 - 59세,1998,1238,633,605
'2653066000,  주례2동,'65,60 - 64세,1998,853,378,475
'2653066000,  주례2동,'70,65 - 69세,1998,514,212,302
'2653066000,  주례2동,'75,70 - 74세,1998,279,94,185
'2653066000,  주례2동,'80,75 - 79세,1998,176,53,123
'2653066000,  주례2동,'85,80 - 84세,1998,99,24,75
'2653066000,  주례2동,'90,85+ ,1998,62,8,54
'2653066100,  주례3동,'00,계,1998,20999,10514,10485
'2653066100,  주례3동,'05,0 - 4세,1998,1456,803,653
'2653066100,  주례3동,'10,5 - 9세,1998,1609,861,748
'2653066100,  주례3동,'15,10 - 14세,1998,1658,887,771
'2653066100,  주례3동,'20,15 - 19세,1998,2036,1002,1034
'2653066100,  주례3동,'25,20 - 24세,1998,1662,841,821
'2653066100,  주례3동,'30,25 - 29세,1998,1837,883,954
'2653066100,  주례3동,'35,30 - 34세,1998,1949,956,993
'2653066100,  주례3동,'40,35 - 39세,1998,2335,1132,1203
'2653066100,  주례3동,'45,40 - 44세,1998,2014,1037,977
'2653066100,  주례3동,'50,45 - 49세,1998,1340,693,647
'2653066100,  주례3동,'55,50 - 54세,1998,901,456,445
'2653066100,  주례3동,'60,55 - 59세,1998,837,414,423
'2653066100,  주례3동,'65,60 - 64세,1998,545,266,279
'2653066100,  주례3동,'70,65 - 69세,1998,350,138,212
'2653066100,  주례3동,'75,70 - 74세,1998,231,87,144
'2653066100,  주례3동,'80,75 - 79세,1998,142,42,100
'2653066100,  주례3동,'85,80 - 84세,1998,63,8,55
'2653066100,  주례3동,'90,85+ ,1998,34,8,26
'2653067000,  학장동,'00,계,1998,40145,20396,19749
'2653067000,  학장동,'05,0 - 4세,1998,2772,1495,1277
'2653067000,  학장동,'10,5 - 9세,1998,3079,1675,1404
'2653067000,  학장동,'15,10 - 14세,1998,3368,1793,1575
'2653067000,  학장동,'20,15 - 19세,1998,4018,2098,1920
'2653067000,  학장동,'25,20 - 24세,1998,3150,1642,1508
'2653067000,  학장동,'30,25 - 29세,1998,3451,1662,1789
'2653067000,  학장동,'35,30 - 34세,1998,3740,1870,1870
'2653067000,  학장동,'40,35 - 39세,1998,4631,2199,2432
'2653067000,  학장동,'45,40 - 44세,1998,4043,2157,1886
'2653067000,  학장동,'50,45 - 49세,1998,2387,1301,1086
'2653067000,  학장동,'55,50 - 54세,1998,1702,850,852
'2653067000,  학장동,'60,55 - 59세,1998,1449,759,690
'2653067000,  학장동,'65,60 - 64세,1998,928,458,470
'2653067000,  학장동,'70,65 - 69세,1998,572,216,356
'2653067000,  학장동,'75,70 - 74세,1998,446,131,315
'2653067000,  학장동,'80,75 - 79세,1998,223,59,164
'2653067000,  학장동,'85,80 - 84세,1998,127,21,106
'2653067000,  학장동,'90,85+ ,1998,59,10,49
'2653068000,  엄궁동,'00,계,1998,24091,12316,11775
'2653068000,  엄궁동,'05,0 - 4세,1998,1924,1050,874
'2653068000,  엄궁동,'10,5 - 9세,1998,1946,1055,891
'2653068000,  엄궁동,'15,10 - 14세,1998,1795,938,857
'2653068000,  엄궁동,'20,15 - 19세,1998,2264,1166,1098
'2653068000,  엄궁동,'25,20 - 24세,1998,1970,994,976
'2653068000,  엄궁동,'30,25 - 29세,1998,2309,1132,1177
'2653068000,  엄궁동,'35,30 - 34세,1998,2615,1286,1329
'2653068000,  엄궁동,'40,35 - 39세,1998,2713,1484,1229
'2653068000,  엄궁동,'45,40 - 44세,1998,2120,1094,1026
'2653068000,  엄궁동,'50,45 - 49세,1998,1389,724,665
'2653068000,  엄궁동,'55,50 - 54세,1998,944,524,420
'2653068000,  엄궁동,'60,55 - 59세,1998,777,380,397
'2653068000,  엄궁동,'65,60 - 64세,1998,530,255,275
'2653068000,  엄궁동,'70,65 - 69세,1998,336,113,223
'2653068000,  엄궁동,'75,70 - 74세,1998,232,79,153
'2653068000,  엄궁동,'80,75 - 79세,1998,127,25,102
'2653068000,  엄궁동,'85,80 - 84세,1998,67,12,55
'2653068000,  엄궁동,'90,85+ ,1998,33,5,28
'26710, 기장군,'00,계,1998,74456,36851,37605
'26710, 기장군,'05,0 - 4세,1998,5218,2790,2428
'26710, 기장군,'10,5 - 9세,1998,5376,2861,2515
'26710, 기장군,'15,10 - 14세,1998,4580,2361,2219
'26710, 기장군,'20,15 - 19세,1998,5970,3041,2929
'26710, 기장군,'25,20 - 24세,1998,5987,3118,2869
'26710, 기장군,'30,25 - 29세,1998,6737,3364,3373
'26710, 기장군,'35,30 - 34세,1998,6776,3467,3309
'26710, 기장군,'40,35 - 39세,1998,6904,3628,3276
'26710, 기장군,'45,40 - 44세,1998,5690,2985,2705
'26710, 기장군,'50,45 - 49세,1998,4160,2105,2055
'26710, 기장군,'55,50 - 54세,1998,3699,1869,1830
'26710, 기장군,'60,55 - 59세,1998,3827,1725,2102
'26710, 기장군,'65,60 - 64세,1998,3283,1411,1872
'26710, 기장군,'70,65 - 69세,1998,2389,935,1454
'26710, 기장군,'75,70 - 74세,1998,1788,598,1190
'26710, 기장군,'80,75 - 79세,1998,1115,359,756
'26710, 기장군,'85,80 - 84세,1998,597,167,430
'26710, 기장군,'90,85+ ,1998,360,67,293
'2671025000,  기장읍,'00,계,1998,37756,18348,19408
'2671025000,  기장읍,'05,0 - 4세,1998,2924,1531,1393
'2671025000,  기장읍,'10,5 - 9세,1998,2879,1487,1392
'2671025000,  기장읍,'15,10 - 14세,1998,2231,1184,1047
'2671025000,  기장읍,'20,15 - 19세,1998,2865,1426,1439
'2671025000,  기장읍,'25,20 - 24세,1998,2973,1479,1494
'2671025000,  기장읍,'30,25 - 29세,1998,3606,1658,1948
'2671025000,  기장읍,'35,30 - 34세,1998,3818,1864,1954
'2671025000,  기장읍,'40,35 - 39세,1998,3771,1984,1787
'2671025000,  기장읍,'45,40 - 44세,1998,2834,1469,1365
'2671025000,  기장읍,'50,45 - 49세,1998,2100,1056,1044
'2671025000,  기장읍,'55,50 - 54세,1998,1820,868,952
'2671025000,  기장읍,'60,55 - 59세,1998,1864,845,1019
'2671025000,  기장읍,'65,60 - 64세,1998,1457,627,830
'2671025000,  기장읍,'70,65 - 69세,1998,1023,393,630
'2671025000,  기장읍,'75,70 - 74세,1998,718,235,483
'2671025000,  기장읍,'80,75 - 79세,1998,480,150,330
'2671025000,  기장읍,'85,80 - 84세,1998,241,62,179
'2671025000,  기장읍,'90,85+ ,1998,152,30,122
'2671025300,  장안읍,'00,계,1998,11650,5854,5796
'2671025300,  장안읍,'05,0 - 4세,1998,773,422,351
'2671025300,  장안읍,'10,5 - 9세,1998,789,447,342
'2671025300,  장안읍,'15,10 - 14세,1998,662,337,325
'2671025300,  장안읍,'20,15 - 19세,1998,989,500,489
'2671025300,  장안읍,'25,20 - 24세,1998,951,509,442
'2671025300,  장안읍,'30,25 - 29세,1998,996,565,431
'2671025300,  장안읍,'35,30 - 34세,1998,973,542,431
'2671025300,  장안읍,'40,35 - 39세,1998,940,491,449
'2671025300,  장안읍,'45,40 - 44세,1998,901,461,440
'2671025300,  장안읍,'50,45 - 49세,1998,635,311,324
'2671025300,  장안읍,'55,50 - 54세,1998,568,313,255
'2671025300,  장안읍,'60,55 - 59세,1998,633,272,361
'2671025300,  장안읍,'65,60 - 64세,1998,624,263,361
'2671025300,  장안읍,'70,65 - 69세,1998,479,189,290
'2671025300,  장안읍,'75,70 - 74세,1998,343,117,226
'2671025300,  장안읍,'80,75 - 79세,1998,209,67,142
'2671025300,  장안읍,'85,80 - 84세,1998,125,41,84
'2671025300,  장안읍,'90,85+ ,1998,60,7,53
'2671031000,  일광면,'00,계,1998,10799,5335,5464
'2671031000,  일광면,'05,0 - 4세,1998,509,280,229
'2671031000,  일광면,'10,5 - 9세,1998,604,333,271
'2671031000,  일광면,'15,10 - 14세,1998,617,291,326
'2671031000,  일광면,'20,15 - 19세,1998,1054,564,490
'2671031000,  일광면,'25,20 - 24세,1998,1029,550,479
'2671031000,  일광면,'30,25 - 29세,1998,907,490,417
'2671031000,  일광면,'35,30 - 34세,1998,669,378,291
'2671031000,  일광면,'40,35 - 39세,1998,787,392,395
'2671031000,  일광면,'45,40 - 44세,1998,875,442,433
'2671031000,  일광면,'50,45 - 49세,1998,700,350,350
'2671031000,  일광면,'55,50 - 54세,1998,683,342,341
'2671031000,  일광면,'60,55 - 59세,1998,673,311,362
'2671031000,  일광면,'65,60 - 64세,1998,595,262,333
'2671031000,  일광면,'70,65 - 69세,1998,429,158,271
'2671031000,  일광면,'75,70 - 74세,1998,324,109,215
'2671031000,  일광면,'80,75 - 79세,1998,186,58,128
'2671031000,  일광면,'85,80 - 84세,1998,102,19,83
'2671031000,  일광면,'90,85+ ,1998,56,6,50
'2671032000,  정관면,'00,계,1998,8246,4214,4032
'2671032000,  정관면,'05,0 - 4세,1998,622,343,279
'2671032000,  정관면,'10,5 - 9세,1998,691,364,327
'2671032000,  정관면,'15,10 - 14세,1998,702,354,348
'2671032000,  정관면,'20,15 - 19세,1998,576,294,282
'2671032000,  정관면,'25,20 - 24세,1998,573,326,247
'2671032000,  정관면,'30,25 - 29세,1998,710,370,340
'2671032000,  정관면,'35,30 - 34세,1998,800,402,398
'2671032000,  정관면,'40,35 - 39세,1998,881,468,413
'2671032000,  정관면,'45,40 - 44세,1998,657,372,285
'2671032000,  정관면,'50,45 - 49세,1998,408,228,180
'2671032000,  정관면,'55,50 - 54세,1998,336,180,156
'2671032000,  정관면,'60,55 - 59세,1998,327,150,177
'2671032000,  정관면,'65,60 - 64세,1998,307,133,174
'2671032000,  정관면,'70,65 - 69세,1998,220,90,130
'2671032000,  정관면,'75,70 - 74세,1998,216,70,146
'2671032000,  정관면,'80,75 - 79세,1998,120,40,80
'2671032000,  정관면,'85,80 - 84세,1998,60,20,40
'2671032000,  정관면,'90,85+ ,1998,40,10,30
'2671033000,  철마면,'00,계,1998,6005,3100,2905
'2671033000,  철마면,'05,0 - 4세,1998,390,214,176
'2671033000,  철마면,'10,5 - 9세,1998,413,230,183
'2671033000,  철마면,'15,10 - 14세,1998,368,195,173
'2671033000,  철마면,'20,15 - 19세,1998,486,257,229
'2671033000,  철마면,'25,20 - 24세,1998,461,254,207
'2671033000,  철마면,'30,25 - 29세,1998,518,281,237
'2671033000,  철마면,'35,30 - 34세,1998,516,281,235
'2671033000,  철마면,'40,35 - 39세,1998,525,293,232
'2671033000,  철마면,'45,40 - 44세,1998,423,241,182
'2671033000,  철마면,'50,45 - 49세,1998,317,160,157
'2671033000,  철마면,'55,50 - 54세,1998,292,166,126
'2671033000,  철마면,'60,55 - 59세,1998,330,147,183
'2671033000,  철마면,'65,60 - 64세,1998,300,126,174
'2671033000,  철마면,'70,65 - 69세,1998,238,105,133
'2671033000,  철마면,'75,70 - 74세,1998,187,67,120
'2671033000,  철마면,'80,75 - 79세,1998,120,44,76
'2671033000,  철마면,'85,80 - 84세,1998,69,25,44
'2671033000,  철마면,'90,85+ ,1998,52,14,38
'27,대구광역시,'00,계,1998,2493440,1253073,1240367
'27,대구광역시,'05,0 - 4세,1998,174095,93685,80410
'27,대구광역시,'10,5 - 9세,1998,181309,101143,80166
'27,대구광역시,'15,10 - 14세,1998,175559,97195,78364
'27,대구광역시,'20,15 - 19세,1998,231829,120667,111162
'27,대구광역시,'25,20 - 24세,1998,218209,110975,107234
'27,대구광역시,'30,25 - 29세,1998,247889,124031,123858
'27,대구광역시,'35,30 - 34세,1998,231001,116333,114668
'27,대구광역시,'40,35 - 39세,1998,243111,120868,122243
'27,대구광역시,'45,40 - 44세,1998,202685,101547,101138
'27,대구광역시,'50,45 - 49세,1998,152399,75548,76851
'27,대구광역시,'55,50 - 54세,1998,112761,55053,57708
'27,대구광역시,'60,55 - 59세,1998,109145,52069,57076
'27,대구광역시,'65,60 - 64세,1998,82021,37561,44460
'27,대구광역시,'70,65 - 69세,1998,53618,21664,31954
'27,대구광역시,'75,70 - 74세,1998,35897,12974,22923
'27,대구광역시,'80,75 - 79세,1998,22741,7062,15679
'27,대구광역시,'85,80 - 84세,1998,12263,3274,8989
'27,대구광역시,'90,85+ ,1998,6908,1424,5484
'27110, 중구,'00,계,1998,99311,49036,50275
'27110, 중구,'05,0 - 4세,1998,4342,2281,2061
'27110, 중구,'10,5 - 9세,1998,4788,2676,2112
'27110, 중구,'15,10 - 14세,1998,5457,3036,2421
'27110, 중구,'20,15 - 19세,1998,9164,4841,4323
'27110, 중구,'25,20 - 24세,1998,10122,5241,4881
'27110, 중구,'30,25 - 29세,1998,10273,5656,4617
'27110, 중구,'35,30 - 34세,1998,7015,3701,3314
'27110, 중구,'40,35 - 39세,1998,7582,3734,3848
'27110, 중구,'45,40 - 44세,1998,7680,3622,4058
'27110, 중구,'50,45 - 49세,1998,7007,3184,3823
'27110, 중구,'55,50 - 54세,1998,6372,2895,3477
'27110, 중구,'60,55 - 59세,1998,6466,3030,3436
'27110, 중구,'65,60 - 64세,1998,4863,2213,2650
'27110, 중구,'70,65 - 69세,1998,3157,1283,1874
'27110, 중구,'75,70 - 74세,1998,2274,808,1466
'27110, 중구,'80,75 - 79세,1998,1501,495,1006
'27110, 중구,'85,80 - 84세,1998,815,239,576
'27110, 중구,'90,85+ ,1998,433,101,332
'2711051500,  동인1.2.4가동,'00,계,1998,7449,3707,3742
'2711051500,  동인1.2.4가동,'05,0 - 4세,1998,378,192,186
'2711051500,  동인1.2.4가동,'10,5 - 9세,1998,323,195,128
'2711051500,  동인1.2.4가동,'15,10 - 14세,1998,380,191,189
'2711051500,  동인1.2.4가동,'20,15 - 19세,1998,661,337,324
'2711051500,  동인1.2.4가동,'25,20 - 24세,1998,711,379,332
'2711051500,  동인1.2.4가동,'30,25 - 29세,1998,812,464,348
'2711051500,  동인1.2.4가동,'35,30 - 34세,1998,574,316,258
'2711051500,  동인1.2.4가동,'40,35 - 39세,1998,545,276,269
'2711051500,  동인1.2.4가동,'45,40 - 44세,1998,567,251,316
'2711051500,  동인1.2.4가동,'50,45 - 49세,1998,502,237,265
'2711051500,  동인1.2.4가동,'55,50 - 54세,1998,458,212,246
'2711051500,  동인1.2.4가동,'60,55 - 59세,1998,490,220,270
'2711051500,  동인1.2.4가동,'65,60 - 64세,1998,376,176,200
'2711051500,  동인1.2.4가동,'70,65 - 69세,1998,261,113,148
'2711051500,  동인1.2.4가동,'75,70 - 74세,1998,183,65,118
'2711051500,  동인1.2.4가동,'80,75 - 79세,1998,144,51,93
'2711051500,  동인1.2.4가동,'85,80 - 84세,1998,64,26,38
'2711051500,  동인1.2.4가동,'90,85+ ,1998,20,6,14
'2711052000,  동인3가동,'00,계,1998,5487,2783,2704
'2711052000,  동인3가동,'05,0 - 4세,1998,257,140,117
'2711052000,  동인3가동,'10,5 - 9세,1998,286,161,125
'2711052000,  동인3가동,'15,10 - 14세,1998,303,161,142
'2711052000,  동인3가동,'20,15 - 19세,1998,498,281,217
'2711052000,  동인3가동,'25,20 - 24세,1998,545,286,259
'2711052000,  동인3가동,'30,25 - 29세,1998,613,341,272
'2711052000,  동인3가동,'35,30 - 34세,1998,417,233,184
'2711052000,  동인3가동,'40,35 - 39세,1998,427,216,211
'2711052000,  동인3가동,'45,40 - 44세,1998,393,193,200
'2711052000,  동인3가동,'50,45 - 49세,1998,375,173,202
'2711052000,  동인3가동,'55,50 - 54세,1998,345,147,198
'2711052000,  동인3가동,'60,55 - 59세,1998,355,162,193
'2711052000,  동인3가동,'65,60 - 64세,1998,295,146,149
'2711052000,  동인3가동,'70,65 - 69세,1998,166,64,102
'2711052000,  동인3가동,'75,70 - 74세,1998,95,36,59
'2711052000,  동인3가동,'80,75 - 79세,1998,66,28,38
'2711052000,  동인3가동,'85,80 - 84세,1998,35,10,25
'2711052000,  동인3가동,'90,85+ ,1998,16,5,11
'2711054500,  삼덕동,'00,계,1998,6208,3027,3181
'2711054500,  삼덕동,'05,0 - 4세,1998,262,139,123
'2711054500,  삼덕동,'10,5 - 9세,1998,271,150,121
'2711054500,  삼덕동,'15,10 - 14세,1998,337,188,149
'2711054500,  삼덕동,'20,15 - 19세,1998,564,293,271
'2711054500,  삼덕동,'25,20 - 24세,1998,674,323,351
'2711054500,  삼덕동,'30,25 - 29세,1998,677,375,302
'2711054500,  삼덕동,'35,30 - 34세,1998,453,246,207
'2711054500,  삼덕동,'40,35 - 39세,1998,407,199,208
'2711054500,  삼덕동,'45,40 - 44세,1998,456,209,247
'2711054500,  삼덕동,'50,45 - 49세,1998,456,188,268
'2711054500,  삼덕동,'55,50 - 54세,1998,388,178,210
'2711054500,  삼덕동,'60,55 - 59세,1998,407,201,206
'2711054500,  삼덕동,'65,60 - 64세,1998,297,137,160
'2711054500,  삼덕동,'70,65 - 69세,1998,205,89,116
'2711054500,  삼덕동,'75,70 - 74세,1998,157,51,106
'2711054500,  삼덕동,'80,75 - 79세,1998,88,35,53
'2711054500,  삼덕동,'85,80 - 84세,1998,73,20,53
'2711054500,  삼덕동,'90,85+ ,1998,36,6,30
'2711056500,  성내1동,'00,계,1998,6169,3037,3132
'2711056500,  성내1동,'05,0 - 4세,1998,257,150,107
'2711056500,  성내1동,'10,5 - 9세,1998,283,147,136
'2711056500,  성내1동,'15,10 - 14세,1998,346,201,145
'2711056500,  성내1동,'20,15 - 19세,1998,546,295,251
'2711056500,  성내1동,'25,20 - 24세,1998,574,302,272
'2711056500,  성내1동,'30,25 - 29세,1998,627,328,299
'2711056500,  성내1동,'35,30 - 34세,1998,432,247,185
'2711056500,  성내1동,'40,35 - 39세,1998,482,210,272
'2711056500,  성내1동,'45,40 - 44세,1998,528,257,271
'2711056500,  성내1동,'50,45 - 49세,1998,426,200,226
'2711056500,  성내1동,'55,50 - 54세,1998,411,183,228
'2711056500,  성내1동,'60,55 - 59세,1998,378,171,207
'2711056500,  성내1동,'65,60 - 64세,1998,283,128,155
'2711056500,  성내1동,'70,65 - 69세,1998,214,78,136
'2711056500,  성내1동,'75,70 - 74세,1998,199,70,129
'2711056500,  성내1동,'80,75 - 79세,1998,101,45,56
'2711056500,  성내1동,'85,80 - 84세,1998,50,17,33
'2711056500,  성내1동,'90,85+ ,1998,32,8,24
'2711057500,  성내2동,'00,계,1998,7539,3813,3726
'2711057500,  성내2동,'05,0 - 4세,1998,314,186,128
'2711057500,  성내2동,'10,5 - 9세,1998,364,211,153
'2711057500,  성내2동,'15,10 - 14세,1998,399,221,178
'2711057500,  성내2동,'20,15 - 19세,1998,627,346,281
'2711057500,  성내2동,'25,20 - 24세,1998,750,395,355
'2711057500,  성내2동,'30,25 - 29세,1998,761,441,320
'2711057500,  성내2동,'35,30 - 34세,1998,486,256,230
'2711057500,  성내2동,'40,35 - 39세,1998,579,287,292
'2711057500,  성내2동,'45,40 - 44세,1998,593,288,305
'2711057500,  성내2동,'50,45 - 49세,1998,562,247,315
'2711057500,  성내2동,'55,50 - 54세,1998,539,269,270
'2711057500,  성내2동,'60,55 - 59세,1998,503,237,266
'2711057500,  성내2동,'65,60 - 64세,1998,396,186,210
'2711057500,  성내2동,'70,65 - 69세,1998,239,96,143
'2711057500,  성내2동,'75,70 - 74세,1998,177,67,110
'2711057500,  성내2동,'80,75 - 79세,1998,126,44,82
'2711057500,  성내2동,'85,80 - 84세,1998,80,23,57
'2711057500,  성내2동,'90,85+ ,1998,44,13,31
'2711058500,  성내3동,'00,계,1998,6726,3373,3353
'2711058500,  성내3동,'05,0 - 4세,1998,244,121,123
'2711058500,  성내3동,'10,5 - 9세,1998,310,184,126
'2711058500,  성내3동,'15,10 - 14세,1998,418,255,163
'2711058500,  성내3동,'20,15 - 19세,1998,583,316,267
'2711058500,  성내3동,'25,20 - 24세,1998,702,362,340
'2711058500,  성내3동,'30,25 - 29세,1998,666,377,289
'2711058500,  성내3동,'35,30 - 34세,1998,439,220,219
'2711058500,  성내3동,'40,35 - 39세,1998,545,276,269
'2711058500,  성내3동,'45,40 - 44세,1998,525,249,276
'2711058500,  성내3동,'50,45 - 49세,1998,494,232,262
'2711058500,  성내3동,'55,50 - 54세,1998,438,207,231
'2711058500,  성내3동,'60,55 - 59세,1998,448,204,244
'2711058500,  성내3동,'65,60 - 64세,1998,365,164,201
'2711058500,  성내3동,'70,65 - 69세,1998,205,94,111
'2711058500,  성내3동,'75,70 - 74세,1998,160,55,105
'2711058500,  성내3동,'80,75 - 79세,1998,107,37,70
'2711058500,  성내3동,'85,80 - 84세,1998,47,13,34
'2711058500,  성내3동,'90,85+ ,1998,30,7,23
'2711059500,  대신동,'00,계,1998,8483,4258,4225
'2711059500,  대신동,'05,0 - 4세,1998,290,140,150
'2711059500,  대신동,'10,5 - 9세,1998,416,238,178
'2711059500,  대신동,'15,10 - 14세,1998,541,307,234
'2711059500,  대신동,'20,15 - 19세,1998,826,439,387
'2711059500,  대신동,'25,20 - 24세,1998,876,466,410
'2711059500,  대신동,'30,25 - 29세,1998,792,468,324
'2711059500,  대신동,'35,30 - 34세,1998,558,295,263
'2711059500,  대신동,'40,35 - 39세,1998,664,329,335
'2711059500,  대신동,'45,40 - 44세,1998,705,355,350
'2711059500,  대신동,'50,45 - 49세,1998,596,286,310
'2711059500,  대신동,'55,50 - 54세,1998,571,253,318
'2711059500,  대신동,'60,55 - 59세,1998,544,266,278
'2711059500,  대신동,'65,60 - 64세,1998,415,185,230
'2711059500,  대신동,'70,65 - 69세,1998,277,103,174
'2711059500,  대신동,'75,70 - 74세,1998,178,63,115
'2711059500,  대신동,'80,75 - 79세,1998,133,35,98
'2711059500,  대신동,'85,80 - 84세,1998,69,23,46
'2711059500,  대신동,'90,85+ ,1998,32,7,25
'2711064000,  남산1동,'00,계,1998,7045,3460,3585
'2711064000,  남산1동,'05,0 - 4세,1998,292,160,132
'2711064000,  남산1동,'10,5 - 9세,1998,333,188,145
'2711064000,  남산1동,'15,10 - 14세,1998,348,188,160
'2711064000,  남산1동,'20,15 - 19세,1998,697,357,340
'2711064000,  남산1동,'25,20 - 24세,1998,732,404,328
'2711064000,  남산1동,'30,25 - 29세,1998,666,384,282
'2711064000,  남산1동,'35,30 - 34세,1998,473,240,233
'2711064000,  남산1동,'40,35 - 39세,1998,578,282,296
'2711064000,  남산1동,'45,40 - 44세,1998,570,257,313
'2711064000,  남산1동,'50,45 - 49세,1998,509,240,269
'2711064000,  남산1동,'55,50 - 54세,1998,444,195,249
'2711064000,  남산1동,'60,55 - 59세,1998,482,216,266
'2711064000,  남산1동,'65,60 - 64세,1998,364,156,208
'2711064000,  남산1동,'70,65 - 69세,1998,226,92,134
'2711064000,  남산1동,'75,70 - 74세,1998,148,47,101
'2711064000,  남산1동,'80,75 - 79세,1998,93,31,62
'2711064000,  남산1동,'85,80 - 84세,1998,60,14,46
'2711064000,  남산1동,'90,85+ ,1998,30,9,21
'2711065000,  남산2동,'00,계,1998,6433,3117,3316
'2711065000,  남산2동,'05,0 - 4세,1998,276,137,139
'2711065000,  남산2동,'10,5 - 9세,1998,282,157,125
'2711065000,  남산2동,'15,10 - 14세,1998,368,198,170
'2711065000,  남산2동,'20,15 - 19세,1998,583,293,290
'2711065000,  남산2동,'25,20 - 24세,1998,628,319,309
'2711065000,  남산2동,'30,25 - 29세,1998,647,364,283
'2711065000,  남산2동,'35,30 - 34세,1998,429,211,218
'2711065000,  남산2동,'40,35 - 39세,1998,501,262,239
'2711065000,  남산2동,'45,40 - 44세,1998,475,230,245
'2711065000,  남산2동,'50,45 - 49세,1998,465,207,258
'2711065000,  남산2동,'55,50 - 54세,1998,437,193,244
'2711065000,  남산2동,'60,55 - 59세,1998,434,201,233
'2711065000,  남산2동,'65,60 - 64세,1998,298,124,174
'2711065000,  남산2동,'70,65 - 69세,1998,221,90,131
'2711065000,  남산2동,'75,70 - 74세,1998,171,65,106
'2711065000,  남산2동,'80,75 - 79세,1998,129,41,88
'2711065000,  남산2동,'85,80 - 84세,1998,53,16,37
'2711065000,  남산2동,'90,85+ ,1998,36,9,27
'2711066000,  남산3동,'00,계,1998,8762,4213,4549
'2711066000,  남산3동,'05,0 - 4세,1998,461,238,223
'2711066000,  남산3동,'10,5 - 9세,1998,466,250,216
'2711066000,  남산3동,'15,10 - 14세,1998,471,259,212
'2711066000,  남산3동,'20,15 - 19세,1998,812,436,376
'2711066000,  남산3동,'25,20 - 24세,1998,871,406,465
'2711066000,  남산3동,'30,25 - 29세,1998,990,502,488
'2711066000,  남산3동,'35,30 - 34세,1998,685,354,331
'2711066000,  남산3동,'40,35 - 39세,1998,684,341,343
'2711066000,  남산3동,'45,40 - 44세,1998,687,296,391
'2711066000,  남산3동,'50,45 - 49세,1998,622,273,349
'2711066000,  남산3동,'55,50 - 54세,1998,517,243,274
'2711066000,  남산3동,'60,55 - 59세,1998,531,264,267
'2711066000,  남산3동,'65,60 - 64세,1998,364,170,194
'2711066000,  남산3동,'70,65 - 69세,1998,234,88,146
'2711066000,  남산3동,'75,70 - 74세,1998,157,45,112
'2711066000,  남산3동,'80,75 - 79세,1998,108,26,82
'2711066000,  남산3동,'85,80 - 84세,1998,73,18,55
'2711066000,  남산3동,'90,85+ ,1998,29,4,25
'2711067000,  남산4동,'00,계,1998,15212,7513,7699
'2711067000,  남산4동,'05,0 - 4세,1998,697,351,346
'2711067000,  남산4동,'10,5 - 9세,1998,838,447,391
'2711067000,  남산4동,'15,10 - 14세,1998,886,504,382
'2711067000,  남산4동,'20,15 - 19세,1998,1580,848,732
'2711067000,  남산4동,'25,20 - 24세,1998,1626,854,772
'2711067000,  남산4동,'30,25 - 29세,1998,1531,805,726
'2711067000,  남산4동,'35,30 - 34세,1998,1100,572,528
'2711067000,  남산4동,'40,35 - 39세,1998,1199,578,621
'2711067000,  남산4동,'45,40 - 44세,1998,1175,571,604
'2711067000,  남산4동,'50,45 - 49세,1998,1062,502,560
'2711067000,  남산4동,'55,50 - 54세,1998,859,407,452
'2711067000,  남산4동,'60,55 - 59세,1998,899,430,469
'2711067000,  남산4동,'65,60 - 64세,1998,648,273,375
'2711067000,  남산4동,'70,65 - 69세,1998,424,163,261
'2711067000,  남산4동,'75,70 - 74세,1998,326,112,214
'2711067000,  남산4동,'80,75 - 79세,1998,203,63,140
'2711067000,  남산4동,'85,80 - 84세,1998,102,24,78
'2711067000,  남산4동,'90,85+ ,1998,57,9,48
'2711068000,  대봉1동,'00,계,1998,7545,3679,3866
'2711068000,  대봉1동,'05,0 - 4세,1998,363,197,166
'2711068000,  대봉1동,'10,5 - 9세,1998,333,183,150
'2711068000,  대봉1동,'15,10 - 14세,1998,354,198,156
'2711068000,  대봉1동,'20,15 - 19세,1998,590,299,291
'2711068000,  대봉1동,'25,20 - 24세,1998,773,416,357
'2711068000,  대봉1동,'30,25 - 29세,1998,837,434,403
'2711068000,  대봉1동,'35,30 - 34세,1998,526,280,246
'2711068000,  대봉1동,'40,35 - 39세,1998,526,255,271
'2711068000,  대봉1동,'45,40 - 44세,1998,488,234,254
'2711068000,  대봉1동,'50,45 - 49세,1998,516,209,307
'2711068000,  대봉1동,'55,50 - 54세,1998,507,208,299
'2711068000,  대봉1동,'60,55 - 59세,1998,571,257,314
'2711068000,  대봉1동,'65,60 - 64세,1998,455,226,229
'2711068000,  대봉1동,'70,65 - 69세,1998,299,132,167
'2711068000,  대봉1동,'75,70 - 74세,1998,190,77,113
'2711068000,  대봉1동,'80,75 - 79세,1998,107,38,69
'2711068000,  대봉1동,'85,80 - 84세,1998,64,23,41
'2711068000,  대봉1동,'90,85+ ,1998,46,13,33
'2711069000,  대봉2동,'00,계,1998,6253,3056,3197
'2711069000,  대봉2동,'05,0 - 4세,1998,251,130,121
'2711069000,  대봉2동,'10,5 - 9세,1998,283,165,118
'2711069000,  대봉2동,'15,10 - 14세,1998,306,165,141
'2711069000,  대봉2동,'20,15 - 19세,1998,597,301,296
'2711069000,  대봉2동,'25,20 - 24세,1998,660,329,331
'2711069000,  대봉2동,'30,25 - 29세,1998,654,373,281
'2711069000,  대봉2동,'35,30 - 34세,1998,443,231,212
'2711069000,  대봉2동,'40,35 - 39세,1998,445,223,222
'2711069000,  대봉2동,'45,40 - 44세,1998,518,232,286
'2711069000,  대봉2동,'50,45 - 49세,1998,422,190,232
'2711069000,  대봉2동,'55,50 - 54세,1998,458,200,258
'2711069000,  대봉2동,'60,55 - 59세,1998,424,201,223
'2711069000,  대봉2동,'65,60 - 64세,1998,307,142,165
'2711069000,  대봉2동,'70,65 - 69세,1998,186,81,105
'2711069000,  대봉2동,'75,70 - 74세,1998,133,55,78
'2711069000,  대봉2동,'80,75 - 79세,1998,96,21,75
'2711069000,  대봉2동,'85,80 - 84세,1998,45,12,33
'2711069000,  대봉2동,'90,85+ ,1998,25,5,20
'27140, 동구,'00,계,1998,342458,172575,169883
'27140, 동구,'05,0 - 4세,1998,23524,12601,10923
'27140, 동구,'10,5 - 9세,1998,22981,12778,10203
'27140, 동구,'15,10 - 14세,1998,20337,11054,9283
'27140, 동구,'20,15 - 19세,1998,29758,15468,14290
'27140, 동구,'25,20 - 24세,1998,31465,16262,15203
'27140, 동구,'30,25 - 29세,1998,36948,19093,17855
'27140, 동구,'35,30 - 34세,1998,31809,16482,15327
'27140, 동구,'40,35 - 39세,1998,30943,15859,15084
'27140, 동구,'45,40 - 44세,1998,25586,12789,12797
'27140, 동구,'50,45 - 49세,1998,20801,9986,10815
'27140, 동구,'55,50 - 54세,1998,17126,8030,9096
'27140, 동구,'60,55 - 59세,1998,17837,8465,9372
'27140, 동구,'65,60 - 64세,1998,13411,6308,7103
'27140, 동구,'70,65 - 69세,1998,8308,3556,4752
'27140, 동구,'75,70 - 74세,1998,5383,2018,3365
'27140, 동구,'80,75 - 79세,1998,3409,1090,2319
'27140, 동구,'85,80 - 84세,1998,1792,512,1280
'27140, 동구,'90,85+ ,1998,1040,224,816
'2714051000,  신암1동,'00,계,1998,18299,9114,9185
'2714051000,  신암1동,'05,0 - 4세,1998,1001,515,486
'2714051000,  신암1동,'10,5 - 9세,1998,1010,544,466
'2714051000,  신암1동,'15,10 - 14세,1998,1059,588,471
'2714051000,  신암1동,'20,15 - 19세,1998,1681,857,824
'2714051000,  신암1동,'25,20 - 24세,1998,2041,1027,1014
'2714051000,  신암1동,'30,25 - 29세,1998,2134,1192,942
'2714051000,  신암1동,'35,30 - 34세,1998,1520,804,716
'2714051000,  신암1동,'40,35 - 39세,1998,1454,734,720
'2714051000,  신암1동,'45,40 - 44세,1998,1305,615,690
'2714051000,  신암1동,'50,45 - 49세,1998,1150,537,613
'2714051000,  신암1동,'55,50 - 54세,1998,968,450,518
'2714051000,  신암1동,'60,55 - 59세,1998,1102,486,616
'2714051000,  신암1동,'65,60 - 64세,1998,795,377,418
'2714051000,  신암1동,'70,65 - 69세,1998,482,220,262
'2714051000,  신암1동,'75,70 - 74세,1998,279,92,187
'2714051000,  신암1동,'80,75 - 79세,1998,166,41,125
'2714051000,  신암1동,'85,80 - 84세,1998,101,24,77
'2714051000,  신암1동,'90,85+ ,1998,51,11,40
'2714052000,  신암2동,'00,계,1998,13304,6628,6676
'2714052000,  신암2동,'05,0 - 4세,1998,917,504,413
'2714052000,  신암2동,'10,5 - 9세,1998,762,412,350
'2714052000,  신암2동,'15,10 - 14세,1998,666,362,304
'2714052000,  신암2동,'20,15 - 19세,1998,1210,631,579
'2714052000,  신암2동,'25,20 - 24세,1998,1321,684,637
'2714052000,  신암2동,'30,25 - 29세,1998,1638,827,811
'2714052000,  신암2동,'35,30 - 34세,1998,1247,680,567
'2714052000,  신암2동,'40,35 - 39세,1998,1077,561,516
'2714052000,  신암2동,'45,40 - 44세,1998,912,451,461
'2714052000,  신암2동,'50,45 - 49세,1998,817,358,459
'2714052000,  신암2동,'55,50 - 54세,1998,672,307,365
'2714052000,  신암2동,'60,55 - 59세,1998,737,347,390
'2714052000,  신암2동,'65,60 - 64세,1998,511,240,271
'2714052000,  신암2동,'70,65 - 69세,1998,339,135,204
'2714052000,  신암2동,'75,70 - 74세,1998,240,75,165
'2714052000,  신암2동,'80,75 - 79세,1998,132,30,102
'2714052000,  신암2동,'85,80 - 84세,1998,77,18,59
'2714052000,  신암2동,'90,85+ ,1998,29,6,23
'2714053000,  신암3동,'00,계,1998,13524,6768,6756
'2714053000,  신암3동,'05,0 - 4세,1998,701,361,340
'2714053000,  신암3동,'10,5 - 9세,1998,771,412,359
'2714053000,  신암3동,'15,10 - 14세,1998,784,428,356
'2714053000,  신암3동,'20,15 - 19세,1998,1252,655,597
'2714053000,  신암3동,'25,20 - 24세,1998,1431,764,667
'2714053000,  신암3동,'30,25 - 29세,1998,1423,805,618
'2714053000,  신암3동,'35,30 - 34세,1998,1068,549,519
'2714053000,  신암3동,'40,35 - 39세,1998,1059,509,550
'2714053000,  신암3동,'45,40 - 44세,1998,1084,509,575
'2714053000,  신암3동,'50,45 - 49세,1998,906,423,483
'2714053000,  신암3동,'55,50 - 54세,1998,806,372,434
'2714053000,  신암3동,'60,55 - 59세,1998,815,383,432
'2714053000,  신암3동,'65,60 - 64세,1998,580,267,313
'2714053000,  신암3동,'70,65 - 69세,1998,360,162,198
'2714053000,  신암3동,'75,70 - 74세,1998,227,90,137
'2714053000,  신암3동,'80,75 - 79세,1998,140,48,92
'2714053000,  신암3동,'85,80 - 84세,1998,80,27,53
'2714053000,  신암3동,'90,85+ ,1998,37,4,33
'2714054000,  신암4동,'00,계,1998,21585,10755,10830
'2714054000,  신암4동,'05,0 - 4세,1998,1285,664,621
'2714054000,  신암4동,'10,5 - 9세,1998,1176,638,538
'2714054000,  신암4동,'15,10 - 14세,1998,1180,645,535
'2714054000,  신암4동,'20,15 - 19세,1998,1972,1071,901
'2714054000,  신암4동,'25,20 - 24세,1998,2252,1116,1136
'2714054000,  신암4동,'30,25 - 29세,1998,2535,1363,1172
'2714054000,  신암4동,'35,30 - 34세,1998,1765,948,817
'2714054000,  신암4동,'40,35 - 39세,1998,1779,836,943
'2714054000,  신암4동,'45,40 - 44세,1998,1671,794,877
'2714054000,  신암4동,'50,45 - 49세,1998,1359,612,747
'2714054000,  신암4동,'55,50 - 54세,1998,1276,589,687
'2714054000,  신암4동,'60,55 - 59세,1998,1267,576,691
'2714054000,  신암4동,'65,60 - 64세,1998,851,432,419
'2714054000,  신암4동,'70,65 - 69세,1998,549,232,317
'2714054000,  신암4동,'75,70 - 74세,1998,302,127,175
'2714054000,  신암4동,'80,75 - 79세,1998,198,66,132
'2714054000,  신암4동,'85,80 - 84세,1998,108,35,73
'2714054000,  신암4동,'90,85+ ,1998,60,11,49
'2714054100,  신암5동,'00,계,1998,12916,6465,6451
'2714054100,  신암5동,'05,0 - 4세,1998,902,487,415
'2714054100,  신암5동,'10,5 - 9세,1998,876,514,362
'2714054100,  신암5동,'15,10 - 14세,1998,858,469,389
'2714054100,  신암5동,'20,15 - 19세,1998,1168,565,603
'2714054100,  신암5동,'25,20 - 24세,1998,1144,607,537
'2714054100,  신암5동,'30,25 - 29세,1998,1411,703,708
'2714054100,  신암5동,'35,30 - 34세,1998,1221,624,597
'2714054100,  신암5동,'40,35 - 39세,1998,1248,605,643
'2714054100,  신암5동,'45,40 - 44세,1998,997,483,514
'2714054100,  신암5동,'50,45 - 49세,1998,737,371,366
'2714054100,  신암5동,'55,50 - 54세,1998,634,295,339
'2714054100,  신암5동,'60,55 - 59세,1998,634,285,349
'2714054100,  신암5동,'65,60 - 64세,1998,461,229,232
'2714054100,  신암5동,'70,65 - 69세,1998,260,115,145
'2714054100,  신암5동,'75,70 - 74세,1998,156,62,94
'2714054100,  신암5동,'80,75 - 79세,1998,121,37,84
'2714054100,  신암5동,'85,80 - 84세,1998,64,7,57
'2714054100,  신암5동,'90,85+ ,1998,24,7,17
'2714055500,  신천1.2동,'00,계,1998,18412,9185,9227
'2714055500,  신천1.2동,'05,0 - 4세,1998,1192,624,568
'2714055500,  신천1.2동,'10,5 - 9세,1998,1116,615,501
'2714055500,  신천1.2동,'15,10 - 14세,1998,986,548,438
'2714055500,  신천1.2동,'20,15 - 19세,1998,1589,866,723
'2714055500,  신천1.2동,'25,20 - 24세,1998,1618,832,786
'2714055500,  신천1.2동,'30,25 - 29세,1998,2043,1046,997
'2714055500,  신천1.2동,'35,30 - 34세,1998,1692,903,789
'2714055500,  신천1.2동,'40,35 - 39세,1998,1568,807,761
'2714055500,  신천1.2동,'45,40 - 44세,1998,1404,681,723
'2714055500,  신천1.2동,'50,45 - 49세,1998,1162,566,596
'2714055500,  신천1.2동,'55,50 - 54세,1998,979,417,562
'2714055500,  신천1.2동,'60,55 - 59세,1998,1007,458,549
'2714055500,  신천1.2동,'65,60 - 64세,1998,840,373,467
'2714055500,  신천1.2동,'70,65 - 69세,1998,529,228,301
'2714055500,  신천1.2동,'75,70 - 74세,1998,310,125,185
'2714055500,  신천1.2동,'80,75 - 79세,1998,198,52,146
'2714055500,  신천1.2동,'85,80 - 84세,1998,108,31,77
'2714055500,  신천1.2동,'90,85+ ,1998,71,13,58
'2714057000,  신천3동,'00,계,1998,13394,6737,6657
'2714057000,  신천3동,'05,0 - 4세,1998,714,374,340
'2714057000,  신천3동,'10,5 - 9세,1998,726,406,320
'2714057000,  신천3동,'15,10 - 14세,1998,788,414,374
'2714057000,  신천3동,'20,15 - 19세,1998,1212,655,557
'2714057000,  신천3동,'25,20 - 24세,1998,1317,646,671
'2714057000,  신천3동,'30,25 - 29세,1998,1413,770,643
'2714057000,  신천3동,'35,30 - 34세,1998,1118,610,508
'2714057000,  신천3동,'40,35 - 39세,1998,1100,559,541
'2714057000,  신천3동,'45,40 - 44세,1998,1026,503,523
'2714057000,  신천3동,'50,45 - 49세,1998,914,441,473
'2714057000,  신천3동,'55,50 - 54세,1998,765,346,419
'2714057000,  신천3동,'60,55 - 59세,1998,836,397,439
'2714057000,  신천3동,'65,60 - 64세,1998,590,286,304
'2714057000,  신천3동,'70,65 - 69세,1998,370,164,206
'2714057000,  신천3동,'75,70 - 74세,1998,243,85,158
'2714057000,  신천3동,'80,75 - 79세,1998,145,50,95
'2714057000,  신천3동,'85,80 - 84세,1998,72,22,50
'2714057000,  신천3동,'90,85+ ,1998,45,9,36
'2714058000,  신천4동,'00,계,1998,13235,6549,6686
'2714058000,  신천4동,'05,0 - 4세,1998,794,404,390
'2714058000,  신천4동,'10,5 - 9세,1998,709,380,329
'2714058000,  신천4동,'15,10 - 14세,1998,656,389,267
'2714058000,  신천4동,'20,15 - 19세,1998,1153,594,559
'2714058000,  신천4동,'25,20 - 24세,1998,1521,754,767
'2714058000,  신천4동,'30,25 - 29세,1998,1577,816,761
'2714058000,  신천4동,'35,30 - 34세,1998,1109,568,541
'2714058000,  신천4동,'40,35 - 39세,1998,996,500,496
'2714058000,  신천4동,'45,40 - 44세,1998,966,447,519
'2714058000,  신천4동,'50,45 - 49세,1998,927,429,498
'2714058000,  신천4동,'55,50 - 54세,1998,740,325,415
'2714058000,  신천4동,'60,55 - 59세,1998,739,363,376
'2714058000,  신천4동,'65,60 - 64세,1998,566,283,283
'2714058000,  신천4동,'70,65 - 69세,1998,332,148,184
'2714058000,  신천4동,'75,70 - 74세,1998,203,74,129
'2714058000,  신천4동,'80,75 - 79세,1998,120,44,76
'2714058000,  신천4동,'85,80 - 84세,1998,75,15,60
'2714058000,  신천4동,'90,85+ ,1998,52,16,36
'2714059000,  효목1동,'00,계,1998,23247,11775,11472
'2714059000,  효목1동,'05,0 - 4세,1998,1665,888,777
'2714059000,  효목1동,'10,5 - 9세,1998,1484,823,661
'2714059000,  효목1동,'15,10 - 14세,1998,1324,729,595
'2714059000,  효목1동,'20,15 - 19세,1998,2017,1044,973
'2714059000,  효목1동,'25,20 - 24세,1998,2234,1188,1046
'2714059000,  효목1동,'30,25 - 29세,1998,2505,1314,1191
'2714059000,  효목1동,'35,30 - 34세,1998,2161,1108,1053
'2714059000,  효목1동,'40,35 - 39세,1998,2110,1115,995
'2714059000,  효목1동,'45,40 - 44세,1998,1695,817,878
'2714059000,  효목1동,'50,45 - 49세,1998,1460,694,766
'2714059000,  효목1동,'55,50 - 54세,1998,1244,594,650
'2714059000,  효목1동,'60,55 - 59세,1998,1186,594,592
'2714059000,  효목1동,'65,60 - 64세,1998,939,416,523
'2714059000,  효목1동,'70,65 - 69세,1998,538,242,296
'2714059000,  효목1동,'75,70 - 74세,1998,311,106,205
'2714059000,  효목1동,'80,75 - 79세,1998,201,61,140
'2714059000,  효목1동,'85,80 - 84세,1998,102,30,72
'2714059000,  효목1동,'90,85+ ,1998,71,12,59
'2714060000,  효목2동,'00,계,1998,17028,8586,8442
'2714060000,  효목2동,'05,0 - 4세,1998,959,519,440
'2714060000,  효목2동,'10,5 - 9세,1998,961,542,419
'2714060000,  효목2동,'15,10 - 14세,1998,931,493,438
'2714060000,  효목2동,'20,15 - 19세,1998,1592,845,747
'2714060000,  효목2동,'25,20 - 24세,1998,1940,1005,935
'2714060000,  효목2동,'30,25 - 29세,1998,1962,1058,904
'2714060000,  효목2동,'35,30 - 34세,1998,1297,699,598
'2714060000,  효목2동,'40,35 - 39세,1998,1366,688,678
'2714060000,  효목2동,'45,40 - 44세,1998,1298,602,696
'2714060000,  효목2동,'50,45 - 49세,1998,1213,529,684
'2714060000,  효목2동,'55,50 - 54세,1998,945,445,500
'2714060000,  효목2동,'60,55 - 59세,1998,985,482,503
'2714060000,  효목2동,'65,60 - 64세,1998,647,339,308
'2714060000,  효목2동,'70,65 - 69세,1998,393,164,229
'2714060000,  효목2동,'75,70 - 74세,1998,257,97,160
'2714060000,  효목2동,'80,75 - 79세,1998,155,49,106
'2714060000,  효목2동,'85,80 - 84세,1998,73,17,56
'2714060000,  효목2동,'90,85+ ,1998,54,13,41
'2714061500,  도평동,'00,계,1998,7909,4079,3830
'2714061500,  도평동,'05,0 - 4세,1998,705,386,319
'2714061500,  도평동,'10,5 - 9세,1998,625,343,282
'2714061500,  도평동,'15,10 - 14세,1998,534,292,242
'2714061500,  도평동,'20,15 - 19세,1998,569,295,274
'2714061500,  도평동,'25,20 - 24세,1998,622,316,306
'2714061500,  도평동,'30,25 - 29세,1998,998,528,470
'2714061500,  도평동,'35,30 - 34세,1998,810,422,388
'2714061500,  도평동,'40,35 - 39세,1998,759,404,355
'2714061500,  도평동,'45,40 - 44세,1998,532,290,242
'2714061500,  도평동,'50,45 - 49세,1998,385,190,195
'2714061500,  도평동,'55,50 - 54세,1998,299,144,155
'2714061500,  도평동,'60,55 - 59세,1998,327,150,177
'2714061500,  도평동,'65,60 - 64세,1998,295,145,150
'2714061500,  도평동,'70,65 - 69세,1998,171,72,99
'2714061500,  도평동,'75,70 - 74세,1998,114,48,66
'2714061500,  도평동,'80,75 - 79세,1998,94,36,58
'2714061500,  도평동,'85,80 - 84세,1998,45,13,32
'2714061500,  도평동,'90,85+ ,1998,25,5,20
'2714062000,  불로·봉무동,'00,계,1998,17350,8924,8426
'2714062000,  불로·봉무동,'05,0 - 4세,1998,1290,714,576
'2714062000,  불로·봉무동,'10,5 - 9세,1998,1330,772,558
'2714062000,  불로·봉무동,'15,10 - 14세,1998,1176,657,519
'2714062000,  불로·봉무동,'20,15 - 19세,1998,1467,778,689
'2714062000,  불로·봉무동,'25,20 - 24세,1998,1359,728,631
'2714062000,  불로·봉무동,'30,25 - 29세,1998,1720,856,864
'2714062000,  불로·봉무동,'35,30 - 34세,1998,1710,909,801
'2714062000,  불로·봉무동,'40,35 - 39세,1998,1760,877,883
'2714062000,  불로·봉무동,'45,40 - 44세,1998,1421,743,678
'2714062000,  불로·봉무동,'50,45 - 49세,1998,984,498,486
'2714062000,  불로·봉무동,'55,50 - 54세,1998,731,355,376
'2714062000,  불로·봉무동,'60,55 - 59세,1998,785,372,413
'2714062000,  불로·봉무동,'65,60 - 64세,1998,632,299,333
'2714062000,  불로·봉무동,'70,65 - 69세,1998,374,164,210
'2714062000,  불로·봉무동,'75,70 - 74세,1998,278,100,178
'2714062000,  불로·봉무동,'80,75 - 79세,1998,191,61,130
'2714062000,  불로·봉무동,'85,80 - 84세,1998,91,33,58
'2714062000,  불로·봉무동,'90,85+ ,1998,51,8,43
'2714064000,  지저동,'00,계,1998,13953,7076,6877
'2714064000,  지저동,'05,0 - 4세,1998,1112,604,508
'2714064000,  지저동,'10,5 - 9세,1998,962,515,447
'2714064000,  지저동,'15,10 - 14세,1998,841,474,367
'2714064000,  지저동,'20,15 - 19세,1998,1209,642,567
'2714064000,  지저동,'25,20 - 24세,1998,1151,595,556
'2714064000,  지저동,'30,25 - 29세,1998,1492,764,728
'2714064000,  지저동,'35,30 - 34세,1998,1455,755,700
'2714064000,  지저동,'40,35 - 39세,1998,1312,657,655
'2714064000,  지저동,'45,40 - 44세,1998,1045,546,499
'2714064000,  지저동,'50,45 - 49세,1998,780,378,402
'2714064000,  지저동,'55,50 - 54세,1998,617,286,331
'2714064000,  지저동,'60,55 - 59세,1998,727,339,388
'2714064000,  지저동,'65,60 - 64세,1998,522,248,274
'2714064000,  지저동,'70,65 - 69세,1998,325,126,199
'2714064000,  지저동,'75,70 - 74세,1998,199,84,115
'2714064000,  지저동,'80,75 - 79세,1998,109,42,67
'2714064000,  지저동,'85,80 - 84세,1998,59,17,42
'2714064000,  지저동,'90,85+ ,1998,36,4,32
'2714065500,  동촌동,'00,계,1998,15561,7845,7716
'2714065500,  동촌동,'05,0 - 4세,1998,964,511,453
'2714065500,  동촌동,'10,5 - 9세,1998,966,523,443
'2714065500,  동촌동,'15,10 - 14세,1998,948,508,440
'2714065500,  동촌동,'20,15 - 19세,1998,1417,724,693
'2714065500,  동촌동,'25,20 - 24세,1998,1495,785,710
'2714065500,  동촌동,'30,25 - 29세,1998,1645,901,744
'2714065500,  동촌동,'35,30 - 34세,1998,1350,703,647
'2714065500,  동촌동,'40,35 - 39세,1998,1350,686,664
'2714065500,  동촌동,'45,40 - 44세,1998,1171,586,585
'2714065500,  동촌동,'50,45 - 49세,1998,959,470,489
'2714065500,  동촌동,'55,50 - 54세,1998,801,366,435
'2714065500,  동촌동,'60,55 - 59세,1998,920,425,495
'2714065500,  동촌동,'65,60 - 64세,1998,648,315,333
'2714065500,  동촌동,'70,65 - 69세,1998,397,162,235
'2714065500,  동촌동,'75,70 - 74세,1998,251,105,146
'2714065500,  동촌동,'80,75 - 79세,1998,153,45,108
'2714065500,  동촌동,'85,80 - 84세,1998,67,18,49
'2714065500,  동촌동,'90,85+ ,1998,59,12,47
'2714067000,  방촌동,'00,계,1998,21823,10956,10867
'2714067000,  방촌동,'05,0 - 4세,1998,1969,1036,933
'2714067000,  방촌동,'10,5 - 9세,1998,1956,1091,865
'2714067000,  방촌동,'15,10 - 14세,1998,1298,711,587
'2714067000,  방촌동,'20,15 - 19세,1998,1583,807,776
'2714067000,  방촌동,'25,20 - 24세,1998,1662,873,789
'2714067000,  방촌동,'30,25 - 29세,1998,2224,1025,1199
'2714067000,  방촌동,'35,30 - 34세,1998,2530,1205,1325
'2714067000,  방촌동,'40,35 - 39세,1998,2296,1236,1060
'2714067000,  방촌동,'45,40 - 44세,1998,1600,822,778
'2714067000,  방촌동,'50,45 - 49세,1998,1229,592,637
'2714067000,  방촌동,'55,50 - 54세,1998,950,473,477
'2714067000,  방촌동,'60,55 - 59세,1998,889,452,437
'2714067000,  방촌동,'65,60 - 64세,1998,635,284,351
'2714067000,  방촌동,'70,65 - 69세,1998,425,163,262
'2714067000,  방촌동,'75,70 - 74세,1998,269,105,164
'2714067000,  방촌동,'80,75 - 79세,1998,161,42,119
'2714067000,  방촌동,'85,80 - 84세,1998,91,27,64
'2714067000,  방촌동,'90,85+ ,1998,56,12,44
'2714068500,  해안동,'00,계,1998,19752,10120,9632
'2714068500,  해안동,'05,0 - 4세,1998,1345,725,620
'2714068500,  해안동,'10,5 - 9세,1998,1287,700,587
'2714068500,  해안동,'15,10 - 14세,1998,1153,667,486
'2714068500,  해안동,'20,15 - 19세,1998,1792,916,876
'2714068500,  해안동,'25,20 - 24세,1998,1883,954,929
'2714068500,  해안동,'30,25 - 29세,1998,2180,1183,997
'2714068500,  해안동,'35,30 - 34세,1998,1843,987,856
'2714068500,  해안동,'40,35 - 39세,1998,1689,884,805
'2714068500,  해안동,'45,40 - 44세,1998,1474,740,734
'2714068500,  해안동,'50,45 - 49세,1998,1165,593,572
'2714068500,  해안동,'55,50 - 54세,1998,964,480,484
'2714068500,  해안동,'60,55 - 59세,1998,991,476,515
'2714068500,  해안동,'65,60 - 64세,1998,800,364,436
'2714068500,  해안동,'70,65 - 69세,1998,465,201,264
'2714068500,  해안동,'75,70 - 74세,1998,328,112,216
'2714068500,  해안동,'80,75 - 79세,1998,222,76,146
'2714068500,  해안동,'85,80 - 84세,1998,115,48,67
'2714068500,  해안동,'90,85+ ,1998,56,14,42
'2714072000,  안심1동,'00,계,1998,29494,14811,14683
'2714072000,  안심1동,'05,0 - 4세,1998,2221,1254,967
'2714072000,  안심1동,'10,5 - 9세,1998,2492,1416,1076
'2714072000,  안심1동,'15,10 - 14세,1998,2160,1113,1047
'2714072000,  안심1동,'20,15 - 19세,1998,2807,1444,1363
'2714072000,  안심1동,'25,20 - 24세,1998,2166,1126,1040
'2714072000,  안심1동,'30,25 - 29세,1998,2705,1275,1430
'2714072000,  안심1동,'35,30 - 34세,1998,2993,1494,1499
'2714072000,  안심1동,'40,35 - 39세,1998,3153,1609,1544
'2714072000,  안심1동,'45,40 - 44세,1998,2370,1203,1167
'2714072000,  안심1동,'50,45 - 49세,1998,1663,852,811
'2714072000,  안심1동,'55,50 - 54세,1998,1118,567,551
'2714072000,  안심1동,'60,55 - 59세,1998,1110,507,603
'2714072000,  안심1동,'65,60 - 64세,1998,922,377,545
'2714072000,  안심1동,'70,65 - 69세,1998,667,259,408
'2714072000,  안심1동,'75,70 - 74세,1998,452,165,287
'2714072000,  안심1동,'80,75 - 79세,1998,282,93,189
'2714072000,  안심1동,'85,80 - 84세,1998,149,38,111
'2714072000,  안심1동,'90,85+ ,1998,64,19,45
'2714073000,  안심2동,'00,계,1998,12015,6138,5877
'2714073000,  안심2동,'05,0 - 4세,1998,869,458,411
'2714073000,  안심2동,'10,5 - 9세,1998,769,439,330
'2714073000,  안심2동,'15,10 - 14세,1998,684,347,337
'2714073000,  안심2동,'20,15 - 19세,1998,1098,564,534
'2714073000,  안심2동,'25,20 - 24세,1998,1142,600,542
'2714073000,  안심2동,'30,25 - 29세,1998,1292,659,633
'2714073000,  안심2동,'35,30 - 34세,1998,1125,613,512
'2714073000,  안심2동,'40,35 - 39세,1998,1040,522,518
'2714073000,  안심2동,'45,40 - 44세,1998,898,491,407
'2714073000,  안심2동,'50,45 - 49세,1998,736,354,382
'2714073000,  안심2동,'55,50 - 54세,1998,663,308,355
'2714073000,  안심2동,'60,55 - 59세,1998,631,328,303
'2714073000,  안심2동,'65,60 - 64세,1998,445,219,226
'2714073000,  안심2동,'70,65 - 69세,1998,246,113,133
'2714073000,  안심2동,'75,70 - 74세,1998,176,62,114
'2714073000,  안심2동,'80,75 - 79세,1998,108,40,68
'2714073000,  안심2동,'85,80 - 84세,1998,53,10,43
'2714073000,  안심2동,'90,85+ ,1998,40,11,29
'2714074500,  안심3.4동,'00,계,1998,23530,11977,11553
'2714074500,  안심3.4동,'05,0 - 4세,1998,1604,868,736
'2714074500,  안심3.4동,'10,5 - 9세,1998,1795,1040,755
'2714074500,  안심3.4동,'15,10 - 14세,1998,1575,832,743
'2714074500,  안심3.4동,'20,15 - 19세,1998,2000,1003,997
'2714074500,  안심3.4동,'25,20 - 24세,1998,1987,1024,963
'2714074500,  안심3.4동,'30,25 - 29세,1998,2449,1240,1209
'2714074500,  안심3.4동,'35,30 - 34세,1998,2182,1092,1090
'2714074500,  안심3.4동,'40,35 - 39세,1998,2306,1213,1093
'2714074500,  안심3.4동,'45,40 - 44세,1998,1716,934,782
'2714074500,  안심3.4동,'50,45 - 49세,1998,1353,671,682
'2714074500,  안심3.4동,'55,50 - 54세,1998,1074,504,570
'2714074500,  안심3.4동,'60,55 - 59세,1998,1185,605,580
'2714074500,  안심3.4동,'65,60 - 64세,1998,905,416,489
'2714074500,  안심3.4동,'70,65 - 69세,1998,537,241,296
'2714074500,  안심3.4동,'75,70 - 74세,1998,392,150,242
'2714074500,  안심3.4동,'80,75 - 79세,1998,268,85,183
'2714074500,  안심3.4동,'85,80 - 84세,1998,134,42,92
'2714074500,  안심3.4동,'90,85+ ,1998,68,17,51
'2714076000,  공산동,'00,계,1998,16127,8087,8040
'2714076000,  공산동,'05,0 - 4세,1998,1315,705,610
'2714076000,  공산동,'10,5 - 9세,1998,1208,653,555
'2714076000,  공산동,'15,10 - 14세,1998,736,388,348
'2714076000,  공산동,'20,15 - 19세,1998,970,512,458
'2714076000,  공산동,'25,20 - 24세,1998,1179,638,541
'2714076000,  공산동,'30,25 - 29세,1998,1602,768,834
'2714076000,  공산동,'35,30 - 34세,1998,1613,809,804
'2714076000,  공산동,'40,35 - 39세,1998,1521,857,664
'2714076000,  공산동,'45,40 - 44세,1998,1001,532,469
'2714076000,  공산동,'50,45 - 49세,1998,902,428,474
'2714076000,  공산동,'55,50 - 54세,1998,880,407,473
'2714076000,  공산동,'60,55 - 59세,1998,964,440,524
'2714076000,  공산동,'65,60 - 64세,1998,827,399,428
'2714076000,  공산동,'70,65 - 69세,1998,549,245,304
'2714076000,  공산동,'75,70 - 74세,1998,396,154,242
'2714076000,  공산동,'80,75 - 79세,1998,245,92,153
'2714076000,  공산동,'85,80 - 84세,1998,128,40,88
'2714076000,  공산동,'90,85+ ,1998,91,20,71
'27170, 서구,'00,계,1998,302773,153964,148809
'27170, 서구,'05,0 - 4세,1998,19577,10635,8942
'27170, 서구,'10,5 - 9세,1998,20090,11233,8857
'27170, 서구,'15,10 - 14세,1998,19900,11202,8698
'27170, 서구,'20,15 - 19세,1998,29572,15483,14089
'27170, 서구,'25,20 - 24세,1998,30391,15465,14926
'27170, 서구,'30,25 - 29세,1998,32396,16992,15404
'27170, 서구,'35,30 - 34세,1998,27714,14653,13061
'27170, 서구,'40,35 - 39세,1998,27959,14218,13741
'27170, 서구,'45,40 - 44세,1998,23439,11380,12059
'27170, 서구,'50,45 - 49세,1998,19366,9551,9815
'27170, 서구,'55,50 - 54세,1998,14710,7123,7587
'27170, 서구,'60,55 - 59세,1998,13911,6667,7244
'27170, 서구,'65,60 - 64세,1998,9775,4591,5184
'27170, 서구,'70,65 - 69세,1998,5819,2358,3461
'27170, 서구,'75,70 - 74세,1998,3783,1247,2536
'27170, 서구,'80,75 - 79세,1998,2430,712,1718
'27170, 서구,'85,80 - 84세,1998,1221,308,913
'27170, 서구,'90,85+ ,1998,720,146,574
'2717051000,  내당1동,'00,계,1998,15673,7862,7811
'2717051000,  내당1동,'05,0 - 4세,1998,937,512,425
'2717051000,  내당1동,'10,5 - 9세,1998,952,517,435
'2717051000,  내당1동,'15,10 - 14세,1998,1037,567,470
'2717051000,  내당1동,'20,15 - 19세,1998,1536,817,719
'2717051000,  내당1동,'25,20 - 24세,1998,1655,851,804
'2717051000,  내당1동,'30,25 - 29세,1998,1600,853,747
'2717051000,  내당1동,'35,30 - 34세,1998,1371,690,681
'2717051000,  내당1동,'40,35 - 39세,1998,1337,642,695
'2717051000,  내당1동,'45,40 - 44세,1998,1219,571,648
'2717051000,  내당1동,'50,45 - 49세,1998,1102,507,595
'2717051000,  내당1동,'55,50 - 54세,1998,831,403,428
'2717051000,  내당1동,'60,55 - 59세,1998,766,395,371
'2717051000,  내당1동,'65,60 - 64세,1998,533,241,292
'2717051000,  내당1동,'70,65 - 69세,1998,329,148,181
'2717051000,  내당1동,'75,70 - 74세,1998,194,75,119
'2717051000,  내당1동,'80,75 - 79세,1998,135,38,97
'2717051000,  내당1동,'85,80 - 84세,1998,80,25,55
'2717051000,  내당1동,'90,85+ ,1998,59,10,49
'2717052500,  내당2·3동,'00,계,1998,16233,8160,8073
'2717052500,  내당2·3동,'05,0 - 4세,1998,994,539,455
'2717052500,  내당2·3동,'10,5 - 9세,1998,1000,575,425
'2717052500,  내당2·3동,'15,10 - 14세,1998,899,499,400
'2717052500,  내당2·3동,'20,15 - 19세,1998,1514,788,726
'2717052500,  내당2·3동,'25,20 - 24세,1998,1626,814,812
'2717052500,  내당2·3동,'30,25 - 29세,1998,1791,949,842
'2717052500,  내당2·3동,'35,30 - 34세,1998,1428,777,651
'2717052500,  내당2·3동,'40,35 - 39세,1998,1344,698,646
'2717052500,  내당2·3동,'45,40 - 44세,1998,1196,582,614
'2717052500,  내당2·3동,'50,45 - 49세,1998,1041,496,545
'2717052500,  내당2·3동,'55,50 - 54세,1998,846,387,459
'2717052500,  내당2·3동,'60,55 - 59세,1998,910,409,501
'2717052500,  내당2·3동,'65,60 - 64세,1998,670,323,347
'2717052500,  내당2·3동,'70,65 - 69세,1998,411,152,259
'2717052500,  내당2·3동,'75,70 - 74세,1998,269,90,179
'2717052500,  내당2·3동,'80,75 - 79세,1998,167,60,107
'2717052500,  내당2·3동,'85,80 - 84세,1998,76,11,65
'2717052500,  내당2·3동,'90,85+ ,1998,51,11,40
'2717054000,  내당4동,'00,계,1998,25024,12475,12549
'2717054000,  내당4동,'05,0 - 4세,1998,1375,744,631
'2717054000,  내당4동,'10,5 - 9세,1998,1532,887,645
'2717054000,  내당4동,'15,10 - 14세,1998,1954,1159,795
'2717054000,  내당4동,'20,15 - 19세,1998,2932,1537,1395
'2717054000,  내당4동,'25,20 - 24세,1998,2652,1339,1313
'2717054000,  내당4동,'30,25 - 29세,1998,2349,1139,1210
'2717054000,  내당4동,'35,30 - 34세,1998,1796,900,896
'2717054000,  내당4동,'40,35 - 39세,1998,2246,965,1281
'2717054000,  내당4동,'45,40 - 44세,1998,2244,1042,1202
'2717054000,  내당4동,'50,45 - 49세,1998,1865,901,964
'2717054000,  내당4동,'55,50 - 54세,1998,1289,664,625
'2717054000,  내당4동,'60,55 - 59세,1998,974,488,486
'2717054000,  내당4동,'65,60 - 64세,1998,708,344,364
'2717054000,  내당4동,'70,65 - 69세,1998,415,172,243
'2717054000,  내당4동,'75,70 - 74세,1998,317,96,221
'2717054000,  내당4동,'80,75 - 79세,1998,203,57,146
'2717054000,  내당4동,'85,80 - 84세,1998,107,26,81
'2717054000,  내당4동,'90,85+ ,1998,66,15,51
'2717055000,  비산1동,'00,계,1998,19927,10233,9694
'2717055000,  비산1동,'05,0 - 4세,1998,1581,851,730
'2717055000,  비산1동,'10,5 - 9세,1998,1465,779,686
'2717055000,  비산1동,'15,10 - 14세,1998,1272,710,562
'2717055000,  비산1동,'20,15 - 19세,1998,1728,921,807
'2717055000,  비산1동,'25,20 - 24세,1998,1861,939,922
'2717055000,  비산1동,'30,25 - 29세,1998,2438,1261,1177
'2717055000,  비산1동,'35,30 - 34세,1998,2092,1145,947
'2717055000,  비산1동,'40,35 - 39세,1998,1834,971,863
'2717055000,  비산1동,'45,40 - 44세,1998,1379,721,658
'2717055000,  비산1동,'50,45 - 49세,1998,1089,552,537
'2717055000,  비산1동,'55,50 - 54세,1998,856,397,459
'2717055000,  비산1동,'60,55 - 59세,1998,856,400,456
'2717055000,  비산1동,'65,60 - 64세,1998,602,286,316
'2717055000,  비산1동,'70,65 - 69세,1998,399,151,248
'2717055000,  비산1동,'75,70 - 74세,1998,237,85,152
'2717055000,  비산1동,'80,75 - 79세,1998,132,44,88
'2717055000,  비산1동,'85,80 - 84세,1998,62,15,47
'2717055000,  비산1동,'90,85+ ,1998,44,5,39
'2717056500,  비산2·3동,'00,계,1998,19920,10129,9791
'2717056500,  비산2·3동,'05,0 - 4세,1998,1131,623,508
'2717056500,  비산2·3동,'10,5 - 9세,1998,1094,612,482
'2717056500,  비산2·3동,'15,10 - 14세,1998,1210,656,554
'2717056500,  비산2·3동,'20,15 - 19세,1998,1804,931,873
'2717056500,  비산2·3동,'25,20 - 24세,1998,1999,1050,949
'2717056500,  비산2·3동,'30,25 - 29세,1998,2225,1227,998
'2717056500,  비산2·3동,'35,30 - 34세,1998,1713,939,774
'2717056500,  비산2·3동,'40,35 - 39세,1998,1715,891,824
'2717056500,  비산2·3동,'45,40 - 44세,1998,1448,720,728
'2717056500,  비산2·3동,'50,45 - 49세,1998,1231,608,623
'2717056500,  비산2·3동,'55,50 - 54세,1998,1062,473,589
'2717056500,  비산2·3동,'60,55 - 59세,1998,1188,561,627
'2717056500,  비산2·3동,'65,60 - 64세,1998,894,408,486
'2717056500,  비산2·3동,'70,65 - 69세,1998,517,208,309
'2717056500,  비산2·3동,'75,70 - 74세,1998,336,116,220
'2717056500,  비산2·3동,'80,75 - 79세,1998,198,66,132
'2717056500,  비산2·3동,'85,80 - 84세,1998,107,31,76
'2717056500,  비산2·3동,'90,85+ ,1998,48,9,39
'2717058000,  비산4동,'00,계,1998,13068,6560,6508
'2717058000,  비산4동,'05,0 - 4세,1998,786,429,357
'2717058000,  비산4동,'10,5 - 9세,1998,800,426,374
'2717058000,  비산4동,'15,10 - 14세,1998,771,446,325
'2717058000,  비산4동,'20,15 - 19세,1998,1220,627,593
'2717058000,  비산4동,'25,20 - 24세,1998,1342,695,647
'2717058000,  비산4동,'30,25 - 29세,1998,1429,751,678
'2717058000,  비산4동,'35,30 - 34세,1998,1117,607,510
'2717058000,  비산4동,'40,35 - 39세,1998,1156,584,572
'2717058000,  비산4동,'45,40 - 44세,1998,1030,521,509
'2717058000,  비산4동,'50,45 - 49세,1998,816,382,434
'2717058000,  비산4동,'55,50 - 54세,1998,708,318,390
'2717058000,  비산4동,'60,55 - 59세,1998,656,302,354
'2717058000,  비산4동,'65,60 - 64세,1998,509,225,284
'2717058000,  비산4동,'70,65 - 69세,1998,308,126,182
'2717058000,  비산4동,'75,70 - 74세,1998,213,66,147
'2717058000,  비산4동,'80,75 - 79세,1998,113,32,81
'2717058000,  비산4동,'85,80 - 84세,1998,56,13,43
'2717058000,  비산4동,'90,85+ ,1998,38,10,28
'2717059000,  비산5동,'00,계,1998,12961,6632,6329
'2717059000,  비산5동,'05,0 - 4세,1998,806,439,367
'2717059000,  비산5동,'10,5 - 9세,1998,1019,583,436
'2717059000,  비산5동,'15,10 - 14세,1998,902,519,383
'2717059000,  비산5동,'20,15 - 19세,1998,1185,597,588
'2717059000,  비산5동,'25,20 - 24세,1998,1261,649,612
'2717059000,  비산5동,'30,25 - 29세,1998,1249,685,564
'2717059000,  비산5동,'35,30 - 34세,1998,1276,629,647
'2717059000,  비산5동,'40,35 - 39세,1998,1259,664,595
'2717059000,  비산5동,'45,40 - 44세,1998,955,477,478
'2717059000,  비산5동,'50,45 - 49세,1998,807,387,420
'2717059000,  비산5동,'55,50 - 54세,1998,612,300,312
'2717059000,  비산5동,'60,55 - 59세,1998,634,292,342
'2717059000,  비산5동,'65,60 - 64세,1998,431,210,221
'2717059000,  비산5동,'70,65 - 69세,1998,247,100,147
'2717059000,  비산5동,'75,70 - 74세,1998,146,59,87
'2717059000,  비산5동,'80,75 - 79세,1998,94,23,71
'2717059000,  비산5동,'85,80 - 84세,1998,52,14,38
'2717059000,  비산5동,'90,85+ ,1998,26,5,21
'2717060000,  비산6동,'00,계,1998,12111,5984,6127
'2717060000,  비산6동,'05,0 - 4세,1998,692,374,318
'2717060000,  비산6동,'10,5 - 9세,1998,671,340,331
'2717060000,  비산6동,'15,10 - 14세,1998,666,342,324
'2717060000,  비산6동,'20,15 - 19세,1998,1174,607,567
'2717060000,  비산6동,'25,20 - 24세,1998,1367,659,708
'2717060000,  비산6동,'30,25 - 29세,1998,1403,742,661
'2717060000,  비산6동,'35,30 - 34세,1998,1006,558,448
'2717060000,  비산6동,'40,35 - 39세,1998,999,516,483
'2717060000,  비산6동,'45,40 - 44세,1998,872,419,453
'2717060000,  비산6동,'50,45 - 49세,1998,779,351,428
'2717060000,  비산6동,'55,50 - 54세,1998,695,328,367
'2717060000,  비산6동,'60,55 - 59세,1998,673,306,367
'2717060000,  비산6동,'65,60 - 64세,1998,474,229,245
'2717060000,  비산6동,'70,65 - 69세,1998,272,109,163
'2717060000,  비산6동,'75,70 - 74세,1998,178,55,123
'2717060000,  비산6동,'80,75 - 79세,1998,109,31,78
'2717060000,  비산6동,'85,80 - 84세,1998,49,11,38
'2717060000,  비산6동,'90,85+ ,1998,32,7,25
'2717061000,  비산7동,'00,계,1998,21327,11020,10307
'2717061000,  비산7동,'05,0 - 4세,1998,1623,870,753
'2717061000,  비산7동,'10,5 - 9세,1998,1530,849,681
'2717061000,  비산7동,'15,10 - 14세,1998,1281,731,550
'2717061000,  비산7동,'20,15 - 19세,1998,1879,986,893
'2717061000,  비산7동,'25,20 - 24세,1998,2232,1131,1101
'2717061000,  비산7동,'30,25 - 29세,1998,2525,1321,1204
'2717061000,  비산7동,'35,30 - 34세,1998,2159,1182,977
'2717061000,  비산7동,'40,35 - 39세,1998,2022,1128,894
'2717061000,  비산7동,'45,40 - 44세,1998,1502,729,773
'2717061000,  비산7동,'50,45 - 49세,1998,1278,600,678
'2717061000,  비산7동,'55,50 - 54세,1998,1019,506,513
'2717061000,  비산7동,'60,55 - 59세,1998,929,460,469
'2717061000,  비산7동,'65,60 - 64세,1998,622,293,329
'2717061000,  비산7동,'70,65 - 69세,1998,325,136,189
'2717061000,  비산7동,'75,70 - 74세,1998,160,52,108
'2717061000,  비산7동,'80,75 - 79세,1998,116,29,87
'2717061000,  비산7동,'85,80 - 84세,1998,85,11,74
'2717061000,  비산7동,'90,85+ ,1998,40,6,34
'2717062000,  평리1동,'00,계,1998,15156,7781,7375
'2717062000,  평리1동,'05,0 - 4세,1998,1010,574,436
'2717062000,  평리1동,'10,5 - 9세,1998,1060,604,456
'2717062000,  평리1동,'15,10 - 14세,1998,1024,569,455
'2717062000,  평리1동,'20,15 - 19세,1998,1440,782,658
'2717062000,  평리1동,'25,20 - 24세,1998,1451,751,700
'2717062000,  평리1동,'30,25 - 29세,1998,1604,808,796
'2717062000,  평리1동,'35,30 - 34세,1998,1489,785,704
'2717062000,  평리1동,'40,35 - 39세,1998,1494,778,716
'2717062000,  평리1동,'45,40 - 44세,1998,1082,540,542
'2717062000,  평리1동,'50,45 - 49세,1998,903,469,434
'2717062000,  평리1동,'55,50 - 54세,1998,675,309,366
'2717062000,  평리1동,'60,55 - 59세,1998,724,353,371
'2717062000,  평리1동,'65,60 - 64세,1998,513,225,288
'2717062000,  평리1동,'70,65 - 69세,1998,277,124,153
'2717062000,  평리1동,'75,70 - 74세,1998,178,53,125
'2717062000,  평리1동,'80,75 - 79세,1998,125,30,95
'2717062000,  평리1동,'85,80 - 84세,1998,72,20,52
'2717062000,  평리1동,'90,85+ ,1998,35,7,28
'2717063000,  평리2동,'00,계,1998,12360,6284,6076
'2717063000,  평리2동,'05,0 - 4세,1998,822,429,393
'2717063000,  평리2동,'10,5 - 9세,1998,914,513,401
'2717063000,  평리2동,'15,10 - 14세,1998,872,482,390
'2717063000,  평리2동,'20,15 - 19세,1998,1184,624,560
'2717063000,  평리2동,'25,20 - 24세,1998,1071,540,531
'2717063000,  평리2동,'30,25 - 29세,1998,1347,725,622
'2717063000,  평리2동,'35,30 - 34세,1998,1243,648,595
'2717063000,  평리2동,'40,35 - 39세,1998,1221,610,611
'2717063000,  평리2동,'45,40 - 44세,1998,970,499,471
'2717063000,  평리2동,'50,45 - 49세,1998,676,352,324
'2717063000,  평리2동,'55,50 - 54세,1998,539,247,292
'2717063000,  평리2동,'60,55 - 59세,1998,559,254,305
'2717063000,  평리2동,'65,60 - 64세,1998,409,181,228
'2717063000,  평리2동,'70,65 - 69세,1998,250,98,152
'2717063000,  평리2동,'75,70 - 74세,1998,154,57,97
'2717063000,  평리2동,'80,75 - 79세,1998,76,15,61
'2717063000,  평리2동,'85,80 - 84세,1998,36,8,28
'2717063000,  평리2동,'90,85+ ,1998,17,2,15
'2717064000,  평리3동,'00,계,1998,22161,11362,10799
'2717064000,  평리3동,'05,0 - 4세,1998,1579,838,741
'2717064000,  평리3동,'10,5 - 9세,1998,1581,887,694
'2717064000,  평리3동,'15,10 - 14세,1998,1393,765,628
'2717064000,  평리3동,'20,15 - 19세,1998,2185,1162,1023
'2717064000,  평리3동,'25,20 - 24세,1998,2273,1146,1127
'2717064000,  평리3동,'30,25 - 29세,1998,2476,1299,1177
'2717064000,  평리3동,'35,30 - 34세,1998,2180,1140,1040
'2717064000,  평리3동,'40,35 - 39세,1998,2077,1087,990
'2717064000,  평리3동,'45,40 - 44세,1998,1721,825,896
'2717064000,  평리3동,'50,45 - 49세,1998,1345,703,642
'2717064000,  평리3동,'55,50 - 54세,1998,928,451,477
'2717064000,  평리3동,'60,55 - 59세,1998,925,463,462
'2717064000,  평리3동,'65,60 - 64세,1998,607,283,324
'2717064000,  평리3동,'70,65 - 69세,1998,374,147,227
'2717064000,  평리3동,'75,70 - 74세,1998,242,89,153
'2717064000,  평리3동,'80,75 - 79세,1998,157,46,111
'2717064000,  평리3동,'85,80 - 84세,1998,66,20,46
'2717064000,  평리3동,'90,85+ ,1998,52,11,41
'2717065000,  평리4동,'00,계,1998,23674,11918,11756
'2717065000,  평리4동,'05,0 - 4세,1998,1606,882,724
'2717065000,  평리4동,'10,5 - 9세,1998,1521,865,656
'2717065000,  평리4동,'15,10 - 14세,1998,1519,864,655
'2717065000,  평리4동,'20,15 - 19세,1998,2317,1239,1078
'2717065000,  평리4동,'25,20 - 24세,1998,2327,1160,1167
'2717065000,  평리4동,'30,25 - 29세,1998,2537,1290,1247
'2717065000,  평리4동,'35,30 - 34세,1998,2244,1160,1084
'2717065000,  평리4동,'40,35 - 39세,1998,2243,1085,1158
'2717065000,  평리4동,'45,40 - 44세,1998,1884,874,1010
'2717065000,  평리4동,'50,45 - 49세,1998,1639,785,854
'2717065000,  평리4동,'55,50 - 54세,1998,1174,588,586
'2717065000,  평리4동,'60,55 - 59세,1998,1004,482,522
'2717065000,  평리4동,'65,60 - 64세,1998,674,324,350
'2717065000,  평리4동,'70,65 - 69세,1998,380,149,231
'2717065000,  평리4동,'75,70 - 74세,1998,281,75,206
'2717065000,  평리4동,'80,75 - 79세,1998,186,57,129
'2717065000,  평리4동,'85,80 - 84세,1998,93,31,62
'2717065000,  평리4동,'90,85+ ,1998,45,8,37
'2717066000,  평리5동,'00,계,1998,12416,6389,6027
'2717066000,  평리5동,'05,0 - 4세,1998,860,466,394
'2717066000,  평리5동,'10,5 - 9세,1998,942,531,411
'2717066000,  평리5동,'15,10 - 14세,1998,882,482,400
'2717066000,  평리5동,'20,15 - 19세,1998,1147,594,553
'2717066000,  평리5동,'25,20 - 24세,1998,1291,677,614
'2717066000,  평리5동,'30,25 - 29세,1998,1329,711,618
'2717066000,  평리5동,'35,30 - 34세,1998,1206,605,601
'2717066000,  평리5동,'40,35 - 39세,1998,1227,622,605
'2717066000,  평리5동,'45,40 - 44세,1998,963,500,463
'2717066000,  평리5동,'50,45 - 49세,1998,778,375,403
'2717066000,  평리5동,'55,50 - 54세,1998,533,284,249
'2717066000,  평리5동,'60,55 - 59세,1998,497,243,254
'2717066000,  평리5동,'65,60 - 64세,1998,304,153,151
'2717066000,  평리5동,'70,65 - 69세,1998,169,71,98
'2717066000,  평리5동,'75,70 - 74세,1998,122,40,82
'2717066000,  평리5동,'80,75 - 79세,1998,91,20,71
'2717066000,  평리5동,'85,80 - 84세,1998,51,13,38
'2717066000,  평리5동,'90,85+ ,1998,24,2,22
'2717066100,  평리6동,'00,계,1998,15218,7930,7288
'2717066100,  평리6동,'05,0 - 4세,1998,1183,620,563
'2717066100,  평리6동,'10,5 - 9세,1998,1149,640,509
'2717066100,  평리6동,'15,10 - 14세,1998,1124,642,482
'2717066100,  평리6동,'20,15 - 19세,1998,1442,737,705
'2717066100,  평리6동,'25,20 - 24세,1998,1373,706,667
'2717066100,  평리6동,'30,25 - 29세,1998,1685,897,788
'2717066100,  평리6동,'35,30 - 34세,1998,1608,853,755
'2717066100,  평리6동,'40,35 - 39세,1998,1554,828,726
'2717066100,  평리6동,'45,40 - 44세,1998,1164,594,570
'2717066100,  평리6동,'50,45 - 49세,1998,849,454,395
'2717066100,  평리6동,'55,50 - 54세,1998,656,328,328
'2717066100,  평리6동,'60,55 - 59세,1998,551,278,273
'2717066100,  평리6동,'65,60 - 64세,1998,362,169,193
'2717066100,  평리6동,'70,65 - 69세,1998,219,91,128
'2717066100,  평리6동,'75,70 - 74세,1998,128,48,80
'2717066100,  평리6동,'80,75 - 79세,1998,99,24,75
'2717066100,  평리6동,'85,80 - 84세,1998,55,17,38
'2717066100,  평리6동,'90,85+ ,1998,17,4,13
'2717067500,  상중이동,'00,계,1998,29333,14928,14405
'2717067500,  상중이동,'05,0 - 4세,1998,1780,995,785
'2717067500,  상중이동,'10,5 - 9세,1998,1909,1077,832
'2717067500,  상중이동,'15,10 - 14세,1998,2088,1204,884
'2717067500,  상중이동,'20,15 - 19세,1998,3326,1702,1624
'2717067500,  상중이동,'25,20 - 24세,1998,2884,1464,1420
'2717067500,  상중이동,'30,25 - 29세,1998,2823,1469,1354
'2717067500,  상중이동,'35,30 - 34세,1998,2447,1296,1151
'2717067500,  상중이동,'40,35 - 39세,1998,2823,1380,1443
'2717067500,  상중이동,'45,40 - 44세,1998,2580,1195,1385
'2717067500,  상중이동,'50,45 - 49세,1998,2067,1081,986
'2717067500,  상중이동,'55,50 - 54세,1998,1435,742,693
'2717067500,  상중이동,'60,55 - 59세,1998,1106,535,571
'2717067500,  상중이동,'65,60 - 64세,1998,747,361,386
'2717067500,  상중이동,'70,65 - 69세,1998,498,183,315
'2717067500,  상중이동,'75,70 - 74세,1998,376,116,260
'2717067500,  상중이동,'80,75 - 79세,1998,252,75,177
'2717067500,  상중이동,'85,80 - 84세,1998,109,30,79
'2717067500,  상중이동,'90,85+ ,1998,83,23,60
'2717069500,  원대동,'00,계,1998,16211,8317,7894
'2717069500,  원대동,'05,0 - 4세,1998,812,450,362
'2717069500,  원대동,'10,5 - 9세,1998,951,548,403
'2717069500,  원대동,'15,10 - 14세,1998,1006,565,441
'2717069500,  원대동,'20,15 - 19세,1998,1559,832,727
'2717069500,  원대동,'25,20 - 24세,1998,1726,894,832
'2717069500,  원대동,'30,25 - 29세,1998,1586,865,721
'2717069500,  원대동,'35,30 - 34세,1998,1339,739,600
'2717069500,  원대동,'40,35 - 39세,1998,1408,769,639
'2717069500,  원대동,'45,40 - 44세,1998,1230,571,659
'2717069500,  원대동,'50,45 - 49세,1998,1101,548,553
'2717069500,  원대동,'55,50 - 54세,1998,852,398,454
'2717069500,  원대동,'60,55 - 59세,1998,959,446,513
'2717069500,  원대동,'65,60 - 64세,1998,716,336,380
'2717069500,  원대동,'70,65 - 69세,1998,429,193,236
'2717069500,  원대동,'75,70 - 74세,1998,252,75,177
'2717069500,  원대동,'80,75 - 79세,1998,177,65,112
'2717069500,  원대동,'85,80 - 84세,1998,65,12,53
'2717069500,  원대동,'90,85+ ,1998,43,11,32
'27200, 남구,'00,계,1998,203050,100157,102893
'27200, 남구,'05,0 - 4세,1998,11325,6042,5283
'27200, 남구,'10,5 - 9세,1998,11392,6297,5095
'27200, 남구,'15,10 - 14세,1998,11525,6386,5139
'27200, 남구,'20,15 - 19세,1998,18686,9607,9079
'27200, 남구,'25,20 - 24세,1998,20639,10212,10427
'27200, 남구,'30,25 - 29세,1998,22699,11893,10806
'27200, 남구,'35,30 - 34세,1998,16353,8495,7858
'27200, 남구,'40,35 - 39세,1998,16311,7868,8443
'27200, 남구,'45,40 - 44세,1998,15374,7278,8096
'27200, 남구,'50,45 - 49세,1998,13414,6208,7206
'27200, 남구,'55,50 - 54세,1998,11179,5080,6099
'27200, 남구,'60,55 - 59세,1998,11832,5533,6299
'27200, 남구,'65,60 - 64세,1998,8980,4207,4773
'27200, 남구,'70,65 - 69세,1998,5703,2467,3236
'27200, 남구,'75,70 - 74세,1998,3528,1416,2112
'27200, 남구,'80,75 - 79세,1998,2172,706,1466
'27200, 남구,'85,80 - 84세,1998,1242,321,921
'27200, 남구,'90,85+ ,1998,696,141,555
'2720051500,  이천동,'00,계,1998,14870,7314,7556
'2720051500,  이천동,'05,0 - 4세,1998,717,377,340
'2720051500,  이천동,'10,5 - 9세,1998,816,444,372
'2720051500,  이천동,'15,10 - 14세,1998,772,440,332
'2720051500,  이천동,'20,15 - 19세,1998,1234,633,601
'2720051500,  이천동,'25,20 - 24세,1998,1387,714,673
'2720051500,  이천동,'30,25 - 29세,1998,1618,871,747
'2720051500,  이천동,'35,30 - 34세,1998,1132,587,545
'2720051500,  이천동,'40,35 - 39세,1998,1173,578,595
'2720051500,  이천동,'45,40 - 44세,1998,1029,518,511
'2720051500,  이천동,'50,45 - 49세,1998,1001,442,559
'2720051500,  이천동,'55,50 - 54세,1998,889,404,485
'2720051500,  이천동,'60,55 - 59세,1998,976,446,530
'2720051500,  이천동,'65,60 - 64세,1998,827,365,462
'2720051500,  이천동,'70,65 - 69세,1998,540,241,299
'2720051500,  이천동,'75,70 - 74세,1998,353,140,213
'2720051500,  이천동,'80,75 - 79세,1998,218,71,147
'2720051500,  이천동,'85,80 - 84세,1998,105,26,79
'2720051500,  이천동,'90,85+ ,1998,83,17,66
'2720053000,  봉덕1동,'00,계,1998,10746,5171,5575
'2720053000,  봉덕1동,'05,0 - 4세,1998,569,273,296
'2720053000,  봉덕1동,'10,5 - 9세,1998,512,285,227
'2720053000,  봉덕1동,'15,10 - 14세,1998,487,269,218
'2720053000,  봉덕1동,'20,15 - 19세,1998,947,487,460
'2720053000,  봉덕1동,'25,20 - 24세,1998,1070,518,552
'2720053000,  봉덕1동,'30,25 - 29세,1998,1261,639,622
'2720053000,  봉덕1동,'35,30 - 34세,1998,885,466,419
'2720053000,  봉덕1동,'40,35 - 39세,1998,797,396,401
'2720053000,  봉덕1동,'45,40 - 44세,1998,773,354,419
'2720053000,  봉덕1동,'50,45 - 49세,1998,674,303,371
'2720053000,  봉덕1동,'55,50 - 54세,1998,644,272,372
'2720053000,  봉덕1동,'60,55 - 59세,1998,735,339,396
'2720053000,  봉덕1동,'65,60 - 64세,1998,568,264,304
'2720053000,  봉덕1동,'70,65 - 69세,1998,376,161,215
'2720053000,  봉덕1동,'75,70 - 74세,1998,202,80,122
'2720053000,  봉덕1동,'80,75 - 79세,1998,142,39,103
'2720053000,  봉덕1동,'85,80 - 84세,1998,61,16,45
'2720053000,  봉덕1동,'90,85+ ,1998,43,10,33
'2720054000,  봉덕2동,'00,계,1998,15847,7818,8029
'2720054000,  봉덕2동,'05,0 - 4세,1998,745,400,345
'2720054000,  봉덕2동,'10,5 - 9세,1998,881,485,396
'2720054000,  봉덕2동,'15,10 - 14세,1998,998,529,469
'2720054000,  봉덕2동,'20,15 - 19세,1998,1506,747,759
'2720054000,  봉덕2동,'25,20 - 24세,1998,1498,768,730
'2720054000,  봉덕2동,'30,25 - 29세,1998,1480,768,712
'2720054000,  봉덕2동,'35,30 - 34세,1998,1143,601,542
'2720054000,  봉덕2동,'40,35 - 39세,1998,1283,643,640
'2720054000,  봉덕2동,'45,40 - 44세,1998,1219,567,652
'2720054000,  봉덕2동,'50,45 - 49세,1998,1184,563,621
'2720054000,  봉덕2동,'55,50 - 54세,1998,893,429,464
'2720054000,  봉덕2동,'60,55 - 59세,1998,948,457,491
'2720054000,  봉덕2동,'65,60 - 64세,1998,760,349,411
'2720054000,  봉덕2동,'70,65 - 69세,1998,553,246,307
'2720054000,  봉덕2동,'75,70 - 74세,1998,353,146,207
'2720054000,  봉덕2동,'80,75 - 79세,1998,211,77,134
'2720054000,  봉덕2동,'85,80 - 84세,1998,125,33,92
'2720054000,  봉덕2동,'90,85+ ,1998,67,10,57
'2720055000,  봉덕3동,'00,계,1998,20417,9926,10491
'2720055000,  봉덕3동,'05,0 - 4세,1998,1000,538,462
'2720055000,  봉덕3동,'10,5 - 9세,1998,1097,604,493
'2720055000,  봉덕3동,'15,10 - 14세,1998,1272,710,562
'2720055000,  봉덕3동,'20,15 - 19세,1998,2019,1053,966
'2720055000,  봉덕3동,'25,20 - 24세,1998,1940,921,1019
'2720055000,  봉덕3동,'30,25 - 29세,1998,2130,1079,1051
'2720055000,  봉덕3동,'35,30 - 34세,1998,1472,761,711
'2720055000,  봉덕3동,'40,35 - 39세,1998,1599,693,906
'2720055000,  봉덕3동,'45,40 - 44세,1998,1782,804,978
'2720055000,  봉덕3동,'50,45 - 49세,1998,1427,679,748
'2720055000,  봉덕3동,'55,50 - 54세,1998,1174,527,647
'2720055000,  봉덕3동,'60,55 - 59세,1998,1247,591,656
'2720055000,  봉덕3동,'65,60 - 64세,1998,902,438,464
'2720055000,  봉덕3동,'70,65 - 69세,1998,605,274,331
'2720055000,  봉덕3동,'75,70 - 74세,1998,331,136,195
'2720055000,  봉덕3동,'80,75 - 79세,1998,205,65,140
'2720055000,  봉덕3동,'85,80 - 84세,1998,130,41,89
'2720055000,  봉덕3동,'90,85+ ,1998,85,12,73
'2720056000,  대명1동,'00,계,1998,13687,6754,6933
'2720056000,  대명1동,'05,0 - 4세,1998,844,465,379
'2720056000,  대명1동,'10,5 - 9세,1998,841,460,381
'2720056000,  대명1동,'15,10 - 14세,1998,833,454,379
'2720056000,  대명1동,'20,15 - 19세,1998,1212,623,589
'2720056000,  대명1동,'25,20 - 24세,1998,1372,707,665
'2720056000,  대명1동,'30,25 - 29세,1998,1525,778,747
'2720056000,  대명1동,'35,30 - 34세,1998,1106,556,550
'2720056000,  대명1동,'40,35 - 39세,1998,1080,520,560
'2720056000,  대명1동,'45,40 - 44세,1998,1100,516,584
'2720056000,  대명1동,'50,45 - 49세,1998,899,404,495
'2720056000,  대명1동,'55,50 - 54세,1998,722,333,389
'2720056000,  대명1동,'60,55 - 59세,1998,747,350,397
'2720056000,  대명1동,'65,60 - 64세,1998,567,264,303
'2720056000,  대명1동,'70,65 - 69세,1998,343,162,181
'2720056000,  대명1동,'75,70 - 74세,1998,236,88,148
'2720056000,  대명1동,'80,75 - 79세,1998,127,44,83
'2720056000,  대명1동,'85,80 - 84세,1998,80,19,61
'2720056000,  대명1동,'90,85+ ,1998,53,11,42
'2720057500,  대명2.8동,'00,계,1998,17878,8773,9105
'2720057500,  대명2.8동,'05,0 - 4세,1998,932,488,444
'2720057500,  대명2.8동,'10,5 - 9세,1998,938,519,419
'2720057500,  대명2.8동,'15,10 - 14세,1998,945,527,418
'2720057500,  대명2.8동,'20,15 - 19세,1998,1681,854,827
'2720057500,  대명2.8동,'25,20 - 24세,1998,1958,933,1025
'2720057500,  대명2.8동,'30,25 - 29세,1998,2196,1169,1027
'2720057500,  대명2.8동,'35,30 - 34세,1998,1426,769,657
'2720057500,  대명2.8동,'40,35 - 39세,1998,1349,625,724
'2720057500,  대명2.8동,'45,40 - 44세,1998,1300,638,662
'2720057500,  대명2.8동,'50,45 - 49세,1998,1128,517,611
'2720057500,  대명2.8동,'55,50 - 54세,1998,1035,432,603
'2720057500,  대명2.8동,'60,55 - 59세,1998,1056,518,538
'2720057500,  대명2.8동,'65,60 - 64세,1998,768,350,418
'2720057500,  대명2.8동,'70,65 - 69세,1998,528,207,321
'2720057500,  대명2.8동,'75,70 - 74세,1998,298,133,165
'2720057500,  대명2.8동,'80,75 - 79세,1998,190,59,131
'2720057500,  대명2.8동,'85,80 - 84세,1998,101,24,77
'2720057500,  대명2.8동,'90,85+ ,1998,49,11,38
'2720058500,  대명3.7동,'00,계,1998,20503,10218,10285
'2720058500,  대명3.7동,'05,0 - 4세,1998,1159,629,530
'2720058500,  대명3.7동,'10,5 - 9세,1998,1083,610,473
'2720058500,  대명3.7동,'15,10 - 14세,1998,1056,584,472
'2720058500,  대명3.7동,'20,15 - 19세,1998,1918,971,947
'2720058500,  대명3.7동,'25,20 - 24세,1998,2383,1148,1235
'2720058500,  대명3.7동,'30,25 - 29세,1998,2582,1428,1154
'2720058500,  대명3.7동,'35,30 - 34세,1998,1686,927,759
'2720058500,  대명3.7동,'40,35 - 39세,1998,1596,789,807
'2720058500,  대명3.7동,'45,40 - 44세,1998,1412,681,731
'2720058500,  대명3.7동,'50,45 - 49세,1998,1297,579,718
'2720058500,  대명3.7동,'55,50 - 54세,1998,1086,464,622
'2720058500,  대명3.7동,'60,55 - 59세,1998,1219,558,661
'2720058500,  대명3.7동,'65,60 - 64세,1998,849,411,438
'2720058500,  대명3.7동,'70,65 - 69세,1998,487,205,282
'2720058500,  대명3.7동,'75,70 - 74세,1998,331,132,199
'2720058500,  대명3.7동,'80,75 - 79세,1998,208,66,142
'2720058500,  대명3.7동,'85,80 - 84세,1998,104,27,77
'2720058500,  대명3.7동,'90,85+ ,1998,47,9,38
'2720059000,  대명4동,'00,계,1998,19050,9565,9485
'2720059000,  대명4동,'05,0 - 4세,1998,1201,643,558
'2720059000,  대명4동,'10,5 - 9세,1998,1184,641,543
'2720059000,  대명4동,'15,10 - 14세,1998,1162,650,512
'2720059000,  대명4동,'20,15 - 19세,1998,1833,952,881
'2720059000,  대명4동,'25,20 - 24세,1998,1948,1002,946
'2720059000,  대명4동,'30,25 - 29세,1998,2058,1084,974
'2720059000,  대명4동,'35,30 - 34세,1998,1682,892,790
'2720059000,  대명4동,'40,35 - 39세,1998,1666,803,863
'2720059000,  대명4동,'45,40 - 44세,1998,1506,706,800
'2720059000,  대명4동,'50,45 - 49세,1998,1232,600,632
'2720059000,  대명4동,'55,50 - 54세,1998,885,433,452
'2720059000,  대명4동,'60,55 - 59세,1998,998,456,542
'2720059000,  대명4동,'65,60 - 64세,1998,694,320,374
'2720059000,  대명4동,'70,65 - 69세,1998,442,188,254
'2720059000,  대명4동,'75,70 - 74세,1998,271,105,166
'2720059000,  대명4동,'80,75 - 79세,1998,142,49,93
'2720059000,  대명4동,'85,80 - 84세,1998,97,29,68
'2720059000,  대명4동,'90,85+ ,1998,49,12,37
'2720060000,  대명5동,'00,계,1998,11584,5709,5875
'2720060000,  대명5동,'05,0 - 4세,1998,625,347,278
'2720060000,  대명5동,'10,5 - 9세,1998,624,362,262
'2720060000,  대명5동,'15,10 - 14세,1998,617,323,294
'2720060000,  대명5동,'20,15 - 19세,1998,1041,564,477
'2720060000,  대명5동,'25,20 - 24세,1998,1205,573,632
'2720060000,  대명5동,'30,25 - 29세,1998,1342,712,630
'2720060000,  대명5동,'35,30 - 34세,1998,910,471,439
'2720060000,  대명5동,'40,35 - 39세,1998,953,461,492
'2720060000,  대명5동,'45,40 - 44세,1998,826,405,421
'2720060000,  대명5동,'50,45 - 49세,1998,725,315,410
'2720060000,  대명5동,'55,50 - 54세,1998,647,293,354
'2720060000,  대명5동,'60,55 - 59세,1998,747,343,404
'2720060000,  대명5동,'65,60 - 64세,1998,540,251,289
'2720060000,  대명5동,'70,65 - 69세,1998,335,141,194
'2720060000,  대명5동,'75,70 - 74세,1998,207,81,126
'2720060000,  대명5동,'80,75 - 79세,1998,125,39,86
'2720060000,  대명5동,'85,80 - 84세,1998,83,22,61
'2720060000,  대명5동,'90,85+ ,1998,32,6,26
'2720061000,  대명6동,'00,계,1998,12762,6334,6428
'2720061000,  대명6동,'05,0 - 4세,1998,722,402,320
'2720061000,  대명6동,'10,5 - 9세,1998,741,401,340
'2720061000,  대명6동,'15,10 - 14세,1998,723,396,327
'2720061000,  대명6동,'20,15 - 19세,1998,1204,642,562
'2720061000,  대명6동,'25,20 - 24세,1998,1319,640,679
'2720061000,  대명6동,'30,25 - 29세,1998,1423,728,695
'2720061000,  대명6동,'35,30 - 34세,1998,976,519,457
'2720061000,  대명6동,'40,35 - 39세,1998,1014,470,544
'2720061000,  대명6동,'45,40 - 44세,1998,961,453,508
'2720061000,  대명6동,'50,45 - 49세,1998,863,418,445
'2720061000,  대명6동,'55,50 - 54세,1998,732,347,385
'2720061000,  대명6동,'60,55 - 59세,1998,696,328,368
'2720061000,  대명6동,'65,60 - 64세,1998,570,271,299
'2720061000,  대명6동,'70,65 - 69세,1998,336,160,176
'2720061000,  대명6동,'75,70 - 74세,1998,207,80,127
'2720061000,  대명6동,'80,75 - 79세,1998,145,52,93
'2720061000,  대명6동,'85,80 - 84세,1998,90,17,73
'2720061000,  대명6동,'90,85+ ,1998,40,10,30
'2720064000,  대명9동,'00,계,1998,17681,8595,9086
'2720064000,  대명9동,'05,0 - 4세,1998,1057,564,493
'2720064000,  대명9동,'10,5 - 9세,1998,972,525,447
'2720064000,  대명9동,'15,10 - 14세,1998,1020,592,428
'2720064000,  대명9동,'20,15 - 19세,1998,1501,750,751
'2720064000,  대명9동,'25,20 - 24세,1998,1666,809,857
'2720064000,  대명9동,'30,25 - 29세,1998,1909,980,929
'2720064000,  대명9동,'35,30 - 34세,1998,1551,749,802
'2720064000,  대명9동,'40,35 - 39세,1998,1483,717,766
'2720064000,  대명9동,'45,40 - 44세,1998,1354,631,723
'2720064000,  대명9동,'50,45 - 49세,1998,1130,529,601
'2720064000,  대명9동,'55,50 - 54세,1998,1038,480,558
'2720064000,  대명9동,'60,55 - 59세,1998,1006,442,564
'2720064000,  대명9동,'65,60 - 64세,1998,831,400,431
'2720064000,  대명9동,'70,65 - 69세,1998,486,205,281
'2720064000,  대명9동,'75,70 - 74세,1998,284,116,168
'2720064000,  대명9동,'80,75 - 79세,1998,200,60,140
'2720064000,  대명9동,'85,80 - 84세,1998,123,30,93
'2720064000,  대명9동,'90,85+ ,1998,70,16,54
'2720065000,  대명10동,'00,계,1998,13468,6716,6752
'2720065000,  대명10동,'05,0 - 4세,1998,811,439,372
'2720065000,  대명10동,'10,5 - 9세,1998,752,418,334
'2720065000,  대명10동,'15,10 - 14세,1998,762,419,343
'2720065000,  대명10동,'20,15 - 19세,1998,1249,627,622
'2720065000,  대명10동,'25,20 - 24세,1998,1369,698,671
'2720065000,  대명10동,'30,25 - 29세,1998,1575,845,730
'2720065000,  대명10동,'35,30 - 34세,1998,1100,574,526
'2720065000,  대명10동,'40,35 - 39세,1998,1068,517,551
'2720065000,  대명10동,'45,40 - 44세,1998,1033,507,526
'2720065000,  대명10동,'50,45 - 49세,1998,879,396,483
'2720065000,  대명10동,'55,50 - 54세,1998,733,333,400
'2720065000,  대명10동,'60,55 - 59세,1998,727,355,372
'2720065000,  대명10동,'65,60 - 64세,1998,560,262,298
'2720065000,  대명10동,'70,65 - 69세,1998,359,147,212
'2720065000,  대명10동,'75,70 - 74세,1998,241,103,138
'2720065000,  대명10동,'80,75 - 79세,1998,137,46,91
'2720065000,  대명10동,'85,80 - 84세,1998,71,20,51
'2720065000,  대명10동,'90,85+ ,1998,42,10,32
'2720066000,  대명11동,'00,계,1998,14557,7264,7293
'2720066000,  대명11동,'05,0 - 4세,1998,943,477,466
'2720066000,  대명11동,'10,5 - 9세,1998,951,543,408
'2720066000,  대명11동,'15,10 - 14세,1998,878,493,385
'2720066000,  대명11동,'20,15 - 19세,1998,1341,704,637
'2720066000,  대명11동,'25,20 - 24세,1998,1524,781,743
'2720066000,  대명11동,'30,25 - 29세,1998,1600,812,788
'2720066000,  대명11동,'35,30 - 34세,1998,1284,623,661
'2720066000,  대명11동,'40,35 - 39세,1998,1250,656,594
'2720066000,  대명11동,'45,40 - 44세,1998,1079,498,581
'2720066000,  대명11동,'50,45 - 49세,1998,975,463,512
'2720066000,  대명11동,'55,50 - 54세,1998,701,333,368
'2720066000,  대명11동,'60,55 - 59세,1998,730,350,380
'2720066000,  대명11동,'65,60 - 64세,1998,544,262,282
'2720066000,  대명11동,'70,65 - 69세,1998,313,130,183
'2720066000,  대명11동,'75,70 - 74세,1998,214,76,138
'2720066000,  대명11동,'80,75 - 79세,1998,122,39,83
'2720066000,  대명11동,'85,80 - 84세,1998,72,17,55
'2720066000,  대명11동,'90,85+ ,1998,36,7,29
'27230, 북구,'00,계,1998,392603,198521,194082
'27230, 북구,'05,0 - 4세,1998,31128,16737,14391
'27230, 북구,'10,5 - 9세,1998,31915,17684,14231
'27230, 북구,'15,10 - 14세,1998,28989,15672,13317
'27230, 북구,'20,15 - 19세,1998,33212,16992,16220
'27230, 북구,'25,20 - 24세,1998,31526,16083,15443
'27230, 북구,'30,25 - 29세,1998,38690,18817,19873
'27230, 북구,'35,30 - 34세,1998,40241,20128,20113
'27230, 북구,'40,35 - 39세,1998,41884,21535,20349
'27230, 북구,'45,40 - 44세,1998,30961,16570,14391
'27230, 북구,'50,45 - 49세,1998,21514,10944,10570
'27230, 북구,'55,50 - 54세,1998,16077,7778,8299
'27230, 북구,'60,55 - 59세,1998,16312,7802,8510
'27230, 북구,'65,60 - 64세,1998,12002,5516,6486
'27230, 북구,'70,65 - 69세,1998,7563,2975,4588
'27230, 북구,'75,70 - 74세,1998,4945,1757,3188
'27230, 북구,'80,75 - 79세,1998,3127,942,2185
'27230, 북구,'85,80 - 84세,1998,1658,430,1228
'27230, 북구,'90,85+ ,1998,859,159,700
'2723051000,  고성동,'00,계,1998,11842,5911,5931
'2723051000,  고성동,'05,0 - 4세,1998,555,297,258
'2723051000,  고성동,'10,5 - 9세,1998,674,369,305
'2723051000,  고성동,'15,10 - 14세,1998,700,378,322
'2723051000,  고성동,'20,15 - 19세,1998,1138,580,558
'2723051000,  고성동,'25,20 - 24세,1998,1214,644,570
'2723051000,  고성동,'30,25 - 29세,1998,1181,661,520
'2723051000,  고성동,'35,30 - 34세,1998,921,485,436
'2723051000,  고성동,'40,35 - 39세,1998,1016,511,505
'2723051000,  고성동,'45,40 - 44세,1998,954,466,488
'2723051000,  고성동,'50,45 - 49세,1998,793,384,409
'2723051000,  고성동,'55,50 - 54세,1998,664,317,347
'2723051000,  고성동,'60,55 - 59세,1998,673,314,359
'2723051000,  고성동,'65,60 - 64세,1998,507,209,298
'2723051000,  고성동,'70,65 - 69세,1998,316,128,188
'2723051000,  고성동,'75,70 - 74세,1998,248,84,164
'2723051000,  고성동,'80,75 - 79세,1998,158,55,103
'2723051000,  고성동,'85,80 - 84세,1998,84,21,63
'2723051000,  고성동,'90,85+ ,1998,46,8,38
'2723052500,  칠성1동,'00,계,1998,9312,4650,4662
'2723052500,  칠성1동,'05,0 - 4세,1998,375,187,188
'2723052500,  칠성1동,'10,5 - 9세,1998,432,244,188
'2723052500,  칠성1동,'15,10 - 14세,1998,525,285,240
'2723052500,  칠성1동,'20,15 - 19세,1998,855,441,414
'2723052500,  칠성1동,'25,20 - 24세,1998,881,464,417
'2723052500,  칠성1동,'30,25 - 29세,1998,909,514,395
'2723052500,  칠성1동,'35,30 - 34세,1998,591,315,276
'2723052500,  칠성1동,'40,35 - 39세,1998,755,384,371
'2723052500,  칠성1동,'45,40 - 44세,1998,740,398,342
'2723052500,  칠성1동,'50,45 - 49세,1998,640,310,330
'2723052500,  칠성1동,'55,50 - 54세,1998,590,267,323
'2723052500,  칠성1동,'60,55 - 59세,1998,685,311,374
'2723052500,  칠성1동,'65,60 - 64세,1998,534,243,291
'2723052500,  칠성1동,'70,65 - 69세,1998,337,133,204
'2723052500,  칠성1동,'75,70 - 74세,1998,191,73,118
'2723052500,  칠성1동,'80,75 - 79세,1998,138,48,90
'2723052500,  칠성1동,'85,80 - 84세,1998,88,23,65
'2723052500,  칠성1동,'90,85+ ,1998,46,10,36
'2723053500,  칠성2동,'00,계,1998,11146,5635,5511
'2723053500,  칠성2동,'05,0 - 4세,1998,757,408,349
'2723053500,  칠성2동,'10,5 - 9세,1998,858,493,365
'2723053500,  칠성2동,'15,10 - 14세,1998,715,377,338
'2723053500,  칠성2동,'20,15 - 19세,1998,973,503,470
'2723053500,  칠성2동,'25,20 - 24세,1998,1007,550,457
'2723053500,  칠성2동,'30,25 - 29세,1998,1028,498,530
'2723053500,  칠성2동,'35,30 - 34세,1998,1029,499,530
'2723053500,  칠성2동,'40,35 - 39세,1998,1097,556,541
'2723053500,  칠성2동,'45,40 - 44세,1998,936,461,475
'2723053500,  칠성2동,'50,45 - 49세,1998,673,338,335
'2723053500,  칠성2동,'55,50 - 54세,1998,590,286,304
'2723053500,  칠성2동,'60,55 - 59세,1998,572,286,286
'2723053500,  칠성2동,'65,60 - 64세,1998,358,183,175
'2723053500,  칠성2동,'70,65 - 69세,1998,205,87,118
'2723053500,  칠성2동,'75,70 - 74세,1998,161,65,96
'2723053500,  칠성2동,'80,75 - 79세,1998,104,28,76
'2723053500,  칠성2동,'85,80 - 84세,1998,53,12,41
'2723053500,  칠성2동,'90,85+ ,1998,30,5,25
'2723055000,  침산1동,'00,계,1998,9473,4986,4487
'2723055000,  침산1동,'05,0 - 4세,1998,573,305,268
'2723055000,  침산1동,'10,5 - 9세,1998,661,370,291
'2723055000,  침산1동,'15,10 - 14세,1998,679,368,311
'2723055000,  침산1동,'20,15 - 19세,1998,923,503,420
'2723055000,  침산1동,'25,20 - 24세,1998,854,446,408
'2723055000,  침산1동,'30,25 - 29세,1998,885,510,375
'2723055000,  침산1동,'35,30 - 34세,1998,939,483,456
'2723055000,  침산1동,'40,35 - 39세,1998,999,559,440
'2723055000,  침산1동,'45,40 - 44세,1998,745,414,331
'2723055000,  침산1동,'50,45 - 49세,1998,572,288,284
'2723055000,  침산1동,'55,50 - 54세,1998,435,220,215
'2723055000,  침산1동,'60,55 - 59세,1998,447,220,227
'2723055000,  침산1동,'65,60 - 64세,1998,328,150,178
'2723055000,  침산1동,'70,65 - 69세,1998,173,73,100
'2723055000,  침산1동,'75,70 - 74세,1998,122,38,84
'2723055000,  침산1동,'80,75 - 79세,1998,77,25,52
'2723055000,  침산1동,'85,80 - 84세,1998,44,9,35
'2723055000,  침산1동,'90,85+ ,1998,17,5,12
'2723056000,  침산2동,'00,계,1998,8510,4195,4315
'2723056000,  침산2동,'05,0 - 4세,1998,564,282,282
'2723056000,  침산2동,'10,5 - 9세,1998,525,292,233
'2723056000,  침산2동,'15,10 - 14세,1998,534,284,250
'2723056000,  침산2동,'20,15 - 19세,1998,762,352,410
'2723056000,  침산2동,'25,20 - 24세,1998,760,361,399
'2723056000,  침산2동,'30,25 - 29세,1998,912,459,453
'2723056000,  침산2동,'35,30 - 34세,1998,786,437,349
'2723056000,  침산2동,'40,35 - 39세,1998,745,380,365
'2723056000,  침산2동,'45,40 - 44세,1998,634,316,318
'2723056000,  침산2동,'50,45 - 49세,1998,538,254,284
'2723056000,  침산2동,'55,50 - 54세,1998,439,217,222
'2723056000,  침산2동,'60,55 - 59세,1998,477,223,254
'2723056000,  침산2동,'65,60 - 64세,1998,344,162,182
'2723056000,  침산2동,'70,65 - 69세,1998,205,82,123
'2723056000,  침산2동,'75,70 - 74세,1998,120,46,74
'2723056000,  침산2동,'80,75 - 79세,1998,91,32,59
'2723056000,  침산2동,'85,80 - 84세,1998,51,12,39
'2723056000,  침산2동,'90,85+ ,1998,23,4,19
'2723057000,  침산3동,'00,계,1998,14878,7503,7375
'2723057000,  침산3동,'05,0 - 4세,1998,1089,586,503
'2723057000,  침산3동,'10,5 - 9세,1998,1219,683,536
'2723057000,  침산3동,'15,10 - 14세,1998,1118,611,507
'2723057000,  침산3동,'20,15 - 19세,1998,1256,590,666
'2723057000,  침산3동,'25,20 - 24세,1998,1226,637,589
'2723057000,  침산3동,'30,25 - 29세,1998,1360,668,692
'2723057000,  침산3동,'35,30 - 34세,1998,1509,743,766
'2723057000,  침산3동,'40,35 - 39세,1998,1583,816,767
'2723057000,  침산3동,'45,40 - 44세,1998,1159,624,535
'2723057000,  침산3동,'50,45 - 49세,1998,872,433,439
'2723057000,  침산3동,'55,50 - 54세,1998,672,338,334
'2723057000,  침산3동,'60,55 - 59세,1998,663,328,335
'2723057000,  침산3동,'65,60 - 64세,1998,465,216,249
'2723057000,  침산3동,'70,65 - 69세,1998,282,103,179
'2723057000,  침산3동,'75,70 - 74세,1998,194,67,127
'2723057000,  침산3동,'80,75 - 79세,1998,120,38,82
'2723057000,  침산3동,'85,80 - 84세,1998,64,19,45
'2723057000,  침산3동,'90,85+ ,1998,27,3,24
'2723058500,  노원1·2동,'00,계,1998,11822,6148,5674
'2723058500,  노원1·2동,'05,0 - 4세,1998,638,346,292
'2723058500,  노원1·2동,'10,5 - 9세,1998,623,349,274
'2723058500,  노원1·2동,'15,10 - 14세,1998,749,439,310
'2723058500,  노원1·2동,'20,15 - 19세,1998,1207,615,592
'2723058500,  노원1·2동,'25,20 - 24세,1998,1314,741,573
'2723058500,  노원1·2동,'30,25 - 29세,1998,1169,623,546
'2723058500,  노원1·2동,'35,30 - 34세,1998,896,499,397
'2723058500,  노원1·2동,'40,35 - 39세,1998,1020,534,486
'2723058500,  노원1·2동,'45,40 - 44세,1998,941,459,482
'2723058500,  노원1·2동,'50,45 - 49세,1998,880,444,436
'2723058500,  노원1·2동,'55,50 - 54세,1998,700,335,365
'2723058500,  노원1·2동,'60,55 - 59세,1998,664,339,325
'2723058500,  노원1·2동,'65,60 - 64세,1998,420,202,218
'2723058500,  노원1·2동,'70,65 - 69세,1998,258,112,146
'2723058500,  노원1·2동,'75,70 - 74세,1998,159,65,94
'2723058500,  노원1·2동,'80,75 - 79세,1998,92,30,62
'2723058500,  노원1·2동,'85,80 - 84세,1998,60,10,50
'2723058500,  노원1·2동,'90,85+ ,1998,32,6,26
'2723059500,  노원3동,'00,계,1998,8043,4191,3852
'2723059500,  노원3동,'05,0 - 4세,1998,382,196,186
'2723059500,  노원3동,'10,5 - 9세,1998,507,312,195
'2723059500,  노원3동,'15,10 - 14세,1998,521,270,251
'2723059500,  노원3동,'20,15 - 19세,1998,877,434,443
'2723059500,  노원3동,'25,20 - 24세,1998,819,435,384
'2723059500,  노원3동,'30,25 - 29세,1998,746,444,302
'2723059500,  노원3동,'35,30 - 34세,1998,648,365,283
'2723059500,  노원3동,'40,35 - 39세,1998,743,398,345
'2723059500,  노원3동,'45,40 - 44세,1998,658,337,321
'2723059500,  노원3동,'50,45 - 49세,1998,571,292,279
'2723059500,  노원3동,'55,50 - 54세,1998,421,213,208
'2723059500,  노원3동,'60,55 - 59세,1998,415,206,209
'2723059500,  노원3동,'65,60 - 64세,1998,300,127,173
'2723059500,  노원3동,'70,65 - 69세,1998,179,80,99
'2723059500,  노원3동,'75,70 - 74세,1998,134,49,85
'2723059500,  노원3동,'80,75 - 79세,1998,72,24,48
'2723059500,  노원3동,'85,80 - 84세,1998,36,7,29
'2723059500,  노원3동,'90,85+ ,1998,14,2,12
'2723061000,  산격1동,'00,계,1998,20301,10167,10134
'2723061000,  산격1동,'05,0 - 4세,1998,1076,580,496
'2723061000,  산격1동,'10,5 - 9세,1998,1128,640,488
'2723061000,  산격1동,'15,10 - 14세,1998,1204,626,578
'2723061000,  산격1동,'20,15 - 19세,1998,2295,1196,1099
'2723061000,  산격1동,'25,20 - 24세,1998,2518,1368,1150
'2723061000,  산격1동,'30,25 - 29세,1998,1986,1095,891
'2723061000,  산격1동,'35,30 - 34세,1998,1568,836,732
'2723061000,  산격1동,'40,35 - 39세,1998,1589,827,762
'2723061000,  산격1동,'45,40 - 44세,1998,1467,678,789
'2723061000,  산격1동,'50,45 - 49세,1998,1467,627,840
'2723061000,  산격1동,'55,50 - 54세,1998,1078,479,599
'2723061000,  산격1동,'60,55 - 59세,1998,1102,512,590
'2723061000,  산격1동,'65,60 - 64세,1998,752,344,408
'2723061000,  산격1동,'70,65 - 69세,1998,458,179,279
'2723061000,  산격1동,'75,70 - 74세,1998,280,86,194
'2723061000,  산격1동,'80,75 - 79세,1998,185,59,126
'2723061000,  산격1동,'85,80 - 84세,1998,103,28,75
'2723061000,  산격1동,'90,85+ ,1998,45,7,38
'2723062000,  산격2동,'00,계,1998,10884,5495,5389
'2723062000,  산격2동,'05,0 - 4세,1998,790,442,348
'2723062000,  산격2동,'10,5 - 9세,1998,875,474,401
'2723062000,  산격2동,'15,10 - 14세,1998,876,479,397
'2723062000,  산격2동,'20,15 - 19세,1998,1104,570,534
'2723062000,  산격2동,'25,20 - 24세,1998,896,439,457
'2723062000,  산격2동,'30,25 - 29세,1998,994,491,503
'2723062000,  산격2동,'35,30 - 34세,1998,997,473,524
'2723062000,  산격2동,'40,35 - 39세,1998,1190,608,582
'2723062000,  산격2동,'45,40 - 44세,1998,919,477,442
'2723062000,  산격2동,'50,45 - 49세,1998,670,343,327
'2723062000,  산격2동,'55,50 - 54세,1998,427,215,212
'2723062000,  산격2동,'60,55 - 59세,1998,394,196,198
'2723062000,  산격2동,'65,60 - 64세,1998,293,138,155
'2723062000,  산격2동,'70,65 - 69세,1998,179,60,119
'2723062000,  산격2동,'75,70 - 74세,1998,132,47,85
'2723062000,  산격2동,'80,75 - 79세,1998,86,25,61
'2723062000,  산격2동,'85,80 - 84세,1998,44,14,30
'2723062000,  산격2동,'90,85+ ,1998,18,4,14
'2723063000,  산격3동,'00,계,1998,15838,7900,7938
'2723063000,  산격3동,'05,0 - 4세,1998,973,516,457
'2723063000,  산격3동,'10,5 - 9세,1998,994,563,431
'2723063000,  산격3동,'15,10 - 14세,1998,972,532,440
'2723063000,  산격3동,'20,15 - 19세,1998,1533,801,732
'2723063000,  산격3동,'25,20 - 24세,1998,1853,902,951
'2723063000,  산격3동,'30,25 - 29세,1998,1705,869,836
'2723063000,  산격3동,'35,30 - 34세,1998,1366,712,654
'2723063000,  산격3동,'40,35 - 39세,1998,1322,635,687
'2723063000,  산격3동,'45,40 - 44세,1998,1273,595,678
'2723063000,  산격3동,'50,45 - 49세,1998,999,492,507
'2723063000,  산격3동,'55,50 - 54세,1998,813,398,415
'2723063000,  산격3동,'60,55 - 59세,1998,768,366,402
'2723063000,  산격3동,'65,60 - 64세,1998,521,258,263
'2723063000,  산격3동,'70,65 - 69세,1998,334,145,189
'2723063000,  산격3동,'75,70 - 74세,1998,191,71,120
'2723063000,  산격3동,'80,75 - 79세,1998,112,23,89
'2723063000,  산격3동,'85,80 - 84세,1998,70,14,56
'2723063000,  산격3동,'90,85+ ,1998,39,8,31
'2723063100,  산격4동,'00,계,1998,15298,7747,7551
'2723063100,  산격4동,'05,0 - 4세,1998,1137,625,512
'2723063100,  산격4동,'10,5 - 9세,1998,964,541,423
'2723063100,  산격4동,'15,10 - 14세,1998,890,509,381
'2723063100,  산격4동,'20,15 - 19세,1998,1512,743,769
'2723063100,  산격4동,'25,20 - 24세,1998,1514,748,766
'2723063100,  산격4동,'30,25 - 29세,1998,1703,872,831
'2723063100,  산격4동,'35,30 - 34세,1998,1451,788,663
'2723063100,  산격4동,'40,35 - 39세,1998,1276,663,613
'2723063100,  산격4동,'45,40 - 44세,1998,1167,564,603
'2723063100,  산격4동,'50,45 - 49세,1998,950,467,483
'2723063100,  산격4동,'55,50 - 54세,1998,782,382,400
'2723063100,  산격4동,'60,55 - 59세,1998,714,370,344
'2723063100,  산격4동,'65,60 - 64세,1998,505,233,272
'2723063100,  산격4동,'70,65 - 69세,1998,301,127,174
'2723063100,  산격4동,'75,70 - 74세,1998,183,56,127
'2723063100,  산격4동,'80,75 - 79세,1998,138,41,97
'2723063100,  산격4동,'85,80 - 84세,1998,73,12,61
'2723063100,  산격4동,'90,85+ ,1998,38,6,32
'2723064000,  대현1동,'00,계,1998,10740,5436,5304
'2723064000,  대현1동,'05,0 - 4세,1998,644,319,325
'2723064000,  대현1동,'10,5 - 9세,1998,659,371,288
'2723064000,  대현1동,'15,10 - 14세,1998,633,344,289
'2723064000,  대현1동,'20,15 - 19세,1998,861,467,394
'2723064000,  대현1동,'25,20 - 24세,1998,1120,565,555
'2723064000,  대현1동,'30,25 - 29세,1998,1335,751,584
'2723064000,  대현1동,'35,30 - 34세,1998,963,495,468
'2723064000,  대현1동,'40,35 - 39세,1998,877,436,441
'2723064000,  대현1동,'45,40 - 44세,1998,755,393,362
'2723064000,  대현1동,'50,45 - 49세,1998,631,300,331
'2723064000,  대현1동,'55,50 - 54세,1998,562,247,315
'2723064000,  대현1동,'60,55 - 59세,1998,618,292,326
'2723064000,  대현1동,'65,60 - 64세,1998,470,222,248
'2723064000,  대현1동,'70,65 - 69세,1998,252,106,146
'2723064000,  대현1동,'75,70 - 74세,1998,177,80,97
'2723064000,  대현1동,'80,75 - 79세,1998,100,29,71
'2723064000,  대현1동,'85,80 - 84세,1998,53,13,40
'2723064000,  대현1동,'90,85+ ,1998,30,6,24
'2723065000,  대현2동,'00,계,1998,14345,7232,7113
'2723065000,  대현2동,'05,0 - 4세,1998,750,402,348
'2723065000,  대현2동,'10,5 - 9세,1998,715,398,317
'2723065000,  대현2동,'15,10 - 14세,1998,752,407,345
'2723065000,  대현2동,'20,15 - 19세,1998,1295,668,627
'2723065000,  대현2동,'25,20 - 24세,1998,1502,761,741
'2723065000,  대현2동,'30,25 - 29세,1998,1560,894,666
'2723065000,  대현2동,'35,30 - 34세,1998,1148,666,482
'2723065000,  대현2동,'40,35 - 39세,1998,1092,561,531
'2723065000,  대현2동,'45,40 - 44세,1998,1070,547,523
'2723065000,  대현2동,'50,45 - 49세,1998,990,456,534
'2723065000,  대현2동,'55,50 - 54세,1998,780,362,418
'2723065000,  대현2동,'60,55 - 59세,1998,946,417,529
'2723065000,  대현2동,'65,60 - 64세,1998,745,352,393
'2723065000,  대현2동,'70,65 - 69세,1998,427,160,267
'2723065000,  대현2동,'75,70 - 74세,1998,294,108,186
'2723065000,  대현2동,'80,75 - 79세,1998,157,42,115
'2723065000,  대현2동,'85,80 - 84세,1998,95,26,69
'2723065000,  대현2동,'90,85+ ,1998,27,5,22
'2723067100,  복현1동,'00,계,1998,10046,5075,4971
'2723067100,  복현1동,'05,0 - 4세,1998,573,308,265
'2723067100,  복현1동,'10,5 - 9세,1998,651,347,304
'2723067100,  복현1동,'15,10 - 14세,1998,615,347,268
'2723067100,  복현1동,'20,15 - 19세,1998,979,510,469
'2723067100,  복현1동,'25,20 - 24세,1998,1100,585,515
'2723067100,  복현1동,'30,25 - 29세,1998,1057,557,500
'2723067100,  복현1동,'35,30 - 34세,1998,816,408,408
'2723067100,  복현1동,'40,35 - 39세,1998,888,426,462
'2723067100,  복현1동,'45,40 - 44세,1998,804,417,387
'2723067100,  복현1동,'50,45 - 49세,1998,681,316,365
'2723067100,  복현1동,'55,50 - 54세,1998,541,251,290
'2723067100,  복현1동,'60,55 - 59세,1998,493,237,256
'2723067100,  복현1동,'65,60 - 64세,1998,352,182,170
'2723067100,  복현1동,'70,65 - 69세,1998,193,87,106
'2723067100,  복현1동,'75,70 - 74세,1998,134,47,87
'2723067100,  복현1동,'80,75 - 79세,1998,96,30,66
'2723067100,  복현1동,'85,80 - 84세,1998,45,17,28
'2723067100,  복현1동,'90,85+ ,1998,28,3,25
'2723067200,  복현2동,'00,계,1998,34707,17384,17323
'2723067200,  복현2동,'05,0 - 4세,1998,2747,1482,1265
'2723067200,  복현2동,'10,5 - 9세,1998,2694,1526,1168
'2723067200,  복현2동,'15,10 - 14세,1998,2731,1507,1224
'2723067200,  복현2동,'20,15 - 19세,1998,3438,1826,1612
'2723067200,  복현2동,'25,20 - 24세,1998,2714,1312,1402
'2723067200,  복현2동,'30,25 - 29세,1998,3112,1444,1668
'2723067200,  복현2동,'35,30 - 34세,1998,3413,1658,1755
'2723067200,  복현2동,'40,35 - 39세,1998,3680,1747,1933
'2723067200,  복현2동,'45,40 - 44세,1998,3196,1642,1554
'2723067200,  복현2동,'50,45 - 49세,1998,2148,1132,1016
'2723067200,  복현2동,'55,50 - 54세,1998,1346,688,658
'2723067200,  복현2동,'60,55 - 59세,1998,1133,564,569
'2723067200,  복현2동,'65,60 - 64세,1998,842,360,482
'2723067200,  복현2동,'70,65 - 69세,1998,628,239,389
'2723067200,  복현2동,'75,70 - 74세,1998,418,140,278
'2723067200,  복현2동,'80,75 - 79세,1998,286,72,214
'2723067200,  복현2동,'85,80 - 84세,1998,117,32,85
'2723067200,  복현2동,'90,85+ ,1998,64,13,51
'2723068000,  검단동,'00,계,1998,12479,6430,6049
'2723068000,  검단동,'05,0 - 4세,1998,856,465,391
'2723068000,  검단동,'10,5 - 9세,1998,893,495,398
'2723068000,  검단동,'15,10 - 14세,1998,1114,604,510
'2723068000,  검단동,'20,15 - 19세,1998,1203,640,563
'2723068000,  검단동,'25,20 - 24세,1998,955,509,446
'2723068000,  검단동,'30,25 - 29세,1998,1209,596,613
'2723068000,  검단동,'35,30 - 34세,1998,1086,546,540
'2723068000,  검단동,'40,35 - 39세,1998,1441,668,773
'2723068000,  검단동,'45,40 - 44세,1998,1127,612,515
'2723068000,  검단동,'50,45 - 49세,1998,737,428,309
'2723068000,  검단동,'55,50 - 54세,1998,511,256,255
'2723068000,  검단동,'60,55 - 59세,1998,520,258,262
'2723068000,  검단동,'65,60 - 64세,1998,373,196,177
'2723068000,  검단동,'70,65 - 69세,1998,189,77,112
'2723068000,  검단동,'75,70 - 74세,1998,130,45,85
'2723068000,  검단동,'80,75 - 79세,1998,80,22,58
'2723068000,  검단동,'85,80 - 84세,1998,30,10,20
'2723068000,  검단동,'90,85+ ,1998,25,3,22
'2723069500,  무태조야동,'00,계,1998,7194,3745,3449
'2723069500,  무태조야동,'05,0 - 4세,1998,454,237,217
'2723069500,  무태조야동,'10,5 - 9세,1998,547,307,240
'2723069500,  무태조야동,'15,10 - 14세,1998,537,282,255
'2723069500,  무태조야동,'20,15 - 19세,1998,661,351,310
'2723069500,  무태조야동,'25,20 - 24세,1998,561,295,266
'2723069500,  무태조야동,'30,25 - 29세,1998,596,318,278
'2723069500,  무태조야동,'35,30 - 34세,1998,645,322,323
'2723069500,  무태조야동,'40,35 - 39세,1998,780,438,342
'2723069500,  무태조야동,'45,40 - 44세,1998,583,338,245
'2723069500,  무태조야동,'50,45 - 49세,1998,405,221,184
'2723069500,  무태조야동,'55,50 - 54세,1998,304,156,148
'2723069500,  무태조야동,'60,55 - 59세,1998,353,170,183
'2723069500,  무태조야동,'65,60 - 64세,1998,278,124,154
'2723069500,  무태조야동,'70,65 - 69세,1998,205,74,131
'2723069500,  무태조야동,'75,70 - 74세,1998,130,58,72
'2723069500,  무태조야동,'80,75 - 79세,1998,82,30,52
'2723069500,  무태조야동,'85,80 - 84세,1998,48,18,30
'2723069500,  무태조야동,'90,85+ ,1998,25,6,19
'2723072000,  칠곡1동,'00,계,1998,42583,21477,21106
'2723072000,  칠곡1동,'05,0 - 4세,1998,4478,2438,2040
'2723072000,  칠곡1동,'10,5 - 9세,1998,4910,2695,2215
'2723072000,  칠곡1동,'15,10 - 14세,1998,3763,1958,1805
'2723072000,  칠곡1동,'20,15 - 19세,1998,2670,1332,1338
'2723072000,  칠곡1동,'25,20 - 24세,1998,2246,1115,1131
'2723072000,  칠곡1동,'30,25 - 29세,1998,3844,1624,2220
'2723072000,  칠곡1동,'35,30 - 34세,1998,5425,2517,2908
'2723072000,  칠곡1동,'40,35 - 39세,1998,5745,3037,2708
'2723072000,  칠곡1동,'45,40 - 44세,1998,3234,1918,1316
'2723072000,  칠곡1동,'50,45 - 49세,1998,1566,826,740
'2723072000,  칠곡1동,'55,50 - 54세,1998,1151,550,601
'2723072000,  칠곡1동,'60,55 - 59세,1998,1184,563,621
'2723072000,  칠곡1동,'65,60 - 64세,1998,925,402,523
'2723072000,  칠곡1동,'70,65 - 69세,1998,587,225,362
'2723072000,  칠곡1동,'75,70 - 74세,1998,433,161,272
'2723072000,  칠곡1동,'80,75 - 79세,1998,232,69,163
'2723072000,  칠곡1동,'85,80 - 84세,1998,111,27,84
'2723072000,  칠곡1동,'90,85+ ,1998,79,20,59
'2723073000,  칠곡2동,'00,계,1998,15047,7653,7394
'2723073000,  칠곡2동,'05,0 - 4세,1998,1369,716,653
'2723073000,  칠곡2동,'10,5 - 9세,1998,1202,666,536
'2723073000,  칠곡2동,'15,10 - 14세,1998,982,524,458
'2723073000,  칠곡2동,'20,15 - 19세,1998,1031,538,493
'2723073000,  칠곡2동,'25,20 - 24세,1998,1109,585,524
'2723073000,  칠곡2동,'30,25 - 29세,1998,1589,766,823
'2723073000,  칠곡2동,'35,30 - 34세,1998,1878,971,907
'2723073000,  칠곡2동,'40,35 - 39세,1998,1595,886,709
'2723073000,  칠곡2동,'45,40 - 44세,1998,975,525,450
'2723073000,  칠곡2동,'50,45 - 49세,1998,784,396,388
'2723073000,  칠곡2동,'55,50 - 54세,1998,646,293,353
'2723073000,  칠곡2동,'60,55 - 59세,1998,693,342,351
'2723073000,  칠곡2동,'65,60 - 64세,1998,437,199,238
'2723073000,  칠곡2동,'70,65 - 69세,1998,294,107,187
'2723073000,  칠곡2동,'75,70 - 74세,1998,202,67,135
'2723073000,  칠곡2동,'80,75 - 79세,1998,138,35,103
'2723073000,  칠곡2동,'85,80 - 84세,1998,81,29,52
'2723073000,  칠곡2동,'90,85+ ,1998,42,8,34
'2723074000,  칠곡3동,'00,계,1998,45314,22840,22474
'2723074000,  칠곡3동,'05,0 - 4세,1998,4630,2527,2103
'2723074000,  칠곡3동,'10,5 - 9세,1998,4805,2593,2212
'2723074000,  칠곡3동,'15,10 - 14세,1998,3920,2080,1840
'2723074000,  칠곡3동,'20,15 - 19세,1998,3093,1576,1517
'2723074000,  칠곡3동,'25,20 - 24세,1998,2283,1130,1153
'2723074000,  칠곡3동,'30,25 - 29세,1998,4350,1824,2526
'2723074000,  칠곡3동,'35,30 - 34세,1998,5650,2726,2924
'2723074000,  칠곡3동,'40,35 - 39세,1998,5853,3043,2810
'2723074000,  칠곡3동,'45,40 - 44세,1998,3594,2059,1535
'2723074000,  칠곡3동,'50,45 - 49세,1998,1796,1032,764
'2723074000,  칠곡3동,'55,50 - 54세,1998,1167,575,592
'2723074000,  칠곡3동,'60,55 - 59세,1998,1312,594,718
'2723074000,  칠곡3동,'65,60 - 64세,1998,1094,487,607
'2723074000,  칠곡3동,'70,65 - 69세,1998,753,273,480
'2723074000,  칠곡3동,'75,70 - 74세,1998,476,158,318
'2723074000,  칠곡3동,'80,75 - 79세,1998,294,100,194
'2723074000,  칠곡3동,'85,80 - 84세,1998,156,48,108
'2723074000,  칠곡3동,'90,85+ ,1998,88,15,73
'2723075000,  관음동,'00,계,1998,23488,11848,11640
'2723075000,  관음동,'05,0 - 4세,1998,2924,1570,1354
'2723075000,  관음동,'10,5 - 9세,1998,2508,1359,1149
'2723075000,  관음동,'15,10 - 14세,1998,1947,1044,903
'2723075000,  관음동,'20,15 - 19세,1998,1469,730,739
'2723075000,  관음동,'25,20 - 24세,1998,1194,546,648
'2723075000,  관음동,'30,25 - 29세,1998,2584,1052,1532
'2723075000,  관음동,'35,30 - 34세,1998,3186,1619,1567
'2723075000,  관음동,'40,35 - 39세,1998,2854,1504,1350
'2723075000,  관음동,'45,40 - 44세,1998,1722,998,724
'2723075000,  관음동,'50,45 - 49세,1998,832,457,375
'2723075000,  관음동,'55,50 - 54세,1998,535,293,242
'2723075000,  관음동,'60,55 - 59세,1998,548,258,290
'2723075000,  관음동,'65,60 - 64세,1998,457,177,280
'2723075000,  관음동,'70,65 - 69세,1998,345,136,209
'2723075000,  관음동,'75,70 - 74세,1998,172,52,120
'2723075000,  관음동,'80,75 - 79세,1998,111,31,80
'2723075000,  관음동,'85,80 - 84세,1998,70,16,54
'2723075000,  관음동,'90,85+ ,1998,30,6,24
'2723076000,  태전동,'00,계,1998,29313,14873,14440
'2723076000,  태전동,'05,0 - 4세,1998,2794,1503,1291
'2723076000,  태전동,'10,5 - 9세,1998,2871,1597,1274
'2723076000,  태전동,'15,10 - 14세,1998,2512,1417,1095
'2723076000,  태전동,'20,15 - 19세,1998,2077,1026,1051
'2723076000,  태전동,'25,20 - 24세,1998,1886,945,941
'2723076000,  태전동,'30,25 - 29세,1998,2876,1287,1589
'2723076000,  태전동,'35,30 - 34세,1998,3330,1565,1765
'2723076000,  태전동,'40,35 - 39세,1998,3744,1918,1826
'2723076000,  태전동,'45,40 - 44세,1998,2308,1332,976
'2723076000,  태전동,'50,45 - 49세,1998,1319,708,611
'2723076000,  태전동,'55,50 - 54세,1998,923,440,483
'2723076000,  태전동,'60,55 - 59세,1998,938,436,502
'2723076000,  태전동,'65,60 - 64세,1998,702,350,352
'2723076000,  태전동,'70,65 - 69세,1998,463,182,281
'2723076000,  태전동,'75,70 - 74세,1998,264,94,170
'2723076000,  태전동,'80,75 - 79세,1998,178,54,124
'2723076000,  태전동,'85,80 - 84세,1998,82,13,69
'2723076000,  태전동,'90,85+ ,1998,46,6,40
'27260, 수성구,'00,계,1998,462205,230606,231599
'27260, 수성구,'05,0 - 4세,1998,27693,14934,12759
'27260, 수성구,'10,5 - 9세,1998,31549,17916,13633
'27260, 수성구,'15,10 - 14세,1998,36485,20837,15648
'27260, 수성구,'20,15 - 19세,1998,49413,26409,23004
'27260, 수성구,'25,20 - 24세,1998,40578,20846,19732
'27260, 수성구,'30,25 - 29세,1998,40847,20104,20743
'27260, 수성구,'35,30 - 34세,1998,36310,17644,18666
'27260, 수성구,'40,35 - 39세,1998,43273,19434,23839
'27260, 수성구,'45,40 - 44세,1998,43080,20474,22606
'27260, 수성구,'50,45 - 49세,1998,32187,16051,16136
'27260, 수성구,'55,50 - 54세,1998,21699,10952,10747
'27260, 수성구,'60,55 - 59세,1998,19178,9494,9684
'27260, 수성구,'65,60 - 64세,1998,14463,6633,7830
'27260, 수성구,'70,65 - 69세,1998,10121,4059,6062
'27260, 수성구,'75,70 - 74세,1998,6970,2546,4424
'27260, 수성구,'80,75 - 79세,1998,4445,1349,3096
'27260, 수성구,'85,80 - 84세,1998,2509,644,1865
'27260, 수성구,'90,85+ ,1998,1405,280,1125
'2726051000,  범어1동,'00,계,1998,17147,8566,8581
'2726051000,  범어1동,'05,0 - 4세,1998,744,411,333
'2726051000,  범어1동,'10,5 - 9세,1998,917,524,393
'2726051000,  범어1동,'15,10 - 14세,1998,1134,666,468
'2726051000,  범어1동,'20,15 - 19세,1998,1801,909,892
'2726051000,  범어1동,'25,20 - 24세,1998,1818,937,881
'2726051000,  범어1동,'30,25 - 29세,1998,1632,902,730
'2726051000,  범어1동,'35,30 - 34세,1998,1126,560,566
'2726051000,  범어1동,'40,35 - 39세,1998,1270,588,682
'2726051000,  범어1동,'45,40 - 44세,1998,1460,669,791
'2726051000,  범어1동,'50,45 - 49세,1998,1292,601,691
'2726051000,  범어1동,'55,50 - 54세,1998,1066,508,558
'2726051000,  범어1동,'60,55 - 59세,1998,979,492,487
'2726051000,  범어1동,'65,60 - 64세,1998,757,378,379
'2726051000,  범어1동,'70,65 - 69세,1998,499,218,281
'2726051000,  범어1동,'75,70 - 74세,1998,330,117,213
'2726051000,  범어1동,'80,75 - 79세,1998,165,52,113
'2726051000,  범어1동,'85,80 - 84세,1998,99,24,75
'2726051000,  범어1동,'90,85+ ,1998,58,10,48
'2726052000,  범어2동,'00,계,1998,13573,6728,6845
'2726052000,  범어2동,'05,0 - 4세,1998,781,419,362
'2726052000,  범어2동,'10,5 - 9세,1998,768,426,342
'2726052000,  범어2동,'15,10 - 14세,1998,823,445,378
'2726052000,  범어2동,'20,15 - 19세,1998,1362,733,629
'2726052000,  범어2동,'25,20 - 24세,1998,1425,718,707
'2726052000,  범어2동,'30,25 - 29세,1998,1434,729,705
'2726052000,  범어2동,'35,30 - 34세,1998,1040,525,515
'2726052000,  범어2동,'40,35 - 39세,1998,1076,516,560
'2726052000,  범어2동,'45,40 - 44세,1998,1103,501,602
'2726052000,  범어2동,'50,45 - 49세,1998,970,455,515
'2726052000,  범어2동,'55,50 - 54세,1998,709,339,370
'2726052000,  범어2동,'60,55 - 59세,1998,729,362,367
'2726052000,  범어2동,'65,60 - 64세,1998,524,252,272
'2726052000,  범어2동,'70,65 - 69세,1998,331,150,181
'2726052000,  범어2동,'75,70 - 74세,1998,207,79,128
'2726052000,  범어2동,'80,75 - 79세,1998,147,47,100
'2726052000,  범어2동,'85,80 - 84세,1998,85,16,69
'2726052000,  범어2동,'90,85+ ,1998,59,16,43
'2726053000,  범어3동,'00,계,1998,12628,6346,6282
'2726053000,  범어3동,'05,0 - 4세,1998,603,317,286
'2726053000,  범어3동,'10,5 - 9세,1998,687,388,299
'2726053000,  범어3동,'15,10 - 14세,1998,722,403,319
'2726053000,  범어3동,'20,15 - 19세,1998,1260,684,576
'2726053000,  범어3동,'25,20 - 24세,1998,1300,694,606
'2726053000,  범어3동,'30,25 - 29세,1998,1305,706,599
'2726053000,  범어3동,'35,30 - 34세,1998,1023,530,493
'2726053000,  범어3동,'40,35 - 39세,1998,974,464,510
'2726053000,  범어3동,'45,40 - 44세,1998,1049,477,572
'2726053000,  범어3동,'50,45 - 49세,1998,888,421,467
'2726053000,  범어3동,'55,50 - 54세,1998,696,328,368
'2726053000,  범어3동,'60,55 - 59세,1998,711,342,369
'2726053000,  범어3동,'65,60 - 64세,1998,541,251,290
'2726053000,  범어3동,'70,65 - 69세,1998,364,158,206
'2726053000,  범어3동,'75,70 - 74세,1998,233,97,136
'2726053000,  범어3동,'80,75 - 79세,1998,154,53,101
'2726053000,  범어3동,'85,80 - 84세,1998,76,24,52
'2726053000,  범어3동,'90,85+ ,1998,42,9,33
'2726054000,  범어4동,'00,계,1998,21996,11099,10897
'2726054000,  범어4동,'05,0 - 4세,1998,855,457,398
'2726054000,  범어4동,'10,5 - 9세,1998,1127,653,474
'2726054000,  범어4동,'15,10 - 14세,1998,2083,1250,833
'2726054000,  범어4동,'20,15 - 19세,1998,3302,1914,1388
'2726054000,  범어4동,'25,20 - 24세,1998,2181,1168,1013
'2726054000,  범어4동,'30,25 - 29세,1998,1606,824,782
'2726054000,  범어4동,'35,30 - 34세,1998,1075,528,547
'2726054000,  범어4동,'40,35 - 39세,1998,1771,628,1143
'2726054000,  범어4동,'45,40 - 44세,1998,2457,1034,1423
'2726054000,  범어4동,'50,45 - 49세,1998,1993,1004,989
'2726054000,  범어4동,'55,50 - 54세,1998,1137,581,556
'2726054000,  범어4동,'60,55 - 59세,1998,823,443,380
'2726054000,  범어4동,'65,60 - 64세,1998,544,274,270
'2726054000,  범어4동,'70,65 - 69세,1998,377,134,243
'2726054000,  범어4동,'75,70 - 74세,1998,281,110,171
'2726054000,  범어4동,'80,75 - 79세,1998,206,56,150
'2726054000,  범어4동,'85,80 - 84세,1998,107,27,80
'2726054000,  범어4동,'90,85+ ,1998,71,14,57
'2726055000,  만촌1동,'00,계,1998,16612,8443,8169
'2726055000,  만촌1동,'05,0 - 4세,1998,1012,547,465
'2726055000,  만촌1동,'10,5 - 9세,1998,1003,580,423
'2726055000,  만촌1동,'15,10 - 14세,1998,1144,665,479
'2726055000,  만촌1동,'20,15 - 19세,1998,1720,909,811
'2726055000,  만촌1동,'25,20 - 24세,1998,1548,822,726
'2726055000,  만촌1동,'30,25 - 29세,1998,1647,864,783
'2726055000,  만촌1동,'35,30 - 34세,1998,1389,727,662
'2726055000,  만촌1동,'40,35 - 39세,1998,1430,671,759
'2726055000,  만촌1동,'45,40 - 44세,1998,1451,679,772
'2726055000,  만촌1동,'50,45 - 49세,1998,1137,564,573
'2726055000,  만촌1동,'55,50 - 54세,1998,810,413,397
'2726055000,  만촌1동,'60,55 - 59세,1998,777,369,408
'2726055000,  만촌1동,'65,60 - 64세,1998,597,284,313
'2726055000,  만촌1동,'70,65 - 69세,1998,399,164,235
'2726055000,  만촌1동,'75,70 - 74세,1998,245,90,155
'2726055000,  만촌1동,'80,75 - 79세,1998,165,62,103
'2726055000,  만촌1동,'85,80 - 84세,1998,86,21,65
'2726055000,  만촌1동,'90,85+ ,1998,52,12,40
'2726056000,  만촌2동,'00,계,1998,15540,7856,7684
'2726056000,  만촌2동,'05,0 - 4세,1998,905,489,416
'2726056000,  만촌2동,'10,5 - 9세,1998,966,563,403
'2726056000,  만촌2동,'15,10 - 14세,1998,1110,659,451
'2726056000,  만촌2동,'20,15 - 19세,1998,1726,910,816
'2726056000,  만촌2동,'25,20 - 24세,1998,1483,768,715
'2726056000,  만촌2동,'30,25 - 29세,1998,1509,755,754
'2726056000,  만촌2동,'35,30 - 34세,1998,1238,636,602
'2726056000,  만촌2동,'40,35 - 39세,1998,1333,621,712
'2726056000,  만촌2동,'45,40 - 44세,1998,1321,619,702
'2726056000,  만촌2동,'50,45 - 49세,1998,1088,517,571
'2726056000,  만촌2동,'55,50 - 54세,1998,754,401,353
'2726056000,  만촌2동,'60,55 - 59세,1998,706,346,360
'2726056000,  만촌2동,'65,60 - 64세,1998,524,251,273
'2726056000,  만촌2동,'70,65 - 69세,1998,338,158,180
'2726056000,  만촌2동,'75,70 - 74세,1998,233,86,147
'2726056000,  만촌2동,'80,75 - 79세,1998,150,39,111
'2726056000,  만촌2동,'85,80 - 84세,1998,89,24,65
'2726056000,  만촌2동,'90,85+ ,1998,67,14,53
'2726056100,  만촌3동,'00,계,1998,21794,10915,10879
'2726056100,  만촌3동,'05,0 - 4세,1998,1365,730,635
'2726056100,  만촌3동,'10,5 - 9세,1998,1346,775,571
'2726056100,  만촌3동,'15,10 - 14세,1998,1778,1056,722
'2726056100,  만촌3동,'20,15 - 19세,1998,2686,1456,1230
'2726056100,  만촌3동,'25,20 - 24세,1998,2013,1080,933
'2726056100,  만촌3동,'30,25 - 29세,1998,1828,871,957
'2726056100,  만촌3동,'35,30 - 34세,1998,1663,811,852
'2726056100,  만촌3동,'40,35 - 39세,1998,1947,864,1083
'2726056100,  만촌3동,'45,40 - 44세,1998,2170,967,1203
'2726056100,  만촌3동,'50,45 - 49세,1998,1582,792,790
'2726056100,  만촌3동,'55,50 - 54세,1998,1033,534,499
'2726056100,  만촌3동,'60,55 - 59세,1998,793,404,389
'2726056100,  만촌3동,'65,60 - 64세,1998,574,254,320
'2726056100,  만촌3동,'70,65 - 69세,1998,396,165,231
'2726056100,  만촌3동,'75,70 - 74세,1998,277,86,191
'2726056100,  만촌3동,'80,75 - 79세,1998,178,36,142
'2726056100,  만촌3동,'85,80 - 84세,1998,106,25,81
'2726056100,  만촌3동,'90,85+ ,1998,59,9,50
'2726057000,  수성1가동,'00,계,1998,20316,9999,10317
'2726057000,  수성1가동,'05,0 - 4세,1998,1171,624,547
'2726057000,  수성1가동,'10,5 - 9세,1998,1171,675,496
'2726057000,  수성1가동,'15,10 - 14세,1998,1256,736,520
'2726057000,  수성1가동,'20,15 - 19세,1998,2107,1025,1082
'2726057000,  수성1가동,'25,20 - 24세,1998,2033,990,1043
'2726057000,  수성1가동,'30,25 - 29세,1998,1972,998,974
'2726057000,  수성1가동,'35,30 - 34세,1998,1565,795,770
'2726057000,  수성1가동,'40,35 - 39세,1998,1661,767,894
'2726057000,  수성1가동,'45,40 - 44세,1998,1600,750,850
'2726057000,  수성1가동,'50,45 - 49세,1998,1491,685,806
'2726057000,  수성1가동,'55,50 - 54세,1998,1186,578,608
'2726057000,  수성1가동,'60,55 - 59세,1998,1053,534,519
'2726057000,  수성1가동,'65,60 - 64세,1998,799,381,418
'2726057000,  수성1가동,'70,65 - 69세,1998,499,205,294
'2726057000,  수성1가동,'75,70 - 74세,1998,342,145,197
'2726057000,  수성1가동,'80,75 - 79세,1998,215,70,145
'2726057000,  수성1가동,'85,80 - 84세,1998,128,36,92
'2726057000,  수성1가동,'90,85+ ,1998,67,5,62
'2726058000,  수성2·3가동,'00,계,1998,14614,7287,7327
'2726058000,  수성2·3가동,'05,0 - 4세,1998,695,357,338
'2726058000,  수성2·3가동,'10,5 - 9세,1998,779,439,340
'2726058000,  수성2·3가동,'15,10 - 14세,1998,943,528,415
'2726058000,  수성2·3가동,'20,15 - 19세,1998,1541,829,712
'2726058000,  수성2·3가동,'25,20 - 24세,1998,1553,783,770
'2726058000,  수성2·3가동,'30,25 - 29세,1998,1505,821,684
'2726058000,  수성2·3가동,'35,30 - 34세,1998,1078,525,553
'2726058000,  수성2·3가동,'40,35 - 39세,1998,1186,549,637
'2726058000,  수성2·3가동,'45,40 - 44세,1998,1208,551,657
'2726058000,  수성2·3가동,'50,45 - 49세,1998,1077,495,582
'2726058000,  수성2·3가동,'55,50 - 54세,1998,833,420,413
'2726058000,  수성2·3가동,'60,55 - 59세,1998,786,384,402
'2726058000,  수성2·3가동,'65,60 - 64세,1998,538,280,258
'2726058000,  수성2·3가동,'70,65 - 69세,1998,375,166,209
'2726058000,  수성2·3가동,'75,70 - 74세,1998,234,88,146
'2726058000,  수성2·3가동,'80,75 - 79세,1998,151,43,108
'2726058000,  수성2·3가동,'85,80 - 84세,1998,89,21,68
'2726058000,  수성2·3가동,'90,85+ ,1998,43,8,35
'2726059000,  수성4가동,'00,계,1998,17660,8715,8945
'2726059000,  수성4가동,'05,0 - 4세,1998,1202,615,587
'2726059000,  수성4가동,'10,5 - 9세,1998,1185,655,530
'2726059000,  수성4가동,'15,10 - 14세,1998,1095,609,486
'2726059000,  수성4가동,'20,15 - 19세,1998,1657,896,761
'2726059000,  수성4가동,'25,20 - 24세,1998,1541,793,748
'2726059000,  수성4가동,'30,25 - 29세,1998,1874,880,994
'2726059000,  수성4가동,'35,30 - 34세,1998,1582,812,770
'2726059000,  수성4가동,'40,35 - 39세,1998,1531,736,795
'2726059000,  수성4가동,'45,40 - 44세,1998,1413,677,736
'2726059000,  수성4가동,'50,45 - 49세,1998,1157,552,605
'2726059000,  수성4가동,'55,50 - 54세,1998,837,408,429
'2726059000,  수성4가동,'60,55 - 59세,1998,826,391,435
'2726059000,  수성4가동,'65,60 - 64세,1998,695,332,363
'2726059000,  수성4가동,'70,65 - 69세,1998,421,162,259
'2726059000,  수성4가동,'75,70 - 74세,1998,308,110,198
'2726059000,  수성4가동,'80,75 - 79세,1998,195,57,138
'2726059000,  수성4가동,'85,80 - 84세,1998,88,23,65
'2726059000,  수성4가동,'90,85+ ,1998,53,7,46
'2726060100,  황금1동,'00,계,1998,21716,10603,11113
'2726060100,  황금1동,'05,0 - 4세,1998,1198,641,557
'2726060100,  황금1동,'10,5 - 9세,1998,1364,778,586
'2726060100,  황금1동,'15,10 - 14세,1998,1692,998,694
'2726060100,  황금1동,'20,15 - 19세,1998,2845,1646,1199
'2726060100,  황금1동,'25,20 - 24세,1998,1922,989,933
'2726060100,  황금1동,'30,25 - 29세,1998,1629,774,855
'2726060100,  황금1동,'35,30 - 34세,1998,1655,795,860
'2726060100,  황금1동,'40,35 - 39세,1998,1978,823,1155
'2726060100,  황금1동,'45,40 - 44세,1998,2324,950,1374
'2726060100,  황금1동,'50,45 - 49세,1998,1649,823,826
'2726060100,  황금1동,'55,50 - 54세,1998,901,461,440
'2726060100,  황금1동,'60,55 - 59세,1998,680,313,367
'2726060100,  황금1동,'65,60 - 64세,1998,549,204,345
'2726060100,  황금1동,'70,65 - 69세,1998,505,157,348
'2726060100,  황금1동,'75,70 - 74세,1998,375,128,247
'2726060100,  황금1동,'80,75 - 79세,1998,244,75,169
'2726060100,  황금1동,'85,80 - 84세,1998,131,30,101
'2726060100,  황금1동,'90,85+ ,1998,75,18,57
'2726060200,  황금2동,'00,계,1998,15645,7922,7723
'2726060200,  황금2동,'05,0 - 4세,1998,1042,560,482
'2726060200,  황금2동,'10,5 - 9세,1998,1039,589,450
'2726060200,  황금2동,'15,10 - 14세,1998,1073,611,462
'2726060200,  황금2동,'20,15 - 19세,1998,1539,821,718
'2726060200,  황금2동,'25,20 - 24세,1998,1504,770,734
'2726060200,  황금2동,'30,25 - 29세,1998,1586,800,786
'2726060200,  황금2동,'35,30 - 34세,1998,1343,671,672
'2726060200,  황금2동,'40,35 - 39세,1998,1454,703,751
'2726060200,  황금2동,'45,40 - 44세,1998,1267,611,656
'2726060200,  황금2동,'50,45 - 49세,1998,1071,506,565
'2726060200,  황금2동,'55,50 - 54세,1998,783,407,376
'2726060200,  황금2동,'60,55 - 59세,1998,711,366,345
'2726060200,  황금2동,'65,60 - 64세,1998,483,245,238
'2726060200,  황금2동,'70,65 - 69세,1998,291,123,168
'2726060200,  황금2동,'75,70 - 74세,1998,190,69,121
'2726060200,  황금2동,'80,75 - 79세,1998,141,40,101
'2726060200,  황금2동,'85,80 - 84세,1998,81,23,58
'2726060200,  황금2동,'90,85+ ,1998,47,7,40
'2726061000,  중동,'00,계,1998,17387,8669,8718
'2726061000,  중동,'05,0 - 4세,1998,979,560,419
'2726061000,  중동,'10,5 - 9세,1998,935,537,398
'2726061000,  중동,'15,10 - 14세,1998,978,552,426
'2726061000,  중동,'20,15 - 19세,1998,1705,877,828
'2726061000,  중동,'25,20 - 24세,1998,1707,844,863
'2726061000,  중동,'30,25 - 29세,1998,1864,955,909
'2726061000,  중동,'35,30 - 34세,1998,1388,719,669
'2726061000,  중동,'40,35 - 39세,1998,1410,673,737
'2726061000,  중동,'45,40 - 44세,1998,1336,654,682
'2726061000,  중동,'50,45 - 49세,1998,1172,561,611
'2726061000,  중동,'55,50 - 54세,1998,931,430,501
'2726061000,  중동,'60,55 - 59세,1998,1007,476,531
'2726061000,  중동,'65,60 - 64세,1998,792,384,408
'2726061000,  중동,'70,65 - 69세,1998,492,215,277
'2726061000,  중동,'75,70 - 74세,1998,316,135,181
'2726061000,  중동,'80,75 - 79세,1998,202,56,146
'2726061000,  중동,'85,80 - 84세,1998,113,30,83
'2726061000,  중동,'90,85+ ,1998,60,11,49
'2726062000,  상동,'00,계,1998,19959,9900,10059
'2726062000,  상동,'05,0 - 4세,1998,1178,647,531
'2726062000,  상동,'10,5 - 9세,1998,1191,687,504
'2726062000,  상동,'15,10 - 14세,1998,1198,661,537
'2726062000,  상동,'20,15 - 19세,1998,1922,960,962
'2726062000,  상동,'25,20 - 24세,1998,1925,974,951
'2726062000,  상동,'30,25 - 29세,1998,2061,1083,978
'2726062000,  상동,'35,30 - 34세,1998,1607,795,812
'2726062000,  상동,'40,35 - 39세,1998,1672,792,880
'2726062000,  상동,'45,40 - 44세,1998,1557,747,810
'2726062000,  상동,'50,45 - 49세,1998,1385,658,727
'2726062000,  상동,'55,50 - 54세,1998,1071,523,548
'2726062000,  상동,'60,55 - 59세,1998,1058,529,529
'2726062000,  상동,'65,60 - 64세,1998,810,366,444
'2726062000,  상동,'70,65 - 69세,1998,543,239,304
'2726062000,  상동,'75,70 - 74세,1998,341,119,222
'2726062000,  상동,'80,75 - 79세,1998,206,65,141
'2726062000,  상동,'85,80 - 84세,1998,153,37,116
'2726062000,  상동,'90,85+ ,1998,81,18,63
'2726063000,  파동,'00,계,1998,17802,8873,8929
'2726063000,  파동,'05,0 - 4세,1998,1001,521,480
'2726063000,  파동,'10,5 - 9세,1998,1096,620,476
'2726063000,  파동,'15,10 - 14세,1998,1165,663,502
'2726063000,  파동,'20,15 - 19세,1998,1814,958,856
'2726063000,  파동,'25,20 - 24세,1998,1588,806,782
'2726063000,  파동,'30,25 - 29세,1998,1643,857,786
'2726063000,  파동,'35,30 - 34세,1998,1345,671,674
'2726063000,  파동,'40,35 - 39세,1998,1475,678,797
'2726063000,  파동,'45,40 - 44세,1998,1429,672,757
'2726063000,  파동,'50,45 - 49세,1998,1261,612,649
'2726063000,  파동,'55,50 - 54세,1998,945,485,460
'2726063000,  파동,'60,55 - 59세,1998,943,439,504
'2726063000,  파동,'65,60 - 64세,1998,768,353,415
'2726063000,  파동,'70,65 - 69세,1998,568,253,315
'2726063000,  파동,'75,70 - 74세,1998,344,148,196
'2726063000,  파동,'80,75 - 79세,1998,215,76,139
'2726063000,  파동,'85,80 - 84세,1998,128,40,88
'2726063000,  파동,'90,85+ ,1998,74,21,53
'2726064000,  두산동,'00,계,1998,11160,5561,5599
'2726064000,  두산동,'05,0 - 4세,1998,877,473,404
'2726064000,  두산동,'10,5 - 9세,1998,645,378,267
'2726064000,  두산동,'15,10 - 14세,1998,645,364,281
'2726064000,  두산동,'20,15 - 19세,1998,1062,558,504
'2726064000,  두산동,'25,20 - 24세,1998,1040,514,526
'2726064000,  두산동,'30,25 - 29세,1998,1339,612,727
'2726064000,  두산동,'35,30 - 34세,1998,1105,592,513
'2726064000,  두산동,'40,35 - 39세,1998,905,432,473
'2726064000,  두산동,'45,40 - 44세,1998,887,414,473
'2726064000,  두산동,'50,45 - 49세,1998,797,381,416
'2726064000,  두산동,'55,50 - 54세,1998,518,271,247
'2726064000,  두산동,'60,55 - 59세,1998,443,218,225
'2726064000,  두산동,'65,60 - 64세,1998,309,153,156
'2726064000,  두산동,'70,65 - 69세,1998,217,81,136
'2726064000,  두산동,'75,70 - 74세,1998,163,56,107
'2726064000,  두산동,'80,75 - 79세,1998,115,42,73
'2726064000,  두산동,'85,80 - 84세,1998,65,19,46
'2726064000,  두산동,'90,85+ ,1998,28,3,25
'2726065100,  지산1동,'00,계,1998,31915,15852,16063
'2726065100,  지산1동,'05,0 - 4세,1998,1895,1019,876
'2726065100,  지산1동,'10,5 - 9세,1998,2191,1234,957
'2726065100,  지산1동,'15,10 - 14세,1998,2421,1346,1075
'2726065100,  지산1동,'20,15 - 19세,1998,3564,1969,1595
'2726065100,  지산1동,'25,20 - 24세,1998,2888,1494,1394
'2726065100,  지산1동,'30,25 - 29세,1998,2871,1376,1495
'2726065100,  지산1동,'35,30 - 34세,1998,2532,1252,1280
'2726065100,  지산1동,'40,35 - 39세,1998,2868,1249,1619
'2726065100,  지산1동,'45,40 - 44세,1998,3021,1426,1595
'2726065100,  지산1동,'50,45 - 49세,1998,2266,1090,1176
'2726065100,  지산1동,'55,50 - 54세,1998,1551,783,768
'2726065100,  지산1동,'60,55 - 59세,1998,1286,648,638
'2726065100,  지산1동,'65,60 - 64세,1998,883,403,480
'2726065100,  지산1동,'70,65 - 69세,1998,665,255,410
'2726065100,  지산1동,'75,70 - 74세,1998,456,160,296
'2726065100,  지산1동,'80,75 - 79세,1998,278,78,200
'2726065100,  지산1동,'85,80 - 84세,1998,189,49,140
'2726065100,  지산1동,'90,85+ ,1998,90,21,69
'2726065200,  지산2동,'00,계,1998,28610,14173,14437
'2726065200,  지산2동,'05,0 - 4세,1998,1778,973,805
'2726065200,  지산2동,'10,5 - 9세,1998,2242,1254,988
'2726065200,  지산2동,'15,10 - 14세,1998,2734,1523,1211
'2726065200,  지산2동,'20,15 - 19세,1998,3216,1699,1517
'2726065200,  지산2동,'25,20 - 24세,1998,1943,986,957
'2726065200,  지산2동,'30,25 - 29세,1998,2098,927,1171
'2726065200,  지산2동,'35,30 - 34세,1998,2050,965,1085
'2726065200,  지산2동,'40,35 - 39세,1998,3076,1295,1781
'2726065200,  지산2동,'45,40 - 44세,1998,3327,1617,1710
'2726065200,  지산2동,'50,45 - 49세,1998,1999,1106,893
'2726065200,  지산2동,'55,50 - 54세,1998,1170,624,546
'2726065200,  지산2동,'60,55 - 59세,1998,832,437,395
'2726065200,  지산2동,'65,60 - 64세,1998,673,268,405
'2726065200,  지산2동,'70,65 - 69세,1998,553,212,341
'2726065200,  지산2동,'75,70 - 74세,1998,454,156,298
'2726065200,  지산2동,'80,75 - 79세,1998,262,81,181
'2726065200,  지산2동,'85,80 - 84세,1998,132,39,93
'2726065200,  지산2동,'90,85+ ,1998,71,11,60
'2726066100,  범물1동,'00,계,1998,20626,10003,10623
'2726066100,  범물1동,'05,0 - 4세,1998,966,538,428
'2726066100,  범물1동,'10,5 - 9세,1998,1193,670,523
'2726066100,  범물1동,'15,10 - 14세,1998,1589,838,751
'2726066100,  범물1동,'20,15 - 19세,1998,2660,1381,1279
'2726066100,  범물1동,'25,20 - 24세,1998,2263,1198,1065
'2726066100,  범물1동,'30,25 - 29세,1998,1677,823,854
'2726066100,  범물1동,'35,30 - 34세,1998,1290,626,664
'2726066100,  범물1동,'40,35 - 39세,1998,1639,708,931
'2726066100,  범물1동,'45,40 - 44세,1998,1996,857,1139
'2726066100,  범물1동,'50,45 - 49세,1998,1620,799,821
'2726066100,  범물1동,'55,50 - 54세,1998,1039,490,549
'2726066100,  범물1동,'60,55 - 59세,1998,913,443,470
'2726066100,  범물1동,'65,60 - 64세,1998,644,266,378
'2726066100,  범물1동,'70,65 - 69세,1998,448,160,288
'2726066100,  범물1동,'75,70 - 74세,1998,318,114,204
'2726066100,  범물1동,'80,75 - 79세,1998,202,60,142
'2726066100,  범물1동,'85,80 - 84세,1998,106,22,84
'2726066100,  범물1동,'90,85+ ,1998,63,10,53
'2726066200,  범물2동,'00,계,1998,19033,9471,9562
'2726066200,  범물2동,'05,0 - 4세,1998,1302,702,600
'2726066200,  범물2동,'10,5 - 9세,1998,1628,920,708
'2726066200,  범물2동,'15,10 - 14세,1998,1895,1085,810
'2726066200,  범물2동,'20,15 - 19세,1998,2120,1103,1017
'2726066200,  범물2동,'25,20 - 24세,1998,1226,604,622
'2726066200,  범물2동,'30,25 - 29세,1998,1301,550,751
'2726066200,  범물2동,'35,30 - 34세,1998,1525,672,853
'2726066200,  범물2동,'40,35 - 39세,1998,2142,939,1203
'2726066200,  범물2동,'45,40 - 44세,1998,2195,1096,1099
'2726066200,  범물2동,'50,45 - 49세,1998,1374,774,600
'2726066200,  범물2동,'55,50 - 54세,1998,668,372,296
'2726066200,  범물2동,'60,55 - 59세,1998,484,249,235
'2726066200,  범물2동,'65,60 - 64세,1998,364,145,219
'2726066200,  범물2동,'70,65 - 69세,1998,309,121,188
'2726066200,  범물2동,'75,70 - 74세,1998,237,69,168
'2726066200,  범물2동,'80,75 - 79세,1998,136,39,97
'2726066200,  범물2동,'85,80 - 84세,1998,92,24,68
'2726066200,  범물2동,'90,85+ ,1998,35,7,28
'2726067000,  고산1동,'00,계,1998,30982,15589,15393
'2726067000,  고산1동,'05,0 - 4세,1998,1966,1067,899
'2726067000,  고산1동,'10,5 - 9세,1998,3012,1678,1334
'2726067000,  고산1동,'15,10 - 14세,1998,3489,2001,1488
'2726067000,  고산1동,'20,15 - 19세,1998,2867,1518,1349
'2726067000,  고산1동,'25,20 - 24세,1998,1935,1003,932
'2726067000,  고산1동,'30,25 - 29세,1998,1992,935,1057
'2726067000,  고산1동,'35,30 - 34세,1998,2422,1015,1407
'2726067000,  고산1동,'40,35 - 39세,1998,3936,1737,2199
'2726067000,  고산1동,'45,40 - 44세,1998,3323,1793,1530
'2726067000,  고산1동,'50,45 - 49세,1998,1851,994,857
'2726067000,  고산1동,'55,50 - 54세,1998,1121,599,522
'2726067000,  고산1동,'60,55 - 59세,1998,933,465,468
'2726067000,  고산1동,'65,60 - 64세,1998,726,336,390
'2726067000,  고산1동,'70,65 - 69세,1998,541,194,347
'2726067000,  고산1동,'75,70 - 74세,1998,407,141,266
'2726067000,  고산1동,'80,75 - 79세,1998,259,67,192
'2726067000,  고산1동,'85,80 - 84세,1998,124,32,92
'2726067000,  고산1동,'90,85+ ,1998,78,14,64
'2726068000,  고산2동,'00,계,1998,28359,14261,14098
'2726068000,  고산2동,'05,0 - 4세,1998,1951,1058,893
'2726068000,  고산2동,'10,5 - 9세,1998,2387,1346,1041
'2726068000,  고산2동,'15,10 - 14세,1998,2781,1641,1140
'2726068000,  고산2동,'20,15 - 19세,1998,2761,1448,1313
'2726068000,  고산2동,'25,20 - 24세,1998,2062,1037,1025
'2726068000,  고산2동,'30,25 - 29세,1998,2227,1057,1170
'2726068000,  고산2동,'35,30 - 34세,1998,2431,1145,1286
'2726068000,  고산2동,'40,35 - 39세,1998,3121,1379,1742
'2726068000,  고산2동,'45,40 - 44세,1998,2739,1396,1343
'2726068000,  고산2동,'50,45 - 49세,1998,1670,906,764
'2726068000,  고산2동,'55,50 - 54세,1998,1050,546,504
'2726068000,  고산2동,'60,55 - 59세,1998,965,471,494
'2726068000,  고산2동,'65,60 - 64세,1998,765,333,432
'2726068000,  고산2동,'70,65 - 69세,1998,572,209,363
'2726068000,  고산2동,'75,70 - 74세,1998,396,139,257
'2726068000,  고산2동,'80,75 - 79세,1998,270,93,177
'2726068000,  고산2동,'85,80 - 84세,1998,136,33,103
'2726068000,  고산2동,'90,85+ ,1998,75,24,51
'2726069000,  고산3동,'00,계,1998,27131,13775,13356
'2726069000,  고산3동,'05,0 - 4세,1998,2227,1209,1018
'2726069000,  고산3동,'10,5 - 9세,1998,2677,1547,1130
'2726069000,  고산3동,'15,10 - 14세,1998,2737,1537,1200
'2726069000,  고산3동,'20,15 - 19세,1998,2176,1206,970
'2726069000,  고산3동,'25,20 - 24세,1998,1680,874,806
'2726069000,  고산3동,'30,25 - 29세,1998,2247,1005,1242
'2726069000,  고산3동,'35,30 - 34세,1998,2838,1277,1561
'2726069000,  고산3동,'40,35 - 39세,1998,3418,1622,1796
'2726069000,  고산3동,'45,40 - 44세,1998,2447,1317,1130
'2726069000,  고산3동,'50,45 - 49세,1998,1397,755,642
'2726069000,  고산3동,'55,50 - 54세,1998,890,451,439
'2726069000,  고산3동,'60,55 - 59세,1998,740,373,367
'2726069000,  고산3동,'65,60 - 64세,1998,604,240,364
'2726069000,  고산3동,'70,65 - 69세,1998,418,160,258
'2726069000,  고산3동,'75,70 - 74세,1998,283,104,179
'2726069000,  고산3동,'80,75 - 79세,1998,189,62,127
'2726069000,  고산3동,'85,80 - 84세,1998,106,25,81
'2726069000,  고산3동,'90,85+ ,1998,57,11,46
'27290, 달서구,'00,계,1998,552170,276780,275390
'27290, 달서구,'05,0 - 4세,1998,43205,23249,19956
'27290, 달서구,'10,5 - 9세,1998,46030,25613,20417
'27290, 달서구,'15,10 - 14세,1998,44616,24589,20027
'27290, 달서구,'20,15 - 19세,1998,52765,27053,25712
'27290, 달서구,'25,20 - 24세,1998,44142,22008,22134
'27290, 달서구,'30,25 - 29세,1998,51906,24633,27273
'27290, 달서구,'35,30 - 34세,1998,54924,26743,28181
'27290, 달서구,'40,35 - 39세,1998,60466,29688,30778
'27290, 달서구,'45,40 - 44세,1998,47492,24259,23233
'27290, 달서구,'50,45 - 49세,1998,31813,16278,15535
'27290, 달서구,'55,50 - 54세,1998,20714,10680,10034
'27290, 달서구,'60,55 - 59세,1998,18018,8639,9379
'27290, 달서구,'65,60 - 64세,1998,13341,5870,7471
'27290, 달서구,'70,65 - 69세,1998,9151,3396,5755
'27290, 달서구,'75,70 - 74세,1998,6265,2136,4129
'27290, 달서구,'80,75 - 79세,1998,3965,1161,2804
'27290, 달서구,'85,80 - 84세,1998,2141,532,1609
'27290, 달서구,'90,85+ ,1998,1216,253,963
'2729051000,  성당1동,'00,계,1998,12313,6065,6248
'2729051000,  성당1동,'05,0 - 4세,1998,739,405,334
'2729051000,  성당1동,'10,5 - 9세,1998,708,400,308
'2729051000,  성당1동,'15,10 - 14세,1998,728,406,322
'2729051000,  성당1동,'20,15 - 19세,1998,1189,631,558
'2729051000,  성당1동,'25,20 - 24세,1998,1419,616,803
'2729051000,  성당1동,'30,25 - 29세,1998,1385,697,688
'2729051000,  성당1동,'35,30 - 34세,1998,981,516,465
'2729051000,  성당1동,'40,35 - 39세,1998,1060,532,528
'2729051000,  성당1동,'45,40 - 44세,1998,929,464,465
'2729051000,  성당1동,'50,45 - 49세,1998,802,355,447
'2729051000,  성당1동,'55,50 - 54세,1998,690,349,341
'2729051000,  성당1동,'60,55 - 59세,1998,604,278,326
'2729051000,  성당1동,'65,60 - 64세,1998,452,207,245
'2729051000,  성당1동,'70,65 - 69세,1998,248,100,148
'2729051000,  성당1동,'75,70 - 74세,1998,172,57,115
'2729051000,  성당1동,'80,75 - 79세,1998,110,31,79
'2729051000,  성당1동,'85,80 - 84세,1998,71,15,56
'2729051000,  성당1동,'90,85+ ,1998,26,6,20
'2729052000,  성당2동,'00,계,1998,22283,10940,11343
'2729052000,  성당2동,'05,0 - 4세,1998,1460,763,697
'2729052000,  성당2동,'10,5 - 9세,1998,1516,851,665
'2729052000,  성당2동,'15,10 - 14세,1998,1680,894,786
'2729052000,  성당2동,'20,15 - 19세,1998,2480,1209,1271
'2729052000,  성당2동,'25,20 - 24세,1998,2077,1001,1076
'2729052000,  성당2동,'30,25 - 29세,1998,2089,1033,1056
'2729052000,  성당2동,'35,30 - 34세,1998,1935,979,956
'2729052000,  성당2동,'40,35 - 39세,1998,2213,1029,1184
'2729052000,  성당2동,'45,40 - 44세,1998,1952,954,998
'2729052000,  성당2동,'50,45 - 49세,1998,1487,727,760
'2729052000,  성당2동,'55,50 - 54세,1998,948,508,440
'2729052000,  성당2동,'60,55 - 59세,1998,853,412,441
'2729052000,  성당2동,'65,60 - 64세,1998,579,235,344
'2729052000,  성당2동,'70,65 - 69세,1998,407,175,232
'2729052000,  성당2동,'75,70 - 74세,1998,257,79,178
'2729052000,  성당2동,'80,75 - 79세,1998,194,53,141
'2729052000,  성당2동,'85,80 - 84세,1998,100,26,74
'2729052000,  성당2동,'90,85+ ,1998,56,12,44
'2729053000,  두류1동,'00,계,1998,9229,4653,4576
'2729053000,  두류1동,'05,0 - 4세,1998,470,247,223
'2729053000,  두류1동,'10,5 - 9세,1998,629,350,279
'2729053000,  두류1동,'15,10 - 14세,1998,577,325,252
'2729053000,  두류1동,'20,15 - 19세,1998,912,484,428
'2729053000,  두류1동,'25,20 - 24세,1998,969,481,488
'2729053000,  두류1동,'30,25 - 29세,1998,1000,543,457
'2729053000,  두류1동,'35,30 - 34세,1998,800,410,390
'2729053000,  두류1동,'40,35 - 39세,1998,824,413,411
'2729053000,  두류1동,'45,40 - 44세,1998,630,301,329
'2729053000,  두류1동,'50,45 - 49세,1998,605,284,321
'2729053000,  두류1동,'55,50 - 54세,1998,496,228,268
'2729053000,  두류1동,'60,55 - 59세,1998,513,250,263
'2729053000,  두류1동,'65,60 - 64세,1998,329,164,165
'2729053000,  두류1동,'70,65 - 69세,1998,214,93,121
'2729053000,  두류1동,'75,70 - 74세,1998,120,47,73
'2729053000,  두류1동,'80,75 - 79세,1998,85,19,66
'2729053000,  두류1동,'85,80 - 84세,1998,35,8,27
'2729053000,  두류1동,'90,85+ ,1998,21,6,15
'2729054000,  두류2동,'00,계,1998,16358,8202,8156
'2729054000,  두류2동,'05,0 - 4세,1998,1056,566,490
'2729054000,  두류2동,'10,5 - 9세,1998,1033,574,459
'2729054000,  두류2동,'15,10 - 14세,1998,991,575,416
'2729054000,  두류2동,'20,15 - 19세,1998,1547,807,740
'2729054000,  두류2동,'25,20 - 24세,1998,1601,780,821
'2729054000,  두류2동,'30,25 - 29세,1998,1852,967,885
'2729054000,  두류2동,'35,30 - 34세,1998,1462,758,704
'2729054000,  두류2동,'40,35 - 39세,1998,1452,717,735
'2729054000,  두류2동,'45,40 - 44세,1998,1215,629,586
'2729054000,  두류2동,'50,45 - 49세,1998,1015,495,520
'2729054000,  두류2동,'55,50 - 54세,1998,812,362,450
'2729054000,  두류2동,'60,55 - 59세,1998,867,404,463
'2729054000,  두류2동,'65,60 - 64세,1998,606,277,329
'2729054000,  두류2동,'70,65 - 69세,1998,372,149,223
'2729054000,  두류2동,'75,70 - 74세,1998,226,83,143
'2729054000,  두류2동,'80,75 - 79세,1998,124,38,86
'2729054000,  두류2동,'85,80 - 84세,1998,83,14,69
'2729054000,  두류2동,'90,85+ ,1998,44,7,37
'2729055000,  두류3동,'00,계,1998,10868,5398,5470
'2729055000,  두류3동,'05,0 - 4세,1998,649,364,285
'2729055000,  두류3동,'10,5 - 9세,1998,716,387,329
'2729055000,  두류3동,'15,10 - 14세,1998,708,400,308
'2729055000,  두류3동,'20,15 - 19세,1998,1155,601,554
'2729055000,  두류3동,'25,20 - 24세,1998,1163,541,622
'2729055000,  두류3동,'30,25 - 29세,1998,1130,604,526
'2729055000,  두류3동,'35,30 - 34세,1998,900,440,460
'2729055000,  두류3동,'40,35 - 39세,1998,963,470,493
'2729055000,  두류3동,'45,40 - 44세,1998,890,407,483
'2729055000,  두류3동,'50,45 - 49세,1998,711,337,374
'2729055000,  두류3동,'55,50 - 54세,1998,526,267,259
'2729055000,  두류3동,'60,55 - 59세,1998,503,230,273
'2729055000,  두류3동,'65,60 - 64세,1998,343,166,177
'2729055000,  두류3동,'70,65 - 69세,1998,212,85,127
'2729055000,  두류3동,'75,70 - 74세,1998,134,52,82
'2729055000,  두류3동,'80,75 - 79세,1998,102,29,73
'2729055000,  두류3동,'85,80 - 84세,1998,42,10,32
'2729055000,  두류3동,'90,85+ ,1998,21,8,13
'2729055500,  감삼동,'00,계,1998,22626,11405,11221
'2729055500,  감삼동,'05,0 - 4세,1998,1768,924,844
'2729055500,  감삼동,'10,5 - 9세,1998,1732,973,759
'2729055500,  감삼동,'15,10 - 14세,1998,1714,956,758
'2729055500,  감삼동,'20,15 - 19세,1998,2243,1104,1139
'2729055500,  감삼동,'25,20 - 24세,1998,2093,1040,1053
'2729055500,  감삼동,'30,25 - 29세,1998,2428,1211,1217
'2729055500,  감삼동,'35,30 - 34세,1998,2282,1179,1103
'2729055500,  감삼동,'40,35 - 39세,1998,2300,1131,1169
'2729055500,  감삼동,'45,40 - 44세,1998,1842,899,943
'2729055500,  감삼동,'50,45 - 49세,1998,1320,690,630
'2729055500,  감삼동,'55,50 - 54세,1998,914,467,447
'2729055500,  감삼동,'60,55 - 59세,1998,688,339,349
'2729055500,  감삼동,'65,60 - 64세,1998,507,251,256
'2729055500,  감삼동,'70,65 - 69세,1998,323,106,217
'2729055500,  감삼동,'75,70 - 74세,1998,207,70,137
'2729055500,  감삼동,'80,75 - 79세,1998,141,41,100
'2729055500,  감삼동,'85,80 - 84세,1998,74,19,55
'2729055500,  감삼동,'90,85+ ,1998,50,5,45
'2729056300,  죽전동,'00,계,1998,18552,9303,9249
'2729056300,  죽전동,'05,0 - 4세,1998,1386,701,685
'2729056300,  죽전동,'10,5 - 9세,1998,1395,790,605
'2729056300,  죽전동,'15,10 - 14세,1998,1402,777,625
'2729056300,  죽전동,'20,15 - 19세,1998,1837,943,894
'2729056300,  죽전동,'25,20 - 24세,1998,1730,804,926
'2729056300,  죽전동,'30,25 - 29세,1998,2021,1027,994
'2729056300,  죽전동,'35,30 - 34세,1998,1772,914,858
'2729056300,  죽전동,'40,35 - 39세,1998,1881,938,943
'2729056300,  죽전동,'45,40 - 44세,1998,1504,741,763
'2729056300,  죽전동,'50,45 - 49세,1998,1112,558,554
'2729056300,  죽전동,'55,50 - 54세,1998,738,391,347
'2729056300,  죽전동,'60,55 - 59세,1998,643,301,342
'2729056300,  죽전동,'65,60 - 64세,1998,413,197,216
'2729056300,  죽전동,'70,65 - 69세,1998,305,105,200
'2729056300,  죽전동,'75,70 - 74세,1998,192,69,123
'2729056300,  죽전동,'80,75 - 79세,1998,116,23,93
'2729056300,  죽전동,'85,80 - 84세,1998,80,20,60
'2729056300,  죽전동,'90,85+ ,1998,25,4,21
'2729056800,  장기동,'00,계,1998,53197,27041,26156
'2729056800,  장기동,'05,0 - 4세,1998,6251,3315,2936
'2729056800,  장기동,'10,5 - 9세,1998,5611,3103,2508
'2729056800,  장기동,'15,10 - 14세,1998,4022,2216,1806
'2729056800,  장기동,'20,15 - 19세,1998,3523,1826,1697
'2729056800,  장기동,'25,20 - 24세,1998,3158,1546,1612
'2729056800,  장기동,'30,25 - 29세,1998,5616,2275,3341
'2729056800,  장기동,'35,30 - 34세,1998,7685,3828,3857
'2729056800,  장기동,'40,35 - 39세,1998,6518,3569,2949
'2729056800,  장기동,'45,40 - 44세,1998,3659,2048,1611
'2729056800,  장기동,'50,45 - 49세,1998,2242,1181,1061
'2729056800,  장기동,'55,50 - 54세,1998,1354,705,649
'2729056800,  장기동,'60,55 - 59세,1998,1226,603,623
'2729056800,  장기동,'65,60 - 64세,1998,861,365,496
'2729056800,  장기동,'70,65 - 69세,1998,621,219,402
'2729056800,  장기동,'75,70 - 74세,1998,401,139,262
'2729056800,  장기동,'80,75 - 79세,1998,258,59,199
'2729056800,  장기동,'85,80 - 84세,1998,119,26,93
'2729056800,  장기동,'90,85+ ,1998,72,18,54
'2729057500,  이곡동,'00,계,1998,49641,25337,24304
'2729057500,  이곡동,'05,0 - 4세,1998,5035,2758,2277
'2729057500,  이곡동,'10,5 - 9세,1998,5600,3121,2479
'2729057500,  이곡동,'15,10 - 14세,1998,4437,2448,1989
'2729057500,  이곡동,'20,15 - 19세,1998,3571,1803,1768
'2729057500,  이곡동,'25,20 - 24세,1998,2749,1344,1405
'2729057500,  이곡동,'30,25 - 29세,1998,4641,2023,2618
'2729057500,  이곡동,'35,30 - 34세,1998,6276,2945,3331
'2729057500,  이곡동,'40,35 - 39세,1998,6668,3442,3226
'2729057500,  이곡동,'45,40 - 44세,1998,4077,2354,1723
'2729057500,  이곡동,'50,45 - 49세,1998,2116,1132,984
'2729057500,  이곡동,'55,50 - 54세,1998,1299,684,615
'2729057500,  이곡동,'60,55 - 59세,1998,1092,548,544
'2729057500,  이곡동,'65,60 - 64세,1998,773,330,443
'2729057500,  이곡동,'70,65 - 69세,1998,495,182,313
'2729057500,  이곡동,'75,70 - 74세,1998,359,107,252
'2729057500,  이곡동,'80,75 - 79세,1998,231,63,168
'2729057500,  이곡동,'85,80 - 84세,1998,130,36,94
'2729057500,  이곡동,'90,85+ ,1998,92,17,75
'2729058500,  신당동,'00,계,1998,29438,14710,14728
'2729058500,  신당동,'05,0 - 4세,1998,3009,1581,1428
'2729058500,  신당동,'10,5 - 9세,1998,2603,1448,1155
'2729058500,  신당동,'15,10 - 14세,1998,2074,1060,1014
'2729058500,  신당동,'20,15 - 19세,1998,2205,1129,1076
'2729058500,  신당동,'25,20 - 24세,1998,2269,1136,1133
'2729058500,  신당동,'30,25 - 29세,1998,3818,1771,2047
'2729058500,  신당동,'35,30 - 34세,1998,3709,1933,1776
'2729058500,  신당동,'40,35 - 39세,1998,3173,1688,1485
'2729058500,  신당동,'45,40 - 44세,1998,1951,1012,939
'2729058500,  신당동,'50,45 - 49세,1998,1174,583,591
'2729058500,  신당동,'55,50 - 54세,1998,851,412,439
'2729058500,  신당동,'60,55 - 59세,1998,762,311,451
'2729058500,  신당동,'65,60 - 64세,1998,650,271,379
'2729058500,  신당동,'70,65 - 69세,1998,463,145,318
'2729058500,  신당동,'75,70 - 74세,1998,358,120,238
'2729058500,  신당동,'80,75 - 79세,1998,209,72,137
'2729058500,  신당동,'85,80 - 84세,1998,103,26,77
'2729058500,  신당동,'90,85+ ,1998,57,12,45
'2729059000,  본리동,'00,계,1998,21487,10631,10856
'2729059000,  본리동,'05,0 - 4세,1998,1469,806,663
'2729059000,  본리동,'10,5 - 9세,1998,1602,904,698
'2729059000,  본리동,'15,10 - 14세,1998,1819,996,823
'2729059000,  본리동,'20,15 - 19세,1998,2385,1198,1187
'2729059000,  본리동,'25,20 - 24세,1998,1678,812,866
'2729059000,  본리동,'30,25 - 29세,1998,1739,833,906
'2729059000,  본리동,'35,30 - 34세,1998,1838,889,949
'2729059000,  본리동,'40,35 - 39세,1998,2262,1048,1214
'2729059000,  본리동,'45,40 - 44세,1998,2124,1015,1109
'2729059000,  본리동,'50,45 - 49세,1998,1460,772,688
'2729059000,  본리동,'55,50 - 54세,1998,838,464,374
'2729059000,  본리동,'60,55 - 59세,1998,699,336,363
'2729059000,  본리동,'65,60 - 64세,1998,549,230,319
'2729059000,  본리동,'70,65 - 69세,1998,414,148,266
'2729059000,  본리동,'75,70 - 74세,1998,277,100,177
'2729059000,  본리동,'80,75 - 79세,1998,187,53,134
'2729059000,  본리동,'85,80 - 84세,1998,85,13,72
'2729059000,  본리동,'90,85+ ,1998,62,14,48
'2729060100,  월성1동,'00,계,1998,15044,7604,7440
'2729060100,  월성1동,'05,0 - 4세,1998,748,444,304
'2729060100,  월성1동,'10,5 - 9세,1998,1184,667,517
'2729060100,  월성1동,'15,10 - 14세,1998,1484,813,671
'2729060100,  월성1동,'20,15 - 19세,1998,1828,944,884
'2729060100,  월성1동,'25,20 - 24세,1998,1124,589,535
'2729060100,  월성1동,'30,25 - 29세,1998,969,491,478
'2729060100,  월성1동,'35,30 - 34세,1998,1001,435,566
'2729060100,  월성1동,'40,35 - 39세,1998,1662,767,895
'2729060100,  월성1동,'45,40 - 44세,1998,1716,826,890
'2729060100,  월성1동,'50,45 - 49세,1998,1115,623,492
'2729060100,  월성1동,'55,50 - 54세,1998,598,340,258
'2729060100,  월성1동,'60,55 - 59세,1998,474,247,227
'2729060100,  월성1동,'65,60 - 64세,1998,374,160,214
'2729060100,  월성1동,'70,65 - 69세,1998,311,116,195
'2729060100,  월성1동,'75,70 - 74세,1998,207,81,126
'2729060100,  월성1동,'80,75 - 79세,1998,126,32,94
'2729060100,  월성1동,'85,80 - 84세,1998,83,23,60
'2729060100,  월성1동,'90,85+ ,1998,40,6,34
'2729060200,  월성2동,'00,계,1998,29738,14678,15060
'2729060200,  월성2동,'05,0 - 4세,1998,1361,714,647
'2729060200,  월성2동,'10,5 - 9세,1998,1391,770,621
'2729060200,  월성2동,'15,10 - 14세,1998,1964,1041,923
'2729060200,  월성2동,'20,15 - 19세,1998,3838,1957,1881
'2729060200,  월성2동,'25,20 - 24세,1998,3888,2144,1744
'2729060200,  월성2동,'30,25 - 29세,1998,2769,1503,1266
'2729060200,  월성2동,'35,30 - 34세,1998,1815,937,878
'2729060200,  월성2동,'40,35 - 39세,1998,2103,924,1179
'2729060200,  월성2동,'45,40 - 44세,1998,2498,1109,1389
'2729060200,  월성2동,'50,45 - 49세,1998,2381,1035,1346
'2729060200,  월성2동,'55,50 - 54세,1998,1767,848,919
'2729060200,  월성2동,'60,55 - 59세,1998,1451,737,714
'2729060200,  월성2동,'65,60 - 64세,1998,947,448,499
'2729060200,  월성2동,'70,65 - 69세,1998,619,229,390
'2729060200,  월성2동,'75,70 - 74세,1998,422,146,276
'2729060200,  월성2동,'80,75 - 79세,1998,275,73,202
'2729060200,  월성2동,'85,80 - 84세,1998,164,44,120
'2729060200,  월성2동,'90,85+ ,1998,85,19,66
'2729061500,  진천동,'00,계,1998,37606,19043,18563
'2729061500,  진천동,'05,0 - 4세,1998,2355,1271,1084
'2729061500,  진천동,'10,5 - 9세,1998,3230,1795,1435
'2729061500,  진천동,'15,10 - 14세,1998,3567,1949,1618
'2729061500,  진천동,'20,15 - 19세,1998,3909,2052,1857
'2729061500,  진천동,'25,20 - 24세,1998,2832,1473,1359
'2729061500,  진천동,'30,25 - 29세,1998,2854,1408,1446
'2729061500,  진천동,'35,30 - 34세,1998,3200,1501,1699
'2729061500,  진천동,'40,35 - 39세,1998,4433,2083,2350
'2729061500,  진천동,'45,40 - 44세,1998,3599,1916,1683
'2729061500,  진천동,'50,45 - 49세,1998,2298,1235,1063
'2729061500,  진천동,'55,50 - 54세,1998,1439,760,679
'2729061500,  진천동,'60,55 - 59세,1998,1203,597,606
'2729061500,  진천동,'65,60 - 64세,1998,1001,439,562
'2729061500,  진천동,'70,65 - 69세,1998,676,258,418
'2729061500,  진천동,'75,70 - 74세,1998,450,147,303
'2729061500,  진천동,'80,75 - 79세,1998,298,87,211
'2729061500,  진천동,'85,80 - 84세,1998,164,47,117
'2729061500,  진천동,'90,85+ ,1998,98,25,73
'2729062400,  상인1동,'00,계,1998,35151,17518,17633
'2729062400,  상인1동,'05,0 - 4세,1998,2354,1281,1073
'2729062400,  상인1동,'10,5 - 9세,1998,3059,1720,1339
'2729062400,  상인1동,'15,10 - 14세,1998,3541,1963,1578
'2729062400,  상인1동,'20,15 - 19세,1998,3694,1906,1788
'2729062400,  상인1동,'25,20 - 24세,1998,2437,1233,1204
'2729062400,  상인1동,'30,25 - 29세,1998,2497,1103,1394
'2729062400,  상인1동,'35,30 - 34세,1998,2821,1277,1544
'2729062400,  상인1동,'40,35 - 39세,1998,4178,1858,2320
'2729062400,  상인1동,'45,40 - 44세,1998,3845,1930,1915
'2729062400,  상인1동,'50,45 - 49세,1998,2284,1279,1005
'2729062400,  상인1동,'55,50 - 54세,1998,1319,738,581
'2729062400,  상인1동,'60,55 - 59세,1998,869,422,447
'2729062400,  상인1동,'65,60 - 64세,1998,704,303,401
'2729062400,  상인1동,'70,65 - 69세,1998,573,198,375
'2729062400,  상인1동,'75,70 - 74세,1998,447,152,295
'2729062400,  상인1동,'80,75 - 79세,1998,295,86,209
'2729062400,  상인1동,'85,80 - 84세,1998,146,45,101
'2729062400,  상인1동,'90,85+ ,1998,88,24,64
'2729062500,  상인2동,'00,계,1998,30890,15576,15314
'2729062500,  상인2동,'05,0 - 4세,1998,2332,1283,1049
'2729062500,  상인2동,'10,5 - 9세,1998,2627,1425,1202
'2729062500,  상인2동,'15,10 - 14세,1998,2750,1535,1215
'2729062500,  상인2동,'20,15 - 19세,1998,2953,1546,1407
'2729062500,  상인2동,'25,20 - 24세,1998,2241,1103,1138
'2729062500,  상인2동,'30,25 - 29세,1998,2750,1334,1416
'2729062500,  상인2동,'35,30 - 34세,1998,2968,1384,1584
'2729062500,  상인2동,'40,35 - 39세,1998,3633,1749,1884
'2729062500,  상인2동,'45,40 - 44세,1998,2866,1506,1360
'2729062500,  상인2동,'50,45 - 49세,1998,1678,893,785
'2729062500,  상인2동,'55,50 - 54세,1998,1079,573,506
'2729062500,  상인2동,'60,55 - 59세,1998,997,479,518
'2729062500,  상인2동,'65,60 - 64세,1998,766,325,441
'2729062500,  상인2동,'70,65 - 69세,1998,513,189,324
'2729062500,  상인2동,'75,70 - 74세,1998,352,128,224
'2729062500,  상인2동,'80,75 - 79세,1998,221,88,133
'2729062500,  상인2동,'85,80 - 84세,1998,102,24,78
'2729062500,  상인2동,'90,85+ ,1998,62,12,50
'2729062600,  상인3동,'00,계,1998,21452,10519,10933
'2729062600,  상인3동,'05,0 - 4세,1998,1080,582,498
'2729062600,  상인3동,'10,5 - 9세,1998,1559,857,702
'2729062600,  상인3동,'15,10 - 14세,1998,1962,1083,879
'2729062600,  상인3동,'20,15 - 19세,1998,2830,1452,1378
'2729062600,  상인3동,'25,20 - 24세,1998,1889,986,903
'2729062600,  상인3동,'30,25 - 29세,1998,1501,769,732
'2729062600,  상인3동,'35,30 - 34세,1998,1529,689,840
'2729062600,  상인3동,'40,35 - 39세,1998,2320,1007,1313
'2729062600,  상인3동,'45,40 - 44세,1998,2221,1041,1180
'2729062600,  상인3동,'50,45 - 49세,1998,1475,760,715
'2729062600,  상인3동,'55,50 - 54세,1998,816,443,373
'2729062600,  상인3동,'60,55 - 59세,1998,711,317,394
'2729062600,  상인3동,'65,60 - 64세,1998,488,194,294
'2729062600,  상인3동,'70,65 - 69세,1998,426,141,285
'2729062600,  상인3동,'75,70 - 74세,1998,315,102,213
'2729062600,  상인3동,'80,75 - 79세,1998,185,59,126
'2729062600,  상인3동,'85,80 - 84세,1998,93,20,73
'2729062600,  상인3동,'90,85+ ,1998,52,17,35
'2729062800,  도원동,'00,계,1998,44588,22532,22056
'2729062800,  도원동,'05,0 - 4세,1998,4487,2455,2032
'2729062800,  도원동,'10,5 - 9세,1998,4884,2709,2175
'2729062800,  도원동,'15,10 - 14세,1998,4059,2257,1802
'2729062800,  도원동,'20,15 - 19세,1998,3287,1668,1619
'2729062800,  도원동,'25,20 - 24세,1998,2282,1166,1116
'2729062800,  도원동,'30,25 - 29세,1998,3548,1436,2112
'2729062800,  도원동,'35,30 - 34세,1998,5450,2488,2962
'2729062800,  도원동,'40,35 - 39세,1998,6023,3050,2973
'2729062800,  도원동,'45,40 - 44세,1998,3961,2205,1756
'2729062800,  도원동,'50,45 - 49세,1998,2036,1143,893
'2729062800,  도원동,'55,50 - 54세,1998,1182,663,519
'2729062800,  도원동,'60,55 - 59세,1998,1074,493,581
'2729062800,  도원동,'65,60 - 64세,1998,867,356,511
'2729062800,  도원동,'70,65 - 69세,1998,583,206,377
'2729062800,  도원동,'75,70 - 74세,1998,391,123,268
'2729062800,  도원동,'80,75 - 79세,1998,262,72,190
'2729062800,  도원동,'85,80 - 84세,1998,134,29,105
'2729062800,  도원동,'90,85+ ,1998,78,13,65
'2729063000,  송현1동,'00,계,1998,26173,13104,13069
'2729063000,  송현1동,'05,0 - 4세,1998,2109,1134,975
'2729063000,  송현1동,'10,5 - 9세,1998,1913,1054,859
'2729063000,  송현1동,'15,10 - 14세,1998,1765,995,770
'2729063000,  송현1동,'20,15 - 19세,1998,2394,1272,1122
'2729063000,  송현1동,'25,20 - 24세,1998,2366,1120,1246
'2729063000,  송현1동,'30,25 - 29세,1998,2883,1425,1458
'2729063000,  송현1동,'35,30 - 34세,1998,2603,1325,1278
'2729063000,  송현1동,'40,35 - 39세,1998,2490,1250,1240
'2729063000,  송현1동,'45,40 - 44세,1998,2038,999,1039
'2729063000,  송현1동,'50,45 - 49세,1998,1519,738,781
'2729063000,  송현1동,'55,50 - 54세,1998,1092,518,574
'2729063000,  송현1동,'60,55 - 59세,1998,1089,539,550
'2729063000,  송현1동,'65,60 - 64세,1998,772,341,431
'2729063000,  송현1동,'70,65 - 69세,1998,466,189,277
'2729063000,  송현1동,'75,70 - 74세,1998,312,113,199
'2729063000,  송현1동,'80,75 - 79세,1998,190,60,130
'2729063000,  송현1동,'85,80 - 84세,1998,111,23,88
'2729063000,  송현1동,'90,85+ ,1998,61,9,52
'2729064000,  송현2동,'00,계,1998,27720,13595,14125
'2729064000,  송현2동,'05,0 - 4세,1998,1569,857,712
'2729064000,  송현2동,'10,5 - 9세,1998,1689,924,765
'2729064000,  송현2동,'15,10 - 14세,1998,2037,1168,869
'2729064000,  송현2동,'20,15 - 19세,1998,3334,1687,1647
'2729064000,  송현2동,'25,20 - 24세,1998,2856,1453,1403
'2729064000,  송현2동,'30,25 - 29세,1998,2445,1248,1197
'2729064000,  송현2동,'35,30 - 34세,1998,2061,978,1083
'2729064000,  송현2동,'40,35 - 39세,1998,2566,1165,1401
'2729064000,  송현2동,'45,40 - 44세,1998,2442,1138,1304
'2729064000,  송현2동,'50,45 - 49세,1998,1948,920,1028
'2729064000,  송현2동,'55,50 - 54세,1998,1312,637,675
'2729064000,  송현2동,'60,55 - 59세,1998,1096,508,588
'2729064000,  송현2동,'65,60 - 64세,1998,894,398,496
'2729064000,  송현2동,'70,65 - 69세,1998,571,230,341
'2729064000,  송현2동,'75,70 - 74세,1998,432,141,291
'2729064000,  송현2동,'80,75 - 79세,1998,247,88,159
'2729064000,  송현2동,'85,80 - 84세,1998,136,39,97
'2729064000,  송현2동,'90,85+ ,1998,85,16,69
'2729065000,  본동,'00,계,1998,17816,8926,8890
'2729065000,  본동,'05,0 - 4세,1998,1518,798,720
'2729065000,  본동,'10,5 - 9세,1998,1349,791,558
'2729065000,  본동,'15,10 - 14세,1998,1335,732,603
'2729065000,  본동,'20,15 - 19세,1998,1651,834,817
'2729065000,  본동,'25,20 - 24세,1998,1321,640,681
'2729065000,  본동,'30,25 - 29세,1998,1971,932,1039
'2729065000,  본동,'35,30 - 34세,1998,1836,938,898
'2729065000,  본동,'40,35 - 39세,1998,1744,858,886
'2729065000,  본동,'45,40 - 44세,1998,1533,765,768
'2729065000,  본동,'50,45 - 49세,1998,1035,538,497
'2729065000,  본동,'55,50 - 54세,1998,644,323,321
'2729065000,  본동,'60,55 - 59세,1998,604,288,316
'2729065000,  본동,'65,60 - 64세,1998,466,213,253
'2729065000,  본동,'70,65 - 69세,1998,339,133,206
'2729065000,  본동,'75,70 - 74세,1998,234,80,154
'2729065000,  본동,'80,75 - 79세,1998,109,35,74
'2729065000,  본동,'85,80 - 84세,1998,86,25,61
'2729065000,  본동,'90,85+ ,1998,41,3,38
'27710, 달성군,'00,계,1998,138870,71434,67436
'27710, 달성군,'05,0 - 4세,1998,13301,7206,6095
'27710, 달성군,'10,5 - 9세,1998,12564,6946,5618
'27710, 달성군,'15,10 - 14세,1998,8250,4419,3831
'27710, 달성군,'20,15 - 19세,1998,9259,4814,4445
'27710, 달성군,'25,20 - 24세,1998,9346,4858,4488
'27710, 달성군,'30,25 - 29세,1998,14130,6843,7287
'27710, 달성군,'35,30 - 34세,1998,16635,8487,8148
'27710, 달성군,'40,35 - 39세,1998,14693,8532,6161
'27710, 달성군,'45,40 - 44세,1998,9073,5175,3898
'27710, 달성군,'50,45 - 49세,1998,6297,3346,2951
'27710, 달성군,'55,50 - 54세,1998,4884,2515,2369
'27710, 달성군,'60,55 - 59세,1998,5591,2439,3152
'27710, 달성군,'65,60 - 64세,1998,5186,2223,2963
'27710, 달성군,'70,65 - 69세,1998,3796,1570,2226
'27710, 달성군,'75,70 - 74세,1998,2749,1046,1703
'27710, 달성군,'80,75 - 79세,1998,1692,607,1085
'27710, 달성군,'85,80 - 84세,1998,885,288,597
'27710, 달성군,'90,85+ ,1998,539,120,419
'2771025000,  화원읍,'00,계,1998,35408,17970,17438
'2771025000,  화원읍,'05,0 - 4세,1998,3455,1814,1641
'2771025000,  화원읍,'10,5 - 9세,1998,3585,2001,1584
'2771025000,  화원읍,'15,10 - 14세,1998,2445,1272,1173
'2771025000,  화원읍,'20,15 - 19세,1998,2651,1370,1281
'2771025000,  화원읍,'25,20 - 24세,1998,2178,1081,1097
'2771025000,  화원읍,'30,25 - 29세,1998,3313,1497,1816
'2771025000,  화원읍,'35,30 - 34세,1998,4411,2058,2353
'2771025000,  화원읍,'40,35 - 39세,1998,4229,2351,1878
'2771025000,  화원읍,'45,40 - 44세,1998,2749,1552,1197
'2771025000,  화원읍,'50,45 - 49세,1998,1644,905,739
'2771025000,  화원읍,'55,50 - 54세,1998,1107,574,533
'2771025000,  화원읍,'60,55 - 59세,1998,1159,547,612
'2771025000,  화원읍,'65,60 - 64세,1998,894,388,506
'2771025000,  화원읍,'70,65 - 69세,1998,672,250,422
'2771025000,  화원읍,'75,70 - 74세,1998,469,176,293
'2771025000,  화원읍,'80,75 - 79세,1998,243,78,165
'2771025000,  화원읍,'85,80 - 84세,1998,133,46,87
'2771025000,  화원읍,'90,85+ ,1998,71,10,61
'2771025300,  논공읍,'00,계,1998,26248,13736,12512
'2771025300,  논공읍,'05,0 - 4세,1998,3551,1933,1618
'2771025300,  논공읍,'10,5 - 9세,1998,2803,1533,1270
'2771025300,  논공읍,'15,10 - 14세,1998,1431,781,650
'2771025300,  논공읍,'20,15 - 19세,1998,1237,650,587
'2771025300,  논공읍,'25,20 - 24세,1998,1611,793,818
'2771025300,  논공읍,'30,25 - 29세,1998,3665,1702,1963
'2771025300,  논공읍,'35,30 - 34세,1998,3958,2136,1822
'2771025300,  논공읍,'40,35 - 39세,1998,2811,1713,1098
'2771025300,  논공읍,'45,40 - 44세,1998,1296,772,524
'2771025300,  논공읍,'50,45 - 49세,1998,802,430,372
'2771025300,  논공읍,'55,50 - 54세,1998,623,333,290
'2771025300,  논공읍,'60,55 - 59세,1998,678,284,394
'2771025300,  논공읍,'65,60 - 64세,1998,671,282,389
'2771025300,  논공읍,'70,65 - 69세,1998,428,172,256
'2771025300,  논공읍,'75,70 - 74세,1998,295,103,192
'2771025300,  논공읍,'80,75 - 79세,1998,203,63,140
'2771025300,  논공읍,'85,80 - 84세,1998,104,34,70
'2771025300,  논공읍,'90,85+ ,1998,81,22,59
'2771025600,  다사읍,'00,계,1998,26030,13415,12615
'2771025600,  다사읍,'05,0 - 4세,1998,3154,1742,1412
'2771025600,  다사읍,'10,5 - 9세,1998,2799,1546,1253
'2771025600,  다사읍,'15,10 - 14세,1998,1505,817,688
'2771025600,  다사읍,'20,15 - 19세,1998,1524,797,727
'2771025600,  다사읍,'25,20 - 24세,1998,1422,704,718
'2771025600,  다사읍,'30,25 - 29세,1998,2729,1153,1576
'2771025600,  다사읍,'35,30 - 34세,1998,3980,1975,2005
'2771025600,  다사읍,'40,35 - 39세,1998,3131,1846,1285
'2771025600,  다사읍,'45,40 - 44세,1998,1612,948,664
'2771025600,  다사읍,'50,45 - 49세,1998,1084,567,517
'2771025600,  다사읍,'55,50 - 54세,1998,704,377,327
'2771025600,  다사읍,'60,55 - 59세,1998,692,315,377
'2771025600,  다사읍,'65,60 - 64세,1998,588,254,334
'2771025600,  다사읍,'70,65 - 69세,1998,443,179,264
'2771025600,  다사읍,'75,70 - 74세,1998,334,103,231
'2771025600,  다사읍,'80,75 - 79세,1998,174,49,125
'2771025600,  다사읍,'85,80 - 84세,1998,85,27,58
'2771025600,  다사읍,'90,85+ ,1998,70,16,54
'2771031000,  가창면,'00,계,1998,10271,5181,5090
'2771031000,  가창면,'05,0 - 4세,1998,566,309,257
'2771031000,  가창면,'10,5 - 9세,1998,634,346,288
'2771031000,  가창면,'15,10 - 14세,1998,589,316,273
'2771031000,  가창면,'20,15 - 19세,1998,818,416,402
'2771031000,  가창면,'25,20 - 24세,1998,806,435,371
'2771031000,  가창면,'30,25 - 29세,1998,868,499,369
'2771031000,  가창면,'35,30 - 34세,1998,834,461,373
'2771031000,  가창면,'40,35 - 39세,1998,850,464,386
'2771031000,  가창면,'45,40 - 44세,1998,745,388,357
'2771031000,  가창면,'50,45 - 49세,1998,598,320,278
'2771031000,  가창면,'55,50 - 54세,1998,497,253,244
'2771031000,  가창면,'60,55 - 59세,1998,596,250,346
'2771031000,  가창면,'65,60 - 64세,1998,595,259,336
'2771031000,  가창면,'70,65 - 69세,1998,433,155,278
'2771031000,  가창면,'75,70 - 74세,1998,343,138,205
'2771031000,  가창면,'80,75 - 79세,1998,251,99,152
'2771031000,  가창면,'85,80 - 84세,1998,159,57,102
'2771031000,  가창면,'90,85+ ,1998,89,16,73
'2771033000,  하빈면,'00,계,1998,5650,3004,2646
'2771033000,  하빈면,'05,0 - 4세,1998,303,181,122
'2771033000,  하빈면,'10,5 - 9세,1998,353,192,161
'2771033000,  하빈면,'15,10 - 14세,1998,229,120,109
'2771033000,  하빈면,'20,15 - 19세,1998,338,181,157
'2771033000,  하빈면,'25,20 - 24세,1998,448,253,195
'2771033000,  하빈면,'30,25 - 29세,1998,482,288,194
'2771033000,  하빈면,'35,30 - 34세,1998,494,271,223
'2771033000,  하빈면,'40,35 - 39세,1998,475,312,163
'2771033000,  하빈면,'45,40 - 44세,1998,406,256,150
'2771033000,  하빈면,'50,45 - 49세,1998,295,159,136
'2771033000,  하빈면,'55,50 - 54세,1998,299,145,154
'2771033000,  하빈면,'60,55 - 59세,1998,409,170,239
'2771033000,  하빈면,'65,60 - 64세,1998,409,174,235
'2771033000,  하빈면,'70,65 - 69세,1998,289,143,146
'2771033000,  하빈면,'75,70 - 74세,1998,193,76,117
'2771033000,  하빈면,'80,75 - 79세,1998,130,51,79
'2771033000,  하빈면,'85,80 - 84세,1998,60,17,43
'2771033000,  하빈면,'90,85+ ,1998,38,15,23
'2771034000,  옥포면,'00,계,1998,10610,5511,5099
'2771034000,  옥포면,'05,0 - 4세,1998,742,402,340
'2771034000,  옥포면,'10,5 - 9세,1998,724,393,331
'2771034000,  옥포면,'15,10 - 14세,1998,556,286,270
'2771034000,  옥포면,'20,15 - 19세,1998,764,404,360
'2771034000,  옥포면,'25,20 - 24세,1998,869,464,405
'2771034000,  옥포면,'30,25 - 29세,1998,983,536,447
'2771034000,  옥포면,'35,30 - 34세,1998,993,545,448
'2771034000,  옥포면,'40,35 - 39세,1998,1003,608,395
'2771034000,  옥포면,'45,40 - 44세,1998,704,407,297
'2771034000,  옥포면,'50,45 - 49세,1998,575,304,271
'2771034000,  옥포면,'55,50 - 54세,1998,498,236,262
'2771034000,  옥포면,'60,55 - 59세,1998,642,279,363
'2771034000,  옥포면,'65,60 - 64세,1998,565,258,307
'2771034000,  옥포면,'70,65 - 69세,1998,405,180,225
'2771034000,  옥포면,'75,70 - 74세,1998,257,103,154
'2771034000,  옥포면,'80,75 - 79세,1998,171,58,113
'2771034000,  옥포면,'85,80 - 84세,1998,95,35,60
'2771034000,  옥포면,'90,85+ ,1998,64,13,51
'2771036000,  현풍면,'00,계,1998,13764,7061,6703
'2771036000,  현풍면,'05,0 - 4세,1998,1040,560,480
'2771036000,  현풍면,'10,5 - 9세,1998,1196,685,511
'2771036000,  현풍면,'15,10 - 14세,1998,1021,568,453
'2771036000,  현풍면,'20,15 - 19세,1998,1049,531,518
'2771036000,  현풍면,'25,20 - 24세,1998,1063,586,477
'2771036000,  현풍면,'30,25 - 29세,1998,1227,635,592
'2771036000,  현풍면,'35,30 - 34세,1998,1320,661,659
'2771036000,  현풍면,'40,35 - 39세,1998,1435,777,658
'2771036000,  현풍면,'45,40 - 44세,1998,939,517,422
'2771036000,  현풍면,'50,45 - 49세,1998,690,349,341
'2771036000,  현풍면,'55,50 - 54세,1998,565,299,266
'2771036000,  현풍면,'60,55 - 59세,1998,565,252,313
'2771036000,  현풍면,'65,60 - 64세,1998,554,232,322
'2771036000,  현풍면,'70,65 - 69세,1998,409,175,234
'2771036000,  현풍면,'75,70 - 74세,1998,341,119,222
'2771036000,  현풍면,'80,75 - 79세,1998,209,83,126
'2771036000,  현풍면,'85,80 - 84세,1998,98,25,73
'2771036000,  현풍면,'90,85+ ,1998,43,7,36
'2771037000,  유가면,'00,계,1998,5034,2555,2479
'2771037000,  유가면,'05,0 - 4세,1998,255,127,128
'2771037000,  유가면,'10,5 - 9세,1998,212,112,100
'2771037000,  유가면,'15,10 - 14세,1998,253,139,114
'2771037000,  유가면,'20,15 - 19세,1998,423,219,204
'2771037000,  유가면,'25,20 - 24세,1998,413,237,176
'2771037000,  유가면,'30,25 - 29세,1998,387,228,159
'2771037000,  유가면,'35,30 - 34세,1998,317,189,128
'2771037000,  유가면,'40,35 - 39세,1998,401,240,161
'2771037000,  유가면,'45,40 - 44세,1998,300,158,142
'2771037000,  유가면,'50,45 - 49세,1998,245,139,106
'2771037000,  유가면,'55,50 - 54세,1998,243,119,124
'2771037000,  유가면,'60,55 - 59세,1998,379,146,233
'2771037000,  유가면,'65,60 - 64세,1998,402,170,232
'2771037000,  유가면,'70,65 - 69세,1998,343,142,201
'2771037000,  유가면,'75,70 - 74세,1998,220,99,121
'2771037000,  유가면,'80,75 - 79세,1998,142,59,83
'2771037000,  유가면,'85,80 - 84세,1998,66,24,42
'2771037000,  유가면,'90,85+ ,1998,33,8,25
'2771038000,  구지면,'00,계,1998,5855,3001,2854
'2771038000,  구지면,'05,0 - 4세,1998,235,138,97
'2771038000,  구지면,'10,5 - 9세,1998,258,138,120
'2771038000,  구지면,'15,10 - 14세,1998,221,120,101
'2771038000,  구지면,'20,15 - 19세,1998,455,246,209
'2771038000,  구지면,'25,20 - 24세,1998,536,305,231
'2771038000,  구지면,'30,25 - 29세,1998,476,305,171
'2771038000,  구지면,'35,30 - 34세,1998,328,191,137
'2771038000,  구지면,'40,35 - 39세,1998,358,221,137
'2771038000,  구지면,'45,40 - 44세,1998,322,177,145
'2771038000,  구지면,'50,45 - 49세,1998,364,173,191
'2771038000,  구지면,'55,50 - 54세,1998,348,179,169
'2771038000,  구지면,'60,55 - 59세,1998,471,196,275
'2771038000,  구지면,'65,60 - 64세,1998,508,206,302
'2771038000,  구지면,'70,65 - 69세,1998,374,174,200
'2771038000,  구지면,'75,70 - 74세,1998,297,129,168
'2771038000,  구지면,'80,75 - 79세,1998,169,67,102
'2771038000,  구지면,'85,80 - 84세,1998,85,23,62
'2771038000,  구지면,'90,85+ ,1998,50,13,37
'28,인천광역시,'00,계,1998,2485199,1253485,1231714
'28,인천광역시,'05,0 - 4세,1998,199207,104567,94640
'28,인천광역시,'10,5 - 9세,1998,212710,110793,101917
'28,인천광역시,'15,10 - 14세,1998,180712,93447,87265
'28,인천광역시,'20,15 - 19세,1998,203612,104484,99128
'28,인천광역시,'25,20 - 24세,1998,180903,91396,89507
'28,인천광역시,'30,25 - 29세,1998,242480,120046,122434
'28,인천광역시,'35,30 - 34세,1998,264842,132126,132716
'28,인천광역시,'40,35 - 39세,1998,279122,145773,133349
'28,인천광역시,'45,40 - 44세,1998,210950,111382,99568
'28,인천광역시,'50,45 - 49세,1998,128127,67909,60218
'28,인천광역시,'55,50 - 54세,1998,101114,52104,49010
'28,인천광역시,'60,55 - 59세,1998,88687,43267,45420
'28,인천광역시,'65,60 - 64세,1998,69078,31287,37791
'28,인천광역시,'70,65 - 69세,1998,48543,18905,29638
'28,인천광역시,'75,70 - 74세,1998,33813,12054,21759
'28,인천광역시,'80,75 - 79세,1998,23315,8607,14708
'28,인천광역시,'85,80 - 84세,1998,11490,3634,7856
'28,인천광역시,'90,85+ ,1998,6494,1704,4790
'28110, 중구,'00,계,1998,73550,37061,36489
'28110, 중구,'05,0 - 4세,1998,4562,2369,2193
'28110, 중구,'10,5 - 9세,1998,4185,2167,2018
'28110, 중구,'15,10 - 14세,1998,4021,2061,1960
'28110, 중구,'20,15 - 19세,1998,6211,3216,2995
'28110, 중구,'25,20 - 24세,1998,6295,3268,3027
'28110, 중구,'30,25 - 29세,1998,7492,4050,3442
'28110, 중구,'35,30 - 34세,1998,6262,3385,2877
'28110, 중구,'40,35 - 39세,1998,6385,3377,3008
'28110, 중구,'45,40 - 44세,1998,6049,3010,3039
'28110, 중구,'50,45 - 49세,1998,4538,2295,2243
'28110, 중구,'55,50 - 54세,1998,4326,2182,2144
'28110, 중구,'60,55 - 59세,1998,4032,1924,2108
'28110, 중구,'65,60 - 64세,1998,3143,1472,1671
'28110, 중구,'70,65 - 69세,1998,2219,848,1371
'28110, 중구,'75,70 - 74세,1998,1636,591,1045
'28110, 중구,'80,75 - 79세,1998,1205,491,714
'28110, 중구,'85,80 - 84세,1998,634,238,396
'28110, 중구,'90,85+ ,1998,355,117,238
'2811052000,  연안동,'00,계,1998,10288,5192,5096
'2811052000,  연안동,'05,0 - 4세,1998,625,326,299
'2811052000,  연안동,'10,5 - 9세,1998,687,379,308
'2811052000,  연안동,'15,10 - 14세,1998,659,336,323
'2811052000,  연안동,'20,15 - 19세,1998,908,442,466
'2811052000,  연안동,'25,20 - 24세,1998,815,425,390
'2811052000,  연안동,'30,25 - 29세,1998,913,470,443
'2811052000,  연안동,'35,30 - 34세,1998,931,477,454
'2811052000,  연안동,'40,35 - 39세,1998,1006,536,470
'2811052000,  연안동,'45,40 - 44세,1998,962,483,479
'2811052000,  연안동,'50,45 - 49세,1998,659,336,323
'2811052000,  연안동,'55,50 - 54세,1998,581,311,270
'2811052000,  연안동,'60,55 - 59세,1998,529,244,285
'2811052000,  연안동,'65,60 - 64세,1998,365,171,194
'2811052000,  연안동,'70,65 - 69세,1998,256,110,146
'2811052000,  연안동,'75,70 - 74세,1998,181,67,114
'2811052000,  연안동,'80,75 - 79세,1998,99,44,55
'2811052000,  연안동,'85,80 - 84세,1998,71,25,46
'2811052000,  연안동,'90,85+ ,1998,41,10,31
'2811053000,  신포동,'00,계,1998,6420,3118,3302
'2811053000,  신포동,'05,0 - 4세,1998,295,163,132
'2811053000,  신포동,'10,5 - 9세,1998,350,170,180
'2811053000,  신포동,'15,10 - 14세,1998,321,162,159
'2811053000,  신포동,'20,15 - 19세,1998,598,318,280
'2811053000,  신포동,'25,20 - 24세,1998,550,273,277
'2811053000,  신포동,'30,25 - 29세,1998,629,337,292
'2811053000,  신포동,'35,30 - 34세,1998,470,249,221
'2811053000,  신포동,'40,35 - 39세,1998,538,247,291
'2811053000,  신포동,'45,40 - 44세,1998,530,254,276
'2811053000,  신포동,'50,45 - 49세,1998,436,214,222
'2811053000,  신포동,'55,50 - 54세,1998,446,206,240
'2811053000,  신포동,'60,55 - 59세,1998,371,181,190
'2811053000,  신포동,'65,60 - 64세,1998,317,137,180
'2811053000,  신포동,'70,65 - 69세,1998,202,77,125
'2811053000,  신포동,'75,70 - 74세,1998,157,53,104
'2811053000,  신포동,'80,75 - 79세,1998,125,47,78
'2811053000,  신포동,'85,80 - 84세,1998,54,16,38
'2811053000,  신포동,'90,85+ ,1998,31,14,17
'2811054000,  신흥동,'00,계,1998,11309,5675,5634
'2811054000,  신흥동,'05,0 - 4세,1998,769,396,373
'2811054000,  신흥동,'10,5 - 9세,1998,623,327,296
'2811054000,  신흥동,'15,10 - 14세,1998,601,292,309
'2811054000,  신흥동,'20,15 - 19세,1998,979,526,453
'2811054000,  신흥동,'25,20 - 24세,1998,1006,533,473
'2811054000,  신흥동,'30,25 - 29세,1998,1194,625,569
'2811054000,  신흥동,'35,30 - 34세,1998,994,532,462
'2811054000,  신흥동,'40,35 - 39세,1998,1002,522,480
'2811054000,  신흥동,'45,40 - 44세,1998,897,427,470
'2811054000,  신흥동,'50,45 - 49세,1998,719,344,375
'2811054000,  신흥동,'55,50 - 54세,1998,680,336,344
'2811054000,  신흥동,'60,55 - 59세,1998,596,288,308
'2811054000,  신흥동,'65,60 - 64세,1998,453,216,237
'2811054000,  신흥동,'70,65 - 69세,1998,321,130,191
'2811054000,  신흥동,'75,70 - 74세,1998,209,78,131
'2811054000,  신흥동,'80,75 - 79세,1998,164,66,98
'2811054000,  신흥동,'85,80 - 84세,1998,66,27,39
'2811054000,  신흥동,'90,85+ ,1998,36,10,26
'2811056000,  도원동,'00,계,1998,6402,3232,3170
'2811056000,  도원동,'05,0 - 4세,1998,473,228,245
'2811056000,  도원동,'10,5 - 9세,1998,329,180,149
'2811056000,  도원동,'15,10 - 14세,1998,339,174,165
'2811056000,  도원동,'20,15 - 19세,1998,584,309,275
'2811056000,  도원동,'25,20 - 24세,1998,618,301,317
'2811056000,  도원동,'30,25 - 29세,1998,765,413,352
'2811056000,  도원동,'35,30 - 34세,1998,631,347,284
'2811056000,  도원동,'40,35 - 39세,1998,544,288,256
'2811056000,  도원동,'45,40 - 44세,1998,523,258,265
'2811056000,  도원동,'50,45 - 49세,1998,382,188,194
'2811056000,  도원동,'55,50 - 54세,1998,333,170,163
'2811056000,  도원동,'60,55 - 59세,1998,298,148,150
'2811056000,  도원동,'65,60 - 64세,1998,210,90,120
'2811056000,  도원동,'70,65 - 69세,1998,155,63,92
'2811056000,  도원동,'75,70 - 74세,1998,79,22,57
'2811056000,  도원동,'80,75 - 79세,1998,83,35,48
'2811056000,  도원동,'85,80 - 84세,1998,43,17,26
'2811056000,  도원동,'90,85+ ,1998,13,1,12
'2811057000,  율목동,'00,계,1998,6167,3135,3032
'2811057000,  율목동,'05,0 - 4세,1998,500,260,240
'2811057000,  율목동,'10,5 - 9세,1998,333,162,171
'2811057000,  율목동,'15,10 - 14세,1998,295,150,145
'2811057000,  율목동,'20,15 - 19세,1998,509,271,238
'2811057000,  율목동,'25,20 - 24세,1998,604,298,306
'2811057000,  율목동,'30,25 - 29세,1998,868,472,396
'2811057000,  율목동,'35,30 - 34세,1998,613,335,278
'2811057000,  율목동,'40,35 - 39세,1998,529,288,241
'2811057000,  율목동,'45,40 - 44세,1998,483,232,251
'2811057000,  율목동,'50,45 - 49세,1998,344,155,189
'2811057000,  율목동,'55,50 - 54세,1998,324,163,161
'2811057000,  율목동,'60,55 - 59세,1998,272,140,132
'2811057000,  율목동,'65,60 - 64세,1998,189,91,98
'2811057000,  율목동,'70,65 - 69세,1998,117,47,70
'2811057000,  율목동,'75,70 - 74세,1998,83,28,55
'2811057000,  율목동,'80,75 - 79세,1998,64,29,35
'2811057000,  율목동,'85,80 - 84세,1998,25,9,16
'2811057000,  율목동,'90,85+ ,1998,15,5,10
'2811058500,  동인천동,'00,계,1998,7658,3751,3907
'2811058500,  동인천동,'05,0 - 4세,1998,355,186,169
'2811058500,  동인천동,'10,5 - 9세,1998,430,215,215
'2811058500,  동인천동,'15,10 - 14세,1998,460,234,226
'2811058500,  동인천동,'20,15 - 19세,1998,682,338,344
'2811058500,  동인천동,'25,20 - 24세,1998,703,362,341
'2811058500,  동인천동,'30,25 - 29세,1998,765,403,362
'2811058500,  동인천동,'35,30 - 34세,1998,580,300,280
'2811058500,  동인천동,'40,35 - 39세,1998,663,324,339
'2811058500,  동인천동,'45,40 - 44세,1998,639,312,327
'2811058500,  동인천동,'50,45 - 49세,1998,501,253,248
'2811058500,  동인천동,'55,50 - 54세,1998,449,210,239
'2811058500,  동인천동,'60,55 - 59세,1998,463,220,243
'2811058500,  동인천동,'65,60 - 64세,1998,324,156,168
'2811058500,  동인천동,'70,65 - 69세,1998,221,83,138
'2811058500,  동인천동,'75,70 - 74세,1998,186,62,124
'2811058500,  동인천동,'80,75 - 79세,1998,119,48,71
'2811058500,  동인천동,'85,80 - 84세,1998,70,30,40
'2811058500,  동인천동,'90,85+ ,1998,48,15,33
'2811060000,  북성동,'00,계,1998,6295,3193,3102
'2811060000,  북성동,'05,0 - 4세,1998,362,181,181
'2811060000,  북성동,'10,5 - 9세,1998,351,182,169
'2811060000,  북성동,'15,10 - 14세,1998,397,216,181
'2811060000,  북성동,'20,15 - 19세,1998,562,296,266
'2811060000,  북성동,'25,20 - 24세,1998,547,295,252
'2811060000,  북성동,'30,25 - 29세,1998,655,369,286
'2811060000,  북성동,'35,30 - 34세,1998,497,271,226
'2811060000,  북성동,'40,35 - 39세,1998,561,287,274
'2811060000,  북성동,'45,40 - 44세,1998,541,263,278
'2811060000,  북성동,'50,45 - 49세,1998,412,213,199
'2811060000,  북성동,'55,50 - 54세,1998,357,167,190
'2811060000,  북성동,'60,55 - 59세,1998,320,151,169
'2811060000,  북성동,'65,60 - 64세,1998,251,115,136
'2811060000,  북성동,'70,65 - 69세,1998,205,70,135
'2811060000,  북성동,'75,70 - 74세,1998,122,60,62
'2811060000,  북성동,'80,75 - 79세,1998,97,35,62
'2811060000,  북성동,'85,80 - 84세,1998,40,16,24
'2811060000,  북성동,'90,85+ ,1998,18,6,12
'2811061000,  송월동,'00,계,1998,6923,3520,3403
'2811061000,  송월동,'05,0 - 4세,1998,423,234,189
'2811061000,  송월동,'10,5 - 9세,1998,440,239,201
'2811061000,  송월동,'15,10 - 14세,1998,430,235,195
'2811061000,  송월동,'20,15 - 19세,1998,650,351,299
'2811061000,  송월동,'25,20 - 24세,1998,605,317,288
'2811061000,  송월동,'30,25 - 29세,1998,676,350,326
'2811061000,  송월동,'35,30 - 34세,1998,636,340,296
'2811061000,  송월동,'40,35 - 39세,1998,593,314,279
'2811061000,  송월동,'45,40 - 44세,1998,601,287,314
'2811061000,  송월동,'50,45 - 49세,1998,402,205,197
'2811061000,  송월동,'55,50 - 54세,1998,373,200,173
'2811061000,  송월동,'60,55 - 59세,1998,339,159,180
'2811061000,  송월동,'65,60 - 64세,1998,283,132,151
'2811061000,  송월동,'70,65 - 69세,1998,171,61,110
'2811061000,  송월동,'75,70 - 74세,1998,138,37,101
'2811061000,  송월동,'80,75 - 79세,1998,106,39,67
'2811061000,  송월동,'85,80 - 84세,1998,41,18,23
'2811061000,  송월동,'90,85+ ,1998,16,2,14
'2811062000,  영종동,'00,계,1998,8966,4641,4325
'2811062000,  영종동,'05,0 - 4세,1998,594,306,288
'2811062000,  영종동,'10,5 - 9세,1998,483,239,244
'2811062000,  영종동,'15,10 - 14세,1998,404,204,200
'2811062000,  영종동,'20,15 - 19세,1998,560,278,282
'2811062000,  영종동,'25,20 - 24세,1998,617,349,268
'2811062000,  영종동,'30,25 - 29세,1998,790,458,332
'2811062000,  영종동,'35,30 - 34세,1998,680,403,277
'2811062000,  영종동,'40,35 - 39세,1998,721,419,302
'2811062000,  영종동,'45,40 - 44세,1998,624,366,258
'2811062000,  영종동,'50,45 - 49세,1998,505,279,226
'2811062000,  영종동,'55,50 - 54세,1998,559,306,253
'2811062000,  영종동,'60,55 - 59세,1998,618,284,334
'2811062000,  영종동,'65,60 - 64세,1998,558,263,295
'2811062000,  영종동,'70,65 - 69세,1998,425,159,266
'2811062000,  영종동,'75,70 - 74세,1998,340,134,206
'2811062000,  영종동,'80,75 - 79세,1998,232,102,130
'2811062000,  영종동,'85,80 - 84세,1998,164,58,106
'2811062000,  영종동,'90,85+ ,1998,92,34,58
'2811063000,  용유동,'00,계,1998,3122,1604,1518
'2811063000,  용유동,'05,0 - 4세,1998,166,89,77
'2811063000,  용유동,'10,5 - 9세,1998,159,74,85
'2811063000,  용유동,'15,10 - 14세,1998,115,58,57
'2811063000,  용유동,'20,15 - 19세,1998,179,87,92
'2811063000,  용유동,'25,20 - 24세,1998,230,115,115
'2811063000,  용유동,'30,25 - 29세,1998,237,153,84
'2811063000,  용유동,'35,30 - 34세,1998,230,131,99
'2811063000,  용유동,'40,35 - 39세,1998,228,152,76
'2811063000,  용유동,'45,40 - 44세,1998,249,128,121
'2811063000,  용유동,'50,45 - 49세,1998,178,108,70
'2811063000,  용유동,'55,50 - 54세,1998,224,113,111
'2811063000,  용유동,'60,55 - 59세,1998,226,109,117
'2811063000,  용유동,'65,60 - 64세,1998,193,101,92
'2811063000,  용유동,'70,65 - 69세,1998,146,48,98
'2811063000,  용유동,'75,70 - 74세,1998,141,50,91
'2811063000,  용유동,'80,75 - 79세,1998,116,46,70
'2811063000,  용유동,'85,80 - 84세,1998,60,22,38
'2811063000,  용유동,'90,85+ ,1998,45,20,25
'28140, 동구,'00,계,1998,82277,41504,40773
'28140, 동구,'05,0 - 4세,1998,4076,2103,1973
'28140, 동구,'10,5 - 9세,1998,4534,2344,2190
'28140, 동구,'15,10 - 14세,1998,4981,2615,2366
'28140, 동구,'20,15 - 19세,1998,7973,4149,3824
'28140, 동구,'25,20 - 24세,1998,7775,4011,3764
'28140, 동구,'30,25 - 29세,1998,7826,4342,3484
'28140, 동구,'35,30 - 34세,1998,6327,3491,2836
'28140, 동구,'40,35 - 39세,1998,7004,3570,3434
'28140, 동구,'45,40 - 44세,1998,7000,3520,3480
'28140, 동구,'50,45 - 49세,1998,5189,2607,2582
'28140, 동구,'55,50 - 54세,1998,4921,2448,2473
'28140, 동구,'60,55 - 59세,1998,4661,2268,2393
'28140, 동구,'65,60 - 64세,1998,3524,1589,1935
'28140, 동구,'70,65 - 69세,1998,2519,1001,1518
'28140, 동구,'75,70 - 74세,1998,1771,635,1136
'28140, 동구,'80,75 - 79세,1998,1262,505,757
'28140, 동구,'85,80 - 84세,1998,583,192,391
'28140, 동구,'90,85+ ,1998,351,114,237
'2814051000,  만석동,'00,계,1998,6471,3255,3216
'2814051000,  만석동,'05,0 - 4세,1998,325,153,172
'2814051000,  만석동,'10,5 - 9세,1998,366,176,190
'2814051000,  만석동,'15,10 - 14세,1998,381,196,185
'2814051000,  만석동,'20,15 - 19세,1998,592,305,287
'2814051000,  만석동,'25,20 - 24세,1998,605,332,273
'2814051000,  만석동,'30,25 - 29세,1998,621,338,283
'2814051000,  만석동,'35,30 - 34세,1998,529,308,221
'2814051000,  만석동,'40,35 - 39세,1998,537,295,242
'2814051000,  만석동,'45,40 - 44세,1998,508,267,241
'2814051000,  만석동,'50,45 - 49세,1998,376,213,163
'2814051000,  만석동,'55,50 - 54세,1998,353,169,184
'2814051000,  만석동,'60,55 - 59세,1998,374,160,214
'2814051000,  만석동,'65,60 - 64세,1998,303,128,175
'2814051000,  만석동,'70,65 - 69세,1998,219,78,141
'2814051000,  만석동,'75,70 - 74세,1998,179,58,121
'2814051000,  만석동,'80,75 - 79세,1998,120,46,74
'2814051000,  만석동,'85,80 - 84세,1998,59,21,38
'2814051000,  만석동,'90,85+ ,1998,24,12,12
'2814052500,  화수1.화평동,'00,계,1998,7357,3724,3633
'2814052500,  화수1.화평동,'05,0 - 4세,1998,366,193,173
'2814052500,  화수1.화평동,'10,5 - 9세,1998,412,218,194
'2814052500,  화수1.화평동,'15,10 - 14세,1998,440,236,204
'2814052500,  화수1.화평동,'20,15 - 19세,1998,715,356,359
'2814052500,  화수1.화평동,'25,20 - 24세,1998,704,355,349
'2814052500,  화수1.화평동,'30,25 - 29세,1998,708,410,298
'2814052500,  화수1.화평동,'35,30 - 34세,1998,557,312,245
'2814052500,  화수1.화평동,'40,35 - 39세,1998,611,311,300
'2814052500,  화수1.화평동,'45,40 - 44세,1998,577,292,285
'2814052500,  화수1.화평동,'50,45 - 49세,1998,463,231,232
'2814052500,  화수1.화평동,'55,50 - 54세,1998,453,242,211
'2814052500,  화수1.화평동,'60,55 - 59세,1998,421,202,219
'2814052500,  화수1.화평동,'65,60 - 64세,1998,318,140,178
'2814052500,  화수1.화평동,'70,65 - 69세,1998,234,92,142
'2814052500,  화수1.화평동,'75,70 - 74세,1998,164,57,107
'2814052500,  화수1.화평동,'80,75 - 79세,1998,121,51,70
'2814052500,  화수1.화평동,'85,80 - 84세,1998,57,17,40
'2814052500,  화수1.화평동,'90,85+ ,1998,36,9,27
'2814053000,  화수2동,'00,계,1998,12400,6116,6284
'2814053000,  화수2동,'05,0 - 4세,1998,828,438,390
'2814053000,  화수2동,'10,5 - 9세,1998,740,377,363
'2814053000,  화수2동,'15,10 - 14세,1998,790,413,377
'2814053000,  화수2동,'20,15 - 19세,1998,1091,562,529
'2814053000,  화수2동,'25,20 - 24세,1998,1025,512,513
'2814053000,  화수2동,'30,25 - 29세,1998,1310,633,677
'2814053000,  화수2동,'35,30 - 34세,1998,1168,617,551
'2814053000,  화수2동,'40,35 - 39세,1998,1187,593,594
'2814053000,  화수2동,'45,40 - 44세,1998,1029,540,489
'2814053000,  화수2동,'50,45 - 49세,1998,753,362,391
'2814053000,  화수2동,'55,50 - 54세,1998,658,325,333
'2814053000,  화수2동,'60,55 - 59세,1998,550,269,281
'2814053000,  화수2동,'65,60 - 64세,1998,409,180,229
'2814053000,  화수2동,'70,65 - 69세,1998,331,114,217
'2814053000,  화수2동,'75,70 - 74세,1998,237,73,164
'2814053000,  화수2동,'80,75 - 79세,1998,166,63,103
'2814053000,  화수2동,'85,80 - 84세,1998,75,29,46
'2814053000,  화수2동,'90,85+ ,1998,53,16,37
'2814055500,  송현1.2동,'00,계,1998,5885,3008,2877
'2814055500,  송현1.2동,'05,0 - 4세,1998,189,93,96
'2814055500,  송현1.2동,'10,5 - 9세,1998,258,131,127
'2814055500,  송현1.2동,'15,10 - 14세,1998,303,173,130
'2814055500,  송현1.2동,'20,15 - 19세,1998,593,337,256
'2814055500,  송현1.2동,'25,20 - 24세,1998,575,313,262
'2814055500,  송현1.2동,'30,25 - 29세,1998,554,355,199
'2814055500,  송현1.2동,'35,30 - 34세,1998,336,180,156
'2814055500,  송현1.2동,'40,35 - 39세,1998,428,215,213
'2814055500,  송현1.2동,'45,40 - 44세,1998,524,246,278
'2814055500,  송현1.2동,'50,45 - 49세,1998,419,221,198
'2814055500,  송현1.2동,'55,50 - 54세,1998,404,192,212
'2814055500,  송현1.2동,'60,55 - 59세,1998,424,214,210
'2814055500,  송현1.2동,'65,60 - 64세,1998,275,112,163
'2814055500,  송현1.2동,'70,65 - 69세,1998,222,80,142
'2814055500,  송현1.2동,'75,70 - 74세,1998,160,65,95
'2814055500,  송현1.2동,'80,75 - 79세,1998,124,49,75
'2814055500,  송현1.2동,'85,80 - 84세,1998,64,22,42
'2814055500,  송현1.2동,'90,85+ ,1998,33,10,23
'2814057000,  송현3동,'00,계,1998,6507,3258,3249
'2814057000,  송현3동,'05,0 - 4세,1998,387,193,194
'2814057000,  송현3동,'10,5 - 9세,1998,397,191,206
'2814057000,  송현3동,'15,10 - 14세,1998,418,206,212
'2814057000,  송현3동,'20,15 - 19세,1998,636,346,290
'2814057000,  송현3동,'25,20 - 24세,1998,556,277,279
'2814057000,  송현3동,'30,25 - 29세,1998,606,326,280
'2814057000,  송현3동,'35,30 - 34세,1998,567,304,263
'2814057000,  송현3동,'40,35 - 39세,1998,598,291,307
'2814057000,  송현3동,'45,40 - 44세,1998,592,307,285
'2814057000,  송현3동,'50,45 - 49세,1998,401,209,192
'2814057000,  송현3동,'55,50 - 54세,1998,349,167,182
'2814057000,  송현3동,'60,55 - 59세,1998,329,161,168
'2814057000,  송현3동,'65,60 - 64세,1998,263,110,153
'2814057000,  송현3동,'70,65 - 69세,1998,199,91,108
'2814057000,  송현3동,'75,70 - 74세,1998,100,40,60
'2814057000,  송현3동,'80,75 - 79세,1998,63,26,37
'2814057000,  송현3동,'85,80 - 84세,1998,27,7,20
'2814057000,  송현3동,'90,85+ ,1998,19,6,13
'2814058000,  송림1동,'00,계,1998,5129,2557,2572
'2814058000,  송림1동,'05,0 - 4세,1998,180,101,79
'2814058000,  송림1동,'10,5 - 9세,1998,262,136,126
'2814058000,  송림1동,'15,10 - 14세,1998,300,163,137
'2814058000,  송림1동,'20,15 - 19세,1998,550,282,268
'2814058000,  송림1동,'25,20 - 24세,1998,514,256,258
'2814058000,  송림1동,'30,25 - 29세,1998,448,255,193
'2814058000,  송림1동,'35,30 - 34세,1998,305,164,141
'2814058000,  송림1동,'40,35 - 39세,1998,393,188,205
'2814058000,  송림1동,'45,40 - 44세,1998,465,220,245
'2814058000,  송림1동,'50,45 - 49세,1998,348,167,181
'2814058000,  송림1동,'55,50 - 54세,1998,336,185,151
'2814058000,  송림1동,'60,55 - 59세,1998,314,153,161
'2814058000,  송림1동,'65,60 - 64세,1998,258,120,138
'2814058000,  송림1동,'70,65 - 69세,1998,181,72,109
'2814058000,  송림1동,'75,70 - 74세,1998,117,36,81
'2814058000,  송림1동,'80,75 - 79세,1998,76,33,43
'2814058000,  송림1동,'85,80 - 84세,1998,51,17,34
'2814058000,  송림1동,'90,85+ ,1998,31,9,22
'2814059000,  송림2동,'00,계,1998,5617,2811,2806
'2814059000,  송림2동,'05,0 - 4세,1998,245,130,115
'2814059000,  송림2동,'10,5 - 9세,1998,318,157,161
'2814059000,  송림2동,'15,10 - 14세,1998,347,189,158
'2814059000,  송림2동,'20,15 - 19세,1998,558,267,291
'2814059000,  송림2동,'25,20 - 24세,1998,548,278,270
'2814059000,  송림2동,'30,25 - 29세,1998,483,267,216
'2814059000,  송림2동,'35,30 - 34세,1998,400,215,185
'2814059000,  송림2동,'40,35 - 39세,1998,481,256,225
'2814059000,  송림2동,'45,40 - 44세,1998,505,230,275
'2814059000,  송림2동,'50,45 - 49세,1998,387,202,185
'2814059000,  송림2동,'55,50 - 54세,1998,346,156,190
'2814059000,  송림2동,'60,55 - 59세,1998,327,161,166
'2814059000,  송림2동,'65,60 - 64세,1998,233,118,115
'2814059000,  송림2동,'70,65 - 69세,1998,164,78,86
'2814059000,  송림2동,'75,70 - 74세,1998,128,48,80
'2814059000,  송림2동,'80,75 - 79세,1998,91,40,51
'2814059000,  송림2동,'85,80 - 84세,1998,28,8,20
'2814059000,  송림2동,'90,85+ ,1998,28,11,17
'2814060500,  송림3.5동,'00,계,1998,11153,5674,5479
'2814060500,  송림3.5동,'05,0 - 4세,1998,491,263,228
'2814060500,  송림3.5동,'10,5 - 9세,1998,565,312,253
'2814060500,  송림3.5동,'15,10 - 14세,1998,652,338,314
'2814060500,  송림3.5동,'20,15 - 19세,1998,1145,593,552
'2814060500,  송림3.5동,'25,20 - 24세,1998,1086,581,505
'2814060500,  송림3.5동,'30,25 - 29세,1998,1003,554,449
'2814060500,  송림3.5동,'35,30 - 34세,1998,821,457,364
'2814060500,  송림3.5동,'40,35 - 39세,1998,902,465,437
'2814060500,  송림3.5동,'45,40 - 44세,1998,990,478,512
'2814060500,  송림3.5동,'50,45 - 49세,1998,724,366,358
'2814060500,  송림3.5동,'55,50 - 54세,1998,707,362,345
'2814060500,  송림3.5동,'60,55 - 59세,1998,683,331,352
'2814060500,  송림3.5동,'65,60 - 64세,1998,512,235,277
'2814060500,  송림3.5동,'70,65 - 69세,1998,351,141,210
'2814060500,  송림3.5동,'75,70 - 74세,1998,235,95,140
'2814060500,  송림3.5동,'80,75 - 79세,1998,165,69,96
'2814060500,  송림3.5동,'85,80 - 84세,1998,77,22,55
'2814060500,  송림3.5동,'90,85+ ,1998,44,12,32
'2814061000,  송림4동,'00,계,1998,6970,3620,3350
'2814061000,  송림4동,'05,0 - 4세,1998,412,213,199
'2814061000,  송림4동,'10,5 - 9세,1998,401,234,167
'2814061000,  송림4동,'15,10 - 14세,1998,397,213,184
'2814061000,  송림4동,'20,15 - 19세,1998,655,356,299
'2814061000,  송림4동,'25,20 - 24세,1998,677,345,332
'2814061000,  송림4동,'30,25 - 29세,1998,685,392,293
'2814061000,  송림4동,'35,30 - 34세,1998,570,327,243
'2814061000,  송림4동,'40,35 - 39세,1998,649,347,302
'2814061000,  송림4동,'45,40 - 44세,1998,560,292,268
'2814061000,  송림4동,'50,45 - 49세,1998,409,207,202
'2814061000,  송림4동,'55,50 - 54세,1998,383,189,194
'2814061000,  송림4동,'60,55 - 59세,1998,378,185,193
'2814061000,  송림4동,'65,60 - 64세,1998,314,141,173
'2814061000,  송림4동,'70,65 - 69세,1998,189,80,109
'2814061000,  송림4동,'75,70 - 74세,1998,134,55,79
'2814061000,  송림4동,'80,75 - 79세,1998,96,32,64
'2814061000,  송림4동,'85,80 - 84세,1998,40,10,30
'2814061000,  송림4동,'90,85+ ,1998,21,2,19
'2814063000,  송림6동,'00,계,1998,8439,4273,4166
'2814063000,  송림6동,'05,0 - 4세,1998,422,212,210
'2814063000,  송림6동,'10,5 - 9세,1998,520,264,256
'2814063000,  송림6동,'15,10 - 14세,1998,559,278,281
'2814063000,  송림6동,'20,15 - 19세,1998,823,424,399
'2814063000,  송림6동,'25,20 - 24세,1998,812,419,393
'2814063000,  송림6동,'30,25 - 29세,1998,788,454,334
'2814063000,  송림6동,'35,30 - 34세,1998,649,356,293
'2814063000,  송림6동,'40,35 - 39세,1998,740,369,371
'2814063000,  송림6동,'45,40 - 44세,1998,727,396,331
'2814063000,  송림6동,'50,45 - 49세,1998,504,234,270
'2814063000,  송림6동,'55,50 - 54세,1998,485,242,243
'2814063000,  송림6동,'60,55 - 59세,1998,460,230,230
'2814063000,  송림6동,'65,60 - 64세,1998,343,161,182
'2814063000,  송림6동,'70,65 - 69세,1998,241,97,144
'2814063000,  송림6동,'75,70 - 74세,1998,163,54,109
'2814063000,  송림6동,'80,75 - 79세,1998,125,51,74
'2814063000,  송림6동,'85,80 - 84세,1998,51,19,32
'2814063000,  송림6동,'90,85+ ,1998,27,13,14
'2814064000,  금창동,'00,계,1998,6349,3208,3141
'2814064000,  금창동,'05,0 - 4세,1998,231,114,117
'2814064000,  금창동,'10,5 - 9세,1998,295,148,147
'2814064000,  금창동,'15,10 - 14세,1998,394,210,184
'2814064000,  금창동,'20,15 - 19세,1998,615,321,294
'2814064000,  금창동,'25,20 - 24세,1998,673,343,330
'2814064000,  금창동,'30,25 - 29세,1998,620,358,262
'2814064000,  금창동,'35,30 - 34세,1998,425,251,174
'2814064000,  금창동,'40,35 - 39세,1998,478,240,238
'2814064000,  금창동,'45,40 - 44세,1998,523,252,271
'2814064000,  금창동,'50,45 - 49세,1998,405,195,210
'2814064000,  금창동,'55,50 - 54세,1998,447,219,228
'2814064000,  금창동,'60,55 - 59세,1998,401,202,199
'2814064000,  금창동,'65,60 - 64세,1998,296,144,152
'2814064000,  금창동,'70,65 - 69세,1998,188,78,110
'2814064000,  금창동,'75,70 - 74세,1998,154,54,100
'2814064000,  금창동,'80,75 - 79세,1998,115,45,70
'2814064000,  금창동,'85,80 - 84세,1998,54,20,34
'2814064000,  금창동,'90,85+ ,1998,35,14,21
'28170, 남구,'00,계,1998,418074,210821,207253
'28170, 남구,'05,0 - 4세,1998,27485,14344,13141
'28170, 남구,'10,5 - 9세,1998,28346,14839,13507
'28170, 남구,'15,10 - 14세,1998,26940,13839,13101
'28170, 남구,'20,15 - 19세,1998,37495,19432,18063
'28170, 남구,'25,20 - 24세,1998,37718,19335,18383
'28170, 남구,'30,25 - 29세,1998,43791,23125,20666
'28170, 남구,'35,30 - 34세,1998,38026,19652,18374
'28170, 남구,'40,35 - 39세,1998,39278,19896,19382
'28170, 남구,'45,40 - 44세,1998,34880,17447,17433
'28170, 남구,'50,45 - 49세,1998,25020,12450,12570
'28170, 남구,'55,50 - 54세,1998,22079,11021,11058
'28170, 남구,'60,55 - 59세,1998,19662,9871,9791
'28170, 남구,'65,60 - 64세,1998,14274,6805,7469
'28170, 남구,'70,65 - 69세,1998,9212,3801,5411
'28170, 남구,'75,70 - 74세,1998,6254,2354,3900
'28170, 남구,'80,75 - 79세,1998,4261,1624,2637
'28170, 남구,'85,80 - 84세,1998,2103,666,1437
'28170, 남구,'90,85+ ,1998,1250,320,930
'2817051000,  숭의1동,'00,계,1998,5832,2919,2913
'2817051000,  숭의1동,'05,0 - 4세,1998,282,135,147
'2817051000,  숭의1동,'10,5 - 9세,1998,280,142,138
'2817051000,  숭의1동,'15,10 - 14세,1998,290,134,156
'2817051000,  숭의1동,'20,15 - 19세,1998,477,257,220
'2817051000,  숭의1동,'25,20 - 24세,1998,566,273,293
'2817051000,  숭의1동,'30,25 - 29세,1998,601,344,257
'2817051000,  숭의1동,'35,30 - 34세,1998,459,262,197
'2817051000,  숭의1동,'40,35 - 39세,1998,438,229,209
'2817051000,  숭의1동,'45,40 - 44세,1998,429,228,201
'2817051000,  숭의1동,'50,45 - 49세,1998,380,168,212
'2817051000,  숭의1동,'55,50 - 54세,1998,380,180,200
'2817051000,  숭의1동,'60,55 - 59세,1998,447,211,236
'2817051000,  숭의1동,'65,60 - 64세,1998,322,148,174
'2817051000,  숭의1동,'70,65 - 69세,1998,200,92,108
'2817051000,  숭의1동,'75,70 - 74세,1998,127,53,74
'2817051000,  숭의1동,'80,75 - 79세,1998,88,38,50
'2817051000,  숭의1동,'85,80 - 84세,1998,41,18,23
'2817051000,  숭의1동,'90,85+ ,1998,25,7,18
'2817052000,  숭의2동,'00,계,1998,9851,4943,4908
'2817052000,  숭의2동,'05,0 - 4세,1998,520,266,254
'2817052000,  숭의2동,'10,5 - 9세,1998,461,232,229
'2817052000,  숭의2동,'15,10 - 14세,1998,495,258,237
'2817052000,  숭의2동,'20,15 - 19세,1998,859,468,391
'2817052000,  숭의2동,'25,20 - 24세,1998,977,479,498
'2817052000,  숭의2동,'30,25 - 29세,1998,1042,567,475
'2817052000,  숭의2동,'35,30 - 34세,1998,753,430,323
'2817052000,  숭의2동,'40,35 - 39세,1998,798,420,378
'2817052000,  숭의2동,'45,40 - 44세,1998,743,358,385
'2817052000,  숭의2동,'50,45 - 49세,1998,619,296,323
'2817052000,  숭의2동,'55,50 - 54세,1998,601,272,329
'2817052000,  숭의2동,'60,55 - 59세,1998,683,330,353
'2817052000,  숭의2동,'65,60 - 64세,1998,530,253,277
'2817052000,  숭의2동,'70,65 - 69세,1998,315,132,183
'2817052000,  숭의2동,'75,70 - 74세,1998,235,101,134
'2817052000,  숭의2동,'80,75 - 79세,1998,139,63,76
'2817052000,  숭의2동,'85,80 - 84세,1998,49,10,39
'2817052000,  숭의2동,'90,85+ ,1998,32,8,24
'2817053000,  숭의3동,'00,계,1998,8166,4111,4055
'2817053000,  숭의3동,'05,0 - 4세,1998,426,233,193
'2817053000,  숭의3동,'10,5 - 9세,1998,411,213,198
'2817053000,  숭의3동,'15,10 - 14세,1998,439,250,189
'2817053000,  숭의3동,'20,15 - 19세,1998,691,354,337
'2817053000,  숭의3동,'25,20 - 24세,1998,786,400,386
'2817053000,  숭의3동,'30,25 - 29세,1998,862,470,392
'2817053000,  숭의3동,'35,30 - 34세,1998,703,403,300
'2817053000,  숭의3동,'40,35 - 39세,1998,629,330,299
'2817053000,  숭의3동,'45,40 - 44세,1998,644,319,325
'2817053000,  숭의3동,'50,45 - 49세,1998,517,238,279
'2817053000,  숭의3동,'55,50 - 54세,1998,480,215,265
'2817053000,  숭의3동,'60,55 - 59세,1998,481,233,248
'2817053000,  숭의3동,'65,60 - 64세,1998,433,193,240
'2817053000,  숭의3동,'70,65 - 69세,1998,267,117,150
'2817053000,  숭의3동,'75,70 - 74세,1998,171,66,105
'2817053000,  숭의3동,'80,75 - 79세,1998,127,47,80
'2817053000,  숭의3동,'85,80 - 84세,1998,65,21,44
'2817053000,  숭의3동,'90,85+ ,1998,34,9,25
'2817054000,  숭의4동,'00,계,1998,16555,8350,8205
'2817054000,  숭의4동,'05,0 - 4세,1998,962,511,451
'2817054000,  숭의4동,'10,5 - 9세,1998,1015,546,469
'2817054000,  숭의4동,'15,10 - 14세,1998,996,524,472
'2817054000,  숭의4동,'20,15 - 19세,1998,1448,732,716
'2817054000,  숭의4동,'25,20 - 24세,1998,1485,748,737
'2817054000,  숭의4동,'30,25 - 29세,1998,1825,1021,804
'2817054000,  숭의4동,'35,30 - 34세,1998,1405,749,656
'2817054000,  숭의4동,'40,35 - 39세,1998,1493,757,736
'2817054000,  숭의4동,'45,40 - 44세,1998,1245,626,619
'2817054000,  숭의4동,'50,45 - 49세,1998,938,426,512
'2817054000,  숭의4동,'55,50 - 54세,1998,958,477,481
'2817054000,  숭의4동,'60,55 - 59세,1998,893,432,461
'2817054000,  숭의4동,'65,60 - 64세,1998,700,330,370
'2817054000,  숭의4동,'70,65 - 69세,1998,482,196,286
'2817054000,  숭의4동,'75,70 - 74세,1998,333,141,192
'2817054000,  숭의4동,'80,75 - 79세,1998,219,91,128
'2817054000,  숭의4동,'85,80 - 84세,1998,99,32,67
'2817054000,  숭의4동,'90,85+ ,1998,59,11,48
'2817055000,  용현1동,'00,계,1998,17160,8830,8330
'2817055000,  용현1동,'05,0 - 4세,1998,1028,516,512
'2817055000,  용현1동,'10,5 - 9세,1998,1048,577,471
'2817055000,  용현1동,'15,10 - 14세,1998,978,504,474
'2817055000,  용현1동,'20,15 - 19세,1998,1516,792,724
'2817055000,  용현1동,'25,20 - 24세,1998,1742,932,810
'2817055000,  용현1동,'30,25 - 29세,1998,1977,1153,824
'2817055000,  용현1동,'35,30 - 34세,1998,1518,798,720
'2817055000,  용현1동,'40,35 - 39세,1998,1474,759,715
'2817055000,  용현1동,'45,40 - 44세,1998,1244,639,605
'2817055000,  용현1동,'50,45 - 49세,1998,978,475,503
'2817055000,  용현1동,'55,50 - 54세,1998,1008,450,558
'2817055000,  용현1동,'60,55 - 59세,1998,992,519,473
'2817055000,  용현1동,'65,60 - 64세,1998,650,315,335
'2817055000,  용현1동,'70,65 - 69세,1998,411,166,245
'2817055000,  용현1동,'75,70 - 74세,1998,269,107,162
'2817055000,  용현1동,'80,75 - 79세,1998,198,87,111
'2817055000,  용현1동,'85,80 - 84세,1998,78,27,51
'2817055000,  용현1동,'90,85+ ,1998,51,14,37
'2817056000,  용현2동,'00,계,1998,16160,8184,7976
'2817056000,  용현2동,'05,0 - 4세,1998,863,445,418
'2817056000,  용현2동,'10,5 - 9세,1998,938,508,430
'2817056000,  용현2동,'15,10 - 14세,1998,978,504,474
'2817056000,  용현2동,'20,15 - 19세,1998,1587,837,750
'2817056000,  용현2동,'25,20 - 24세,1998,1596,799,797
'2817056000,  용현2동,'30,25 - 29세,1998,1580,883,697
'2817056000,  용현2동,'35,30 - 34세,1998,1205,618,587
'2817056000,  용현2동,'40,35 - 39세,1998,1400,716,684
'2817056000,  용현2동,'45,40 - 44세,1998,1371,662,709
'2817056000,  용현2동,'50,45 - 49세,1998,1092,535,557
'2817056000,  용현2동,'55,50 - 54세,1998,1032,528,504
'2817056000,  용현2동,'60,55 - 59세,1998,908,462,446
'2817056000,  용현2동,'65,60 - 64세,1998,613,308,305
'2817056000,  용현2동,'70,65 - 69세,1998,400,158,242
'2817056000,  용현2동,'75,70 - 74세,1998,272,102,170
'2817056000,  용현2동,'80,75 - 79세,1998,187,73,114
'2817056000,  용현2동,'85,80 - 84세,1998,78,25,53
'2817056000,  용현2동,'90,85+ ,1998,60,21,39
'2817057000,  용현3동,'00,계,1998,12049,6161,5888
'2817057000,  용현3동,'05,0 - 4세,1998,797,403,394
'2817057000,  용현3동,'10,5 - 9세,1998,754,385,369
'2817057000,  용현3동,'15,10 - 14세,1998,628,345,283
'2817057000,  용현3동,'20,15 - 19세,1998,968,529,439
'2817057000,  용현3동,'25,20 - 24세,1998,1136,611,525
'2817057000,  용현3동,'30,25 - 29세,1998,1383,728,655
'2817057000,  용현3동,'35,30 - 34세,1998,1142,645,497
'2817057000,  용현3동,'40,35 - 39세,1998,999,544,455
'2817057000,  용현3동,'45,40 - 44세,1998,900,449,451
'2817057000,  용현3동,'50,45 - 49세,1998,656,298,358
'2817057000,  용현3동,'55,50 - 54세,1998,684,307,377
'2817057000,  용현3동,'60,55 - 59세,1998,683,344,339
'2817057000,  용현3동,'65,60 - 64세,1998,532,261,271
'2817057000,  용현3동,'70,65 - 69세,1998,306,129,177
'2817057000,  용현3동,'75,70 - 74세,1998,201,75,126
'2817057000,  용현3동,'80,75 - 79세,1998,157,65,92
'2817057000,  용현3동,'85,80 - 84세,1998,76,29,47
'2817057000,  용현3동,'90,85+ ,1998,47,14,33
'2817058000,  용현4동,'00,계,1998,7798,4080,3718
'2817058000,  용현4동,'05,0 - 4세,1998,421,221,200
'2817058000,  용현4동,'10,5 - 9세,1998,416,213,203
'2817058000,  용현4동,'15,10 - 14세,1998,385,201,184
'2817058000,  용현4동,'20,15 - 19세,1998,664,354,310
'2817058000,  용현4동,'25,20 - 24세,1998,997,580,417
'2817058000,  용현4동,'30,25 - 29세,1998,1063,681,382
'2817058000,  용현4동,'35,30 - 34세,1998,607,319,288
'2817058000,  용현4동,'40,35 - 39세,1998,559,289,270
'2817058000,  용현4동,'45,40 - 44세,1998,519,252,267
'2817058000,  용현4동,'50,45 - 49세,1998,467,207,260
'2817058000,  용현4동,'55,50 - 54세,1998,465,216,249
'2817058000,  용현4동,'60,55 - 59세,1998,431,227,204
'2817058000,  용현4동,'65,60 - 64세,1998,296,130,166
'2817058000,  용현4동,'70,65 - 69세,1998,216,84,132
'2817058000,  용현4동,'75,70 - 74세,1998,118,42,76
'2817058000,  용현4동,'80,75 - 79세,1998,101,46,55
'2817058000,  용현4동,'85,80 - 84세,1998,40,11,29
'2817058000,  용현4동,'90,85+ ,1998,33,7,26
'2817059000,  용현5동,'00,계,1998,33561,16858,16703
'2817059000,  용현5동,'05,0 - 4세,1998,2357,1247,1110
'2817059000,  용현5동,'10,5 - 9세,1998,2700,1395,1305
'2817059000,  용현5동,'15,10 - 14세,1998,2636,1344,1292
'2817059000,  용현5동,'20,15 - 19세,1998,3207,1638,1569
'2817059000,  용현5동,'25,20 - 24세,1998,2433,1246,1187
'2817059000,  용현5동,'30,25 - 29세,1998,3003,1516,1487
'2817059000,  용현5동,'35,30 - 34세,1998,3054,1498,1556
'2817059000,  용현5동,'40,35 - 39세,1998,3684,1766,1918
'2817059000,  용현5동,'45,40 - 44세,1998,3307,1697,1610
'2817059000,  용현5동,'50,45 - 49세,1998,1980,1078,902
'2817059000,  용현5동,'55,50 - 54세,1998,1551,830,721
'2817059000,  용현5동,'60,55 - 59세,1998,1196,622,574
'2817059000,  용현5동,'65,60 - 64세,1998,933,437,496
'2817059000,  용현5동,'70,65 - 69세,1998,564,215,349
'2817059000,  용현5동,'75,70 - 74세,1998,440,159,281
'2817059000,  용현5동,'80,75 - 79세,1998,291,106,185
'2817059000,  용현5동,'85,80 - 84세,1998,138,40,98
'2817059000,  용현5동,'90,85+ ,1998,87,24,63
'2817060000,  학익1동,'00,계,1998,23037,11719,11318
'2817060000,  학익1동,'05,0 - 4세,1998,1618,880,738
'2817060000,  학익1동,'10,5 - 9세,1998,1850,975,875
'2817060000,  학익1동,'15,10 - 14세,1998,1579,770,809
'2817060000,  학익1동,'20,15 - 19세,1998,2040,1103,937
'2817060000,  학익1동,'25,20 - 24세,1998,1845,969,876
'2817060000,  학익1동,'30,25 - 29세,1998,2324,1179,1145
'2817060000,  학익1동,'35,30 - 34세,1998,2314,1141,1173
'2817060000,  학익1동,'40,35 - 39세,1998,2360,1247,1113
'2817060000,  학익1동,'45,40 - 44세,1998,2009,1031,978
'2817060000,  학익1동,'50,45 - 49세,1998,1276,683,593
'2817060000,  학익1동,'55,50 - 54세,1998,1060,524,536
'2817060000,  학익1동,'60,55 - 59세,1998,989,492,497
'2817060000,  학익1동,'65,60 - 64세,1998,719,339,380
'2817060000,  학익1동,'70,65 - 69세,1998,479,187,292
'2817060000,  학익1동,'75,70 - 74세,1998,276,102,174
'2817060000,  학익1동,'80,75 - 79세,1998,162,61,101
'2817060000,  학익1동,'85,80 - 84세,1998,84,27,57
'2817060000,  학익1동,'90,85+ ,1998,53,9,44
'2817061000,  학익2동,'00,계,1998,26746,13455,13291
'2817061000,  학익2동,'05,0 - 4세,1998,1999,1056,943
'2817061000,  학익2동,'10,5 - 9세,1998,2110,1145,965
'2817061000,  학익2동,'15,10 - 14세,1998,1981,1028,953
'2817061000,  학익2동,'20,15 - 19세,1998,2287,1202,1085
'2817061000,  학익2동,'25,20 - 24세,1998,2004,1025,979
'2817061000,  학익2동,'30,25 - 29세,1998,2595,1305,1290
'2817061000,  학익2동,'35,30 - 34세,1998,2620,1283,1337
'2817061000,  학익2동,'40,35 - 39세,1998,2811,1377,1434
'2817061000,  학익2동,'45,40 - 44세,1998,2476,1263,1213
'2817061000,  학익2동,'50,45 - 49세,1998,1518,794,724
'2817061000,  학익2동,'55,50 - 54세,1998,1236,658,578
'2817061000,  학익2동,'60,55 - 59세,1998,1000,506,494
'2817061000,  학익2동,'65,60 - 64세,1998,714,338,376
'2817061000,  학익2동,'70,65 - 69세,1998,489,160,329
'2817061000,  학익2동,'75,70 - 74세,1998,430,141,289
'2817061000,  학익2동,'80,75 - 79세,1998,262,107,155
'2817061000,  학익2동,'85,80 - 84세,1998,142,49,93
'2817061000,  학익2동,'90,85+ ,1998,72,18,54
'2817062000,  옥련동,'00,계,1998,48048,23886,24162
'2817062000,  옥련동,'05,0 - 4세,1998,4495,2399,2096
'2817062000,  옥련동,'10,5 - 9세,1998,5094,2594,2500
'2817062000,  옥련동,'15,10 - 14세,1998,3582,1814,1768
'2817062000,  옥련동,'20,15 - 19세,1998,3486,1837,1649
'2817062000,  옥련동,'25,20 - 24세,1998,2635,1345,1290
'2817062000,  옥련동,'30,25 - 29세,1998,3997,1683,2314
'2817062000,  옥련동,'35,30 - 34세,1998,5855,2708,3147
'2817062000,  옥련동,'40,35 - 39세,1998,6226,3239,2987
'2817062000,  옥련동,'45,40 - 44세,1998,4254,2303,1951
'2817062000,  옥련동,'50,45 - 49세,1998,2248,1243,1005
'2817062000,  옥련동,'55,50 - 54세,1998,1708,890,818
'2817062000,  옥련동,'60,55 - 59세,1998,1437,701,736
'2817062000,  옥련동,'65,60 - 64세,1998,1075,474,601
'2817062000,  옥련동,'70,65 - 69세,1998,750,258,492
'2817062000,  옥련동,'75,70 - 74세,1998,554,191,363
'2817062000,  옥련동,'80,75 - 79세,1998,389,136,253
'2817062000,  옥련동,'85,80 - 84세,1998,180,48,132
'2817062000,  옥련동,'90,85+ ,1998,83,23,60
'2817063000,  도화1동,'00,계,1998,21522,10784,10738
'2817063000,  도화1동,'05,0 - 4세,1998,1361,707,654
'2817063000,  도화1동,'10,5 - 9세,1998,1404,707,697
'2817063000,  도화1동,'15,10 - 14세,1998,1244,613,631
'2817063000,  도화1동,'20,15 - 19세,1998,1795,920,875
'2817063000,  도화1동,'25,20 - 24세,1998,2015,1023,992
'2817063000,  도화1동,'30,25 - 29세,1998,2334,1250,1084
'2817063000,  도화1동,'35,30 - 34세,1998,1948,1010,938
'2817063000,  도화1동,'40,35 - 39세,1998,1909,976,933
'2817063000,  도화1동,'45,40 - 44세,1998,1669,858,811
'2817063000,  도화1동,'50,45 - 49세,1998,1314,619,695
'2817063000,  도화1동,'55,50 - 54세,1998,1228,594,634
'2817063000,  도화1동,'60,55 - 59세,1998,1121,541,580
'2817063000,  도화1동,'65,60 - 64세,1998,858,423,435
'2817063000,  도화1동,'70,65 - 69세,1998,561,251,310
'2817063000,  도화1동,'75,70 - 74세,1998,346,148,198
'2817063000,  도화1동,'80,75 - 79세,1998,234,86,148
'2817063000,  도화1동,'85,80 - 84세,1998,122,40,82
'2817063000,  도화1동,'90,85+ ,1998,59,18,41
'2817064000,  도화2동,'00,계,1998,19099,9743,9356
'2817064000,  도화2동,'05,0 - 4세,1998,1218,645,573
'2817064000,  도화2동,'10,5 - 9세,1998,1254,631,623
'2817064000,  도화2동,'15,10 - 14세,1998,1207,646,561
'2817064000,  도화2동,'20,15 - 19세,1998,1706,895,811
'2817064000,  도화2동,'25,20 - 24세,1998,1764,902,862
'2817064000,  도화2동,'30,25 - 29세,1998,2005,1083,922
'2817064000,  도화2동,'35,30 - 34세,1998,1814,967,847
'2817064000,  도화2동,'40,35 - 39세,1998,1768,939,829
'2817064000,  도화2동,'45,40 - 44세,1998,1511,771,740
'2817064000,  도화2동,'50,45 - 49세,1998,1083,561,522
'2817064000,  도화2동,'55,50 - 54세,1998,936,447,489
'2817064000,  도화2동,'60,55 - 59세,1998,970,468,502
'2817064000,  도화2동,'65,60 - 64세,1998,719,337,382
'2817064000,  도화2동,'70,65 - 69세,1998,475,213,262
'2817064000,  도화2동,'75,70 - 74세,1998,303,103,200
'2817064000,  도화2동,'80,75 - 79세,1998,195,85,110
'2817064000,  도화2동,'85,80 - 84세,1998,107,35,72
'2817064000,  도화2동,'90,85+ ,1998,64,15,49
'2817065000,  도화3동,'00,계,1998,9824,5063,4761
'2817065000,  도화3동,'05,0 - 4세,1998,545,277,268
'2817065000,  도화3동,'10,5 - 9세,1998,611,320,291
'2817065000,  도화3동,'15,10 - 14세,1998,648,341,307
'2817065000,  도화3동,'20,15 - 19세,1998,1008,505,503
'2817065000,  도화3동,'25,20 - 24세,1998,1052,572,480
'2817065000,  도화3동,'30,25 - 29세,1998,953,515,438
'2817065000,  도화3동,'35,30 - 34세,1998,836,448,388
'2817065000,  도화3동,'40,35 - 39세,1998,933,488,445
'2817065000,  도화3동,'45,40 - 44세,1998,845,434,411
'2817065000,  도화3동,'50,45 - 49세,1998,657,336,321
'2817065000,  도화3동,'55,50 - 54세,1998,589,311,278
'2817065000,  도화3동,'60,55 - 59세,1998,412,217,195
'2817065000,  도화3동,'65,60 - 64세,1998,300,139,161
'2817065000,  도화3동,'70,65 - 69세,1998,171,75,96
'2817065000,  도화3동,'75,70 - 74세,1998,113,35,78
'2817065000,  도화3동,'80,75 - 79세,1998,95,32,63
'2817065000,  도화3동,'85,80 - 84세,1998,36,14,22
'2817065000,  도화3동,'90,85+ ,1998,20,4,16
'2817066000,  주안1동,'00,계,1998,9254,4656,4598
'2817066000,  주안1동,'05,0 - 4세,1998,570,307,263
'2817066000,  주안1동,'10,5 - 9세,1998,463,248,215
'2817066000,  주안1동,'15,10 - 14세,1998,432,217,215
'2817066000,  주안1동,'20,15 - 19세,1998,770,397,373
'2817066000,  주안1동,'25,20 - 24세,1998,968,523,445
'2817066000,  주안1동,'30,25 - 29세,1998,1126,600,526
'2817066000,  주안1동,'35,30 - 34세,1998,793,424,369
'2817066000,  주안1동,'40,35 - 39세,1998,709,370,339
'2817066000,  주안1동,'45,40 - 44세,1998,671,312,359
'2817066000,  주안1동,'50,45 - 49세,1998,594,266,328
'2817066000,  주안1동,'55,50 - 54세,1998,571,280,291
'2817066000,  주안1동,'60,55 - 59세,1998,546,276,270
'2817066000,  주안1동,'65,60 - 64세,1998,397,188,209
'2817066000,  주안1동,'70,65 - 69세,1998,283,117,166
'2817066000,  주안1동,'75,70 - 74세,1998,154,54,100
'2817066000,  주안1동,'80,75 - 79세,1998,106,48,58
'2817066000,  주안1동,'85,80 - 84세,1998,64,18,46
'2817066000,  주안1동,'90,85+ ,1998,37,11,26
'2817067000,  주안2동,'00,계,1998,25486,12844,12642
'2817067000,  주안2동,'05,0 - 4세,1998,1646,882,764
'2817067000,  주안2동,'10,5 - 9세,1998,1546,781,765
'2817067000,  주안2동,'15,10 - 14세,1998,1488,781,707
'2817067000,  주안2동,'20,15 - 19세,1998,2243,1158,1085
'2817067000,  주안2동,'25,20 - 24세,1998,2491,1296,1195
'2817067000,  주안2동,'30,25 - 29세,1998,2758,1465,1293
'2817067000,  주안2동,'35,30 - 34세,1998,2248,1166,1082
'2817067000,  주안2동,'40,35 - 39세,1998,2129,1094,1035
'2817067000,  주안2동,'45,40 - 44세,1998,2059,1001,1058
'2817067000,  주안2동,'50,45 - 49세,1998,1528,752,776
'2817067000,  주안2동,'55,50 - 54세,1998,1521,736,785
'2817067000,  주안2동,'60,55 - 59세,1998,1355,692,663
'2817067000,  주안2동,'65,60 - 64세,1998,985,491,494
'2817067000,  주안2동,'70,65 - 69세,1998,598,253,345
'2817067000,  주안2동,'75,70 - 74세,1998,380,148,232
'2817067000,  주안2동,'80,75 - 79세,1998,270,88,182
'2817067000,  주안2동,'85,80 - 84세,1998,147,41,106
'2817067000,  주안2동,'90,85+ ,1998,94,19,75
'2817068000,  주안3동,'00,계,1998,14658,7352,7306
'2817068000,  주안3동,'05,0 - 4세,1998,1039,514,525
'2817068000,  주안3동,'10,5 - 9세,1998,939,482,457
'2817068000,  주안3동,'15,10 - 14세,1998,895,467,428
'2817068000,  주안3동,'20,15 - 19세,1998,1401,712,689
'2817068000,  주안3동,'25,20 - 24세,1998,1492,762,730
'2817068000,  주안3동,'30,25 - 29세,1998,1665,859,806
'2817068000,  주안3동,'35,30 - 34세,1998,1320,720,600
'2817068000,  주안3동,'40,35 - 39세,1998,1271,631,640
'2817068000,  주안3동,'45,40 - 44세,1998,1117,568,549
'2817068000,  주안3동,'50,45 - 49세,1998,933,439,494
'2817068000,  주안3동,'55,50 - 54세,1998,799,399,400
'2817068000,  주안3동,'60,55 - 59세,1998,694,348,346
'2817068000,  주안3동,'65,60 - 64세,1998,456,221,235
'2817068000,  주안3동,'70,65 - 69세,1998,235,100,135
'2817068000,  주안3동,'75,70 - 74세,1998,166,64,102
'2817068000,  주안3동,'80,75 - 79세,1998,130,36,94
'2817068000,  주안3동,'85,80 - 84세,1998,67,17,50
'2817068000,  주안3동,'90,85+ ,1998,39,13,26
'2817069000,  주안4동,'00,계,1998,25254,12600,12654
'2817069000,  주안4동,'05,0 - 4세,1998,1404,701,703
'2817069000,  주안4동,'10,5 - 9세,1998,1553,827,726
'2817069000,  주안4동,'15,10 - 14세,1998,1516,785,731
'2817069000,  주안4동,'20,15 - 19세,1998,2372,1233,1139
'2817069000,  주안4동,'25,20 - 24세,1998,2571,1284,1287
'2817069000,  주안4동,'30,25 - 29세,1998,2644,1382,1262
'2817069000,  주안4동,'35,30 - 34세,1998,2027,1020,1007
'2817069000,  주안4동,'40,35 - 39세,1998,2173,1072,1101
'2817069000,  주안4동,'45,40 - 44세,1998,2127,1039,1088
'2817069000,  주안4동,'50,45 - 49세,1998,1689,776,913
'2817069000,  주안4동,'55,50 - 54세,1998,1565,812,753
'2817069000,  주안4동,'60,55 - 59세,1998,1261,657,604
'2817069000,  주안4동,'65,60 - 64세,1998,877,434,443
'2817069000,  주안4동,'70,65 - 69세,1998,588,253,335
'2817069000,  주안4동,'75,70 - 74세,1998,389,140,249
'2817069000,  주안4동,'80,75 - 79세,1998,277,113,164
'2817069000,  주안4동,'85,80 - 84세,1998,138,47,91
'2817069000,  주안4동,'90,85+ ,1998,83,25,58
'2817070000,  주안5동,'00,계,1998,26915,13721,13194
'2817070000,  주안5동,'05,0 - 4세,1998,2151,1113,1038
'2817070000,  주안5동,'10,5 - 9세,1998,1939,999,940
'2817070000,  주안5동,'15,10 - 14세,1998,1602,814,788
'2817070000,  주안5동,'20,15 - 19세,1998,2178,1114,1064
'2817070000,  주안5동,'25,20 - 24세,1998,2411,1238,1173
'2817070000,  주안5동,'30,25 - 29세,1998,3324,1731,1593
'2817070000,  주안5동,'35,30 - 34세,1998,2918,1567,1351
'2817070000,  주안5동,'40,35 - 39세,1998,2631,1434,1197
'2817070000,  주안5동,'45,40 - 44세,1998,2002,1012,990
'2817070000,  주안5동,'50,45 - 49세,1998,1371,691,680
'2817070000,  주안5동,'55,50 - 54세,1998,1216,605,611
'2817070000,  주안5동,'60,55 - 59세,1998,1090,511,579
'2817070000,  주안5동,'65,60 - 64세,1998,797,396,401
'2817070000,  주안5동,'70,65 - 69세,1998,534,221,313
'2817070000,  주안5동,'75,70 - 74세,1998,358,138,220
'2817070000,  주안5동,'80,75 - 79세,1998,228,85,143
'2817070000,  주안5동,'85,80 - 84세,1998,100,38,62
'2817070000,  주안5동,'90,85+ ,1998,65,14,51
'2817071000,  주안6동,'00,계,1998,15130,7551,7579
'2817071000,  주안6동,'05,0 - 4세,1998,1115,602,513
'2817071000,  주안6동,'10,5 - 9세,1998,1105,587,518
'2817071000,  주안6동,'15,10 - 14세,1998,882,440,442
'2817071000,  주안6동,'20,15 - 19세,1998,1183,642,541
'2817071000,  주안6동,'25,20 - 24세,1998,1280,639,641
'2817071000,  주안6동,'30,25 - 29세,1998,1675,867,808
'2817071000,  주안6동,'35,30 - 34세,1998,1515,757,758
'2817071000,  주안6동,'40,35 - 39세,1998,1459,763,696
'2817071000,  주안6동,'45,40 - 44세,1998,1229,589,640
'2817071000,  주안6동,'50,45 - 49세,1998,838,396,442
'2817071000,  주안6동,'55,50 - 54세,1998,738,349,389
'2817071000,  주안6동,'60,55 - 59세,1998,722,344,378
'2817071000,  주안6동,'65,60 - 64세,1998,552,258,294
'2817071000,  주안6동,'70,65 - 69세,1998,330,142,188
'2817071000,  주안6동,'75,70 - 74세,1998,216,88,128
'2817071000,  주안6동,'80,75 - 79세,1998,143,47,96
'2817071000,  주안6동,'85,80 - 84세,1998,98,29,69
'2817071000,  주안6동,'90,85+ ,1998,50,12,38
'2817072000,  주안7동,'00,계,1998,20361,10156,10205
'2817072000,  주안7동,'05,0 - 4세,1998,1423,739,684
'2817072000,  주안7동,'10,5 - 9세,1998,1336,720,616
'2817072000,  주안7동,'15,10 - 14세,1998,1287,662,625
'2817072000,  주안7동,'20,15 - 19세,1998,1929,943,986
'2817072000,  주안7동,'25,20 - 24세,1998,1947,960,987
'2817072000,  주안7동,'30,25 - 29세,1998,2206,1139,1067
'2817072000,  주안7동,'35,30 - 34세,1998,1867,967,900
'2817072000,  주안7동,'40,35 - 39세,1998,1873,930,943
'2817072000,  주안7동,'45,40 - 44세,1998,1614,796,818
'2817072000,  주안7동,'50,45 - 49세,1998,1287,632,655
'2817072000,  주안7동,'55,50 - 54세,1998,1055,529,526
'2817072000,  주안7동,'60,55 - 59세,1998,930,483,447
'2817072000,  주안7동,'65,60 - 64세,1998,610,290,320
'2817072000,  주안7동,'70,65 - 69세,1998,375,157,218
'2817072000,  주안7동,'75,70 - 74세,1998,276,92,184
'2817072000,  주안7동,'80,75 - 79세,1998,192,71,121
'2817072000,  주안7동,'85,80 - 84세,1998,89,25,64
'2817072000,  주안7동,'90,85+ ,1998,65,21,44
'2817073000,  주안8동,'00,계,1998,26083,13042,13041
'2817073000,  주안8동,'05,0 - 4세,1998,1939,1019,920
'2817073000,  주안8동,'10,5 - 9세,1998,2091,1092,999
'2817073000,  주안8동,'15,10 - 14세,1998,1913,956,957
'2817073000,  주안8동,'20,15 - 19세,1998,2382,1214,1168
'2817073000,  주안8동,'25,20 - 24세,1998,1992,998,994
'2817073000,  주안8동,'30,25 - 29세,1998,2432,1210,1222
'2817073000,  주안8동,'35,30 - 34세,1998,2604,1300,1304
'2817073000,  주안8동,'40,35 - 39세,1998,2877,1430,1447
'2817073000,  주안8동,'45,40 - 44세,1998,2345,1169,1176
'2817073000,  주안8동,'50,45 - 49세,1998,1487,803,684
'2817073000,  주안8동,'55,50 - 54세,1998,1184,617,567
'2817073000,  주안8동,'60,55 - 59세,1998,974,482,492
'2817073000,  주안8동,'65,60 - 64세,1998,684,314,370
'2817073000,  주안8동,'70,65 - 69세,1998,476,187,289
'2817073000,  주안8동,'75,70 - 74세,1998,325,125,200
'2817073000,  주안8동,'80,75 - 79세,1998,218,77,141
'2817073000,  주안8동,'85,80 - 84세,1998,114,36,78
'2817073000,  주안8동,'90,85+ ,1998,46,13,33
'2817073500,  관교동,'00,계,1998,20957,10364,10593
'2817073500,  관교동,'05,0 - 4세,1998,1270,646,624
'2817073500,  관교동,'10,5 - 9세,1998,1685,874,811
'2817073500,  관교동,'15,10 - 14세,1998,1999,1030,969
'2817073500,  관교동,'20,15 - 19세,1998,2208,1143,1065
'2817073500,  관교동,'25,20 - 24세,1998,1582,774,808
'2817073500,  관교동,'30,25 - 29세,1998,1682,813,869
'2817073500,  관교동,'35,30 - 34세,1998,1645,788,857
'2817073500,  관교동,'40,35 - 39세,1998,2250,1009,1241
'2817073500,  관교동,'45,40 - 44세,1998,2302,1109,1193
'2817073500,  관교동,'50,45 - 49세,1998,1450,796,654
'2817073500,  관교동,'55,50 - 54세,1998,907,523,384
'2817073500,  관교동,'60,55 - 59세,1998,634,341,293
'2817073500,  관교동,'65,60 - 64세,1998,426,187,239
'2817073500,  관교동,'70,65 - 69세,1998,333,148,185
'2817073500,  관교동,'75,70 - 74세,1998,257,98,159
'2817073500,  관교동,'80,75 - 79세,1998,183,55,128
'2817073500,  관교동,'85,80 - 84세,1998,95,22,73
'2817073500,  관교동,'90,85+ ,1998,49,8,41
'2817074000,  문학동,'00,계,1998,6616,3335,3281
'2817074000,  문학동,'05,0 - 4세,1998,531,279,252
'2817074000,  문학동,'10,5 - 9세,1998,437,240,197
'2817074000,  문학동,'15,10 - 14세,1998,442,225,217
'2817074000,  문학동,'20,15 - 19세,1998,576,290,286
'2817074000,  문학동,'25,20 - 24세,1998,586,302,284
'2817074000,  문학동,'30,25 - 29세,1998,732,364,368
'2817074000,  문학동,'35,30 - 34세,1998,711,372,339
'2817074000,  문학동,'40,35 - 39세,1998,651,326,325
'2817074000,  문학동,'45,40 - 44세,1998,502,265,237
'2817074000,  문학동,'50,45 - 49세,1998,368,185,183
'2817074000,  문학동,'55,50 - 54세,1998,315,162,153
'2817074000,  문학동,'60,55 - 59세,1998,250,133,117
'2817074000,  문학동,'65,60 - 64세,1998,171,75,96
'2817074000,  문학동,'70,65 - 69세,1998,124,48,76
'2817074000,  문학동,'75,70 - 74세,1998,99,32,67
'2817074000,  문학동,'80,75 - 79세,1998,59,17,42
'2817074000,  문학동,'85,80 - 84세,1998,36,15,21
'2817074000,  문학동,'90,85+ ,1998,26,5,21
'28185, 연수구,'00,계,1998,259862,129967,129895
'28185, 연수구,'05,0 - 4세,1998,21610,11380,10230
'28185, 연수구,'10,5 - 9세,1998,27059,14175,12884
'28185, 연수구,'15,10 - 14세,1998,22387,11600,10787
'28185, 연수구,'20,15 - 19세,1998,20466,10466,10000
'28185, 연수구,'25,20 - 24세,1998,14964,7481,7483
'28185, 연수구,'30,25 - 29세,1998,22618,10456,12162
'28185, 연수구,'35,30 - 34세,1998,28755,13156,15599
'28185, 연수구,'40,35 - 39세,1998,34498,17491,17007
'28185, 연수구,'45,40 - 44세,1998,24844,13568,11276
'28185, 연수구,'50,45 - 49세,1998,12141,6789,5352
'28185, 연수구,'55,50 - 54세,1998,8332,4482,3850
'28185, 연수구,'60,55 - 59세,1998,6481,3180,3301
'28185, 연수구,'65,60 - 64세,1998,5160,2223,2937
'28185, 연수구,'70,65 - 69세,1998,3857,1369,2488
'28185, 연수구,'75,70 - 74세,1998,2961,961,2000
'28185, 연수구,'80,75 - 79세,1998,2133,731,1402
'28185, 연수구,'85,80 - 84세,1998,1030,305,725
'28185, 연수구,'90,85+ ,1998,566,154,412
'2818575000,  선학동,'00,계,1998,24646,12261,12385
'2818575000,  선학동,'05,0 - 4세,1998,1674,878,796
'2818575000,  선학동,'10,5 - 9세,1998,2093,1085,1008
'2818575000,  선학동,'15,10 - 14세,1998,2051,1062,989
'2818575000,  선학동,'20,15 - 19세,1998,2437,1244,1193
'2818575000,  선학동,'25,20 - 24세,1998,1812,894,918
'2818575000,  선학동,'30,25 - 29세,1998,2312,1161,1151
'2818575000,  선학동,'35,30 - 34세,1998,2353,1089,1264
'2818575000,  선학동,'40,35 - 39세,1998,2967,1449,1518
'2818575000,  선학동,'45,40 - 44세,1998,2326,1199,1127
'2818575000,  선학동,'50,45 - 49세,1998,1306,706,600
'2818575000,  선학동,'55,50 - 54세,1998,940,503,437
'2818575000,  선학동,'60,55 - 59세,1998,743,356,387
'2818575000,  선학동,'65,60 - 64세,1998,537,248,289
'2818575000,  선학동,'70,65 - 69세,1998,422,165,257
'2818575000,  선학동,'75,70 - 74세,1998,298,102,196
'2818575000,  선학동,'80,75 - 79세,1998,193,67,126
'2818575000,  선학동,'85,80 - 84세,1998,110,37,73
'2818575000,  선학동,'90,85+ ,1998,72,16,56
'2818576100,  연수1동,'00,계,1998,31604,16035,15569
'2818576100,  연수1동,'05,0 - 4세,1998,3082,1626,1456
'2818576100,  연수1동,'10,5 - 9세,1998,2823,1468,1355
'2818576100,  연수1동,'15,10 - 14세,1998,2283,1206,1077
'2818576100,  연수1동,'20,15 - 19세,1998,2019,994,1025
'2818576100,  연수1동,'25,20 - 24세,1998,2327,1052,1275
'2818576100,  연수1동,'30,25 - 29세,1998,4436,2238,2198
'2818576100,  연수1동,'35,30 - 34세,1998,3978,2052,1926
'2818576100,  연수1동,'40,35 - 39세,1998,3791,1968,1823
'2818576100,  연수1동,'45,40 - 44세,1998,2524,1399,1125
'2818576100,  연수1동,'50,45 - 49세,1998,1203,649,554
'2818576100,  연수1동,'55,50 - 54세,1998,850,452,398
'2818576100,  연수1동,'60,55 - 59세,1998,712,342,370
'2818576100,  연수1동,'65,60 - 64세,1998,551,234,317
'2818576100,  연수1동,'70,65 - 69세,1998,394,162,232
'2818576100,  연수1동,'75,70 - 74세,1998,273,84,189
'2818576100,  연수1동,'80,75 - 79세,1998,213,79,134
'2818576100,  연수1동,'85,80 - 84세,1998,92,19,73
'2818576100,  연수1동,'90,85+ ,1998,53,11,42
'2818576200,  연수2동,'00,계,1998,29338,14584,14754
'2818576200,  연수2동,'05,0 - 4세,1998,2383,1267,1116
'2818576200,  연수2동,'10,5 - 9세,1998,3132,1667,1465
'2818576200,  연수2동,'15,10 - 14세,1998,2671,1384,1287
'2818576200,  연수2동,'20,15 - 19세,1998,2429,1224,1205
'2818576200,  연수2동,'25,20 - 24세,1998,1593,798,795
'2818576200,  연수2동,'30,25 - 29세,1998,2513,1117,1396
'2818576200,  연수2동,'35,30 - 34세,1998,3239,1430,1809
'2818576200,  연수2동,'40,35 - 39세,1998,3995,2023,1972
'2818576200,  연수2동,'45,40 - 44세,1998,2904,1596,1308
'2818576200,  연수2동,'50,45 - 49세,1998,1356,752,604
'2818576200,  연수2동,'55,50 - 54세,1998,840,453,387
'2818576200,  연수2동,'60,55 - 59세,1998,603,286,317
'2818576200,  연수2동,'65,60 - 64세,1998,515,221,294
'2818576200,  연수2동,'70,65 - 69세,1998,421,128,293
'2818576200,  연수2동,'75,70 - 74세,1998,346,100,246
'2818576200,  연수2동,'80,75 - 79세,1998,234,82,152
'2818576200,  연수2동,'85,80 - 84세,1998,113,42,71
'2818576200,  연수2동,'90,85+ ,1998,51,14,37
'2818576300,  연수3동,'00,계,1998,25688,12699,12989
'2818576300,  연수3동,'05,0 - 4세,1998,2047,1034,1013
'2818576300,  연수3동,'10,5 - 9세,1998,2903,1522,1381
'2818576300,  연수3동,'15,10 - 14세,1998,2453,1266,1187
'2818576300,  연수3동,'20,15 - 19세,1998,2208,1121,1087
'2818576300,  연수3동,'25,20 - 24세,1998,1258,649,609
'2818576300,  연수3동,'30,25 - 29세,1998,1885,831,1054
'2818576300,  연수3동,'35,30 - 34세,1998,2840,1243,1597
'2818576300,  연수3동,'40,35 - 39세,1998,3610,1829,1781
'2818576300,  연수3동,'45,40 - 44세,1998,2606,1385,1221
'2818576300,  연수3동,'50,45 - 49세,1998,1165,682,483
'2818576300,  연수3동,'55,50 - 54세,1998,702,385,317
'2818576300,  연수3동,'60,55 - 59세,1998,539,242,297
'2818576300,  연수3동,'65,60 - 64세,1998,445,166,279
'2818576300,  연수3동,'70,65 - 69세,1998,383,128,255
'2818576300,  연수3동,'75,70 - 74세,1998,321,107,214
'2818576300,  연수3동,'80,75 - 79세,1998,182,64,118
'2818576300,  연수3동,'85,80 - 84세,1998,93,30,63
'2818576300,  연수3동,'90,85+ ,1998,48,15,33
'2818576600,  청학동,'00,계,1998,32005,16301,15704
'2818576600,  청학동,'05,0 - 4세,1998,3045,1599,1446
'2818576600,  청학동,'10,5 - 9세,1998,3177,1694,1483
'2818576600,  청학동,'15,10 - 14세,1998,2398,1226,1172
'2818576600,  청학동,'20,15 - 19세,1998,2237,1187,1050
'2818576600,  청학동,'25,20 - 24세,1998,1957,988,969
'2818576600,  청학동,'30,25 - 29세,1998,3419,1617,1802
'2818576600,  청학동,'35,30 - 34세,1998,3937,1917,2020
'2818576600,  청학동,'40,35 - 39세,1998,4060,2167,1893
'2818576600,  청학동,'45,40 - 44세,1998,2683,1487,1196
'2818576600,  청학동,'50,45 - 49세,1998,1399,770,629
'2818576600,  청학동,'55,50 - 54세,1998,1062,561,501
'2818576600,  청학동,'60,55 - 59세,1998,803,398,405
'2818576600,  청학동,'65,60 - 64세,1998,673,289,384
'2818576600,  청학동,'70,65 - 69세,1998,428,151,277
'2818576600,  청학동,'75,70 - 74세,1998,338,106,232
'2818576600,  청학동,'80,75 - 79세,1998,248,93,155
'2818576600,  청학동,'85,80 - 84세,1998,100,37,63
'2818576600,  청학동,'90,85+ ,1998,41,14,27
'2818578000,  동춘1동,'00,계,1998,20131,10016,10115
'2818578000,  동춘1동,'05,0 - 4세,1998,1344,710,634
'2818578000,  동춘1동,'10,5 - 9세,1998,2299,1219,1080
'2818578000,  동춘1동,'15,10 - 14세,1998,2007,1065,942
'2818578000,  동춘1동,'20,15 - 19세,1998,1550,774,776
'2818578000,  동춘1동,'25,20 - 24세,1998,1040,541,499
'2818578000,  동춘1동,'30,25 - 29세,1998,1178,556,622
'2818578000,  동춘1동,'35,30 - 34세,1998,1943,791,1152
'2818578000,  동춘1동,'40,35 - 39세,1998,2808,1413,1395
'2818578000,  동춘1동,'45,40 - 44세,1998,2109,1187,922
'2818578000,  동춘1동,'50,45 - 49세,1998,944,533,411
'2818578000,  동춘1동,'55,50 - 54세,1998,670,363,307
'2818578000,  동춘1동,'60,55 - 59세,1998,523,245,278
'2818578000,  동춘1동,'65,60 - 64세,1998,460,208,252
'2818578000,  동춘1동,'70,65 - 69세,1998,391,141,250
'2818578000,  동춘1동,'75,70 - 74세,1998,314,108,206
'2818578000,  동춘1동,'80,75 - 79세,1998,286,92,194
'2818578000,  동춘1동,'85,80 - 84세,1998,144,40,104
'2818578000,  동춘1동,'90,85+ ,1998,121,30,91
'2818579000,  동춘2동,'00,계,1998,25956,13045,12911
'2818579000,  동춘2동,'05,0 - 4세,1998,2508,1271,1237
'2818579000,  동춘2동,'10,5 - 9세,1998,3330,1767,1563
'2818579000,  동춘2동,'15,10 - 14세,1998,2444,1289,1155
'2818579000,  동춘2동,'20,15 - 19세,1998,1701,852,849
'2818579000,  동춘2동,'25,20 - 24세,1998,959,495,464
'2818579000,  동춘2동,'30,25 - 29세,1998,1814,731,1083
'2818579000,  동춘2동,'35,30 - 34세,1998,3348,1467,1881
'2818579000,  동춘2동,'40,35 - 39세,1998,4119,2157,1962
'2818579000,  동춘2동,'45,40 - 44세,1998,2482,1468,1014
'2818579000,  동춘2동,'50,45 - 49세,1998,966,572,394
'2818579000,  동춘2동,'55,50 - 54세,1998,563,312,251
'2818579000,  동춘2동,'60,55 - 59세,1998,455,231,224
'2818579000,  동춘2동,'65,60 - 64세,1998,421,154,267
'2818579000,  동춘2동,'70,65 - 69세,1998,324,108,216
'2818579000,  동춘2동,'75,70 - 74세,1998,237,83,154
'2818579000,  동춘2동,'80,75 - 79세,1998,164,52,112
'2818579000,  동춘2동,'85,80 - 84세,1998,83,23,60
'2818579000,  동춘2동,'90,85+ ,1998,38,13,25
'2818580000,  청량동,'00,계,1998,22446,11140,11306
'2818580000,  청량동,'05,0 - 4세,1998,1032,596,436
'2818580000,  청량동,'10,5 - 9세,1998,2208,1159,1049
'2818580000,  청량동,'15,10 - 14세,1998,2498,1288,1210
'2818580000,  청량동,'20,15 - 19세,1998,2399,1233,1166
'2818580000,  청량동,'25,20 - 24세,1998,1383,719,664
'2818580000,  청량동,'30,25 - 29세,1998,1064,522,542
'2818580000,  청량동,'35,30 - 34세,1998,1262,459,803
'2818580000,  청량동,'40,35 - 39세,1998,2922,1246,1676
'2818580000,  청량동,'45,40 - 44세,1998,2956,1544,1412
'2818580000,  청량동,'50,45 - 49세,1998,1554,882,672
'2818580000,  청량동,'55,50 - 54세,1998,997,563,434
'2818580000,  청량동,'60,55 - 59세,1998,666,379,287
'2818580000,  청량동,'65,60 - 64세,1998,483,229,254
'2818580000,  청량동,'70,65 - 69세,1998,344,128,216
'2818580000,  청량동,'75,70 - 74세,1998,280,80,200
'2818580000,  청량동,'80,75 - 79세,1998,224,66,158
'2818580000,  청량동,'85,80 - 84세,1998,115,29,86
'2818580000,  청량동,'90,85+ ,1998,59,18,41
'28200, 남동구,'00,계,1998,396499,199907,196592
'28200, 남동구,'05,0 - 4세,1998,33066,17392,15674
'28200, 남동구,'10,5 - 9세,1998,33250,17267,15983
'28200, 남동구,'15,10 - 14세,1998,28187,14737,13450
'28200, 남동구,'20,15 - 19세,1998,33629,17216,16413
'28200, 남동구,'25,20 - 24세,1998,29918,15022,14896
'28200, 남동구,'30,25 - 29세,1998,40369,19677,20692
'28200, 남동구,'35,30 - 34세,1998,42858,21721,21137
'28200, 남동구,'40,35 - 39세,1998,43856,22839,21017
'28200, 남동구,'45,40 - 44세,1998,33748,17473,16275
'28200, 남동구,'50,45 - 49세,1998,21277,11193,10084
'28200, 남동구,'55,50 - 54세,1998,16124,8348,7776
'28200, 남동구,'60,55 - 59세,1998,13065,6399,6666
'28200, 남동구,'65,60 - 64세,1998,9841,4492,5349
'28200, 남동구,'70,65 - 69세,1998,6770,2555,4215
'28200, 남동구,'75,70 - 74세,1998,4868,1699,3169
'28200, 남동구,'80,75 - 79세,1998,3253,1142,2111
'28200, 남동구,'85,80 - 84세,1998,1569,518,1051
'28200, 남동구,'90,85+ ,1998,851,217,634
'2820051000,  구월1동,'00,계,1998,25779,12997,12782
'2820051000,  구월1동,'05,0 - 4세,1998,2197,1140,1057
'2820051000,  구월1동,'10,5 - 9세,1998,2210,1142,1068
'2820051000,  구월1동,'15,10 - 14세,1998,1909,1010,899
'2820051000,  구월1동,'20,15 - 19세,1998,2168,1109,1059
'2820051000,  구월1동,'25,20 - 24세,1998,1901,928,973
'2820051000,  구월1동,'30,25 - 29세,1998,2663,1303,1360
'2820051000,  구월1동,'35,30 - 34세,1998,2786,1398,1388
'2820051000,  구월1동,'40,35 - 39세,1998,2860,1476,1384
'2820051000,  구월1동,'45,40 - 44세,1998,2166,1142,1024
'2820051000,  구월1동,'50,45 - 49세,1998,1333,693,640
'2820051000,  구월1동,'55,50 - 54세,1998,1073,546,527
'2820051000,  구월1동,'60,55 - 59세,1998,840,436,404
'2820051000,  구월1동,'65,60 - 64세,1998,639,310,329
'2820051000,  구월1동,'70,65 - 69세,1998,418,159,259
'2820051000,  구월1동,'75,70 - 74세,1998,277,92,185
'2820051000,  구월1동,'80,75 - 79세,1998,197,71,126
'2820051000,  구월1동,'85,80 - 84세,1998,89,23,66
'2820051000,  구월1동,'90,85+ ,1998,53,19,34
'2820052000,  구월2동,'00,계,1998,30664,15447,15217
'2820052000,  구월2동,'05,0 - 4세,1998,2628,1416,1212
'2820052000,  구월2동,'10,5 - 9세,1998,2984,1619,1365
'2820052000,  구월2동,'15,10 - 14세,1998,2343,1269,1074
'2820052000,  구월2동,'20,15 - 19세,1998,2423,1262,1161
'2820052000,  구월2동,'25,20 - 24세,1998,2051,1033,1018
'2820052000,  구월2동,'30,25 - 29세,1998,2898,1380,1518
'2820052000,  구월2동,'35,30 - 34세,1998,3378,1588,1790
'2820052000,  구월2동,'40,35 - 39세,1998,3739,1925,1814
'2820052000,  구월2동,'45,40 - 44세,1998,2664,1371,1293
'2820052000,  구월2동,'50,45 - 49세,1998,1626,858,768
'2820052000,  구월2동,'55,50 - 54세,1998,1107,599,508
'2820052000,  구월2동,'60,55 - 59세,1998,868,416,452
'2820052000,  구월2동,'65,60 - 64세,1998,648,262,386
'2820052000,  구월2동,'70,65 - 69세,1998,478,169,309
'2820052000,  구월2동,'75,70 - 74세,1998,388,129,259
'2820052000,  구월2동,'80,75 - 79세,1998,265,99,166
'2820052000,  구월2동,'85,80 - 84세,1998,117,33,84
'2820052000,  구월2동,'90,85+ ,1998,59,19,40
'2820052100,  구월3동,'00,계,1998,15915,7955,7960
'2820052100,  구월3동,'05,0 - 4세,1998,1252,638,614
'2820052100,  구월3동,'10,5 - 9세,1998,1358,688,670
'2820052100,  구월3동,'15,10 - 14세,1998,1160,619,541
'2820052100,  구월3동,'20,15 - 19세,1998,1400,713,687
'2820052100,  구월3동,'25,20 - 24세,1998,1308,632,676
'2820052100,  구월3동,'30,25 - 29세,1998,1705,863,842
'2820052100,  구월3동,'35,30 - 34세,1998,1609,797,812
'2820052100,  구월3동,'40,35 - 39세,1998,1669,840,829
'2820052100,  구월3동,'45,40 - 44세,1998,1342,685,657
'2820052100,  구월3동,'50,45 - 49세,1998,899,450,449
'2820052100,  구월3동,'55,50 - 54세,1998,689,364,325
'2820052100,  구월3동,'60,55 - 59세,1998,534,279,255
'2820052100,  구월3동,'65,60 - 64세,1998,363,182,181
'2820052100,  구월3동,'70,65 - 69세,1998,235,90,145
'2820052100,  구월3동,'75,70 - 74세,1998,164,50,114
'2820052100,  구월3동,'80,75 - 79세,1998,142,45,97
'2820052100,  구월3동,'85,80 - 84세,1998,58,14,44
'2820052100,  구월3동,'90,85+ ,1998,28,6,22
'2820052200,  구월4동,'00,계,1998,23519,11949,11570
'2820052200,  구월4동,'05,0 - 4세,1998,2298,1215,1083
'2820052200,  구월4동,'10,5 - 9세,1998,2023,1032,991
'2820052200,  구월4동,'15,10 - 14세,1998,1517,776,741
'2820052200,  구월4동,'20,15 - 19세,1998,1769,893,876
'2820052200,  구월4동,'25,20 - 24세,1998,1767,891,876
'2820052200,  구월4동,'30,25 - 29세,1998,2822,1342,1480
'2820052200,  구월4동,'35,30 - 34세,1998,2930,1606,1324
'2820052200,  구월4동,'40,35 - 39세,1998,2547,1364,1183
'2820052200,  구월4동,'45,40 - 44세,1998,1772,914,858
'2820052200,  구월4동,'50,45 - 49세,1998,1070,568,502
'2820052200,  구월4동,'55,50 - 54세,1998,810,398,412
'2820052200,  구월4동,'60,55 - 59세,1998,766,379,387
'2820052200,  구월4동,'65,60 - 64세,1998,566,266,300
'2820052200,  구월4동,'70,65 - 69세,1998,352,138,214
'2820052200,  구월4동,'75,70 - 74세,1998,230,81,149
'2820052200,  구월4동,'80,75 - 79세,1998,159,51,108
'2820052200,  구월4동,'85,80 - 84세,1998,78,24,54
'2820052200,  구월4동,'90,85+ ,1998,43,11,32
'2820053000,  간석1동,'00,계,1998,27096,13500,13596
'2820053000,  간석1동,'05,0 - 4세,1998,2025,1052,973
'2820053000,  간석1동,'10,5 - 9세,1998,1894,977,917
'2820053000,  간석1동,'15,10 - 14세,1998,1768,921,847
'2820053000,  간석1동,'20,15 - 19세,1998,2297,1175,1122
'2820053000,  간석1동,'25,20 - 24세,1998,2354,1186,1168
'2820053000,  간석1동,'30,25 - 29세,1998,2990,1443,1547
'2820053000,  간석1동,'35,30 - 34세,1998,2723,1424,1299
'2820053000,  간석1동,'40,35 - 39세,1998,2691,1352,1339
'2820053000,  간석1동,'45,40 - 44세,1998,2277,1142,1135
'2820053000,  간석1동,'50,45 - 49세,1998,1658,818,840
'2820053000,  간석1동,'55,50 - 54세,1998,1384,694,690
'2820053000,  간석1동,'60,55 - 59세,1998,1025,524,501
'2820053000,  간석1동,'65,60 - 64세,1998,743,331,412
'2820053000,  간석1동,'70,65 - 69세,1998,498,206,292
'2820053000,  간석1동,'75,70 - 74세,1998,344,129,215
'2820053000,  간석1동,'80,75 - 79세,1998,226,73,153
'2820053000,  간석1동,'85,80 - 84세,1998,122,41,81
'2820053000,  간석1동,'90,85+ ,1998,77,12,65
'2820054000,  간석2동,'00,계,1998,15545,7773,7772
'2820054000,  간석2동,'05,0 - 4세,1998,1206,654,552
'2820054000,  간석2동,'10,5 - 9세,1998,1189,631,558
'2820054000,  간석2동,'15,10 - 14세,1998,1108,593,515
'2820054000,  간석2동,'20,15 - 19세,1998,1374,689,685
'2820054000,  간석2동,'25,20 - 24세,1998,1231,633,598
'2820054000,  간석2동,'30,25 - 29세,1998,1513,732,781
'2820054000,  간석2동,'35,30 - 34세,1998,1524,774,750
'2820054000,  간석2동,'40,35 - 39세,1998,1568,766,802
'2820054000,  간석2동,'45,40 - 44세,1998,1408,699,709
'2820054000,  간석2동,'50,45 - 49세,1998,952,465,487
'2820054000,  간석2동,'55,50 - 54세,1998,736,380,356
'2820054000,  간석2동,'60,55 - 59세,1998,516,271,245
'2820054000,  간석2동,'65,60 - 64세,1998,402,185,217
'2820054000,  간석2동,'70,65 - 69세,1998,313,115,198
'2820054000,  간석2동,'75,70 - 74세,1998,222,73,149
'2820054000,  간석2동,'80,75 - 79세,1998,165,72,93
'2820054000,  간석2동,'85,80 - 84세,1998,80,32,48
'2820054000,  간석2동,'90,85+ ,1998,38,9,29
'2820055000,  간석3동,'00,계,1998,33983,17129,16854
'2820055000,  간석3동,'05,0 - 4세,1998,2711,1412,1299
'2820055000,  간석3동,'10,5 - 9세,1998,2364,1236,1128
'2820055000,  간석3동,'15,10 - 14세,1998,2057,1037,1020
'2820055000,  간석3동,'20,15 - 19세,1998,2819,1389,1430
'2820055000,  간석3동,'25,20 - 24세,1998,3042,1509,1533
'2820055000,  간석3동,'30,25 - 29세,1998,4179,2112,2067
'2820055000,  간석3동,'35,30 - 34세,1998,3522,1901,1621
'2820055000,  간석3동,'40,35 - 39세,1998,3425,1824,1601
'2820055000,  간석3동,'45,40 - 44세,1998,2594,1335,1259
'2820055000,  간석3동,'50,45 - 49세,1998,1818,903,915
'2820055000,  간석3동,'55,50 - 54세,1998,1552,753,799
'2820055000,  간석3동,'60,55 - 59세,1998,1419,656,763
'2820055000,  간석3동,'65,60 - 64세,1998,1011,510,501
'2820055000,  간석3동,'70,65 - 69세,1998,616,269,347
'2820055000,  간석3동,'75,70 - 74세,1998,408,147,261
'2820055000,  간석3동,'80,75 - 79세,1998,237,77,160
'2820055000,  간석3동,'85,80 - 84세,1998,141,45,96
'2820055000,  간석3동,'90,85+ ,1998,68,14,54
'2820055100,  간석4동,'00,계,1998,27162,13671,13491
'2820055100,  간석4동,'05,0 - 4세,1998,2094,1082,1012
'2820055100,  간석4동,'10,5 - 9세,1998,2175,1137,1038
'2820055100,  간석4동,'15,10 - 14세,1998,1974,1037,937
'2820055100,  간석4동,'20,15 - 19세,1998,2271,1175,1096
'2820055100,  간석4동,'25,20 - 24세,1998,2143,1002,1141
'2820055100,  간석4동,'30,25 - 29세,1998,2876,1432,1444
'2820055100,  간석4동,'35,30 - 34세,1998,2879,1497,1382
'2820055100,  간석4동,'40,35 - 39세,1998,2957,1506,1451
'2820055100,  간석4동,'45,40 - 44세,1998,2395,1226,1169
'2820055100,  간석4동,'50,45 - 49세,1998,1450,785,665
'2820055100,  간석4동,'55,50 - 54세,1998,1174,582,592
'2820055100,  간석4동,'60,55 - 59세,1998,942,479,463
'2820055100,  간석4동,'65,60 - 64세,1998,716,316,400
'2820055100,  간석4동,'70,65 - 69세,1998,448,188,260
'2820055100,  간석4동,'75,70 - 74세,1998,306,111,195
'2820055100,  간석4동,'80,75 - 79세,1998,192,59,133
'2820055100,  간석4동,'85,80 - 84세,1998,106,41,65
'2820055100,  간석4동,'90,85+ ,1998,64,16,48
'2820056000,  만수1동,'00,계,1998,24771,12272,12499
'2820056000,  만수1동,'05,0 - 4세,1998,1958,1033,925
'2820056000,  만수1동,'10,5 - 9세,1998,1829,920,909
'2820056000,  만수1동,'15,10 - 14세,1998,1722,857,865
'2820056000,  만수1동,'20,15 - 19세,1998,2414,1231,1183
'2820056000,  만수1동,'25,20 - 24세,1998,2139,1093,1046
'2820056000,  만수1동,'30,25 - 29세,1998,2541,1249,1292
'2820056000,  만수1동,'35,30 - 34세,1998,2545,1301,1244
'2820056000,  만수1동,'40,35 - 39세,1998,2603,1358,1245
'2820056000,  만수1동,'45,40 - 44세,1998,2029,1003,1026
'2820056000,  만수1동,'50,45 - 49세,1998,1391,701,690
'2820056000,  만수1동,'55,50 - 54세,1998,1049,493,556
'2820056000,  만수1동,'60,55 - 59세,1998,873,397,476
'2820056000,  만수1동,'65,60 - 64세,1998,654,296,358
'2820056000,  만수1동,'70,65 - 69세,1998,382,147,235
'2820056000,  만수1동,'75,70 - 74세,1998,301,94,207
'2820056000,  만수1동,'80,75 - 79세,1998,197,59,138
'2820056000,  만수1동,'85,80 - 84세,1998,104,33,71
'2820056000,  만수1동,'90,85+ ,1998,40,7,33
'2820057000,  만수2동,'00,계,1998,28307,14408,13899
'2820057000,  만수2동,'05,0 - 4세,1998,2103,1128,975
'2820057000,  만수2동,'10,5 - 9세,1998,2131,1126,1005
'2820057000,  만수2동,'15,10 - 14세,1998,1965,1028,937
'2820057000,  만수2동,'20,15 - 19세,1998,2702,1386,1316
'2820057000,  만수2동,'25,20 - 24세,1998,2333,1222,1111
'2820057000,  만수2동,'30,25 - 29세,1998,2596,1346,1250
'2820057000,  만수2동,'35,30 - 34세,1998,2796,1441,1355
'2820057000,  만수2동,'40,35 - 39세,1998,2991,1544,1447
'2820057000,  만수2동,'45,40 - 44세,1998,2469,1262,1207
'2820057000,  만수2동,'50,45 - 49세,1998,1701,882,819
'2820057000,  만수2동,'55,50 - 54세,1998,1282,667,615
'2820057000,  만수2동,'60,55 - 59세,1998,1101,538,563
'2820057000,  만수2동,'65,60 - 64세,1998,789,373,416
'2820057000,  만수2동,'70,65 - 69세,1998,554,207,347
'2820057000,  만수2동,'75,70 - 74세,1998,363,114,249
'2820057000,  만수2동,'80,75 - 79세,1998,236,81,155
'2820057000,  만수2동,'85,80 - 84세,1998,119,41,78
'2820057000,  만수2동,'90,85+ ,1998,76,22,54
'2820058000,  만수3동,'00,계,1998,19635,10006,9629
'2820058000,  만수3동,'05,0 - 4세,1998,1483,777,706
'2820058000,  만수3동,'10,5 - 9세,1998,1487,748,739
'2820058000,  만수3동,'15,10 - 14세,1998,1314,682,632
'2820058000,  만수3동,'20,15 - 19세,1998,1913,957,956
'2820058000,  만수3동,'25,20 - 24세,1998,1770,900,870
'2820058000,  만수3동,'30,25 - 29세,1998,2088,1091,997
'2820058000,  만수3동,'35,30 - 34세,1998,1982,1043,939
'2820058000,  만수3동,'40,35 - 39세,1998,1936,1048,888
'2820058000,  만수3동,'45,40 - 44세,1998,1607,806,801
'2820058000,  만수3동,'50,45 - 49세,1998,1157,609,548
'2820058000,  만수3동,'55,50 - 54세,1998,880,469,411
'2820058000,  만수3동,'60,55 - 59세,1998,694,351,343
'2820058000,  만수3동,'65,60 - 64세,1998,475,233,242
'2820058000,  만수3동,'70,65 - 69세,1998,317,109,208
'2820058000,  만수3동,'75,70 - 74세,1998,248,89,159
'2820058000,  만수3동,'80,75 - 79세,1998,170,56,114
'2820058000,  만수3동,'85,80 - 84세,1998,75,26,49
'2820058000,  만수3동,'90,85+ ,1998,39,12,27
'2820058100,  만수4동,'00,계,1998,26940,13430,13510
'2820058100,  만수4동,'05,0 - 4세,1998,2469,1354,1115
'2820058100,  만수4동,'10,5 - 9세,1998,2559,1354,1205
'2820058100,  만수4동,'15,10 - 14세,1998,2239,1175,1064
'2820058100,  만수4동,'20,15 - 19세,1998,2349,1229,1120
'2820058100,  만수4동,'25,20 - 24세,1998,1501,723,778
'2820058100,  만수4동,'30,25 - 29세,1998,2206,940,1266
'2820058100,  만수4동,'35,30 - 34세,1998,2876,1344,1532
'2820058100,  만수4동,'40,35 - 39세,1998,3333,1647,1686
'2820058100,  만수4동,'45,40 - 44세,1998,2822,1482,1340
'2820058100,  만수4동,'50,45 - 49세,1998,1504,869,635
'2820058100,  만수4동,'55,50 - 54세,1998,833,478,355
'2820058100,  만수4동,'60,55 - 59세,1998,533,261,272
'2820058100,  만수4동,'65,60 - 64세,1998,469,169,300
'2820058100,  만수4동,'70,65 - 69세,1998,479,134,345
'2820058100,  만수4동,'75,70 - 74세,1998,364,125,239
'2820058100,  만수4동,'80,75 - 79세,1998,250,97,153
'2820058100,  만수4동,'85,80 - 84세,1998,108,38,70
'2820058100,  만수4동,'90,85+ ,1998,46,11,35
'2820058200,  만수5동,'00,계,1998,22416,11285,11131
'2820058200,  만수5동,'05,0 - 4세,1998,1774,919,855
'2820058200,  만수5동,'10,5 - 9세,1998,1705,913,792
'2820058200,  만수5동,'15,10 - 14세,1998,1441,742,699
'2820058200,  만수5동,'20,15 - 19세,1998,2152,1129,1023
'2820058200,  만수5동,'25,20 - 24세,1998,1914,949,965
'2820058200,  만수5동,'30,25 - 29세,1998,2344,1170,1174
'2820058200,  만수5동,'35,30 - 34세,1998,2264,1146,1118
'2820058200,  만수5동,'40,35 - 39세,1998,2206,1135,1071
'2820058200,  만수5동,'45,40 - 44세,1998,1921,962,959
'2820058200,  만수5동,'50,45 - 49세,1998,1304,667,637
'2820058200,  만수5동,'55,50 - 54세,1998,1063,556,507
'2820058200,  만수5동,'60,55 - 59세,1998,803,403,400
'2820058200,  만수5동,'65,60 - 64세,1998,569,261,308
'2820058200,  만수5동,'70,65 - 69세,1998,370,140,230
'2820058200,  만수5동,'75,70 - 74세,1998,276,100,176
'2820058200,  만수5동,'80,75 - 79세,1998,177,60,117
'2820058200,  만수5동,'85,80 - 84세,1998,84,23,61
'2820058200,  만수5동,'90,85+ ,1998,49,10,39
'2820058300,  만수6동,'00,계,1998,32197,16000,16197
'2820058300,  만수6동,'05,0 - 4세,1998,2646,1358,1288
'2820058300,  만수6동,'10,5 - 9세,1998,3328,1688,1640
'2820058300,  만수6동,'15,10 - 14세,1998,2859,1481,1378
'2820058300,  만수6동,'20,15 - 19세,1998,2684,1367,1317
'2820058300,  만수6동,'25,20 - 24세,1998,1784,865,919
'2820058300,  만수6동,'30,25 - 29세,1998,2569,1145,1424
'2820058300,  만수6동,'35,30 - 34세,1998,3547,1617,1930
'2820058300,  만수6동,'40,35 - 39세,1998,4256,2138,2118
'2820058300,  만수6동,'45,40 - 44세,1998,3132,1688,1444
'2820058300,  만수6동,'50,45 - 49세,1998,1597,914,683
'2820058300,  만수6동,'55,50 - 54세,1998,1061,593,468
'2820058300,  만수6동,'60,55 - 59세,1998,797,406,391
'2820058300,  만수6동,'65,60 - 64세,1998,664,292,372
'2820058300,  만수6동,'70,65 - 69세,1998,497,165,332
'2820058300,  만수6동,'75,70 - 74세,1998,375,146,229
'2820058300,  만수6동,'80,75 - 79세,1998,226,81,145
'2820058300,  만수6동,'85,80 - 84세,1998,111,40,71
'2820058300,  만수6동,'90,85+ ,1998,64,16,48
'2820065000,  장수서창동,'00,계,1998,7401,3809,3592
'2820065000,  장수서창동,'05,0 - 4세,1998,570,307,263
'2820065000,  장수서창동,'10,5 - 9세,1998,682,360,322
'2820065000,  장수서창동,'15,10 - 14세,1998,511,268,243
'2820065000,  장수서창동,'20,15 - 19세,1998,619,319,300
'2820065000,  장수서창동,'25,20 - 24세,1998,478,277,201
'2820065000,  장수서창동,'30,25 - 29세,1998,603,275,328
'2820065000,  장수서창동,'35,30 - 34세,1998,825,413,412
'2820065000,  장수서창동,'40,35 - 39세,1998,851,466,385
'2820065000,  장수서창동,'45,40 - 44세,1998,611,348,263
'2820065000,  장수서창동,'50,45 - 49세,1998,363,198,165
'2820065000,  장수서창동,'55,50 - 54세,1998,308,173,135
'2820065000,  장수서창동,'60,55 - 59세,1998,275,124,151
'2820065000,  장수서창동,'65,60 - 64세,1998,221,100,121
'2820065000,  장수서창동,'70,65 - 69세,1998,162,68,94
'2820065000,  장수서창동,'75,70 - 74세,1998,139,52,87
'2820065000,  장수서창동,'80,75 - 79세,1998,106,31,75
'2820065000,  장수서창동,'85,80 - 84세,1998,53,21,32
'2820065000,  장수서창동,'90,85+ ,1998,24,9,15
'2820066000,  남촌도림동,'00,계,1998,17695,9117,8578
'2820066000,  남촌도림동,'05,0 - 4세,1998,1952,1006,946
'2820066000,  남촌도림동,'10,5 - 9세,1998,1826,933,893
'2820066000,  남촌도림동,'15,10 - 14세,1998,1190,627,563
'2820066000,  남촌도림동,'20,15 - 19세,1998,1060,558,502
'2820066000,  남촌도림동,'25,20 - 24세,1998,1048,529,519
'2820066000,  남촌도림동,'30,25 - 29세,1998,1924,922,1002
'2820066000,  남촌도림동,'35,30 - 34세,1998,2467,1246,1221
'2820066000,  남촌도림동,'40,35 - 39세,1998,2180,1288,892
'2820066000,  남촌도림동,'45,40 - 44세,1998,1209,675,534
'2820066000,  남촌도림동,'50,45 - 49세,1998,652,362,290
'2820066000,  남촌도림동,'55,50 - 54세,1998,527,277,250
'2820066000,  남촌도림동,'60,55 - 59세,1998,512,235,277
'2820066000,  남촌도림동,'65,60 - 64세,1998,445,198,247
'2820066000,  남촌도림동,'70,65 - 69세,1998,274,104,170
'2820066000,  남촌도림동,'75,70 - 74세,1998,223,74,149
'2820066000,  남촌도림동,'80,75 - 79세,1998,141,61,80
'2820066000,  남촌도림동,'85,80 - 84세,1998,38,15,23
'2820066000,  남촌도림동,'90,85+ ,1998,27,7,20
'2820067000,  논현고잔동,'00,계,1998,17474,9159,8315
'2820067000,  논현고잔동,'05,0 - 4세,1998,1700,901,799
'2820067000,  논현고잔동,'10,5 - 9세,1998,1506,763,743
'2820067000,  논현고잔동,'15,10 - 14세,1998,1110,615,495
'2820067000,  논현고잔동,'20,15 - 19세,1998,1215,635,580
'2820067000,  논현고잔동,'25,20 - 24세,1998,1154,650,504
'2820067000,  논현고잔동,'30,25 - 29세,1998,1852,932,920
'2820067000,  논현고잔동,'35,30 - 34세,1998,2205,1185,1020
'2820067000,  논현고잔동,'40,35 - 39세,1998,2044,1162,882
'2820067000,  논현고잔동,'45,40 - 44세,1998,1330,733,597
'2820067000,  논현고잔동,'50,45 - 49세,1998,802,451,351
'2820067000,  논현고잔동,'55,50 - 54세,1998,596,326,270
'2820067000,  논현고잔동,'60,55 - 59세,1998,567,244,323
'2820067000,  논현고잔동,'65,60 - 64세,1998,467,208,259
'2820067000,  논현고잔동,'70,65 - 69세,1998,377,147,230
'2820067000,  논현고잔동,'75,70 - 74세,1998,240,93,147
'2820067000,  논현고잔동,'80,75 - 79세,1998,167,69,98
'2820067000,  논현고잔동,'85,80 - 84세,1998,86,28,58
'2820067000,  논현고잔동,'90,85+ ,1998,56,17,39
'28237, 부평구,'00,계,1998,519839,262662,257177
'28237, 부평구,'05,0 - 4세,1998,41469,21780,19689
'28237, 부평구,'10,5 - 9세,1998,44616,23323,21293
'28237, 부평구,'15,10 - 14세,1998,38045,19765,18280
'28237, 부평구,'20,15 - 19세,1998,42952,21938,21014
'28237, 부평구,'25,20 - 24세,1998,38833,19403,19430
'28237, 부평구,'30,25 - 29세,1998,52473,26146,26327
'28237, 부평구,'35,30 - 34세,1998,56465,28472,27993
'28237, 부평구,'40,35 - 39세,1998,58361,30587,27774
'28237, 부평구,'45,40 - 44세,1998,44042,23004,21038
'28237, 부평구,'50,45 - 49세,1998,27062,14373,12689
'28237, 부평구,'55,50 - 54세,1998,20359,10497,9862
'28237, 부평구,'60,55 - 59세,1998,18066,8712,9354
'28237, 부평구,'65,60 - 64세,1998,13837,6100,7737
'28237, 부평구,'70,65 - 69세,1998,9627,3895,5732
'28237, 부평구,'75,70 - 74세,1998,6277,2307,3970
'28237, 부평구,'80,75 - 79세,1998,4167,1514,2653
'28237, 부평구,'85,80 - 84세,1998,2036,560,1476
'28237, 부평구,'90,85+ ,1998,1152,286,866
'2823751000,  부평1동,'00,계,1998,34835,17269,17566
'2823751000,  부평1동,'05,0 - 4세,1998,2617,1380,1237
'2823751000,  부평1동,'10,5 - 9세,1998,3091,1630,1461
'2823751000,  부평1동,'15,10 - 14세,1998,2680,1383,1297
'2823751000,  부평1동,'20,15 - 19세,1998,2838,1450,1388
'2823751000,  부평1동,'25,20 - 24세,1998,2120,1061,1059
'2823751000,  부평1동,'30,25 - 29세,1998,3061,1463,1598
'2823751000,  부평1동,'35,30 - 34세,1998,3485,1666,1819
'2823751000,  부평1동,'40,35 - 39세,1998,4008,1985,2023
'2823751000,  부평1동,'45,40 - 44세,1998,3295,1660,1635
'2823751000,  부평1동,'50,45 - 49세,1998,1933,1021,912
'2823751000,  부평1동,'55,50 - 54세,1998,1417,723,694
'2823751000,  부평1동,'60,55 - 59세,1998,1313,648,665
'2823751000,  부평1동,'65,60 - 64세,1998,1096,467,629
'2823751000,  부평1동,'70,65 - 69세,1998,788,340,448
'2823751000,  부평1동,'75,70 - 74세,1998,502,193,309
'2823751000,  부평1동,'80,75 - 79세,1998,342,130,212
'2823751000,  부평1동,'85,80 - 84세,1998,152,48,104
'2823751000,  부평1동,'90,85+ ,1998,97,21,76
'2823752000,  부평2동,'00,계,1998,21376,10847,10529
'2823752000,  부평2동,'05,0 - 4세,1998,1604,838,766
'2823752000,  부평2동,'10,5 - 9세,1998,1478,771,707
'2823752000,  부평2동,'15,10 - 14세,1998,1281,722,559
'2823752000,  부평2동,'20,15 - 19세,1998,1745,873,872
'2823752000,  부평2동,'25,20 - 24세,1998,1912,947,965
'2823752000,  부평2동,'30,25 - 29세,1998,2597,1332,1265
'2823752000,  부평2동,'35,30 - 34세,1998,2279,1231,1048
'2823752000,  부평2동,'40,35 - 39세,1998,2033,1085,948
'2823752000,  부평2동,'45,40 - 44세,1998,1562,798,764
'2823752000,  부평2동,'50,45 - 49세,1998,1146,559,587
'2823752000,  부평2동,'55,50 - 54세,1998,958,489,469
'2823752000,  부평2동,'60,55 - 59세,1998,937,435,502
'2823752000,  부평2동,'65,60 - 64세,1998,747,326,421
'2823752000,  부평2동,'70,65 - 69세,1998,472,195,277
'2823752000,  부평2동,'75,70 - 74세,1998,290,124,166
'2823752000,  부평2동,'80,75 - 79세,1998,202,80,122
'2823752000,  부평2동,'85,80 - 84세,1998,80,27,53
'2823752000,  부평2동,'90,85+ ,1998,53,15,38
'2823753000,  부평3동,'00,계,1998,16029,8163,7866
'2823753000,  부평3동,'05,0 - 4세,1998,1056,524,532
'2823753000,  부평3동,'10,5 - 9세,1998,1057,575,482
'2823753000,  부평3동,'15,10 - 14세,1998,922,494,428
'2823753000,  부평3동,'20,15 - 19세,1998,1372,696,676
'2823753000,  부평3동,'25,20 - 24세,1998,1508,767,741
'2823753000,  부평3동,'30,25 - 29세,1998,1849,992,857
'2823753000,  부평3동,'35,30 - 34세,1998,1504,823,681
'2823753000,  부평3동,'40,35 - 39세,1998,1497,817,680
'2823753000,  부평3동,'45,40 - 44세,1998,1255,646,609
'2823753000,  부평3동,'50,45 - 49세,1998,884,428,456
'2823753000,  부평3동,'55,50 - 54세,1998,828,384,444
'2823753000,  부평3동,'60,55 - 59세,1998,765,380,385
'2823753000,  부평3동,'65,60 - 64세,1998,582,263,319
'2823753000,  부평3동,'70,65 - 69세,1998,411,172,239
'2823753000,  부평3동,'75,70 - 74세,1998,249,92,157
'2823753000,  부평3동,'80,75 - 79세,1998,175,76,99
'2823753000,  부평3동,'85,80 - 84세,1998,76,25,51
'2823753000,  부평3동,'90,85+ ,1998,39,9,30
'2823754000,  부평4동,'00,계,1998,22352,11394,10958
'2823754000,  부평4동,'05,0 - 4세,1998,1476,778,698
'2823754000,  부평4동,'10,5 - 9세,1998,1551,814,737
'2823754000,  부평4동,'15,10 - 14세,1998,1345,713,632
'2823754000,  부평4동,'20,15 - 19세,1998,1975,1029,946
'2823754000,  부평4동,'25,20 - 24세,1998,2087,1056,1031
'2823754000,  부평4동,'30,25 - 29세,1998,2486,1325,1161
'2823754000,  부평4동,'35,30 - 34세,1998,2226,1215,1011
'2823754000,  부평4동,'40,35 - 39세,1998,2087,1065,1022
'2823754000,  부평4동,'45,40 - 44세,1998,1847,943,904
'2823754000,  부평4동,'50,45 - 49세,1998,1262,643,619
'2823754000,  부평4동,'55,50 - 54세,1998,1104,556,548
'2823754000,  부평4동,'60,55 - 59세,1998,1040,493,547
'2823754000,  부평4동,'65,60 - 64세,1998,781,369,412
'2823754000,  부평4동,'70,65 - 69세,1998,465,203,262
'2823754000,  부평4동,'75,70 - 74세,1998,261,101,160
'2823754000,  부평4동,'80,75 - 79세,1998,209,56,153
'2823754000,  부평4동,'85,80 - 84세,1998,100,23,77
'2823754000,  부평4동,'90,85+ ,1998,50,12,38
'2823755000,  부평5동,'00,계,1998,19788,10014,9774
'2823755000,  부평5동,'05,0 - 4세,1998,1276,673,603
'2823755000,  부평5동,'10,5 - 9세,1998,1373,685,688
'2823755000,  부평5동,'15,10 - 14세,1998,1307,687,620
'2823755000,  부평5동,'20,15 - 19세,1998,1770,916,854
'2823755000,  부평5동,'25,20 - 24세,1998,1761,875,886
'2823755000,  부평5동,'30,25 - 29세,1998,2046,1102,944
'2823755000,  부평5동,'35,30 - 34세,1998,1844,946,898
'2823755000,  부평5동,'40,35 - 39세,1998,1917,1027,890
'2823755000,  부평5동,'45,40 - 44세,1998,1631,792,839
'2823755000,  부평5동,'50,45 - 49세,1998,1100,563,537
'2823755000,  부평5동,'55,50 - 54세,1998,1049,513,536
'2823755000,  부평5동,'60,55 - 59세,1998,921,452,469
'2823755000,  부평5동,'65,60 - 64세,1998,743,358,385
'2823755000,  부평5동,'70,65 - 69세,1998,445,207,238
'2823755000,  부평5동,'75,70 - 74세,1998,299,122,177
'2823755000,  부평5동,'80,75 - 79세,1998,174,60,114
'2823755000,  부평5동,'85,80 - 84세,1998,75,20,55
'2823755000,  부평5동,'90,85+ ,1998,57,16,41
'2823756000,  부평6동,'00,계,1998,15835,7876,7959
'2823756000,  부평6동,'05,0 - 4세,1998,1252,661,591
'2823756000,  부평6동,'10,5 - 9세,1998,1154,590,564
'2823756000,  부평6동,'15,10 - 14세,1998,979,488,491
'2823756000,  부평6동,'20,15 - 19세,1998,1174,567,607
'2823756000,  부평6동,'25,20 - 24세,1998,1406,656,750
'2823756000,  부평6동,'30,25 - 29세,1998,1978,1014,964
'2823756000,  부평6동,'35,30 - 34세,1998,1671,897,774
'2823756000,  부평6동,'40,35 - 39세,1998,1509,792,717
'2823756000,  부평6동,'45,40 - 44세,1998,1165,620,545
'2823756000,  부평6동,'50,45 - 49세,1998,784,404,380
'2823756000,  부평6동,'55,50 - 54세,1998,684,315,369
'2823756000,  부평6동,'60,55 - 59세,1998,706,321,385
'2823756000,  부평6동,'65,60 - 64세,1998,549,243,306
'2823756000,  부평6동,'70,65 - 69세,1998,360,157,203
'2823756000,  부평6동,'75,70 - 74세,1998,228,84,144
'2823756000,  부평6동,'80,75 - 79세,1998,122,41,81
'2823756000,  부평6동,'85,80 - 84세,1998,77,20,57
'2823756000,  부평6동,'90,85+ ,1998,37,6,31
'2823757000,  산곡1동,'00,계,1998,25298,12876,12422
'2823757000,  산곡1동,'05,0 - 4세,1998,1673,857,816
'2823757000,  산곡1동,'10,5 - 9세,1998,1910,1018,892
'2823757000,  산곡1동,'15,10 - 14세,1998,1836,948,888
'2823757000,  산곡1동,'20,15 - 19세,1998,2310,1180,1130
'2823757000,  산곡1동,'25,20 - 24세,1998,2182,1085,1097
'2823757000,  산곡1동,'30,25 - 29세,1998,2544,1361,1183
'2823757000,  산곡1동,'35,30 - 34세,1998,2570,1350,1220
'2823757000,  산곡1동,'40,35 - 39세,1998,2570,1355,1215
'2823757000,  산곡1동,'45,40 - 44세,1998,2161,1089,1072
'2823757000,  산곡1동,'50,45 - 49세,1998,1444,780,664
'2823757000,  산곡1동,'55,50 - 54세,1998,1081,569,512
'2823757000,  산곡1동,'60,55 - 59세,1998,1011,499,512
'2823757000,  산곡1동,'65,60 - 64세,1998,758,330,428
'2823757000,  산곡1동,'70,65 - 69세,1998,500,213,287
'2823757000,  산곡1동,'75,70 - 74세,1998,334,110,224
'2823757000,  산곡1동,'80,75 - 79세,1998,235,93,142
'2823757000,  산곡1동,'85,80 - 84세,1998,125,27,98
'2823757000,  산곡1동,'90,85+ ,1998,54,12,42
'2823758000,  산곡2동,'00,계,1998,27868,13904,13964
'2823758000,  산곡2동,'05,0 - 4세,1998,1923,1023,900
'2823758000,  산곡2동,'10,5 - 9세,1998,2581,1345,1236
'2823758000,  산곡2동,'15,10 - 14세,1998,2456,1271,1185
'2823758000,  산곡2동,'20,15 - 19세,1998,2642,1344,1298
'2823758000,  산곡2동,'25,20 - 24세,1998,1874,929,945
'2823758000,  산곡2동,'30,25 - 29세,1998,2062,1016,1046
'2823758000,  산곡2동,'35,30 - 34세,1998,2597,1178,1419
'2823758000,  산곡2동,'40,35 - 39세,1998,3482,1715,1767
'2823758000,  산곡2동,'45,40 - 44세,1998,2799,1455,1344
'2823758000,  산곡2동,'50,45 - 49세,1998,1667,881,786
'2823758000,  산곡2동,'55,50 - 54세,1998,1079,622,457
'2823758000,  산곡2동,'60,55 - 59세,1998,831,406,425
'2823758000,  산곡2동,'65,60 - 64세,1998,709,306,403
'2823758000,  산곡2동,'70,65 - 69세,1998,467,192,275
'2823758000,  산곡2동,'75,70 - 74세,1998,345,123,222
'2823758000,  산곡2동,'80,75 - 79세,1998,202,66,136
'2823758000,  산곡2동,'85,80 - 84세,1998,103,22,81
'2823758000,  산곡2동,'90,85+ ,1998,49,10,39
'2823758100,  산곡3동,'00,계,1998,30005,14767,15238
'2823758100,  산곡3동,'05,0 - 4세,1998,1996,1059,937
'2823758100,  산곡3동,'10,5 - 9세,1998,2573,1328,1245
'2823758100,  산곡3동,'15,10 - 14세,1998,2576,1315,1261
'2823758100,  산곡3동,'20,15 - 19세,1998,2546,1289,1257
'2823758100,  산곡3동,'25,20 - 24세,1998,1939,963,976
'2823758100,  산곡3동,'30,25 - 29세,1998,2359,1183,1176
'2823758100,  산곡3동,'35,30 - 34세,1998,2580,1159,1421
'2823758100,  산곡3동,'40,35 - 39세,1998,3389,1614,1775
'2823758100,  산곡3동,'45,40 - 44세,1998,2970,1542,1428
'2823758100,  산곡3동,'50,45 - 49세,1998,1716,924,792
'2823758100,  산곡3동,'55,50 - 54세,1998,1304,670,634
'2823758100,  산곡3동,'60,55 - 59세,1998,1131,551,580
'2823758100,  산곡3동,'65,60 - 64세,1998,980,422,558
'2823758100,  산곡3동,'70,65 - 69세,1998,817,320,497
'2823758100,  산곡3동,'75,70 - 74세,1998,507,203,304
'2823758100,  산곡3동,'80,75 - 79세,1998,334,146,188
'2823758100,  산곡3동,'85,80 - 84세,1998,171,50,121
'2823758100,  산곡3동,'90,85+ ,1998,117,29,88
'2823758200,  산곡4동,'00,계,1998,23000,11362,11638
'2823758200,  산곡4동,'05,0 - 4세,1998,1788,950,838
'2823758200,  산곡4동,'10,5 - 9세,1998,2348,1194,1154
'2823758200,  산곡4동,'15,10 - 14세,1998,1987,1061,926
'2823758200,  산곡4동,'20,15 - 19세,1998,1897,998,899
'2823758200,  산곡4동,'25,20 - 24세,1998,1244,589,655
'2823758200,  산곡4동,'30,25 - 29세,1998,1875,835,1040
'2823758200,  산곡4동,'35,30 - 34세,1998,2320,1062,1258
'2823758200,  산곡4동,'40,35 - 39세,1998,2963,1436,1527
'2823758200,  산곡4동,'45,40 - 44세,1998,2411,1224,1187
'2823758200,  산곡4동,'50,45 - 49세,1998,1292,726,566
'2823758200,  산곡4동,'55,50 - 54세,1998,772,434,338
'2823758200,  산곡4동,'60,55 - 59세,1998,618,297,321
'2823758200,  산곡4동,'65,60 - 64세,1998,480,217,263
'2823758200,  산곡4동,'70,65 - 69세,1998,398,141,257
'2823758200,  산곡4동,'75,70 - 74세,1998,285,93,192
'2823758200,  산곡4동,'80,75 - 79세,1998,173,62,111
'2823758200,  산곡4동,'85,80 - 84세,1998,99,29,70
'2823758200,  산곡4동,'90,85+ ,1998,50,14,36
'2823759100,  청천1동,'00,계,1998,19691,10466,9225
'2823759100,  청천1동,'05,0 - 4세,1998,1458,804,654
'2823759100,  청천1동,'10,5 - 9세,1998,1547,860,687
'2823759100,  청천1동,'15,10 - 14세,1998,1429,736,693
'2823759100,  청천1동,'20,15 - 19세,1998,1696,863,833
'2823759100,  청천1동,'25,20 - 24세,1998,1758,923,835
'2823759100,  청천1동,'30,25 - 29세,1998,2275,1256,1019
'2823759100,  청천1동,'35,30 - 34세,1998,2261,1286,975
'2823759100,  청천1동,'40,35 - 39세,1998,2141,1167,974
'2823759100,  청천1동,'45,40 - 44세,1998,1559,864,695
'2823759100,  청천1동,'50,45 - 49세,1998,1034,539,495
'2823759100,  청천1동,'55,50 - 54세,1998,742,393,349
'2823759100,  청천1동,'60,55 - 59세,1998,630,325,305
'2823759100,  청천1동,'65,60 - 64세,1998,414,188,226
'2823759100,  청천1동,'70,65 - 69세,1998,301,120,181
'2823759100,  청천1동,'75,70 - 74세,1998,197,69,128
'2823759100,  청천1동,'80,75 - 79세,1998,130,36,94
'2823759100,  청천1동,'85,80 - 84세,1998,77,21,56
'2823759100,  청천1동,'90,85+ ,1998,42,16,26
'2823759200,  청천2동,'00,계,1998,38728,19720,19008
'2823759200,  청천2동,'05,0 - 4세,1998,4090,2171,1919
'2823759200,  청천2동,'10,5 - 9세,1998,3717,1972,1745
'2823759200,  청천2동,'15,10 - 14세,1998,2620,1331,1289
'2823759200,  청천2동,'20,15 - 19세,1998,2641,1343,1298
'2823759200,  청천2동,'25,20 - 24세,1998,2535,1264,1271
'2823759200,  청천2동,'30,25 - 29세,1998,4322,2040,2282
'2823759200,  청천2동,'35,30 - 34세,1998,5195,2621,2574
'2823759200,  청천2동,'40,35 - 39세,1998,4651,2525,2126
'2823759200,  청천2동,'45,40 - 44세,1998,2908,1581,1327
'2823759200,  청천2동,'50,45 - 49세,1998,1656,886,770
'2823759200,  청천2동,'55,50 - 54세,1998,1273,652,621
'2823759200,  청천2동,'60,55 - 59세,1998,1109,538,571
'2823759200,  청천2동,'65,60 - 64세,1998,746,338,408
'2823759200,  청천2동,'70,65 - 69세,1998,543,219,324
'2823759200,  청천2동,'75,70 - 74세,1998,327,115,212
'2823759200,  청천2동,'80,75 - 79세,1998,230,90,140
'2823759200,  청천2동,'85,80 - 84세,1998,104,23,81
'2823759200,  청천2동,'90,85+ ,1998,61,11,50
'2823764100,  갈산1동,'00,계,1998,18461,9489,8972
'2823764100,  갈산1동,'05,0 - 4세,1998,1659,856,803
'2823764100,  갈산1동,'10,5 - 9세,1998,1605,852,753
'2823764100,  갈산1동,'15,10 - 14세,1998,1267,683,584
'2823764100,  갈산1동,'20,15 - 19세,1998,1436,740,696
'2823764100,  갈산1동,'25,20 - 24세,1998,1364,707,657
'2823764100,  갈산1동,'30,25 - 29세,1998,2052,1011,1041
'2823764100,  갈산1동,'35,30 - 34세,1998,2245,1155,1090
'2823764100,  갈산1동,'40,35 - 39세,1998,2138,1197,941
'2823764100,  갈산1동,'45,40 - 44세,1998,1409,740,669
'2823764100,  갈산1동,'50,45 - 49세,1998,905,471,434
'2823764100,  갈산1동,'55,50 - 54세,1998,681,371,310
'2823764100,  갈산1동,'60,55 - 59세,1998,600,269,331
'2823764100,  갈산1동,'65,60 - 64세,1998,427,191,236
'2823764100,  갈산1동,'70,65 - 69세,1998,286,111,175
'2823764100,  갈산1동,'75,70 - 74세,1998,173,62,111
'2823764100,  갈산1동,'80,75 - 79세,1998,120,44,76
'2823764100,  갈산1동,'85,80 - 84세,1998,66,22,44
'2823764100,  갈산1동,'90,85+ ,1998,28,7,21
'2823764200,  갈산2동,'00,계,1998,28856,14300,14556
'2823764200,  갈산2동,'05,0 - 4세,1998,2134,1113,1021
'2823764200,  갈산2동,'10,5 - 9세,1998,2736,1441,1295
'2823764200,  갈산2동,'15,10 - 14세,1998,2691,1412,1279
'2823764200,  갈산2동,'20,15 - 19세,1998,2857,1430,1427
'2823764200,  갈산2동,'25,20 - 24세,1998,1779,846,933
'2823764200,  갈산2동,'30,25 - 29세,1998,2489,1185,1304
'2823764200,  갈산2동,'35,30 - 34세,1998,2850,1290,1560
'2823764200,  갈산2동,'40,35 - 39세,1998,3705,1822,1883
'2823764200,  갈산2동,'45,40 - 44세,1998,2872,1487,1385
'2823764200,  갈산2동,'50,45 - 49세,1998,1508,839,669
'2823764200,  갈산2동,'55,50 - 54세,1998,942,534,408
'2823764200,  갈산2동,'60,55 - 59세,1998,666,318,348
'2823764200,  갈산2동,'65,60 - 64세,1998,562,238,324
'2823764200,  갈산2동,'70,65 - 69세,1998,384,137,247
'2823764200,  갈산2동,'75,70 - 74세,1998,310,94,216
'2823764200,  갈산2동,'80,75 - 79세,1998,204,73,131
'2823764200,  갈산2동,'85,80 - 84세,1998,100,24,76
'2823764200,  갈산2동,'90,85+ ,1998,67,17,50
'2823764500,  삼산동,'00,계,1998,26455,13262,13193
'2823764500,  삼산동,'05,0 - 4세,1998,2015,1041,974
'2823764500,  삼산동,'10,5 - 9세,1998,2370,1214,1156
'2823764500,  삼산동,'15,10 - 14세,1998,2126,1056,1070
'2823764500,  삼산동,'20,15 - 19세,1998,2427,1250,1177
'2823764500,  삼산동,'25,20 - 24세,1998,2044,1132,912
'2823764500,  삼산동,'30,25 - 29세,1998,2253,1100,1153
'2823764500,  삼산동,'35,30 - 34세,1998,2787,1399,1388
'2823764500,  삼산동,'40,35 - 39세,1998,3110,1615,1495
'2823764500,  삼산동,'45,40 - 44세,1998,2211,1166,1045
'2823764500,  삼산동,'50,45 - 49세,1998,1376,750,626
'2823764500,  삼산동,'55,50 - 54세,1998,925,454,471
'2823764500,  삼산동,'60,55 - 59세,1998,826,376,450
'2823764500,  삼산동,'65,60 - 64세,1998,614,225,389
'2823764500,  삼산동,'70,65 - 69세,1998,502,181,321
'2823764500,  삼산동,'75,70 - 74세,1998,406,135,271
'2823764500,  삼산동,'80,75 - 79세,1998,271,99,172
'2823764500,  삼산동,'85,80 - 84세,1998,125,45,80
'2823764500,  삼산동,'90,85+ ,1998,67,24,43
'2823765000,  부개1동,'00,계,1998,23739,12026,11713
'2823765000,  부개1동,'05,0 - 4세,1998,1647,853,794
'2823765000,  부개1동,'10,5 - 9세,1998,1730,918,812
'2823765000,  부개1동,'15,10 - 14세,1998,1771,919,852
'2823765000,  부개1동,'20,15 - 19세,1998,2195,1128,1067
'2823765000,  부개1동,'25,20 - 24세,1998,2100,1041,1059
'2823765000,  부개1동,'30,25 - 29세,1998,2428,1270,1158
'2823765000,  부개1동,'35,30 - 34세,1998,2224,1166,1058
'2823765000,  부개1동,'40,35 - 39세,1998,2436,1234,1202
'2823765000,  부개1동,'45,40 - 44세,1998,2081,1065,1016
'2823765000,  부개1동,'50,45 - 49세,1998,1429,753,676
'2823765000,  부개1동,'55,50 - 54세,1998,1047,538,509
'2823765000,  부개1동,'60,55 - 59세,1998,958,482,476
'2823765000,  부개1동,'65,60 - 64세,1998,676,306,370
'2823765000,  부개1동,'70,65 - 69세,1998,410,159,251
'2823765000,  부개1동,'75,70 - 74세,1998,261,94,167
'2823765000,  부개1동,'80,75 - 79세,1998,199,67,132
'2823765000,  부개1동,'85,80 - 84세,1998,93,23,70
'2823765000,  부개1동,'90,85+ ,1998,54,10,44
'2823766000,  부개2동,'00,계,1998,22273,11233,11040
'2823766000,  부개2동,'05,0 - 4세,1998,1755,931,824
'2823766000,  부개2동,'10,5 - 9세,1998,1761,893,868
'2823766000,  부개2동,'15,10 - 14세,1998,1571,773,798
'2823766000,  부개2동,'20,15 - 19세,1998,1889,971,918
'2823766000,  부개2동,'25,20 - 24세,1998,1834,920,914
'2823766000,  부개2동,'30,25 - 29세,1998,2386,1179,1207
'2823766000,  부개2동,'35,30 - 34세,1998,2375,1226,1149
'2823766000,  부개2동,'40,35 - 39세,1998,2314,1200,1114
'2823766000,  부개2동,'45,40 - 44세,1998,1810,956,854
'2823766000,  부개2동,'50,45 - 49세,1998,1275,665,610
'2823766000,  부개2동,'55,50 - 54세,1998,947,470,477
'2823766000,  부개2동,'60,55 - 59세,1998,828,427,401
'2823766000,  부개2동,'65,60 - 64세,1998,576,265,311
'2823766000,  부개2동,'70,65 - 69세,1998,432,174,258
'2823766000,  부개2동,'75,70 - 74세,1998,255,102,153
'2823766000,  부개2동,'80,75 - 79세,1998,157,55,102
'2823766000,  부개2동,'85,80 - 84세,1998,66,16,50
'2823766000,  부개2동,'90,85+ ,1998,42,10,32
'2823766100,  부개3동,'00,계,1998,38694,19457,19237
'2823766100,  부개3동,'05,0 - 4세,1998,4562,2444,2118
'2823766100,  부개3동,'10,5 - 9세,1998,4467,2307,2160
'2823766100,  부개3동,'15,10 - 14세,1998,2760,1420,1340
'2823766100,  부개3동,'20,15 - 19세,1998,2274,1133,1141
'2823766100,  부개3동,'25,20 - 24세,1998,1933,924,1009
'2823766100,  부개3동,'30,25 - 29세,1998,3843,1546,2297
'2823766100,  부개3동,'35,30 - 34세,1998,5834,2817,3017
'2823766100,  부개3동,'40,35 - 39세,1998,5212,2991,2221
'2823766100,  부개3동,'45,40 - 44세,1998,2873,1600,1273
'2823766100,  부개3동,'50,45 - 49세,1998,1411,782,629
'2823766100,  부개3동,'55,50 - 54세,1998,925,498,427
'2823766100,  부개3동,'60,55 - 59세,1998,776,364,412
'2823766100,  부개3동,'65,60 - 64세,1998,653,246,407
'2823766100,  부개3동,'70,65 - 69세,1998,507,176,331
'2823766100,  부개3동,'75,70 - 74세,1998,325,116,209
'2823766100,  부개3동,'80,75 - 79세,1998,188,56,132
'2823766100,  부개3동,'85,80 - 84세,1998,99,27,72
'2823766100,  부개3동,'90,85+ ,1998,52,10,42
'2823767000,  일신동,'00,계,1998,14283,7290,6993
'2823767000,  일신동,'05,0 - 4세,1998,1197,620,577
'2823767000,  일신동,'10,5 - 9세,1998,1420,759,661
'2823767000,  일신동,'15,10 - 14세,1998,1138,599,539
'2823767000,  일신동,'20,15 - 19세,1998,1191,628,563
'2823767000,  일신동,'25,20 - 24세,1998,967,467,500
'2823767000,  일신동,'30,25 - 29세,1998,1305,670,635
'2823767000,  일신동,'35,30 - 34세,1998,1560,724,836
'2823767000,  일신동,'40,35 - 39세,1998,1724,923,801
'2823767000,  일신동,'45,40 - 44세,1998,1225,662,563
'2823767000,  일신동,'50,45 - 49세,1998,698,390,308
'2823767000,  일신동,'55,50 - 54세,1998,555,284,271
'2823767000,  일신동,'60,55 - 59세,1998,469,239,230
'2823767000,  일신동,'65,60 - 64세,1998,291,133,158
'2823767000,  일신동,'70,65 - 69세,1998,229,95,134
'2823767000,  일신동,'75,70 - 74세,1998,131,43,88
'2823767000,  일신동,'80,75 - 79세,1998,105,32,73
'2823767000,  일신동,'85,80 - 84세,1998,59,15,44
'2823767000,  일신동,'90,85+ ,1998,19,7,12
'2823768000,  십정1동,'00,계,1998,25673,13300,12373
'2823768000,  십정1동,'05,0 - 4세,1998,2024,1026,998
'2823768000,  십정1동,'10,5 - 9세,1998,1993,1052,941
'2823768000,  십정1동,'15,10 - 14세,1998,1654,879,775
'2823768000,  십정1동,'20,15 - 19세,1998,2177,1155,1022
'2823768000,  십정1동,'25,20 - 24세,1998,2179,1116,1063
'2823768000,  십정1동,'30,25 - 29세,1998,2896,1528,1368
'2823768000,  십정1동,'35,30 - 34세,1998,2841,1536,1305
'2823768000,  십정1동,'40,35 - 39세,1998,2644,1437,1207
'2823768000,  십정1동,'45,40 - 44세,1998,2010,1060,950
'2823768000,  십정1동,'50,45 - 49세,1998,1313,729,584
'2823768000,  십정1동,'55,50 - 54세,1998,1055,538,517
'2823768000,  십정1동,'60,55 - 59세,1998,1043,494,549
'2823768000,  십정1동,'65,60 - 64세,1998,748,346,402
'2823768000,  십정1동,'70,65 - 69세,1998,452,184,268
'2823768000,  십정1동,'75,70 - 74세,1998,287,106,181
'2823768000,  십정1동,'80,75 - 79세,1998,213,79,134
'2823768000,  십정1동,'85,80 - 84세,1998,92,23,69
'2823768000,  십정1동,'90,85+ ,1998,52,12,40
'2823769000,  십정2동,'00,계,1998,26600,13647,12953
'2823769000,  십정2동,'05,0 - 4세,1998,2267,1178,1089
'2823769000,  십정2동,'10,5 - 9세,1998,2154,1105,1049
'2823769000,  십정2동,'15,10 - 14세,1998,1649,875,774
'2823769000,  십정2동,'20,15 - 19세,1998,1900,955,945
'2823769000,  십정2동,'25,20 - 24세,1998,2307,1135,1172
'2823769000,  십정2동,'30,25 - 29세,1998,3367,1738,1629
'2823769000,  십정2동,'35,30 - 34세,1998,3217,1725,1492
'2823769000,  십정2동,'40,35 - 39세,1998,2831,1585,1246
'2823769000,  십정2동,'45,40 - 44세,1998,1988,1054,934
'2823769000,  십정2동,'50,45 - 49세,1998,1229,640,589
'2823769000,  십정2동,'55,50 - 54세,1998,991,490,501
'2823769000,  십정2동,'60,55 - 59세,1998,888,398,490
'2823769000,  십정2동,'65,60 - 64세,1998,705,323,382
'2823769000,  십정2동,'70,65 - 69세,1998,458,199,259
'2823769000,  십정2동,'75,70 - 74세,1998,305,126,179
'2823769000,  십정2동,'80,75 - 79세,1998,182,73,109
'2823769000,  십정2동,'85,80 - 84세,1998,97,30,67
'2823769000,  십정2동,'90,85+ ,1998,65,18,47
'28245, 계양구,'00,계,1998,326220,164499,161721
'28245, 계양구,'05,0 - 4세,1998,32389,17103,15286
'28245, 계양구,'10,5 - 9세,1998,35169,18173,16996
'28245, 계양구,'15,10 - 14세,1998,26500,13544,12956
'28245, 계양구,'20,15 - 19세,1998,22600,11603,10997
'28245, 계양구,'25,20 - 24세,1998,17948,8757,9191
'28245, 계양구,'30,25 - 29세,1998,30363,13815,16548
'28245, 계양구,'35,30 - 34세,1998,41670,19861,21809
'28245, 계양구,'40,35 - 39세,1998,44201,23694,20507
'28245, 계양구,'45,40 - 44세,1998,27206,15396,11810
'28245, 계양구,'50,45 - 49세,1998,13140,7386,5754
'28245, 계양구,'55,50 - 54세,1998,8922,4783,4139
'28245, 계양구,'60,55 - 59세,1998,7765,3629,4136
'28245, 계양구,'65,60 - 64세,1998,6546,2754,3792
'28245, 계양구,'70,65 - 69세,1998,4836,1748,3088
'28245, 계양구,'75,70 - 74세,1998,3225,1065,2160
'28245, 계양구,'80,75 - 79세,1998,2169,743,1426
'28245, 계양구,'85,80 - 84세,1998,1031,326,705
'28245, 계양구,'90,85+ ,1998,540,119,421
'2824560100,  효성1동,'00,계,1998,37875,19248,18627
'2824560100,  효성1동,'05,0 - 4세,1998,3181,1710,1471
'2824560100,  효성1동,'10,5 - 9세,1998,3759,1930,1829
'2824560100,  효성1동,'15,10 - 14세,1998,3244,1695,1549
'2824560100,  효성1동,'20,15 - 19세,1998,3162,1662,1500
'2824560100,  효성1동,'25,20 - 24세,1998,2337,1222,1115
'2824560100,  효성1동,'30,25 - 29세,1998,3149,1468,1681
'2824560100,  효성1동,'35,30 - 34세,1998,4110,1952,2158
'2824560100,  효성1동,'40,35 - 39세,1998,5020,2589,2431
'2824560100,  효성1동,'45,40 - 44세,1998,3474,1937,1537
'2824560100,  효성1동,'50,45 - 49세,1998,1774,976,798
'2824560100,  효성1동,'55,50 - 54세,1998,1266,696,570
'2824560100,  효성1동,'60,55 - 59세,1998,986,500,486
'2824560100,  효성1동,'65,60 - 64세,1998,855,376,479
'2824560100,  효성1동,'70,65 - 69세,1998,588,211,377
'2824560100,  효성1동,'75,70 - 74세,1998,443,155,288
'2824560100,  효성1동,'80,75 - 79세,1998,320,116,204
'2824560100,  효성1동,'85,80 - 84세,1998,129,35,94
'2824560100,  효성1동,'90,85+ ,1998,78,18,60
'2824560200,  효성2동,'00,계,1998,35156,17885,17271
'2824560200,  효성2동,'05,0 - 4세,1998,3422,1822,1600
'2824560200,  효성2동,'10,5 - 9세,1998,3686,1949,1737
'2824560200,  효성2동,'15,10 - 14세,1998,2705,1388,1317
'2824560200,  효성2동,'20,15 - 19세,1998,2555,1300,1255
'2824560200,  효성2동,'25,20 - 24세,1998,2232,1140,1092
'2824560200,  효성2동,'30,25 - 29세,1998,3304,1549,1755
'2824560200,  효성2동,'35,30 - 34세,1998,4458,2074,2384
'2824560200,  효성2동,'40,35 - 39세,1998,4643,2567,2076
'2824560200,  효성2동,'45,40 - 44세,1998,2781,1534,1247
'2824560200,  효성2동,'50,45 - 49세,1998,1561,843,718
'2824560200,  효성2동,'55,50 - 54세,1998,1080,598,482
'2824560200,  효성2동,'60,55 - 59세,1998,932,443,489
'2824560200,  효성2동,'65,60 - 64세,1998,686,301,385
'2824560200,  효성2동,'70,65 - 69세,1998,444,178,266
'2824560200,  효성2동,'75,70 - 74세,1998,312,102,210
'2824560200,  효성2동,'80,75 - 79세,1998,206,65,141
'2824560200,  효성2동,'85,80 - 84세,1998,94,24,70
'2824560200,  효성2동,'90,85+ ,1998,55,8,47
'2824561100,  계산1동,'00,계,1998,27093,13703,13390
'2824561100,  계산1동,'05,0 - 4세,1998,2278,1178,1100
'2824561100,  계산1동,'10,5 - 9세,1998,2513,1275,1238
'2824561100,  계산1동,'15,10 - 14세,1998,2208,1161,1047
'2824561100,  계산1동,'20,15 - 19세,1998,2143,1104,1039
'2824561100,  계산1동,'25,20 - 24세,1998,1890,924,966
'2824561100,  계산1동,'30,25 - 29세,1998,2606,1265,1341
'2824561100,  계산1동,'35,30 - 34세,1998,3168,1573,1595
'2824561100,  계산1동,'40,35 - 39세,1998,3344,1774,1570
'2824561100,  계산1동,'45,40 - 44세,1998,2307,1270,1037
'2824561100,  계산1동,'50,45 - 49세,1998,1286,701,585
'2824561100,  계산1동,'55,50 - 54세,1998,859,484,375
'2824561100,  계산1동,'60,55 - 59세,1998,750,349,401
'2824561100,  계산1동,'65,60 - 64세,1998,623,265,358
'2824561100,  계산1동,'70,65 - 69세,1998,456,169,287
'2824561100,  계산1동,'75,70 - 74세,1998,297,100,197
'2824561100,  계산1동,'80,75 - 79세,1998,216,70,146
'2824561100,  계산1동,'85,80 - 84세,1998,108,32,76
'2824561100,  계산1동,'90,85+ ,1998,41,9,32
'2824561200,  계산2동,'00,계,1998,22564,11403,11161
'2824561200,  계산2동,'05,0 - 4세,1998,2109,1097,1012
'2824561200,  계산2동,'10,5 - 9세,1998,2226,1161,1065
'2824561200,  계산2동,'15,10 - 14세,1998,1803,954,849
'2824561200,  계산2동,'20,15 - 19세,1998,1694,904,790
'2824561200,  계산2동,'25,20 - 24세,1998,1444,687,757
'2824561200,  계산2동,'30,25 - 29세,1998,2185,1022,1163
'2824561200,  계산2동,'35,30 - 34세,1998,2700,1341,1359
'2824561200,  계산2동,'40,35 - 39세,1998,2879,1513,1366
'2824561200,  계산2동,'45,40 - 44세,1998,1921,1035,886
'2824561200,  계산2동,'50,45 - 49세,1998,1020,574,446
'2824561200,  계산2동,'55,50 - 54세,1998,718,391,327
'2824561200,  계산2동,'60,55 - 59세,1998,572,253,319
'2824561200,  계산2동,'65,60 - 64세,1998,440,188,252
'2824561200,  계산2동,'70,65 - 69세,1998,355,112,243
'2824561200,  계산2동,'75,70 - 74세,1998,216,76,140
'2824561200,  계산2동,'80,75 - 79세,1998,150,52,98
'2824561200,  계산2동,'85,80 - 84세,1998,82,31,51
'2824561200,  계산2동,'90,85+ ,1998,50,12,38
'2824561300,  계산3동,'00,계,1998,49858,24881,24977
'2824561300,  계산3동,'05,0 - 4세,1998,5027,2696,2331
'2824561300,  계산3동,'10,5 - 9세,1998,6205,3261,2944
'2824561300,  계산3동,'15,10 - 14세,1998,4882,2519,2363
'2824561300,  계산3동,'20,15 - 19세,1998,3302,1636,1666
'2824561300,  계산3동,'25,20 - 24세,1998,1969,901,1068
'2824561300,  계산3동,'30,25 - 29세,1998,3667,1537,2130
'2824561300,  계산3동,'35,30 - 34세,1998,6226,2717,3509
'2824561300,  계산3동,'40,35 - 39세,1998,7897,4039,3858
'2824561300,  계산3동,'45,40 - 44세,1998,4696,2758,1938
'2824561300,  계산3동,'50,45 - 49세,1998,1804,1097,707
'2824561300,  계산3동,'55,50 - 54세,1998,1034,574,460
'2824561300,  계산3동,'60,55 - 59세,1998,824,368,456
'2824561300,  계산3동,'65,60 - 64세,1998,778,287,491
'2824561300,  계산3동,'70,65 - 69세,1998,648,219,429
'2824561300,  계산3동,'75,70 - 74세,1998,412,119,293
'2824561300,  계산3동,'80,75 - 79세,1998,272,75,197
'2824561300,  계산3동,'85,80 - 84세,1998,143,57,86
'2824561300,  계산3동,'90,85+ ,1998,72,21,51
'2824562100,  작전1동,'00,계,1998,30359,15216,15143
'2824562100,  작전1동,'05,0 - 4세,1998,2910,1550,1360
'2824562100,  작전1동,'10,5 - 9세,1998,3550,1791,1759
'2824562100,  작전1동,'15,10 - 14세,1998,2624,1321,1303
'2824562100,  작전1동,'20,15 - 19세,1998,2216,1136,1080
'2824562100,  작전1동,'25,20 - 24세,1998,1471,723,748
'2824562100,  작전1동,'30,25 - 29세,1998,2602,1166,1436
'2824562100,  작전1동,'35,30 - 34세,1998,3758,1723,2035
'2824562100,  작전1동,'40,35 - 39세,1998,4375,2290,2085
'2824562100,  작전1동,'45,40 - 44세,1998,2705,1571,1134
'2824562100,  작전1동,'50,45 - 49세,1998,1238,712,526
'2824562100,  작전1동,'55,50 - 54세,1998,727,386,341
'2824562100,  작전1동,'60,55 - 59세,1998,621,305,316
'2824562100,  작전1동,'65,60 - 64세,1998,520,203,317
'2824562100,  작전1동,'70,65 - 69세,1998,426,143,283
'2824562100,  작전1동,'75,70 - 74세,1998,294,96,198
'2824562100,  작전1동,'80,75 - 79세,1998,192,62,130
'2824562100,  작전1동,'85,80 - 84세,1998,80,22,58
'2824562100,  작전1동,'90,85+ ,1998,50,16,34
'2824562200,  작전2동,'00,계,1998,32816,16593,16223
'2824562200,  작전2동,'05,0 - 4세,1998,2851,1518,1333
'2824562200,  작전2동,'10,5 - 9세,1998,3016,1586,1430
'2824562200,  작전2동,'15,10 - 14세,1998,2613,1289,1324
'2824562200,  작전2동,'20,15 - 19세,1998,2744,1421,1323
'2824562200,  작전2동,'25,20 - 24세,1998,2252,1114,1138
'2824562200,  작전2동,'30,25 - 29세,1998,3004,1446,1558
'2824562200,  작전2동,'35,30 - 34세,1998,3698,1803,1895
'2824562200,  작전2동,'40,35 - 39세,1998,3965,2110,1855
'2824562200,  작전2동,'45,40 - 44세,1998,2961,1570,1391
'2824562200,  작전2동,'50,45 - 49세,1998,1591,879,712
'2824562200,  작전2동,'55,50 - 54세,1998,1110,610,500
'2824562200,  작전2동,'60,55 - 59세,1998,968,461,507
'2824562200,  작전2동,'65,60 - 64세,1998,773,358,415
'2824562200,  작전2동,'70,65 - 69세,1998,540,191,349
'2824562200,  작전2동,'75,70 - 74세,1998,335,119,216
'2824562200,  작전2동,'80,75 - 79세,1998,221,76,145
'2824562200,  작전2동,'85,80 - 84세,1998,112,30,82
'2824562200,  작전2동,'90,85+ ,1998,62,12,50
'2824564000,  작전서운동,'00,계,1998,34089,17106,16983
'2824564000,  작전서운동,'05,0 - 4세,1998,4264,2211,2053
'2824564000,  작전서운동,'10,5 - 9세,1998,4007,2037,1970
'2824564000,  작전서운동,'15,10 - 14세,1998,2555,1311,1244
'2824564000,  작전서운동,'20,15 - 19세,1998,1642,861,781
'2824564000,  작전서운동,'25,20 - 24세,1998,1383,632,751
'2824564000,  작전서운동,'30,25 - 29세,1998,3901,1637,2264
'2824564000,  작전서운동,'35,30 - 34세,1998,5482,2713,2769
'2824564000,  작전서운동,'40,35 - 39세,1998,4743,2623,2120
'2824564000,  작전서운동,'45,40 - 44세,1998,2358,1411,947
'2824564000,  작전서운동,'50,45 - 49세,1998,968,574,394
'2824564000,  작전서운동,'55,50 - 54세,1998,605,292,313
'2824564000,  작전서운동,'60,55 - 59세,1998,639,277,362
'2824564000,  작전서운동,'65,60 - 64세,1998,516,203,313
'2824564000,  작전서운동,'70,65 - 69세,1998,451,155,296
'2824564000,  작전서운동,'75,70 - 74세,1998,283,80,203
'2824564000,  작전서운동,'80,75 - 79세,1998,180,57,123
'2824564000,  작전서운동,'85,80 - 84세,1998,62,24,38
'2824564000,  작전서운동,'90,85+ ,1998,50,8,42
'2824571000,  계양1동,'00,계,1998,15568,7868,7700
'2824571000,  계양1동,'05,0 - 4세,1998,1524,769,755
'2824571000,  계양1동,'10,5 - 9세,1998,1666,834,832
'2824571000,  계양1동,'15,10 - 14세,1998,944,484,460
'2824571000,  계양1동,'20,15 - 19세,1998,911,426,485
'2824571000,  계양1동,'25,20 - 24세,1998,918,461,457
'2824571000,  계양1동,'30,25 - 29세,1998,1339,649,690
'2824571000,  계양1동,'35,30 - 34세,1998,1936,931,1005
'2824571000,  계양1동,'40,35 - 39세,1998,1874,1107,767
'2824571000,  계양1동,'45,40 - 44세,1998,1128,651,477
'2824571000,  계양1동,'50,45 - 49세,1998,606,319,287
'2824571000,  계양1동,'55,50 - 54세,1998,596,302,294
'2824571000,  계양1동,'60,55 - 59세,1998,606,298,308
'2824571000,  계양1동,'65,60 - 64세,1998,541,255,286
'2824571000,  계양1동,'70,65 - 69세,1998,386,159,227
'2824571000,  계양1동,'75,70 - 74세,1998,272,102,170
'2824571000,  계양1동,'80,75 - 79세,1998,185,83,102
'2824571000,  계양1동,'85,80 - 84세,1998,99,30,69
'2824571000,  계양1동,'90,85+ ,1998,37,8,29
'2824572000,  계양2동,'00,계,1998,40842,20596,20246
'2824572000,  계양2동,'05,0 - 4세,1998,4823,2552,2271
'2824572000,  계양2동,'10,5 - 9세,1998,4541,2349,2192
'2824572000,  계양2동,'15,10 - 14세,1998,2922,1422,1500
'2824572000,  계양2동,'20,15 - 19세,1998,2231,1153,1078
'2824572000,  계양2동,'25,20 - 24세,1998,2052,953,1099
'2824572000,  계양2동,'30,25 - 29세,1998,4606,2076,2530
'2824572000,  계양2동,'35,30 - 34세,1998,6134,3034,3100
'2824572000,  계양2동,'40,35 - 39세,1998,5461,3082,2379
'2824572000,  계양2동,'45,40 - 44세,1998,2875,1659,1216
'2824572000,  계양2동,'50,45 - 49세,1998,1292,711,581
'2824572000,  계양2동,'55,50 - 54세,1998,927,450,477
'2824572000,  계양2동,'60,55 - 59세,1998,867,375,492
'2824572000,  계양2동,'65,60 - 64세,1998,814,318,496
'2824572000,  계양2동,'70,65 - 69세,1998,542,211,331
'2824572000,  계양2동,'75,70 - 74세,1998,361,116,245
'2824572000,  계양2동,'80,75 - 79세,1998,227,87,140
'2824572000,  계양2동,'85,80 - 84세,1998,122,41,81
'2824572000,  계양2동,'90,85+ ,1998,45,7,38
'28260, 서구,'00,계,1998,326386,165910,160476
'28260, 서구,'05,0 - 4세,1998,30676,16079,14597
'28260, 서구,'10,5 - 9세,1998,31140,16178,14962
'28260, 서구,'15,10 - 14세,1998,24851,12837,12014
'28260, 서구,'20,15 - 19세,1998,25692,13185,12507
'28260, 서구,'25,20 - 24세,1998,21197,10570,10627
'28260, 서구,'30,25 - 29세,1998,32110,15203,16907
'28260, 서구,'35,30 - 34세,1998,39360,19707,19653
'28260, 서구,'40,35 - 39세,1998,39255,21013,18242
'28260, 서구,'45,40 - 44세,1998,27203,14848,12355
'28260, 서구,'50,45 - 49세,1998,15077,8402,6675
'28260, 서구,'55,50 - 54세,1998,10921,5844,5077
'28260, 서구,'60,55 - 59세,1998,9060,4494,4566
'28260, 서구,'65,60 - 64세,1998,7066,3144,3922
'28260, 서구,'70,65 - 69세,1998,5097,1872,3225
'28260, 서구,'75,70 - 74세,1998,3483,1187,2296
'28260, 서구,'80,75 - 79세,1998,2430,848,1582
'28260, 서구,'85,80 - 84세,1998,1133,342,791
'28260, 서구,'90,85+ ,1998,635,157,478
'2826051500,  검암경서동,'00,계,1998,3460,1828,1632
'2826051500,  검암경서동,'05,0 - 4세,1998,145,72,73
'2826051500,  검암경서동,'10,5 - 9세,1998,173,91,82
'2826051500,  검암경서동,'15,10 - 14세,1998,199,108,91
'2826051500,  검암경서동,'20,15 - 19세,1998,342,184,158
'2826051500,  검암경서동,'25,20 - 24세,1998,298,165,133
'2826051500,  검암경서동,'30,25 - 29세,1998,298,180,118
'2826051500,  검암경서동,'35,30 - 34세,1998,244,145,99
'2826051500,  검암경서동,'40,35 - 39세,1998,285,159,126
'2826051500,  검암경서동,'45,40 - 44세,1998,284,158,126
'2826051500,  검암경서동,'50,45 - 49세,1998,218,119,99
'2826051500,  검암경서동,'55,50 - 54세,1998,206,112,94
'2826051500,  검암경서동,'60,55 - 59세,1998,204,105,99
'2826051500,  검암경서동,'65,60 - 64세,1998,183,90,93
'2826051500,  검암경서동,'70,65 - 69세,1998,130,56,74
'2826051500,  검암경서동,'75,70 - 74세,1998,112,40,72
'2826051500,  검암경서동,'80,75 - 79세,1998,77,26,51
'2826051500,  검암경서동,'85,80 - 84세,1998,40,14,26
'2826051500,  검암경서동,'90,85+ ,1998,22,4,18
'2826053000,  연희동,'00,계,1998,33411,16969,16442
'2826053000,  연희동,'05,0 - 4세,1998,3753,1933,1820
'2826053000,  연희동,'10,5 - 9세,1998,3921,2065,1856
'2826053000,  연희동,'15,10 - 14세,1998,2651,1378,1273
'2826053000,  연희동,'20,15 - 19세,1998,2079,1077,1002
'2826053000,  연희동,'25,20 - 24세,1998,1524,758,766
'2826053000,  연희동,'30,25 - 29세,1998,3094,1337,1757
'2826053000,  연희동,'35,30 - 34세,1998,4791,2272,2519
'2826053000,  연희동,'40,35 - 39세,1998,4666,2531,2135
'2826053000,  연희동,'45,40 - 44세,1998,2685,1561,1124
'2826053000,  연희동,'50,45 - 49세,1998,1258,740,518
'2826053000,  연희동,'55,50 - 54세,1998,757,397,360
'2826053000,  연희동,'60,55 - 59세,1998,677,339,338
'2826053000,  연희동,'65,60 - 64세,1998,535,239,296
'2826053000,  연희동,'70,65 - 69세,1998,394,131,263
'2826053000,  연희동,'75,70 - 74세,1998,282,92,190
'2826053000,  연희동,'80,75 - 79세,1998,210,77,133
'2826053000,  연희동,'85,80 - 84세,1998,85,31,54
'2826053000,  연희동,'90,85+ ,1998,49,11,38
'2826054200,  가정1동,'00,계,1998,28766,14652,14114
'2826054200,  가정1동,'05,0 - 4세,1998,2805,1454,1351
'2826054200,  가정1동,'10,5 - 9세,1998,2542,1300,1242
'2826054200,  가정1동,'15,10 - 14세,1998,1978,991,987
'2826054200,  가정1동,'20,15 - 19세,1998,2175,1121,1054
'2826054200,  가정1동,'25,20 - 24세,1998,2128,1024,1104
'2826054200,  가정1동,'30,25 - 29세,1998,3269,1629,1640
'2826054200,  가정1동,'35,30 - 34세,1998,3640,1952,1688
'2826054200,  가정1동,'40,35 - 39세,1998,3225,1745,1480
'2826054200,  가정1동,'45,40 - 44세,1998,2254,1231,1023
'2826054200,  가정1동,'50,45 - 49세,1998,1319,705,614
'2826054200,  가정1동,'55,50 - 54세,1998,925,491,434
'2826054200,  가정1동,'60,55 - 59세,1998,850,402,448
'2826054200,  가정1동,'65,60 - 64세,1998,596,256,340
'2826054200,  가정1동,'70,65 - 69세,1998,431,153,278
'2826054200,  가정1동,'75,70 - 74세,1998,293,102,191
'2826054200,  가정1동,'80,75 - 79세,1998,204,65,139
'2826054200,  가정1동,'85,80 - 84세,1998,75,20,55
'2826054200,  가정1동,'90,85+ ,1998,57,11,46
'2826054300,  가정2동,'00,계,1998,25020,12597,12423
'2826054300,  가정2동,'05,0 - 4세,1998,2880,1470,1410
'2826054300,  가정2동,'10,5 - 9세,1998,2745,1431,1314
'2826054300,  가정2동,'15,10 - 14세,1998,1928,982,946
'2826054300,  가정2동,'20,15 - 19세,1998,1544,813,731
'2826054300,  가정2동,'25,20 - 24세,1998,1234,571,663
'2826054300,  가정2동,'30,25 - 29세,1998,2784,1214,1570
'2826054300,  가정2동,'35,30 - 34세,1998,3497,1714,1783
'2826054300,  가정2동,'40,35 - 39세,1998,3332,1834,1498
'2826054300,  가정2동,'45,40 - 44세,1998,1911,1112,799
'2826054300,  가정2동,'50,45 - 49세,1998,833,489,344
'2826054300,  가정2동,'55,50 - 54세,1998,559,281,278
'2826054300,  가정2동,'60,55 - 59세,1998,506,227,279
'2826054300,  가정2동,'65,60 - 64세,1998,447,184,263
'2826054300,  가정2동,'70,65 - 69세,1998,359,111,248
'2826054300,  가정2동,'75,70 - 74세,1998,220,82,138
'2826054300,  가정2동,'80,75 - 79세,1998,148,58,90
'2826054300,  가정2동,'85,80 - 84세,1998,55,16,39
'2826054300,  가정2동,'90,85+ ,1998,38,8,30
'2826054400,  가정3동,'00,계,1998,15553,7827,7726
'2826054400,  가정3동,'05,0 - 4세,1998,1506,835,671
'2826054400,  가정3동,'10,5 - 9세,1998,1819,946,873
'2826054400,  가정3동,'15,10 - 14세,1998,1386,699,687
'2826054400,  가정3동,'20,15 - 19세,1998,1101,564,537
'2826054400,  가정3동,'25,20 - 24세,1998,756,375,381
'2826054400,  가정3동,'30,25 - 29세,1998,1364,601,763
'2826054400,  가정3동,'35,30 - 34세,1998,1995,923,1072
'2826054400,  가정3동,'40,35 - 39세,1998,2177,1153,1024
'2826054400,  가정3동,'45,40 - 44세,1998,1306,730,576
'2826054400,  가정3동,'50,45 - 49세,1998,575,332,243
'2826054400,  가정3동,'55,50 - 54세,1998,401,198,203
'2826054400,  가정3동,'60,55 - 59세,1998,363,169,194
'2826054400,  가정3동,'65,60 - 64세,1998,285,117,168
'2826054400,  가정3동,'70,65 - 69세,1998,243,93,150
'2826054400,  가정3동,'75,70 - 74세,1998,135,47,88
'2826054400,  가정3동,'80,75 - 79세,1998,87,30,57
'2826054400,  가정3동,'85,80 - 84세,1998,38,10,28
'2826054400,  가정3동,'90,85+ ,1998,16,5,11
'2826055000,  석남1동,'00,계,1998,28118,14387,13731
'2826055000,  석남1동,'05,0 - 4세,1998,2413,1278,1135
'2826055000,  석남1동,'10,5 - 9세,1998,2402,1250,1152
'2826055000,  석남1동,'15,10 - 14세,1998,2099,1114,985
'2826055000,  석남1동,'20,15 - 19세,1998,2523,1254,1269
'2826055000,  석남1동,'25,20 - 24세,1998,2154,1111,1043
'2826055000,  석남1동,'30,25 - 29세,1998,2841,1424,1417
'2826055000,  석남1동,'35,30 - 34세,1998,3067,1589,1478
'2826055000,  석남1동,'40,35 - 39세,1998,3072,1621,1451
'2826055000,  석남1동,'45,40 - 44세,1998,2466,1298,1168
'2826055000,  석남1동,'50,45 - 49세,1998,1443,796,647
'2826055000,  석남1동,'55,50 - 54세,1998,1132,589,543
'2826055000,  석남1동,'60,55 - 59세,1998,836,442,394
'2826055000,  석남1동,'65,60 - 64세,1998,610,250,360
'2826055000,  석남1동,'70,65 - 69세,1998,415,163,252
'2826055000,  석남1동,'75,70 - 74세,1998,276,83,193
'2826055000,  석남1동,'80,75 - 79세,1998,208,81,127
'2826055000,  석남1동,'85,80 - 84세,1998,104,32,72
'2826055000,  석남1동,'90,85+ ,1998,57,12,45
'2826056000,  석남2동,'00,계,1998,20215,10428,9787
'2826056000,  석남2동,'05,0 - 4세,1998,1581,846,735
'2826056000,  석남2동,'10,5 - 9세,1998,1494,787,707
'2826056000,  석남2동,'15,10 - 14세,1998,1428,744,684
'2826056000,  석남2동,'20,15 - 19세,1998,1931,1006,925
'2826056000,  석남2동,'25,20 - 24세,1998,1776,915,861
'2826056000,  석남2동,'30,25 - 29세,1998,2061,1044,1017
'2826056000,  석남2동,'35,30 - 34세,1998,2005,1089,916
'2826056000,  석남2동,'40,35 - 39세,1998,2059,1073,986
'2826056000,  석남2동,'45,40 - 44세,1998,1728,868,860
'2826056000,  석남2동,'50,45 - 49세,1998,1225,638,587
'2826056000,  석남2동,'55,50 - 54세,1998,892,501,391
'2826056000,  석남2동,'60,55 - 59세,1998,735,385,350
'2826056000,  석남2동,'65,60 - 64세,1998,492,249,243
'2826056000,  석남2동,'70,65 - 69세,1998,309,125,184
'2826056000,  석남2동,'75,70 - 74세,1998,213,75,138
'2826056000,  석남2동,'80,75 - 79세,1998,171,52,119
'2826056000,  석남2동,'85,80 - 84세,1998,75,19,56
'2826056000,  석남2동,'90,85+ ,1998,40,12,28
'2826056100,  석남3동,'00,계,1998,20740,10489,10251
'2826056100,  석남3동,'05,0 - 4세,1998,1819,944,875
'2826056100,  석남3동,'10,5 - 9세,1998,2013,1041,972
'2826056100,  석남3동,'15,10 - 14세,1998,1708,862,846
'2826056100,  석남3동,'20,15 - 19세,1998,1776,911,865
'2826056100,  석남3동,'25,20 - 24세,1998,1342,680,662
'2826056100,  석남3동,'30,25 - 29세,1998,1903,887,1016
'2826056100,  석남3동,'35,30 - 34세,1998,2484,1200,1284
'2826056100,  석남3동,'40,35 - 39세,1998,2580,1364,1216
'2826056100,  석남3동,'45,40 - 44세,1998,1768,1007,761
'2826056100,  석남3동,'50,45 - 49세,1998,924,529,395
'2826056100,  석남3동,'55,50 - 54세,1998,632,332,300
'2826056100,  석남3동,'60,55 - 59세,1998,567,255,312
'2826056100,  석남3동,'65,60 - 64세,1998,453,192,261
'2826056100,  석남3동,'70,65 - 69세,1998,308,120,188
'2826056100,  석남3동,'75,70 - 74세,1998,210,81,129
'2826056100,  석남3동,'80,75 - 79세,1998,152,54,98
'2826056100,  석남3동,'85,80 - 84세,1998,64,20,44
'2826056100,  석남3동,'90,85+ ,1998,37,10,27
'2826057500,  신현원창동,'00,계,1998,29113,14770,14343
'2826057500,  신현원창동,'05,0 - 4세,1998,2412,1243,1169
'2826057500,  신현원창동,'10,5 - 9세,1998,2867,1506,1361
'2826057500,  신현원창동,'15,10 - 14세,1998,2624,1390,1234
'2826057500,  신현원창동,'20,15 - 19세,1998,2631,1312,1319
'2826057500,  신현원창동,'25,20 - 24세,1998,1875,909,966
'2826057500,  신현원창동,'30,25 - 29세,1998,2524,1188,1336
'2826057500,  신현원창동,'35,30 - 34세,1998,3166,1546,1620
'2826057500,  신현원창동,'40,35 - 39세,1998,3722,1902,1820
'2826057500,  신현원창동,'45,40 - 44세,1998,2685,1460,1225
'2826057500,  신현원창동,'50,45 - 49세,1998,1463,854,609
'2826057500,  신현원창동,'55,50 - 54세,1998,991,568,423
'2826057500,  신현원창동,'60,55 - 59세,1998,625,352,273
'2826057500,  신현원창동,'65,60 - 64세,1998,499,210,289
'2826057500,  신현원창동,'70,65 - 69세,1998,399,135,264
'2826057500,  신현원창동,'75,70 - 74세,1998,285,98,187
'2826057500,  신현원창동,'80,75 - 79세,1998,201,59,142
'2826057500,  신현원창동,'85,80 - 84세,1998,99,28,71
'2826057500,  신현원창동,'90,85+ ,1998,45,10,35
'2826058000,  가좌1동,'00,계,1998,18642,9654,8988
'2826058000,  가좌1동,'05,0 - 4세,1998,1562,834,728
'2826058000,  가좌1동,'10,5 - 9세,1998,1553,790,763
'2826058000,  가좌1동,'15,10 - 14세,1998,1298,693,605
'2826058000,  가좌1동,'20,15 - 19세,1998,1624,823,801
'2826058000,  가좌1동,'25,20 - 24세,1998,1508,773,735
'2826058000,  가좌1동,'30,25 - 29세,1998,2004,1027,977
'2826058000,  가좌1동,'35,30 - 34세,1998,2071,1083,988
'2826058000,  가좌1동,'40,35 - 39세,1998,2001,1120,881
'2826058000,  가좌1동,'45,40 - 44세,1998,1506,790,716
'2826058000,  가좌1동,'50,45 - 49세,1998,940,518,422
'2826058000,  가좌1동,'55,50 - 54세,1998,709,382,327
'2826058000,  가좌1동,'60,55 - 59세,1998,680,323,357
'2826058000,  가좌1동,'65,60 - 64세,1998,476,244,232
'2826058000,  가좌1동,'70,65 - 69세,1998,301,122,179
'2826058000,  가좌1동,'75,70 - 74세,1998,178,55,123
'2826058000,  가좌1동,'80,75 - 79세,1998,126,43,83
'2826058000,  가좌1동,'85,80 - 84세,1998,71,25,46
'2826058000,  가좌1동,'90,85+ ,1998,34,9,25
'2826059000,  가좌2동,'00,계,1998,23489,11667,11822
'2826059000,  가좌2동,'05,0 - 4세,1998,1978,1017,961
'2826059000,  가좌2동,'10,5 - 9세,1998,2084,1083,1001
'2826059000,  가좌2동,'15,10 - 14세,1998,1927,1017,910
'2826059000,  가좌2동,'20,15 - 19세,1998,2104,1045,1059
'2826059000,  가좌2동,'25,20 - 24세,1998,1408,714,694
'2826059000,  가좌2동,'30,25 - 29세,1998,2097,962,1135
'2826059000,  가좌2동,'35,30 - 34세,1998,2484,1240,1244
'2826059000,  가좌2동,'40,35 - 39세,1998,2724,1355,1369
'2826059000,  가좌2동,'45,40 - 44세,1998,2322,1193,1129
'2826059000,  가좌2동,'50,45 - 49세,1998,1296,702,594
'2826059000,  가좌2동,'55,50 - 54세,1998,835,461,374
'2826059000,  가좌2동,'60,55 - 59세,1998,572,279,293
'2826059000,  가좌2동,'65,60 - 64세,1998,497,200,297
'2826059000,  가좌2동,'70,65 - 69세,1998,435,155,280
'2826059000,  가좌2동,'75,70 - 74세,1998,354,117,237
'2826059000,  가좌2동,'80,75 - 79세,1998,218,77,141
'2826059000,  가좌2동,'85,80 - 84세,1998,109,37,72
'2826059000,  가좌2동,'90,85+ ,1998,45,13,32
'2826060000,  가좌3동,'00,계,1998,26466,13391,13075
'2826060000,  가좌3동,'05,0 - 4세,1998,2129,1127,1002
'2826060000,  가좌3동,'10,5 - 9세,1998,2216,1158,1058
'2826060000,  가좌3동,'15,10 - 14세,1998,2063,1042,1021
'2826060000,  가좌3동,'20,15 - 19세,1998,2438,1262,1176
'2826060000,  가좌3동,'25,20 - 24세,1998,2049,1016,1033
'2826060000,  가좌3동,'30,25 - 29세,1998,2499,1225,1274
'2826060000,  가좌3동,'35,30 - 34세,1998,2787,1377,1410
'2826060000,  가좌3동,'40,35 - 39세,1998,2992,1543,1449
'2826060000,  가좌3동,'45,40 - 44세,1998,2416,1264,1152
'2826060000,  가좌3동,'50,45 - 49세,1998,1385,773,612
'2826060000,  가좌3동,'55,50 - 54세,1998,1063,578,485
'2826060000,  가좌3동,'60,55 - 59세,1998,784,412,372
'2826060000,  가좌3동,'65,60 - 64세,1998,625,282,343
'2826060000,  가좌3동,'70,65 - 69세,1998,390,136,254
'2826060000,  가좌3동,'75,70 - 74세,1998,292,99,193
'2826060000,  가좌3동,'80,75 - 79세,1998,184,58,126
'2826060000,  가좌3동,'85,80 - 84세,1998,96,27,69
'2826060000,  가좌3동,'90,85+ ,1998,58,12,46
'2826061000,  가좌4동,'00,계,1998,15972,8126,7846
'2826061000,  가좌4동,'05,0 - 4세,1998,1346,681,665
'2826061000,  가좌4동,'10,5 - 9세,1998,1410,741,669
'2826061000,  가좌4동,'15,10 - 14세,1998,1250,640,610
'2826061000,  가좌4동,'20,15 - 19세,1998,1355,710,645
'2826061000,  가좌4동,'25,20 - 24세,1998,1126,552,574
'2826061000,  가좌4동,'30,25 - 29세,1998,1617,798,819
'2826061000,  가좌4동,'35,30 - 34세,1998,1726,889,837
'2826061000,  가좌4동,'40,35 - 39세,1998,1858,987,871
'2826061000,  가좌4동,'45,40 - 44세,1998,1394,739,655
'2826061000,  가좌4동,'50,45 - 49세,1998,836,461,375
'2826061000,  가좌4동,'55,50 - 54세,1998,593,324,269
'2826061000,  가좌4동,'60,55 - 59세,1998,432,217,215
'2826061000,  가좌4동,'65,60 - 64세,1998,350,159,191
'2826061000,  가좌4동,'70,65 - 69세,1998,264,95,169
'2826061000,  가좌4동,'75,70 - 74세,1998,177,61,116
'2826061000,  가좌4동,'80,75 - 79세,1998,134,46,88
'2826061000,  가좌4동,'85,80 - 84세,1998,69,18,51
'2826061000,  가좌4동,'90,85+ ,1998,35,8,27
'2826062000,  검단동,'00,계,1998,37421,19125,18296
'2826062000,  검단동,'05,0 - 4세,1998,4347,2345,2002
'2826062000,  검단동,'10,5 - 9세,1998,3901,1989,1912
'2826062000,  검단동,'15,10 - 14세,1998,2312,1177,1135
'2826062000,  검단동,'20,15 - 19세,1998,2069,1103,966
'2826062000,  검단동,'25,20 - 24세,1998,2019,1007,1012
'2826062000,  검단동,'30,25 - 29세,1998,3755,1687,2068
'2826062000,  검단동,'35,30 - 34세,1998,5403,2688,2715
'2826062000,  검단동,'40,35 - 39세,1998,4562,2626,1936
'2826062000,  검단동,'45,40 - 44세,1998,2478,1437,1041
'2826062000,  검단동,'50,45 - 49세,1998,1362,746,616
'2826062000,  검단동,'55,50 - 54세,1998,1226,630,596
'2826062000,  검단동,'60,55 - 59세,1998,1229,587,642
'2826062000,  검단동,'65,60 - 64세,1998,1018,472,546
'2826062000,  검단동,'70,65 - 69세,1998,719,277,442
'2826062000,  검단동,'75,70 - 74세,1998,456,155,301
'2826062000,  검단동,'80,75 - 79세,1998,310,122,188
'2826062000,  검단동,'85,80 - 84세,1998,153,45,108
'2826062000,  검단동,'90,85+ ,1998,102,32,70
'28710, 강화군,'00,계,1998,68572,34127,34445
'28710, 강화군,'05,0 - 4세,1998,3112,1630,1482
'28710, 강화군,'10,5 - 9세,1998,3656,1923,1733
'28710, 강화군,'15,10 - 14세,1998,4150,2120,2030
'28710, 강화군,'20,15 - 19세,1998,5658,2810,2848
'28710, 강화군,'25,20 - 24세,1998,5329,3004,2325
'28710, 강화군,'30,25 - 29세,1998,4538,2697,1841
'28710, 강화군,'35,30 - 34세,1998,4167,2153,2014
'28710, 강화군,'40,35 - 39세,1998,5227,2699,2528
'28710, 강화군,'45,40 - 44세,1998,5008,2571,2437
'28710, 강화군,'50,45 - 49세,1998,3930,1975,1955
'28710, 강화군,'55,50 - 54세,1998,4297,2091,2206
'28710, 강화군,'60,55 - 59세,1998,4944,2341,2603
'28710, 강화군,'65,60 - 64세,1998,4736,2285,2451
'28710, 강화군,'70,65 - 69세,1998,3503,1471,2032
'28710, 강화군,'75,70 - 74세,1998,2652,997,1655
'28710, 강화군,'80,75 - 79세,1998,1942,809,1133
'28710, 강화군,'85,80 - 84세,1998,1091,380,711
'28710, 강화군,'90,85+ ,1998,632,171,461
'2871025000,  강화읍,'00,계,1998,23849,11640,12209
'2871025000,  강화읍,'05,0 - 4세,1998,1534,787,747
'2871025000,  강화읍,'10,5 - 9세,1998,1672,881,791
'2871025000,  강화읍,'15,10 - 14세,1998,1704,874,830
'2871025000,  강화읍,'20,15 - 19세,1998,2138,1038,1100
'2871025000,  강화읍,'25,20 - 24세,1998,1791,907,884
'2871025000,  강화읍,'30,25 - 29세,1998,1878,980,898
'2871025000,  강화읍,'35,30 - 34세,1998,1944,951,993
'2871025000,  강화읍,'40,35 - 39세,1998,2258,1133,1125
'2871025000,  강화읍,'45,40 - 44세,1998,1960,969,991
'2871025000,  강화읍,'50,45 - 49세,1998,1325,669,656
'2871025000,  강화읍,'55,50 - 54세,1998,1247,611,636
'2871025000,  강화읍,'60,55 - 59세,1998,1165,551,614
'2871025000,  강화읍,'65,60 - 64세,1998,1076,496,580
'2871025000,  강화읍,'70,65 - 69세,1998,795,303,492
'2871025000,  강화읍,'75,70 - 74세,1998,597,209,388
'2871025000,  강화읍,'80,75 - 79세,1998,406,162,244
'2871025000,  강화읍,'85,80 - 84세,1998,226,79,147
'2871025000,  강화읍,'90,85+ ,1998,133,40,93
'2871031000,  선원면,'00,계,1998,4392,2243,2149
'2871031000,  선원면,'05,0 - 4세,1998,219,112,107
'2871031000,  선원면,'10,5 - 9세,1998,205,104,101
'2871031000,  선원면,'15,10 - 14세,1998,259,138,121
'2871031000,  선원면,'20,15 - 19세,1998,334,163,171
'2871031000,  선원면,'25,20 - 24세,1998,372,215,157
'2871031000,  선원면,'30,25 - 29세,1998,310,191,119
'2871031000,  선원면,'35,30 - 34세,1998,254,141,113
'2871031000,  선원면,'40,35 - 39세,1998,341,188,153
'2871031000,  선원면,'45,40 - 44세,1998,324,175,149
'2871031000,  선원면,'50,45 - 49세,1998,240,115,125
'2871031000,  선원면,'55,50 - 54세,1998,288,145,143
'2871031000,  선원면,'60,55 - 59세,1998,304,148,156
'2871031000,  선원면,'65,60 - 64세,1998,322,160,162
'2871031000,  선원면,'70,65 - 69세,1998,251,109,142
'2871031000,  선원면,'75,70 - 74세,1998,160,63,97
'2871031000,  선원면,'80,75 - 79세,1998,102,45,57
'2871031000,  선원면,'85,80 - 84세,1998,60,17,43
'2871031000,  선원면,'90,85+ ,1998,47,14,33
'2871032000,  불은면,'00,계,1998,4183,2129,2054
'2871032000,  불은면,'05,0 - 4세,1998,140,81,59
'2871032000,  불은면,'10,5 - 9세,1998,166,78,88
'2871032000,  불은면,'15,10 - 14세,1998,220,113,107
'2871032000,  불은면,'20,15 - 19세,1998,375,181,194
'2871032000,  불은면,'25,20 - 24세,1998,354,204,150
'2871032000,  불은면,'30,25 - 29세,1998,232,158,74
'2871032000,  불은면,'35,30 - 34세,1998,202,117,85
'2871032000,  불은면,'40,35 - 39세,1998,287,140,147
'2871032000,  불은면,'45,40 - 44세,1998,316,160,156
'2871032000,  불은면,'50,45 - 49세,1998,265,146,119
'2871032000,  불은면,'55,50 - 54세,1998,299,148,151
'2871032000,  불은면,'60,55 - 59세,1998,366,178,188
'2871032000,  불은면,'65,60 - 64세,1998,331,164,167
'2871032000,  불은면,'70,65 - 69세,1998,252,115,137
'2871032000,  불은면,'75,70 - 74세,1998,155,49,106
'2871032000,  불은면,'80,75 - 79세,1998,123,59,64
'2871032000,  불은면,'85,80 - 84세,1998,67,27,40
'2871032000,  불은면,'90,85+ ,1998,33,11,22
'2871033000,  길상면,'00,계,1998,6002,3013,2989
'2871033000,  길상면,'05,0 - 4세,1998,226,114,112
'2871033000,  길상면,'10,5 - 9세,1998,324,158,166
'2871033000,  길상면,'15,10 - 14세,1998,394,201,193
'2871033000,  길상면,'20,15 - 19세,1998,488,267,221
'2871033000,  길상면,'25,20 - 24세,1998,450,264,186
'2871033000,  길상면,'30,25 - 29세,1998,387,246,141
'2871033000,  길상면,'35,30 - 34세,1998,341,181,160
'2871033000,  길상면,'40,35 - 39세,1998,471,240,231
'2871033000,  길상면,'45,40 - 44세,1998,473,244,229
'2871033000,  길상면,'50,45 - 49세,1998,352,168,184
'2871033000,  길상면,'55,50 - 54세,1998,425,210,215
'2871033000,  길상면,'60,55 - 59세,1998,407,207,200
'2871033000,  길상면,'65,60 - 64세,1998,373,186,187
'2871033000,  길상면,'70,65 - 69세,1998,306,120,186
'2871033000,  길상면,'75,70 - 74세,1998,239,91,148
'2871033000,  길상면,'80,75 - 79세,1998,169,66,103
'2871033000,  길상면,'85,80 - 84세,1998,110,40,70
'2871033000,  길상면,'90,85+ ,1998,67,10,57
'2871034000,  화도면,'00,계,1998,4185,2118,2067
'2871034000,  화도면,'05,0 - 4세,1998,137,76,61
'2871034000,  화도면,'10,5 - 9세,1998,205,113,92
'2871034000,  화도면,'15,10 - 14세,1998,220,109,111
'2871034000,  화도면,'20,15 - 19세,1998,343,173,170
'2871034000,  화도면,'25,20 - 24세,1998,331,191,140
'2871034000,  화도면,'30,25 - 29세,1998,206,134,72
'2871034000,  화도면,'35,30 - 34세,1998,187,97,90
'2871034000,  화도면,'40,35 - 39세,1998,268,133,135
'2871034000,  화도면,'45,40 - 44세,1998,250,131,119
'2871034000,  화도면,'50,45 - 49세,1998,278,143,135
'2871034000,  화도면,'55,50 - 54세,1998,283,139,144
'2871034000,  화도면,'60,55 - 59세,1998,336,171,165
'2871034000,  화도면,'65,60 - 64세,1998,300,147,153
'2871034000,  화도면,'70,65 - 69세,1998,278,124,154
'2871034000,  화도면,'75,70 - 74세,1998,234,94,140
'2871034000,  화도면,'80,75 - 79세,1998,165,79,86
'2871034000,  화도면,'85,80 - 84세,1998,100,37,63
'2871034000,  화도면,'90,85+ ,1998,64,27,37
'2871035000,  양도면,'00,계,1998,4015,2001,2014
'2871035000,  양도면,'05,0 - 4세,1998,113,57,56
'2871035000,  양도면,'10,5 - 9세,1998,179,106,73
'2871035000,  양도면,'15,10 - 14세,1998,243,119,124
'2871035000,  양도면,'20,15 - 19세,1998,318,160,158
'2871035000,  양도면,'25,20 - 24세,1998,337,194,143
'2871035000,  양도면,'30,25 - 29세,1998,227,154,73
'2871035000,  양도면,'35,30 - 34세,1998,176,88,88
'2871035000,  양도면,'40,35 - 39세,1998,252,144,108
'2871035000,  양도면,'45,40 - 44세,1998,273,150,123
'2871035000,  양도면,'50,45 - 49세,1998,209,107,102
'2871035000,  양도면,'55,50 - 54세,1998,278,134,144
'2871035000,  양도면,'60,55 - 59세,1998,342,156,186
'2871035000,  양도면,'65,60 - 64세,1998,355,170,185
'2871035000,  양도면,'70,65 - 69세,1998,271,115,156
'2871035000,  양도면,'75,70 - 74세,1998,187,72,115
'2871035000,  양도면,'80,75 - 79세,1998,150,48,102
'2871035000,  양도면,'85,80 - 84세,1998,58,19,39
'2871035000,  양도면,'90,85+ ,1998,47,8,39
'2871036000,  내가면,'00,계,1998,3574,1785,1789
'2871036000,  내가면,'05,0 - 4세,1998,114,62,52
'2871036000,  내가면,'10,5 - 9세,1998,147,74,73
'2871036000,  내가면,'15,10 - 14세,1998,182,96,86
'2871036000,  내가면,'20,15 - 19세,1998,274,139,135
'2871036000,  내가면,'25,20 - 24세,1998,313,192,121
'2871036000,  내가면,'30,25 - 29세,1998,238,149,89
'2871036000,  내가면,'35,30 - 34세,1998,173,97,76
'2871036000,  내가면,'40,35 - 39세,1998,208,114,94
'2871036000,  내가면,'45,40 - 44세,1998,252,118,134
'2871036000,  내가면,'50,45 - 49세,1998,225,106,119
'2871036000,  내가면,'55,50 - 54세,1998,266,139,127
'2871036000,  내가면,'60,55 - 59세,1998,308,136,172
'2871036000,  내가면,'65,60 - 64세,1998,284,139,145
'2871036000,  내가면,'70,65 - 69세,1998,197,74,123
'2871036000,  내가면,'75,70 - 74세,1998,150,59,91
'2871036000,  내가면,'80,75 - 79세,1998,135,60,75
'2871036000,  내가면,'85,80 - 84세,1998,67,18,49
'2871036000,  내가면,'90,85+ ,1998,41,13,28
'2871037000,  하점면,'00,계,1998,4856,2449,2407
'2871037000,  하점면,'05,0 - 4세,1998,176,109,67
'2871037000,  하점면,'10,5 - 9세,1998,181,103,78
'2871037000,  하점면,'15,10 - 14세,1998,229,110,119
'2871037000,  하점면,'20,15 - 19세,1998,363,171,192
'2871037000,  하점면,'25,20 - 24세,1998,425,263,162
'2871037000,  하점면,'30,25 - 29세,1998,348,232,116
'2871037000,  하점면,'35,30 - 34세,1998,221,124,97
'2871037000,  하점면,'40,35 - 39세,1998,290,147,143
'2871037000,  하점면,'45,40 - 44세,1998,298,161,137
'2871037000,  하점면,'50,45 - 49세,1998,267,133,134
'2871037000,  하점면,'55,50 - 54세,1998,305,133,172
'2871037000,  하점면,'60,55 - 59세,1998,485,231,254
'2871037000,  하점면,'65,60 - 64세,1998,424,207,217
'2871037000,  하점면,'70,65 - 69세,1998,296,134,162
'2871037000,  하점면,'75,70 - 74세,1998,219,83,136
'2871037000,  하점면,'80,75 - 79세,1998,165,58,107
'2871037000,  하점면,'85,80 - 84세,1998,107,36,71
'2871037000,  하점면,'90,85+ ,1998,57,14,43
'2871038000,  양사면,'00,계,1998,2243,1085,1158
'2871038000,  양사면,'05,0 - 4세,1998,67,37,30
'2871038000,  양사면,'10,5 - 9세,1998,79,41,38
'2871038000,  양사면,'15,10 - 14세,1998,115,47,68
'2871038000,  양사면,'20,15 - 19세,1998,180,86,94
'2871038000,  양사면,'25,20 - 24세,1998,181,90,91
'2871038000,  양사면,'30,25 - 29세,1998,129,82,47
'2871038000,  양사면,'35,30 - 34세,1998,112,66,46
'2871038000,  양사면,'40,35 - 39세,1998,131,72,59
'2871038000,  양사면,'45,40 - 44세,1998,122,60,62
'2871038000,  양사면,'50,45 - 49세,1998,115,61,54
'2871038000,  양사면,'55,50 - 54세,1998,145,66,79
'2871038000,  양사면,'60,55 - 59세,1998,210,93,117
'2871038000,  양사면,'65,60 - 64세,1998,230,114,116
'2871038000,  양사면,'70,65 - 69세,1998,127,63,64
'2871038000,  양사면,'75,70 - 74세,1998,115,48,67
'2871038000,  양사면,'80,75 - 79세,1998,102,37,65
'2871038000,  양사면,'85,80 - 84세,1998,56,16,40
'2871038000,  양사면,'90,85+ ,1998,27,6,21
'2871039000,  송해면,'00,계,1998,4115,2093,2022
'2871039000,  송해면,'05,0 - 4세,1998,134,68,66
'2871039000,  송해면,'10,5 - 9세,1998,161,86,75
'2871039000,  송해면,'15,10 - 14세,1998,211,123,88
'2871039000,  송해면,'20,15 - 19세,1998,385,191,194
'2871039000,  송해면,'25,20 - 24세,1998,392,238,154
'2871039000,  송해면,'30,25 - 29세,1998,277,180,97
'2871039000,  송해면,'35,30 - 34세,1998,209,117,92
'2871039000,  송해면,'40,35 - 39세,1998,252,138,114
'2871039000,  송해면,'45,40 - 44세,1998,265,140,125
'2871039000,  송해면,'50,45 - 49세,1998,252,118,134
'2871039000,  송해면,'55,50 - 54세,1998,268,130,138
'2871039000,  송해면,'60,55 - 59세,1998,327,162,165
'2871039000,  송해면,'65,60 - 64세,1998,342,147,195
'2871039000,  송해면,'70,65 - 69세,1998,219,103,116
'2871039000,  송해면,'75,70 - 74세,1998,182,65,117
'2871039000,  송해면,'80,75 - 79세,1998,133,55,78
'2871039000,  송해면,'85,80 - 84세,1998,73,25,48
'2871039000,  송해면,'90,85+ ,1998,33,7,26
'2871040000,  교동면,'00,계,1998,3897,1955,1942
'2871040000,  교동면,'05,0 - 4세,1998,122,68,54
'2871040000,  교동면,'10,5 - 9세,1998,198,109,89
'2871040000,  교동면,'15,10 - 14세,1998,218,111,107
'2871040000,  교동면,'20,15 - 19세,1998,263,132,131
'2871040000,  교동면,'25,20 - 24세,1998,211,136,75
'2871040000,  교동면,'30,25 - 29세,1998,162,105,57
'2871040000,  교동면,'35,30 - 34세,1998,196,92,104
'2871040000,  교동면,'40,35 - 39세,1998,241,131,110
'2871040000,  교동면,'45,40 - 44세,1998,266,145,121
'2871040000,  교동면,'50,45 - 49세,1998,221,115,106
'2871040000,  교동면,'55,50 - 54세,1998,267,129,138
'2871040000,  교동면,'60,55 - 59세,1998,387,172,215
'2871040000,  교동면,'65,60 - 64세,1998,374,195,179
'2871040000,  교동면,'70,65 - 69세,1998,256,107,149
'2871040000,  교동면,'75,70 - 74세,1998,220,92,128
'2871040000,  교동면,'80,75 - 79세,1998,144,64,80
'2871040000,  교동면,'85,80 - 84세,1998,99,35,64
'2871040000,  교동면,'90,85+ ,1998,52,17,35
'2871041000,  삼산면,'00,계,1998,2509,1255,1254
'2871041000,  삼산면,'05,0 - 4세,1998,108,48,60
'2871041000,  삼산면,'10,5 - 9세,1998,106,56,50
'2871041000,  삼산면,'15,10 - 14세,1998,130,66,64
'2871041000,  삼산면,'20,15 - 19세,1998,163,96,67
'2871041000,  삼산면,'25,20 - 24세,1998,139,90,49
'2871041000,  삼산면,'30,25 - 29세,1998,129,76,53
'2871041000,  삼산면,'35,30 - 34세,1998,122,67,55
'2871041000,  삼산면,'40,35 - 39세,1998,172,90,82
'2871041000,  삼산면,'45,40 - 44세,1998,156,88,68
'2871041000,  삼산면,'50,45 - 49세,1998,139,73,66
'2871041000,  삼산면,'55,50 - 54세,1998,180,83,97
'2871041000,  삼산면,'60,55 - 59세,1998,232,103,129
'2871041000,  삼산면,'65,60 - 64세,1998,240,119,121
'2871041000,  삼산면,'70,65 - 69세,1998,190,79,111
'2871041000,  삼산면,'75,70 - 74세,1998,130,43,87
'2871041000,  삼산면,'80,75 - 79세,1998,100,55,45
'2871041000,  삼산면,'85,80 - 84세,1998,48,21,27
'2871041000,  삼산면,'90,85+ ,1998,25,2,23
'2871042000,  서도면,'00,계,1998,752,361,391
'2871042000,  서도면,'05,0 - 4세,1998,22,11,11
'2871042000,  서도면,'10,5 - 9세,1998,33,14,19
'2871042000,  서도면,'15,10 - 14세,1998,25,13,12
'2871042000,  서도면,'20,15 - 19세,1998,34,13,21
'2871042000,  서도면,'25,20 - 24세,1998,33,20,13
'2871042000,  서도면,'30,25 - 29세,1998,15,10,5
'2871042000,  서도면,'35,30 - 34세,1998,30,15,15
'2871042000,  서도면,'40,35 - 39세,1998,56,29,27
'2871042000,  서도면,'45,40 - 44세,1998,53,30,23
'2871042000,  서도면,'50,45 - 49세,1998,42,21,21
'2871042000,  서도면,'55,50 - 54세,1998,46,24,22
'2871042000,  서도면,'60,55 - 59세,1998,75,33,42
'2871042000,  서도면,'65,60 - 64세,1998,85,41,44
'2871042000,  서도면,'70,65 - 69세,1998,65,25,40
'2871042000,  서도면,'75,70 - 74세,1998,64,29,35
'2871042000,  서도면,'80,75 - 79세,1998,48,21,27
'2871042000,  서도면,'85,80 - 84세,1998,20,10,10
'2871042000,  서도면,'90,85+ ,1998,6,2,4
'28720, 옹진군,'00,계,1998,13920,7027,6893
'28720, 옹진군,'05,0 - 4세,1998,762,387,375
'28720, 옹진군,'10,5 - 9세,1998,755,404,351
'28720, 옹진군,'15,10 - 14세,1998,650,329,321
'28720, 옹진군,'20,15 - 19세,1998,936,469,467
'28720, 옹진군,'25,20 - 24세,1998,926,545,381
'28720, 옹진군,'30,25 - 29세,1998,900,535,365
'28720, 옹진군,'35,30 - 34세,1998,952,528,424
'28720, 옹진군,'40,35 - 39세,1998,1057,607,450
'28720, 옹진군,'45,40 - 44세,1998,970,545,425
'28720, 옹진군,'50,45 - 49세,1998,753,439,314
'28720, 옹진군,'55,50 - 54세,1998,833,408,425
'28720, 옹진군,'60,55 - 59세,1998,951,449,502
'28720, 옹진군,'65,60 - 64세,1998,951,423,528
'28720, 옹진군,'70,65 - 69세,1998,903,345,558
'28720, 옹진군,'75,70 - 74세,1998,686,258,428
'28720, 옹진군,'80,75 - 79세,1998,493,200,293
'28720, 옹진군,'85,80 - 84세,1998,280,107,173
'28720, 옹진군,'90,85+ ,1998,162,49,113
'2872031000,  북도면,'00,계,1998,1708,868,840
'2872031000,  북도면,'05,0 - 4세,1998,65,35,30
'2872031000,  북도면,'10,5 - 9세,1998,67,33,34
'2872031000,  북도면,'15,10 - 14세,1998,40,15,25
'2872031000,  북도면,'20,15 - 19세,1998,114,62,52
'2872031000,  북도면,'25,20 - 24세,1998,114,55,59
'2872031000,  북도면,'30,25 - 29세,1998,118,75,43
'2872031000,  북도면,'35,30 - 34세,1998,115,69,46
'2872031000,  북도면,'40,35 - 39세,1998,126,85,41
'2872031000,  북도면,'45,40 - 44세,1998,141,74,67
'2872031000,  북도면,'50,45 - 49세,1998,95,62,33
'2872031000,  북도면,'55,50 - 54세,1998,117,63,54
'2872031000,  북도면,'60,55 - 59세,1998,99,41,58
'2872031000,  북도면,'65,60 - 64세,1998,124,57,67
'2872031000,  북도면,'70,65 - 69세,1998,126,45,81
'2872031000,  북도면,'75,70 - 74세,1998,103,39,64
'2872031000,  북도면,'80,75 - 79세,1998,76,32,44
'2872031000,  북도면,'85,80 - 84세,1998,48,20,28
'2872031000,  북도면,'90,85+ ,1998,20,6,14
'2872032000,  송림면,'00,계,1998,1350,695,655
'2872032000,  송림면,'05,0 - 4세,1998,97,43,54
'2872032000,  송림면,'10,5 - 9세,1998,86,49,37
'2872032000,  송림면,'15,10 - 14세,1998,71,36,35
'2872032000,  송림면,'20,15 - 19세,1998,85,43,42
'2872032000,  송림면,'25,20 - 24세,1998,95,53,42
'2872032000,  송림면,'30,25 - 29세,1998,100,61,39
'2872032000,  송림면,'35,30 - 34세,1998,112,56,56
'2872032000,  송림면,'40,35 - 39세,1998,115,70,45
'2872032000,  송림면,'45,40 - 44세,1998,106,61,45
'2872032000,  송림면,'50,45 - 49세,1998,52,34,18
'2872032000,  송림면,'55,50 - 54세,1998,83,43,40
'2872032000,  송림면,'60,55 - 59세,1998,72,28,44
'2872032000,  송림면,'65,60 - 64세,1998,80,33,47
'2872032000,  송림면,'70,65 - 69세,1998,64,23,41
'2872032000,  송림면,'75,70 - 74세,1998,55,19,36
'2872032000,  송림면,'80,75 - 79세,1998,44,23,21
'2872032000,  송림면,'85,80 - 84세,1998,20,12,8
'2872032000,  송림면,'90,85+ ,1998,13,8,5
'2872033000,  백령면,'00,계,1998,4366,2187,2179
'2872033000,  백령면,'05,0 - 4세,1998,328,156,172
'2872033000,  백령면,'10,5 - 9세,1998,317,164,153
'2872033000,  백령면,'15,10 - 14세,1998,243,122,121
'2872033000,  백령면,'20,15 - 19세,1998,291,151,140
'2872033000,  백령면,'25,20 - 24세,1998,298,171,127
'2872033000,  백령면,'30,25 - 29세,1998,342,189,153
'2872033000,  백령면,'35,30 - 34세,1998,356,187,169
'2872033000,  백령면,'40,35 - 39세,1998,363,200,163
'2872033000,  백령면,'45,40 - 44세,1998,288,145,143
'2872033000,  백령면,'50,45 - 49세,1998,216,127,89
'2872033000,  백령면,'55,50 - 54세,1998,212,106,106
'2872033000,  백령면,'60,55 - 59세,1998,228,126,102
'2872033000,  백령면,'65,60 - 64세,1998,237,92,145
'2872033000,  백령면,'70,65 - 69세,1998,253,97,156
'2872033000,  백령면,'75,70 - 74세,1998,170,68,102
'2872033000,  백령면,'80,75 - 79세,1998,112,50,62
'2872033000,  백령면,'85,80 - 84세,1998,76,27,49
'2872033000,  백령면,'90,85+ ,1998,36,9,27
'2872034000,  대청면,'00,계,1998,1448,750,698
'2872034000,  대청면,'05,0 - 4세,1998,61,33,28
'2872034000,  대청면,'10,5 - 9세,1998,72,34,38
'2872034000,  대청면,'15,10 - 14세,1998,88,51,37
'2872034000,  대청면,'20,15 - 19세,1998,128,63,65
'2872034000,  대청면,'25,20 - 24세,1998,70,47,23
'2872034000,  대청면,'30,25 - 29세,1998,62,44,18
'2872034000,  대청면,'35,30 - 34세,1998,104,55,49
'2872034000,  대청면,'40,35 - 39세,1998,139,76,63
'2872034000,  대청면,'45,40 - 44세,1998,118,67,51
'2872034000,  대청면,'50,45 - 49세,1998,97,57,40
'2872034000,  대청면,'55,50 - 54세,1998,102,45,57
'2872034000,  대청면,'60,55 - 59세,1998,132,64,68
'2872034000,  대청면,'65,60 - 64세,1998,73,42,31
'2872034000,  대청면,'70,65 - 69세,1998,81,26,55
'2872034000,  대청면,'75,70 - 74세,1998,65,29,36
'2872034000,  대청면,'80,75 - 79세,1998,29,11,18
'2872034000,  대청면,'85,80 - 84세,1998,15,3,12
'2872034000,  대청면,'90,85+ ,1998,12,3,9
'2872035000,  덕적면,'00,계,1998,1411,712,699
'2872035000,  덕적면,'05,0 - 4세,1998,55,28,27
'2872035000,  덕적면,'10,5 - 9세,1998,51,31,20
'2872035000,  덕적면,'15,10 - 14세,1998,45,24,21
'2872035000,  덕적면,'20,15 - 19세,1998,57,22,35
'2872035000,  덕적면,'25,20 - 24세,1998,61,38,23
'2872035000,  덕적면,'30,25 - 29세,1998,73,48,25
'2872035000,  덕적면,'35,30 - 34세,1998,77,56,21
'2872035000,  덕적면,'40,35 - 39세,1998,90,60,30
'2872035000,  덕적면,'45,40 - 44세,1998,87,59,28
'2872035000,  덕적면,'50,45 - 49세,1998,76,45,31
'2872035000,  덕적면,'55,50 - 54세,1998,98,46,52
'2872035000,  덕적면,'60,55 - 59세,1998,120,59,61
'2872035000,  덕적면,'65,60 - 64세,1998,142,58,84
'2872035000,  덕적면,'70,65 - 69세,1998,136,55,81
'2872035000,  덕적면,'75,70 - 74세,1998,110,42,68
'2872035000,  덕적면,'80,75 - 79세,1998,75,22,53
'2872035000,  덕적면,'85,80 - 84세,1998,36,13,23
'2872035000,  덕적면,'90,85+ ,1998,22,6,16
'2872036000,  영흥면,'00,계,1998,2819,1404,1415
'2872036000,  영흥면,'05,0 - 4세,1998,126,74,52
'2872036000,  영흥면,'10,5 - 9세,1998,132,75,57
'2872036000,  영흥면,'15,10 - 14세,1998,144,68,76
'2872036000,  영흥면,'20,15 - 19세,1998,230,109,121
'2872036000,  영흥면,'25,20 - 24세,1998,234,140,94
'2872036000,  영흥면,'30,25 - 29세,1998,148,86,62
'2872036000,  영흥면,'35,30 - 34세,1998,151,81,70
'2872036000,  영흥면,'40,35 - 39세,1998,182,89,93
'2872036000,  영흥면,'45,40 - 44세,1998,180,106,74
'2872036000,  영흥면,'50,45 - 49세,1998,165,90,75
'2872036000,  영흥면,'55,50 - 54세,1998,178,84,94
'2872036000,  영흥면,'60,55 - 59세,1998,222,100,122
'2872036000,  영흥면,'65,60 - 64세,1998,211,108,103
'2872036000,  영흥면,'70,65 - 69세,1998,158,57,101
'2872036000,  영흥면,'75,70 - 74세,1998,133,43,90
'2872036000,  영흥면,'80,75 - 79세,1998,113,51,62
'2872036000,  영흥면,'85,80 - 84세,1998,68,29,39
'2872036000,  영흥면,'90,85+ ,1998,44,14,30
'2872037000,  자월면,'00,계,1998,818,411,407
'2872037000,  자월면,'05,0 - 4세,1998,30,18,12
'2872037000,  자월면,'10,5 - 9세,1998,30,18,12
'2872037000,  자월면,'15,10 - 14세,1998,19,13,6
'2872037000,  자월면,'20,15 - 19세,1998,31,19,12
'2872037000,  자월면,'25,20 - 24세,1998,54,41,13
'2872037000,  자월면,'30,25 - 29세,1998,57,32,25
'2872037000,  자월면,'35,30 - 34세,1998,37,24,13
'2872037000,  자월면,'40,35 - 39세,1998,42,27,15
'2872037000,  자월면,'45,40 - 44세,1998,50,33,17
'2872037000,  자월면,'50,45 - 49세,1998,52,24,28
'2872037000,  자월면,'55,50 - 54세,1998,43,21,22
'2872037000,  자월면,'60,55 - 59세,1998,78,31,47
'2872037000,  자월면,'65,60 - 64세,1998,84,33,51
'2872037000,  자월면,'70,65 - 69세,1998,85,42,43
'2872037000,  자월면,'75,70 - 74세,1998,50,18,32
'2872037000,  자월면,'80,75 - 79세,1998,44,11,33
'2872037000,  자월면,'85,80 - 84세,1998,17,3,14
'2872037000,  자월면,'90,85+ ,1998,15,3,12
'29,광주광역시,'00,계,1998,1339441,665166,674275
'29,광주광역시,'05,0 - 4세,1998,109139,56940,52199
'29,광주광역시,'10,5 - 9세,1998,106031,55701,50330
'29,광주광역시,'15,10 - 14세,1998,99993,51751,48242
'29,광주광역시,'20,15 - 19세,1998,131124,67386,63738
'29,광주광역시,'25,20 - 24세,1998,124515,62776,61739
'29,광주광역시,'30,25 - 29세,1998,134693,67756,66937
'29,광주광역시,'35,30 - 34세,1998,123605,62852,60753
'29,광주광역시,'40,35 - 39세,1998,122767,61447,61320
'29,광주광역시,'45,40 - 44세,1998,98570,48589,49981
'29,광주광역시,'50,45 - 49세,1998,71538,35250,36288
'29,광주광역시,'55,50 - 54세,1998,58381,28616,29765
'29,광주광역시,'60,55 - 59세,1998,51563,24886,26677
'29,광주광역시,'65,60 - 64세,1998,38151,17377,20774
'29,광주광역시,'70,65 - 69세,1998,26466,10572,15894
'29,광주광역시,'75,70 - 74세,1998,17953,6715,11238
'29,광주광역시,'80,75 - 79세,1998,13082,3965,9117
'29,광주광역시,'85,80 - 84세,1998,7015,1760,5255
'29,광주광역시,'90,85+ ,1998,4855,827,4028
'29110, 동구,'00,계,1998,133077,65891,67186
'29110, 동구,'05,0 - 4세,1998,7134,3728,3406
'29110, 동구,'10,5 - 9세,1998,7516,3932,3584
'29110, 동구,'15,10 - 14세,1998,8634,4481,4153
'29110, 동구,'20,15 - 19세,1998,13939,7121,6818
'29110, 동구,'25,20 - 24세,1998,15129,7803,7326
'29110, 동구,'30,25 - 29세,1998,13760,7531,6229
'29110, 동구,'35,30 - 34세,1998,8964,4742,4222
'29110, 동구,'40,35 - 39세,1998,9677,4653,5024
'29110, 동구,'45,40 - 44세,1998,9484,4409,5075
'29110, 동구,'50,45 - 49세,1998,8313,3882,4431
'29110, 동구,'55,50 - 54세,1998,7930,3643,4287
'29110, 동구,'60,55 - 59세,1998,7565,3649,3916
'29110, 동구,'65,60 - 64세,1998,5590,2713,2877
'29110, 동구,'70,65 - 69세,1998,3706,1648,2058
'29110, 동구,'75,70 - 74세,1998,2447,1026,1421
'29110, 동구,'80,75 - 79세,1998,1720,572,1148
'29110, 동구,'85,80 - 84세,1998,929,243,686
'29110, 동구,'90,85+ ,1998,640,115,525
'2911052500,  충장동,'00,계,1998,8548,4325,4223
'2911052500,  충장동,'05,0 - 4세,1998,359,190,169
'2911052500,  충장동,'10,5 - 9세,1998,427,207,220
'2911052500,  충장동,'15,10 - 14세,1998,453,229,224
'2911052500,  충장동,'20,15 - 19세,1998,873,444,429
'2911052500,  충장동,'25,20 - 24세,1998,936,507,429
'2911052500,  충장동,'30,25 - 29세,1998,886,514,372
'2911052500,  충장동,'35,30 - 34세,1998,538,284,254
'2911052500,  충장동,'40,35 - 39세,1998,570,274,296
'2911052500,  충장동,'45,40 - 44세,1998,670,320,350
'2911052500,  충장동,'50,45 - 49세,1998,625,303,322
'2911052500,  충장동,'55,50 - 54세,1998,643,278,365
'2911052500,  충장동,'60,55 - 59세,1998,587,310,277
'2911052500,  충장동,'65,60 - 64세,1998,358,195,163
'2911052500,  충장동,'70,65 - 69세,1998,233,111,122
'2911052500,  충장동,'75,70 - 74세,1998,173,81,92
'2911052500,  충장동,'80,75 - 79세,1998,120,47,73
'2911052500,  충장동,'85,80 - 84세,1998,57,21,36
'2911052500,  충장동,'90,85+ ,1998,40,10,30
'2911054500,  동명동,'00,계,1998,8060,3996,4064
'2911054500,  동명동,'05,0 - 4세,1998,356,191,165
'2911054500,  동명동,'10,5 - 9세,1998,376,193,183
'2911054500,  동명동,'15,10 - 14세,1998,432,248,184
'2911054500,  동명동,'20,15 - 19세,1998,862,442,420
'2911054500,  동명동,'25,20 - 24세,1998,1067,547,520
'2911054500,  동명동,'30,25 - 29세,1998,897,500,397
'2911054500,  동명동,'35,30 - 34세,1998,479,264,215
'2911054500,  동명동,'40,35 - 39세,1998,487,230,257
'2911054500,  동명동,'45,40 - 44세,1998,529,228,301
'2911054500,  동명동,'50,45 - 49세,1998,490,214,276
'2911054500,  동명동,'55,50 - 54세,1998,507,231,276
'2911054500,  동명동,'60,55 - 59세,1998,539,259,280
'2911054500,  동명동,'65,60 - 64세,1998,385,196,189
'2911054500,  동명동,'70,65 - 69세,1998,270,114,156
'2911054500,  동명동,'75,70 - 74세,1998,164,67,97
'2911054500,  동명동,'80,75 - 79세,1998,125,44,81
'2911054500,  동명동,'85,80 - 84세,1998,70,25,45
'2911054500,  동명동,'90,85+ ,1998,25,3,22
'2911056000,  계림1동,'00,계,1998,10049,4967,5082
'2911056000,  계림1동,'05,0 - 4세,1998,491,269,222
'2911056000,  계림1동,'10,5 - 9세,1998,544,270,274
'2911056000,  계림1동,'15,10 - 14세,1998,569,297,272
'2911056000,  계림1동,'20,15 - 19세,1998,1047,531,516
'2911056000,  계림1동,'25,20 - 24세,1998,1224,625,599
'2911056000,  계림1동,'30,25 - 29세,1998,1109,624,485
'2911056000,  계림1동,'35,30 - 34세,1998,627,343,284
'2911056000,  계림1동,'40,35 - 39세,1998,696,321,375
'2911056000,  계림1동,'45,40 - 44세,1998,731,341,390
'2911056000,  계림1동,'50,45 - 49세,1998,660,300,360
'2911056000,  계림1동,'55,50 - 54세,1998,672,314,358
'2911056000,  계림1동,'60,55 - 59세,1998,584,285,299
'2911056000,  계림1동,'65,60 - 64세,1998,415,194,221
'2911056000,  계림1동,'70,65 - 69세,1998,279,121,158
'2911056000,  계림1동,'75,70 - 74세,1998,169,66,103
'2911056000,  계림1동,'80,75 - 79세,1998,124,48,76
'2911056000,  계림1동,'85,80 - 84세,1998,68,15,53
'2911056000,  계림1동,'90,85+ ,1998,40,3,37
'2911057000,  계림2동,'00,계,1998,10956,5360,5596
'2911057000,  계림2동,'05,0 - 4세,1998,706,381,325
'2911057000,  계림2동,'10,5 - 9세,1998,742,395,347
'2911057000,  계림2동,'15,10 - 14세,1998,699,343,356
'2911057000,  계림2동,'20,15 - 19세,1998,1183,588,595
'2911057000,  계림2동,'25,20 - 24세,1998,1160,568,592
'2911057000,  계림2동,'30,25 - 29세,1998,1099,582,517
'2911057000,  계림2동,'35,30 - 34세,1998,801,417,384
'2911057000,  계림2동,'40,35 - 39세,1998,872,416,456
'2911057000,  계림2동,'45,40 - 44세,1998,788,364,424
'2911057000,  계림2동,'50,45 - 49세,1998,711,349,362
'2911057000,  계림2동,'55,50 - 54세,1998,585,275,310
'2911057000,  계림2동,'60,55 - 59세,1998,547,257,290
'2911057000,  계림2동,'65,60 - 64세,1998,403,184,219
'2911057000,  계림2동,'70,65 - 69세,1998,265,124,141
'2911057000,  계림2동,'75,70 - 74세,1998,168,66,102
'2911057000,  계림2동,'80,75 - 79세,1998,124,35,89
'2911057000,  계림2동,'85,80 - 84세,1998,67,10,57
'2911057000,  계림2동,'90,85+ ,1998,36,6,30
'2911059000,  산수1동,'00,계,1998,13004,6519,6485
'2911059000,  산수1동,'05,0 - 4세,1998,700,387,313
'2911059000,  산수1동,'10,5 - 9세,1998,649,330,319
'2911059000,  산수1동,'15,10 - 14세,1998,790,382,408
'2911059000,  산수1동,'20,15 - 19세,1998,1293,678,615
'2911059000,  산수1동,'25,20 - 24세,1998,1602,835,767
'2911059000,  산수1동,'30,25 - 29세,1998,1505,843,662
'2911059000,  산수1동,'35,30 - 34세,1998,895,503,392
'2911059000,  산수1동,'40,35 - 39세,1998,885,443,442
'2911059000,  산수1동,'45,40 - 44세,1998,866,408,458
'2911059000,  산수1동,'50,45 - 49세,1998,810,366,444
'2911059000,  산수1동,'55,50 - 54세,1998,814,387,427
'2911059000,  산수1동,'60,55 - 59세,1998,743,353,390
'2911059000,  산수1동,'65,60 - 64세,1998,552,275,277
'2911059000,  산수1동,'70,65 - 69세,1998,351,147,204
'2911059000,  산수1동,'75,70 - 74세,1998,234,97,137
'2911059000,  산수1동,'80,75 - 79세,1998,163,49,114
'2911059000,  산수1동,'85,80 - 84세,1998,85,23,62
'2911059000,  산수1동,'90,85+ ,1998,67,13,54
'2911060000,  산수2동,'00,계,1998,14440,7092,7348
'2911060000,  산수2동,'05,0 - 4세,1998,915,467,448
'2911060000,  산수2동,'10,5 - 9세,1998,890,483,407
'2911060000,  산수2동,'15,10 - 14세,1998,934,497,437
'2911060000,  산수2동,'20,15 - 19세,1998,1432,719,713
'2911060000,  산수2동,'25,20 - 24세,1998,1598,784,814
'2911060000,  산수2동,'30,25 - 29세,1998,1501,777,724
'2911060000,  산수2동,'35,30 - 34세,1998,1034,544,490
'2911060000,  산수2동,'40,35 - 39세,1998,1037,492,545
'2911060000,  산수2동,'45,40 - 44세,1998,994,457,537
'2911060000,  산수2동,'50,45 - 49세,1998,855,391,464
'2911060000,  산수2동,'55,50 - 54세,1998,849,392,457
'2911060000,  산수2동,'60,55 - 59세,1998,812,394,418
'2911060000,  산수2동,'65,60 - 64세,1998,610,306,304
'2911060000,  산수2동,'70,65 - 69세,1998,365,181,184
'2911060000,  산수2동,'75,70 - 74세,1998,270,111,159
'2911060000,  산수2동,'80,75 - 79세,1998,170,58,112
'2911060000,  산수2동,'85,80 - 84세,1998,94,27,67
'2911060000,  산수2동,'90,85+ ,1998,80,12,68
'2911062000,  지산1동,'00,계,1998,5029,2491,2538
'2911062000,  지산1동,'05,0 - 4세,1998,226,117,109
'2911062000,  지산1동,'10,5 - 9세,1998,216,122,94
'2911062000,  지산1동,'15,10 - 14세,1998,257,139,118
'2911062000,  지산1동,'20,15 - 19세,1998,527,263,264
'2911062000,  지산1동,'25,20 - 24세,1998,710,393,317
'2911062000,  지산1동,'30,25 - 29세,1998,624,339,285
'2911062000,  지산1동,'35,30 - 34세,1998,328,173,155
'2911062000,  지산1동,'40,35 - 39세,1998,268,119,149
'2911062000,  지산1동,'45,40 - 44세,1998,313,126,187
'2911062000,  지산1동,'50,45 - 49세,1998,311,137,174
'2911062000,  지산1동,'55,50 - 54세,1998,328,152,176
'2911062000,  지산1동,'60,55 - 59세,1998,318,145,173
'2911062000,  지산1동,'65,60 - 64세,1998,248,128,120
'2911062000,  지산1동,'70,65 - 69세,1998,147,61,86
'2911062000,  지산1동,'75,70 - 74세,1998,92,43,49
'2911062000,  지산1동,'80,75 - 79세,1998,61,26,35
'2911062000,  지산1동,'85,80 - 84세,1998,32,4,28
'2911062000,  지산1동,'90,85+ ,1998,23,4,19
'2911063000,  지산2동,'00,계,1998,9902,4854,5048
'2911063000,  지산2동,'05,0 - 4세,1998,550,278,272
'2911063000,  지산2동,'10,5 - 9세,1998,515,272,243
'2911063000,  지산2동,'15,10 - 14세,1998,665,337,328
'2911063000,  지산2동,'20,15 - 19세,1998,1052,519,533
'2911063000,  지산2동,'25,20 - 24세,1998,1204,621,583
'2911063000,  지산2동,'30,25 - 29세,1998,1114,609,505
'2911063000,  지산2동,'35,30 - 34세,1998,673,351,322
'2911063000,  지산2동,'40,35 - 39세,1998,686,313,373
'2911063000,  지산2동,'45,40 - 44세,1998,659,310,349
'2911063000,  지산2동,'50,45 - 49세,1998,584,255,329
'2911063000,  지산2동,'55,50 - 54세,1998,558,254,304
'2911063000,  지산2동,'60,55 - 59세,1998,578,290,288
'2911063000,  지산2동,'65,60 - 64세,1998,431,203,228
'2911063000,  지산2동,'70,65 - 69세,1998,256,125,131
'2911063000,  지산2동,'75,70 - 74세,1998,147,62,85
'2911063000,  지산2동,'80,75 - 79세,1998,114,32,82
'2911063000,  지산2동,'85,80 - 84세,1998,57,12,45
'2911063000,  지산2동,'90,85+ ,1998,59,11,48
'2911065500,  서남동,'00,계,1998,6702,3285,3417
'2911065500,  서남동,'05,0 - 4세,1998,265,124,141
'2911065500,  서남동,'10,5 - 9세,1998,356,194,162
'2911065500,  서남동,'15,10 - 14세,1998,425,212,213
'2911065500,  서남동,'20,15 - 19세,1998,690,345,345
'2911065500,  서남동,'25,20 - 24세,1998,799,402,397
'2911065500,  서남동,'30,25 - 29세,1998,679,403,276
'2911065500,  서남동,'35,30 - 34세,1998,434,227,207
'2911065500,  서남동,'40,35 - 39세,1998,488,243,245
'2911065500,  서남동,'45,40 - 44세,1998,470,217,253
'2911065500,  서남동,'50,45 - 49세,1998,406,177,229
'2911065500,  서남동,'55,50 - 54세,1998,435,196,239
'2911065500,  서남동,'60,55 - 59세,1998,404,183,221
'2911065500,  서남동,'65,60 - 64세,1998,304,133,171
'2911065500,  서남동,'70,65 - 69세,1998,229,112,117
'2911065500,  서남동,'75,70 - 74세,1998,137,58,79
'2911065500,  서남동,'80,75 - 79세,1998,105,41,64
'2911065500,  서남동,'85,80 - 84세,1998,51,13,38
'2911065500,  서남동,'90,85+ ,1998,25,5,20
'2911068000,  학1동,'00,계,1998,6437,3136,3301
'2911068000,  학1동,'05,0 - 4세,1998,314,146,168
'2911068000,  학1동,'10,5 - 9세,1998,268,140,128
'2911068000,  학1동,'15,10 - 14세,1998,353,185,168
'2911068000,  학1동,'20,15 - 19세,1998,635,337,298
'2911068000,  학1동,'25,20 - 24세,1998,824,437,387
'2911068000,  학1동,'30,25 - 29세,1998,661,365,296
'2911068000,  학1동,'35,30 - 34세,1998,366,206,160
'2911068000,  학1동,'40,35 - 39세,1998,433,220,213
'2911068000,  학1동,'45,40 - 44세,1998,454,213,241
'2911068000,  학1동,'50,45 - 49세,1998,409,181,228
'2911068000,  학1동,'55,50 - 54세,1998,402,171,231
'2911068000,  학1동,'60,55 - 59세,1998,392,190,202
'2911068000,  학1동,'65,60 - 64세,1998,319,123,196
'2911068000,  학1동,'70,65 - 69세,1998,221,90,131
'2911068000,  학1동,'75,70 - 74세,1998,151,73,78
'2911068000,  학1동,'80,75 - 79세,1998,115,33,82
'2911068000,  학1동,'85,80 - 84세,1998,70,18,52
'2911068000,  학1동,'90,85+ ,1998,50,8,42
'2911069000,  학2동,'00,계,1998,5281,2666,2615
'2911069000,  학2동,'05,0 - 4세,1998,303,161,142
'2911069000,  학2동,'10,5 - 9세,1998,275,154,121
'2911069000,  학2동,'15,10 - 14세,1998,306,160,146
'2911069000,  학2동,'20,15 - 19세,1998,576,304,272
'2911069000,  학2동,'25,20 - 24세,1998,616,295,321
'2911069000,  학2동,'30,25 - 29세,1998,572,331,241
'2911069000,  학2동,'35,30 - 34세,1998,391,241,150
'2911069000,  학2동,'40,35 - 39세,1998,392,200,192
'2911069000,  학2동,'45,40 - 44세,1998,370,167,203
'2911069000,  학2동,'50,45 - 49세,1998,298,163,135
'2911069000,  학2동,'55,50 - 54세,1998,284,127,157
'2911069000,  학2동,'60,55 - 59세,1998,276,114,162
'2911069000,  학2동,'65,60 - 64세,1998,241,105,136
'2911069000,  학2동,'70,65 - 69세,1998,156,65,91
'2911069000,  학2동,'75,70 - 74세,1998,114,48,66
'2911069000,  학2동,'80,75 - 79세,1998,63,20,43
'2911069000,  학2동,'85,80 - 84세,1998,27,7,20
'2911069000,  학2동,'90,85+ ,1998,21,4,17
'2911071000,  학운동,'00,계,1998,14441,7101,7340
'2911071000,  학운동,'05,0 - 4세,1998,853,417,436
'2911071000,  학운동,'10,5 - 9세,1998,923,474,449
'2911071000,  학운동,'15,10 - 14세,1998,1045,563,482
'2911071000,  학운동,'20,15 - 19세,1998,1470,767,703
'2911071000,  학운동,'25,20 - 24세,1998,1385,762,623
'2911071000,  학운동,'30,25 - 29세,1998,1308,658,650
'2911071000,  학운동,'35,30 - 34세,1998,969,469,500
'2911071000,  학운동,'40,35 - 39세,1998,1089,529,560
'2911071000,  학운동,'45,40 - 44세,1998,1105,533,572
'2911071000,  학운동,'50,45 - 49세,1998,910,396,514
'2911071000,  학운동,'55,50 - 54세,1998,843,397,446
'2911071000,  학운동,'60,55 - 59세,1998,797,361,436
'2911071000,  학운동,'65,60 - 64세,1998,616,334,282
'2911071000,  학운동,'70,65 - 69세,1998,454,202,252
'2911071000,  학운동,'75,70 - 74세,1998,293,119,174
'2911071000,  학운동,'80,75 - 79세,1998,205,68,137
'2911071000,  학운동,'85,80 - 84세,1998,105,39,66
'2911071000,  학운동,'90,85+ ,1998,71,13,58
'2911072000,  지원동,'00,계,1998,20228,10099,10129
'2911072000,  지원동,'05,0 - 4세,1998,1096,600,496
'2911072000,  지원동,'10,5 - 9세,1998,1335,698,637
'2911072000,  지원동,'15,10 - 14세,1998,1706,889,817
'2911072000,  지원동,'20,15 - 19세,1998,2299,1184,1115
'2911072000,  지원동,'25,20 - 24세,1998,2004,1027,977
'2911072000,  지원동,'30,25 - 29세,1998,1805,986,819
'2911072000,  지원동,'35,30 - 34세,1998,1429,720,709
'2911072000,  지원동,'40,35 - 39세,1998,1774,853,921
'2911072000,  지원동,'45,40 - 44세,1998,1535,725,810
'2911072000,  지원동,'50,45 - 49세,1998,1244,650,594
'2911072000,  지원동,'55,50 - 54세,1998,1010,469,541
'2911072000,  지원동,'60,55 - 59세,1998,988,508,480
'2911072000,  지원동,'65,60 - 64세,1998,708,337,371
'2911072000,  지원동,'70,65 - 69세,1998,480,195,285
'2911072000,  지원동,'75,70 - 74세,1998,335,135,200
'2911072000,  지원동,'80,75 - 79세,1998,231,71,160
'2911072000,  지원동,'85,80 - 84세,1998,146,29,117
'2911072000,  지원동,'90,85+ ,1998,103,23,80
'29140, 서구,'00,계,1998,248213,123238,124975
'29140, 서구,'05,0 - 4세,1998,19712,10316,9396
'29140, 서구,'10,5 - 9세,1998,19086,10064,9022
'29140, 서구,'15,10 - 14세,1998,19683,10332,9351
'29140, 서구,'20,15 - 19세,1998,25620,13302,12318
'29140, 서구,'25,20 - 24세,1998,22876,11558,11318
'29140, 서구,'30,25 - 29세,1998,23832,11919,11913
'29140, 서구,'35,30 - 34세,1998,22043,11182,10861
'29140, 서구,'40,35 - 39세,1998,23033,11070,11963
'29140, 서구,'45,40 - 44세,1998,19560,9602,9958
'29140, 서구,'50,45 - 49세,1998,13916,6888,7028
'29140, 서구,'55,50 - 54세,1998,10858,5483,5375
'29140, 서구,'60,55 - 59세,1998,9116,4466,4650
'29140, 서구,'65,60 - 64세,1998,6487,2964,3523
'29140, 서구,'70,65 - 69세,1998,4678,1795,2883
'29140, 서구,'75,70 - 74세,1998,3151,1113,2038
'29140, 서구,'80,75 - 79세,1998,2381,700,1681
'29140, 서구,'85,80 - 84세,1998,1310,340,970
'29140, 서구,'90,85+ ,1998,871,144,727
'2914057000,  양1동,'00,계,1998,3968,1954,2014
'2914057000,  양1동,'05,0 - 4세,1998,176,85,91
'2914057000,  양1동,'10,5 - 9세,1998,209,109,100
'2914057000,  양1동,'15,10 - 14세,1998,244,116,128
'2914057000,  양1동,'20,15 - 19세,1998,418,219,199
'2914057000,  양1동,'25,20 - 24세,1998,469,261,208
'2914057000,  양1동,'30,25 - 29세,1998,371,220,151
'2914057000,  양1동,'35,30 - 34세,1998,274,145,129
'2914057000,  양1동,'40,35 - 39세,1998,266,128,138
'2914057000,  양1동,'45,40 - 44세,1998,279,140,139
'2914057000,  양1동,'50,45 - 49세,1998,258,116,142
'2914057000,  양1동,'55,50 - 54세,1998,266,131,135
'2914057000,  양1동,'60,55 - 59세,1998,256,126,130
'2914057000,  양1동,'65,60 - 64세,1998,180,72,108
'2914057000,  양1동,'70,65 - 69세,1998,118,34,84
'2914057000,  양1동,'75,70 - 74세,1998,86,28,58
'2914057000,  양1동,'80,75 - 79세,1998,57,16,41
'2914057000,  양1동,'85,80 - 84세,1998,30,7,23
'2914057000,  양1동,'90,85+ ,1998,11,1,10
'2914058000,  양2동,'00,계,1998,5316,2652,2664
'2914058000,  양2동,'05,0 - 4세,1998,239,123,116
'2914058000,  양2동,'10,5 - 9세,1998,238,116,122
'2914058000,  양2동,'15,10 - 14세,1998,319,169,150
'2914058000,  양2동,'20,15 - 19세,1998,505,257,248
'2914058000,  양2동,'25,20 - 24세,1998,664,337,327
'2914058000,  양2동,'30,25 - 29세,1998,568,322,246
'2914058000,  양2동,'35,30 - 34세,1998,310,162,148
'2914058000,  양2동,'40,35 - 39세,1998,346,174,172
'2914058000,  양2동,'45,40 - 44세,1998,332,160,172
'2914058000,  양2동,'50,45 - 49세,1998,358,154,204
'2914058000,  양2동,'55,50 - 54세,1998,388,170,218
'2914058000,  양2동,'60,55 - 59세,1998,387,209,178
'2914058000,  양2동,'65,60 - 64세,1998,248,129,119
'2914058000,  양2동,'70,65 - 69세,1998,163,72,91
'2914058000,  양2동,'75,70 - 74세,1998,105,46,59
'2914058000,  양2동,'80,75 - 79세,1998,72,30,42
'2914058000,  양2동,'85,80 - 84세,1998,43,15,28
'2914058000,  양2동,'90,85+ ,1998,31,7,24
'2914059000,  양3동,'00,계,1998,7979,4106,3873
'2914059000,  양3동,'05,0 - 4세,1998,513,266,247
'2914059000,  양3동,'10,5 - 9세,1998,483,254,229
'2914059000,  양3동,'15,10 - 14세,1998,554,290,264
'2914059000,  양3동,'20,15 - 19세,1998,852,439,413
'2914059000,  양3동,'25,20 - 24세,1998,881,489,392
'2914059000,  양3동,'30,25 - 29세,1998,778,440,338
'2914059000,  양3동,'35,30 - 34세,1998,634,344,290
'2914059000,  양3동,'40,35 - 39세,1998,648,342,306
'2914059000,  양3동,'45,40 - 44세,1998,560,288,272
'2914059000,  양3동,'50,45 - 49세,1998,490,245,245
'2914059000,  양3동,'55,50 - 54세,1998,431,208,223
'2914059000,  양3동,'60,55 - 59세,1998,388,181,207
'2914059000,  양3동,'65,60 - 64세,1998,305,152,153
'2914059000,  양3동,'70,65 - 69세,1998,178,77,101
'2914059000,  양3동,'75,70 - 74세,1998,111,44,67
'2914059000,  양3동,'80,75 - 79세,1998,96,32,64
'2914059000,  양3동,'85,80 - 84세,1998,44,10,34
'2914059000,  양3동,'90,85+ ,1998,33,5,28
'2914065000,  농성1동,'00,계,1998,12710,6273,6437
'2914065000,  농성1동,'05,0 - 4세,1998,797,444,353
'2914065000,  농성1동,'10,5 - 9세,1998,644,322,322
'2914065000,  농성1동,'15,10 - 14세,1998,703,342,361
'2914065000,  농성1동,'20,15 - 19세,1998,1391,703,688
'2914065000,  농성1동,'25,20 - 24세,1998,1587,775,812
'2914065000,  농성1동,'30,25 - 29세,1998,1530,802,728
'2914065000,  농성1동,'35,30 - 34세,1998,901,498,403
'2914065000,  농성1동,'40,35 - 39세,1998,819,370,449
'2914065000,  농성1동,'45,40 - 44세,1998,925,427,498
'2914065000,  농성1동,'50,45 - 49세,1998,813,393,420
'2914065000,  농성1동,'55,50 - 54세,1998,756,363,393
'2914065000,  농성1동,'60,55 - 59세,1998,678,339,339
'2914065000,  농성1동,'65,60 - 64세,1998,439,235,204
'2914065000,  농성1동,'70,65 - 69세,1998,281,110,171
'2914065000,  농성1동,'75,70 - 74세,1998,203,91,112
'2914065000,  농성1동,'80,75 - 79세,1998,131,32,99
'2914065000,  농성1동,'85,80 - 84세,1998,63,21,42
'2914065000,  농성1동,'90,85+ ,1998,49,6,43
'2914066000,  농성2동,'00,계,1998,8864,4438,4426
'2914066000,  농성2동,'05,0 - 4세,1998,556,274,282
'2914066000,  농성2동,'10,5 - 9세,1998,481,266,215
'2914066000,  농성2동,'15,10 - 14세,1998,520,284,236
'2914066000,  농성2동,'20,15 - 19세,1998,990,524,466
'2914066000,  농성2동,'25,20 - 24세,1998,1099,559,540
'2914066000,  농성2동,'30,25 - 29세,1998,985,541,444
'2914066000,  농성2동,'35,30 - 34세,1998,623,322,301
'2914066000,  농성2동,'40,35 - 39세,1998,638,296,342
'2914066000,  농성2동,'45,40 - 44세,1998,608,262,346
'2914066000,  농성2동,'50,45 - 49세,1998,552,260,292
'2914066000,  농성2동,'55,50 - 54세,1998,522,262,260
'2914066000,  농성2동,'60,55 - 59세,1998,506,262,244
'2914066000,  농성2동,'65,60 - 64세,1998,277,149,128
'2914066000,  농성2동,'70,65 - 69세,1998,182,75,107
'2914066000,  농성2동,'75,70 - 74세,1998,134,51,83
'2914066000,  농성2동,'80,75 - 79세,1998,96,26,70
'2914066000,  농성2동,'85,80 - 84세,1998,51,17,34
'2914066000,  농성2동,'90,85+ ,1998,44,8,36
'2914073000,  광천동,'00,계,1998,11780,5913,5867
'2914073000,  광천동,'05,0 - 4세,1998,729,362,367
'2914073000,  광천동,'10,5 - 9세,1998,739,395,344
'2914073000,  광천동,'15,10 - 14세,1998,835,417,418
'2914073000,  광천동,'20,15 - 19세,1998,1217,578,639
'2914073000,  광천동,'25,20 - 24세,1998,1368,718,650
'2914073000,  광천동,'30,25 - 29세,1998,1283,737,546
'2914073000,  광천동,'35,30 - 34세,1998,906,485,421
'2914073000,  광천동,'40,35 - 39세,1998,900,455,445
'2914073000,  광천동,'45,40 - 44세,1998,780,377,403
'2914073000,  광천동,'50,45 - 49세,1998,647,323,324
'2914073000,  광천동,'55,50 - 54세,1998,644,299,345
'2914073000,  광천동,'60,55 - 59세,1998,603,326,277
'2914073000,  광천동,'65,60 - 64세,1998,433,195,238
'2914073000,  광천동,'70,65 - 69세,1998,269,126,143
'2914073000,  광천동,'75,70 - 74세,1998,181,57,124
'2914073000,  광천동,'80,75 - 79세,1998,128,39,89
'2914073000,  광천동,'85,80 - 84세,1998,71,18,53
'2914073000,  광천동,'90,85+ ,1998,47,6,41
'2914074000,  유덕동,'00,계,1998,6082,3146,2936
'2914074000,  유덕동,'05,0 - 4세,1998,435,222,213
'2914074000,  유덕동,'10,5 - 9세,1998,344,172,172
'2914074000,  유덕동,'15,10 - 14세,1998,383,186,197
'2914074000,  유덕동,'20,15 - 19세,1998,608,318,290
'2914074000,  유덕동,'25,20 - 24세,1998,624,354,270
'2914074000,  유덕동,'30,25 - 29세,1998,634,369,265
'2914074000,  유덕동,'35,30 - 34세,1998,512,305,207
'2914074000,  유덕동,'40,35 - 39세,1998,498,264,234
'2914074000,  유덕동,'45,40 - 44세,1998,390,205,185
'2914074000,  유덕동,'50,45 - 49세,1998,332,168,164
'2914074000,  유덕동,'55,50 - 54세,1998,309,161,148
'2914074000,  유덕동,'60,55 - 59세,1998,319,148,171
'2914074000,  유덕동,'65,60 - 64세,1998,254,120,134
'2914074000,  유덕동,'70,65 - 69세,1998,171,68,103
'2914074000,  유덕동,'75,70 - 74세,1998,108,39,69
'2914074000,  유덕동,'80,75 - 79세,1998,90,28,62
'2914074000,  유덕동,'85,80 - 84세,1998,43,10,33
'2914074000,  유덕동,'90,85+ ,1998,28,9,19
'2914075100,  상무1동,'00,계,1998,46266,22835,23431
'2914075100,  상무1동,'05,0 - 4세,1998,5496,2858,2638
'2914075100,  상무1동,'10,5 - 9세,1998,4284,2248,2036
'2914075100,  상무1동,'15,10 - 14세,1998,3353,1703,1650
'2914075100,  상무1동,'20,15 - 19세,1998,3687,1897,1790
'2914075100,  상무1동,'25,20 - 24세,1998,3307,1620,1687
'2914075100,  상무1동,'30,25 - 29세,1998,4922,2082,2840
'2914075100,  상무1동,'35,30 - 34세,1998,5778,3019,2759
'2914075100,  상무1동,'40,35 - 39세,1998,4752,2508,2244
'2914075100,  상무1동,'45,40 - 44세,1998,3166,1590,1576
'2914075100,  상무1동,'50,45 - 49세,1998,2027,1025,1002
'2914075100,  상무1동,'55,50 - 54세,1998,1552,732,820
'2914075100,  상무1동,'60,55 - 59세,1998,1300,611,689
'2914075100,  상무1동,'65,60 - 64세,1998,903,406,497
'2914075100,  상무1동,'70,65 - 69세,1998,662,256,406
'2914075100,  상무1동,'75,70 - 74세,1998,432,132,300
'2914075100,  상무1동,'80,75 - 79세,1998,337,100,237
'2914075100,  상무1동,'85,80 - 84세,1998,187,38,149
'2914075100,  상무1동,'90,85+ ,1998,121,10,111
'2914075200,  상무2동,'00,계,1998,32017,15812,16205
'2914075200,  상무2동,'05,0 - 4세,1998,2251,1169,1082
'2914075200,  상무2동,'10,5 - 9세,1998,2242,1206,1036
'2914075200,  상무2동,'15,10 - 14세,1998,2479,1338,1141
'2914075200,  상무2동,'20,15 - 19세,1998,3765,1933,1832
'2914075200,  상무2동,'25,20 - 24세,1998,3532,1823,1709
'2914075200,  상무2동,'30,25 - 29세,1998,3080,1579,1501
'2914075200,  상무2동,'35,30 - 34세,1998,2518,1275,1243
'2914075200,  상무2동,'40,35 - 39세,1998,2757,1271,1486
'2914075200,  상무2동,'45,40 - 44세,1998,2457,1156,1301
'2914075200,  상무2동,'50,45 - 49세,1998,1931,892,1039
'2914075200,  상무2동,'55,50 - 54세,1998,1551,744,807
'2914075200,  상무2동,'60,55 - 59세,1998,1264,612,652
'2914075200,  상무2동,'65,60 - 64세,1998,759,357,402
'2914075200,  상무2동,'70,65 - 69세,1998,571,229,342
'2914075200,  상무2동,'75,70 - 74세,1998,348,119,229
'2914075200,  상무2동,'80,75 - 79세,1998,263,65,198
'2914075200,  상무2동,'85,80 - 84세,1998,139,28,111
'2914075200,  상무2동,'90,85+ ,1998,110,16,94
'2914076000,  화정1동,'00,계,1998,15752,7853,7899
'2914076000,  화정1동,'05,0 - 4세,1998,983,544,439
'2914076000,  화정1동,'10,5 - 9세,1998,966,506,460
'2914076000,  화정1동,'15,10 - 14세,1998,1176,628,548
'2914076000,  화정1동,'20,15 - 19세,1998,1717,901,816
'2914076000,  화정1동,'25,20 - 24세,1998,1733,860,873
'2914076000,  화정1동,'30,25 - 29세,1998,1624,894,730
'2914076000,  화정1동,'35,30 - 34세,1998,1139,575,564
'2914076000,  화정1동,'40,35 - 39세,1998,1234,563,671
'2914076000,  화정1동,'45,40 - 44세,1998,1183,556,627
'2914076000,  화정1동,'50,45 - 49세,1998,997,443,554
'2914076000,  화정1동,'55,50 - 54세,1998,843,435,408
'2914076000,  화정1동,'60,55 - 59세,1998,671,334,337
'2914076000,  화정1동,'65,60 - 64세,1998,536,258,278
'2914076000,  화정1동,'70,65 - 69세,1998,365,151,214
'2914076000,  화정1동,'75,70 - 74세,1998,243,101,142
'2914076000,  화정1동,'80,75 - 79세,1998,172,55,117
'2914076000,  화정1동,'85,80 - 84세,1998,88,32,56
'2914076000,  화정1동,'90,85+ ,1998,82,17,65
'2914077000,  화정2동,'00,계,1998,23832,11828,12004
'2914077000,  화정2동,'05,0 - 4세,1998,1867,1016,851
'2914077000,  화정2동,'10,5 - 9세,1998,1869,981,888
'2914077000,  화정2동,'15,10 - 14세,1998,2134,1193,941
'2914077000,  화정2동,'20,15 - 19세,1998,2670,1456,1214
'2914077000,  화정2동,'25,20 - 24세,1998,2122,1027,1095
'2914077000,  화정2동,'30,25 - 29세,1998,2177,1072,1105
'2914077000,  화정2동,'35,30 - 34세,1998,2047,1010,1037
'2914077000,  화정2동,'40,35 - 39세,1998,2317,1067,1250
'2914077000,  화정2동,'45,40 - 44세,1998,2049,982,1067
'2914077000,  화정2동,'50,45 - 49세,1998,1440,715,725
'2914077000,  화정2동,'55,50 - 54세,1998,897,478,419
'2914077000,  화정2동,'60,55 - 59세,1998,673,324,349
'2914077000,  화정2동,'65,60 - 64세,1998,497,214,283
'2914077000,  화정2동,'70,65 - 69세,1998,382,113,269
'2914077000,  화정2동,'75,70 - 74세,1998,275,79,196
'2914077000,  화정2동,'80,75 - 79세,1998,216,55,161
'2914077000,  화정2동,'85,80 - 84세,1998,124,29,95
'2914077000,  화정2동,'90,85+ ,1998,76,17,59
'2914078000,  화정3동,'00,계,1998,16192,8062,8130
'2914078000,  화정3동,'05,0 - 4세,1998,1144,594,550
'2914078000,  화정3동,'10,5 - 9세,1998,1237,654,583
'2914078000,  화정3동,'15,10 - 14세,1998,1378,738,640
'2914078000,  화정3동,'20,15 - 19세,1998,1884,1031,853
'2914078000,  화정3동,'25,20 - 24세,1998,1501,738,763
'2914078000,  화정3동,'30,25 - 29세,1998,1471,756,715
'2914078000,  화정3동,'35,30 - 34세,1998,1286,654,632
'2914078000,  화정3동,'40,35 - 39세,1998,1415,638,777
'2914078000,  화정3동,'45,40 - 44세,1998,1418,670,748
'2914078000,  화정3동,'50,45 - 49세,1998,1031,491,540
'2914078000,  화정3동,'55,50 - 54세,1998,737,413,324
'2914078000,  화정3동,'60,55 - 59세,1998,508,264,244
'2914078000,  화정3동,'65,60 - 64세,1998,352,151,201
'2914078000,  화정3동,'70,65 - 69세,1998,298,108,190
'2914078000,  화정3동,'75,70 - 74세,1998,208,73,135
'2914078000,  화정3동,'80,75 - 79세,1998,171,53,118
'2914078000,  화정3동,'85,80 - 84세,1998,98,25,73
'2914078000,  화정3동,'90,85+ ,1998,55,11,44
'2914079000,  화정4동,'00,계,1998,26820,13198,13622
'2914079000,  화정4동,'05,0 - 4세,1998,2049,1032,1017
'2914079000,  화정4동,'10,5 - 9세,1998,2427,1302,1125
'2914079000,  화정4동,'15,10 - 14세,1998,2882,1520,1362
'2914079000,  화정4동,'20,15 - 19세,1998,3013,1594,1419
'2914079000,  화정4동,'25,20 - 24세,1998,1809,858,951
'2914079000,  화정4동,'30,25 - 29세,1998,2007,944,1063
'2914079000,  화정4동,'35,30 - 34세,1998,2245,1013,1232
'2914079000,  화정4동,'40,35 - 39세,1998,3036,1312,1724
'2914079000,  화정4동,'45,40 - 44세,1998,2895,1489,1406
'2914079000,  화정4동,'50,45 - 49세,1998,1529,859,670
'2914079000,  화정4동,'55,50 - 54세,1998,848,477,371
'2914079000,  화정4동,'60,55 - 59세,1998,576,279,297
'2914079000,  화정4동,'65,60 - 64세,1998,466,189,277
'2914079000,  화정4동,'70,65 - 69세,1998,384,131,253
'2914079000,  화정4동,'75,70 - 74세,1998,258,84,174
'2914079000,  화정4동,'80,75 - 79세,1998,210,60,150
'2914079000,  화정4동,'85,80 - 84세,1998,132,42,90
'2914079000,  화정4동,'90,85+ ,1998,54,13,41
'2914080000,  서창동,'00,계,1998,30635,15168,15467
'2914080000,  서창동,'05,0 - 4세,1998,2477,1327,1150
'2914080000,  서창동,'10,5 - 9세,1998,2923,1533,1390
'2914080000,  서창동,'15,10 - 14세,1998,2723,1408,1315
'2914080000,  서창동,'20,15 - 19세,1998,2903,1452,1451
'2914080000,  서창동,'25,20 - 24세,1998,2180,1139,1041
'2914080000,  서창동,'30,25 - 29세,1998,2402,1161,1241
'2914080000,  서창동,'35,30 - 34세,1998,2870,1375,1495
'2914080000,  서창동,'40,35 - 39세,1998,3407,1682,1725
'2914080000,  서창동,'45,40 - 44세,1998,2518,1300,1218
'2914080000,  서창동,'50,45 - 49세,1998,1511,804,707
'2914080000,  서창동,'55,50 - 54세,1998,1114,610,504
'2914080000,  서창동,'60,55 - 59세,1998,987,451,536
'2914080000,  서창동,'65,60 - 64세,1998,838,337,501
'2914080000,  서창동,'70,65 - 69세,1998,654,245,409
'2914080000,  서창동,'75,70 - 74세,1998,459,169,290
'2914080000,  서창동,'80,75 - 79세,1998,342,109,233
'2914080000,  서창동,'85,80 - 84세,1998,197,48,149
'2914080000,  서창동,'90,85+ ,1998,130,18,112
'29155, 남구,'00,계,1998,244382,119933,124449
'29155, 남구,'05,0 - 4세,1998,15745,8265,7480
'29155, 남구,'10,5 - 9세,1998,16767,8767,8000
'29155, 남구,'15,10 - 14세,1998,19075,9840,9235
'29155, 남구,'20,15 - 19세,1998,27995,14310,13685
'29155, 남구,'25,20 - 24세,1998,24954,12465,12489
'29155, 남구,'30,25 - 29세,1998,22695,11992,10703
'29155, 남구,'35,30 - 34세,1998,18155,9088,9067
'29155, 남구,'40,35 - 39세,1998,20688,9589,11099
'29155, 남구,'45,40 - 44세,1998,19501,9113,10388
'29155, 남구,'50,45 - 49세,1998,15022,7283,7739
'29155, 남구,'55,50 - 54세,1998,12234,6003,6231
'29155, 남구,'60,55 - 59세,1998,10350,5140,5210
'29155, 남구,'65,60 - 64세,1998,7391,3387,4004
'29155, 남구,'70,65 - 69세,1998,5137,2068,3069
'29155, 남구,'75,70 - 74세,1998,3524,1318,2206
'29155, 남구,'80,75 - 79세,1998,2701,771,1930
'29155, 남구,'85,80 - 84세,1998,1416,343,1073
'29155, 남구,'90,85+ ,1998,1032,191,841
'2915551000,  양림동,'00,계,1998,7885,3974,3911
'2915551000,  양림동,'05,0 - 4세,1998,400,221,179
'2915551000,  양림동,'10,5 - 9세,1998,456,256,200
'2915551000,  양림동,'15,10 - 14세,1998,453,260,193
'2915551000,  양림동,'20,15 - 19세,1998,775,396,379
'2915551000,  양림동,'25,20 - 24세,1998,890,455,435
'2915551000,  양림동,'30,25 - 29세,1998,843,501,342
'2915551000,  양림동,'35,30 - 34세,1998,549,291,258
'2915551000,  양림동,'40,35 - 39세,1998,558,289,269
'2915551000,  양림동,'45,40 - 44세,1998,474,222,252
'2915551000,  양림동,'50,45 - 49세,1998,519,228,291
'2915551000,  양림동,'55,50 - 54세,1998,510,228,282
'2915551000,  양림동,'60,55 - 59세,1998,470,231,239
'2915551000,  양림동,'65,60 - 64세,1998,365,156,209
'2915551000,  양림동,'70,65 - 69세,1998,216,98,118
'2915551000,  양림동,'75,70 - 74세,1998,168,72,96
'2915551000,  양림동,'80,75 - 79세,1998,131,43,88
'2915551000,  양림동,'85,80 - 84세,1998,60,16,44
'2915551000,  양림동,'90,85+ ,1998,48,11,37
'2915552000,  방림1동,'00,계,1998,6297,3084,3213
'2915552000,  방림1동,'05,0 - 4세,1998,321,167,154
'2915552000,  방림1동,'10,5 - 9세,1998,328,173,155
'2915552000,  방림1동,'15,10 - 14세,1998,401,189,212
'2915552000,  방림1동,'20,15 - 19세,1998,703,355,348
'2915552000,  방림1동,'25,20 - 24세,1998,775,395,380
'2915552000,  방림1동,'30,25 - 29세,1998,632,359,273
'2915552000,  방림1동,'35,30 - 34세,1998,456,243,213
'2915552000,  방림1동,'40,35 - 39세,1998,433,201,232
'2915552000,  방림1동,'45,40 - 44세,1998,426,198,228
'2915552000,  방림1동,'50,45 - 49세,1998,384,165,219
'2915552000,  방림1동,'55,50 - 54세,1998,383,188,195
'2915552000,  방림1동,'60,55 - 59세,1998,366,164,202
'2915552000,  방림1동,'65,60 - 64세,1998,262,128,134
'2915552000,  방림1동,'70,65 - 69세,1998,168,74,94
'2915552000,  방림1동,'75,70 - 74세,1998,112,46,66
'2915552000,  방림1동,'80,75 - 79세,1998,87,29,58
'2915552000,  방림1동,'85,80 - 84세,1998,44,9,35
'2915552000,  방림1동,'90,85+ ,1998,16,1,15
'2915553000,  방림2동,'00,계,1998,21584,10672,10912
'2915553000,  방림2동,'05,0 - 4세,1998,1255,653,602
'2915553000,  방림2동,'10,5 - 9세,1998,1297,690,607
'2915553000,  방림2동,'15,10 - 14세,1998,1578,831,747
'2915553000,  방림2동,'20,15 - 19세,1998,2553,1312,1241
'2915553000,  방림2동,'25,20 - 24세,1998,2409,1219,1190
'2915553000,  방림2동,'30,25 - 29세,1998,1943,1028,915
'2915553000,  방림2동,'35,30 - 34세,1998,1467,749,718
'2915553000,  방림2동,'40,35 - 39세,1998,1650,771,879
'2915553000,  방림2동,'45,40 - 44세,1998,1706,777,929
'2915553000,  방림2동,'50,45 - 49세,1998,1475,696,779
'2915553000,  방림2동,'55,50 - 54세,1998,1231,614,617
'2915553000,  방림2동,'60,55 - 59세,1998,1002,524,478
'2915553000,  방림2동,'65,60 - 64세,1998,707,344,363
'2915553000,  방림2동,'70,65 - 69세,1998,490,213,277
'2915553000,  방림2동,'75,70 - 74세,1998,334,117,217
'2915553000,  방림2동,'80,75 - 79세,1998,248,75,173
'2915553000,  방림2동,'85,80 - 84세,1998,149,43,106
'2915553000,  방림2동,'90,85+ ,1998,90,16,74
'2915553700,  봉선1동,'00,계,1998,15735,7554,8181
'2915553700,  봉선1동,'05,0 - 4세,1998,1273,664,609
'2915553700,  봉선1동,'10,5 - 9세,1998,1230,634,596
'2915553700,  봉선1동,'15,10 - 14세,1998,1255,666,589
'2915553700,  봉선1동,'20,15 - 19세,1998,1585,823,762
'2915553700,  봉선1동,'25,20 - 24세,1998,1344,657,687
'2915553700,  봉선1동,'30,25 - 29세,1998,1683,764,919
'2915553700,  봉선1동,'35,30 - 34세,1998,1439,700,739
'2915553700,  봉선1동,'40,35 - 39세,1998,1529,695,834
'2915553700,  봉선1동,'45,40 - 44세,1998,1277,594,683
'2915553700,  봉선1동,'50,45 - 49세,1998,874,425,449
'2915553700,  봉선1동,'55,50 - 54세,1998,561,272,289
'2915553700,  봉선1동,'60,55 - 59세,1998,507,236,271
'2915553700,  봉선1동,'65,60 - 64세,1998,386,161,225
'2915553700,  봉선1동,'70,65 - 69세,1998,294,115,179
'2915553700,  봉선1동,'75,70 - 74세,1998,208,74,134
'2915553700,  봉선1동,'80,75 - 79세,1998,166,46,120
'2915553700,  봉선1동,'85,80 - 84세,1998,69,18,51
'2915553700,  봉선1동,'90,85+ ,1998,55,10,45
'2915553800,  봉선2동,'00,계,1998,23394,11148,12246
'2915553800,  봉선2동,'05,0 - 4세,1998,1337,697,640
'2915553800,  봉선2동,'10,5 - 9세,1998,2107,1048,1059
'2915553800,  봉선2동,'15,10 - 14세,1998,2645,1372,1273
'2915553800,  봉선2동,'20,15 - 19세,1998,2929,1498,1431
'2915553800,  봉선2동,'25,20 - 24세,1998,1618,829,789
'2915553800,  봉선2동,'30,25 - 29세,1998,1235,618,617
'2915553800,  봉선2동,'35,30 - 34세,1998,1351,514,837
'2915553800,  봉선2동,'40,35 - 39세,1998,2603,1037,1566
'2915553800,  봉선2동,'45,40 - 44세,1998,2778,1333,1445
'2915553800,  봉선2동,'50,45 - 49세,1998,1593,866,727
'2915553800,  봉선2동,'55,50 - 54세,1998,899,460,439
'2915553800,  봉선2동,'60,55 - 59세,1998,617,288,329
'2915553800,  봉선2동,'65,60 - 64세,1998,495,209,286
'2915553800,  봉선2동,'70,65 - 69세,1998,439,148,291
'2915553800,  봉선2동,'75,70 - 74세,1998,320,121,199
'2915553800,  봉선2동,'80,75 - 79세,1998,215,63,152
'2915553800,  봉선2동,'85,80 - 84세,1998,108,25,83
'2915553800,  봉선2동,'90,85+ ,1998,105,22,83
'2915554500,  사직동,'00,계,1998,10143,5061,5082
'2915554500,  사직동,'05,0 - 4세,1998,539,289,250
'2915554500,  사직동,'10,5 - 9세,1998,608,320,288
'2915554500,  사직동,'15,10 - 14세,1998,691,343,348
'2915554500,  사직동,'20,15 - 19세,1998,964,522,442
'2915554500,  사직동,'25,20 - 24세,1998,1045,513,532
'2915554500,  사직동,'30,25 - 29세,1998,1024,588,436
'2915554500,  사직동,'35,30 - 34세,1998,769,415,354
'2915554500,  사직동,'40,35 - 39세,1998,807,388,419
'2915554500,  사직동,'45,40 - 44세,1998,736,382,354
'2915554500,  사직동,'50,45 - 49세,1998,571,269,302
'2915554500,  사직동,'55,50 - 54세,1998,587,264,323
'2915554500,  사직동,'60,55 - 59세,1998,599,273,326
'2915554500,  사직동,'65,60 - 64세,1998,425,193,232
'2915554500,  사직동,'70,65 - 69세,1998,311,137,174
'2915554500,  사직동,'75,70 - 74세,1998,197,79,118
'2915554500,  사직동,'80,75 - 79세,1998,150,54,96
'2915554500,  사직동,'85,80 - 84세,1998,73,26,47
'2915554500,  사직동,'90,85+ ,1998,47,6,41
'2915560000,  월산1동,'00,계,1998,4844,2379,2465
'2915560000,  월산1동,'05,0 - 4세,1998,255,123,132
'2915560000,  월산1동,'10,5 - 9세,1998,234,125,109
'2915560000,  월산1동,'15,10 - 14세,1998,299,147,152
'2915560000,  월산1동,'20,15 - 19세,1998,497,259,238
'2915560000,  월산1동,'25,20 - 24세,1998,546,271,275
'2915560000,  월산1동,'30,25 - 29세,1998,547,308,239
'2915560000,  월산1동,'35,30 - 34세,1998,357,183,174
'2915560000,  월산1동,'40,35 - 39세,1998,309,156,153
'2915560000,  월산1동,'45,40 - 44세,1998,349,149,200
'2915560000,  월산1동,'50,45 - 49세,1998,268,135,133
'2915560000,  월산1동,'55,50 - 54세,1998,300,127,173
'2915560000,  월산1동,'60,55 - 59세,1998,338,172,166
'2915560000,  월산1동,'65,60 - 64세,1998,236,103,133
'2915560000,  월산1동,'70,65 - 69세,1998,131,66,65
'2915560000,  월산1동,'75,70 - 74세,1998,81,30,51
'2915560000,  월산1동,'80,75 - 79세,1998,46,14,32
'2915560000,  월산1동,'85,80 - 84세,1998,29,6,23
'2915560000,  월산1동,'90,85+ ,1998,22,5,17
'2915561000,  월산2동,'00,계,1998,7560,3750,3810
'2915561000,  월산2동,'05,0 - 4세,1998,385,195,190
'2915561000,  월산2동,'10,5 - 9세,1998,403,211,192
'2915561000,  월산2동,'15,10 - 14세,1998,464,256,208
'2915561000,  월산2동,'20,15 - 19세,1998,923,457,466
'2915561000,  월산2동,'25,20 - 24세,1998,890,450,440
'2915561000,  월산2동,'30,25 - 29세,1998,804,450,354
'2915561000,  월산2동,'35,30 - 34세,1998,501,279,222
'2915561000,  월산2동,'40,35 - 39세,1998,537,266,271
'2915561000,  월산2동,'45,40 - 44세,1998,516,231,285
'2915561000,  월산2동,'50,45 - 49세,1998,487,228,259
'2915561000,  월산2동,'55,50 - 54세,1998,457,222,235
'2915561000,  월산2동,'60,55 - 59세,1998,419,205,214
'2915561000,  월산2동,'65,60 - 64세,1998,292,133,159
'2915561000,  월산2동,'70,65 - 69세,1998,187,78,109
'2915561000,  월산2동,'75,70 - 74세,1998,109,41,68
'2915561000,  월산2동,'80,75 - 79세,1998,102,31,71
'2915561000,  월산2동,'85,80 - 84세,1998,48,10,38
'2915561000,  월산2동,'90,85+ ,1998,36,7,29
'2915562000,  월산3동,'00,계,1998,5369,2621,2748
'2915562000,  월산3동,'05,0 - 4세,1998,242,132,110
'2915562000,  월산3동,'10,5 - 9세,1998,276,151,125
'2915562000,  월산3동,'15,10 - 14세,1998,365,178,187
'2915562000,  월산3동,'20,15 - 19세,1998,600,292,308
'2915562000,  월산3동,'25,20 - 24세,1998,685,346,339
'2915562000,  월산3동,'30,25 - 29세,1998,497,281,216
'2915562000,  월산3동,'35,30 - 34세,1998,303,167,136
'2915562000,  월산3동,'40,35 - 39세,1998,360,168,192
'2915562000,  월산3동,'45,40 - 44세,1998,351,166,185
'2915562000,  월산3동,'50,45 - 49세,1998,395,180,215
'2915562000,  월산3동,'55,50 - 54세,1998,389,178,211
'2915562000,  월산3동,'60,55 - 59세,1998,322,159,163
'2915562000,  월산3동,'65,60 - 64세,1998,229,108,121
'2915562000,  월산3동,'70,65 - 69세,1998,140,49,91
'2915562000,  월산3동,'75,70 - 74세,1998,82,28,54
'2915562000,  월산3동,'80,75 - 79세,1998,73,24,49
'2915562000,  월산3동,'85,80 - 84세,1998,36,9,27
'2915562000,  월산3동,'90,85+ ,1998,24,5,19
'2915563000,  월산4동,'00,계,1998,16159,8089,8070
'2915563000,  월산4동,'05,0 - 4세,1998,1152,594,558
'2915563000,  월산4동,'10,5 - 9세,1998,1002,506,496
'2915563000,  월산4동,'15,10 - 14세,1998,1012,540,472
'2915563000,  월산4동,'20,15 - 19세,1998,1814,983,831
'2915563000,  월산4동,'25,20 - 24세,1998,1942,958,984
'2915563000,  월산4동,'30,25 - 29세,1998,1902,1018,884
'2915563000,  월산4동,'35,30 - 34세,1998,1226,643,583
'2915563000,  월산4동,'40,35 - 39세,1998,1207,591,616
'2915563000,  월산4동,'45,40 - 44세,1998,1133,511,622
'2915563000,  월산4동,'50,45 - 49세,1998,984,460,524
'2915563000,  월산4동,'55,50 - 54세,1998,912,461,451
'2915563000,  월산4동,'60,55 - 59세,1998,688,378,310
'2915563000,  월산4동,'65,60 - 64세,1998,447,216,231
'2915563000,  월산4동,'70,65 - 69세,1998,248,101,147
'2915563000,  월산4동,'75,70 - 74세,1998,187,67,120
'2915563000,  월산4동,'80,75 - 79세,1998,151,33,118
'2915563000,  월산4동,'85,80 - 84세,1998,86,21,65
'2915563000,  월산4동,'90,85+ ,1998,66,8,58
'2915564000,  월산5동,'00,계,1998,12114,5967,6147
'2915564000,  월산5동,'05,0 - 4세,1998,840,450,390
'2915564000,  월산5동,'10,5 - 9세,1998,719,388,331
'2915564000,  월산5동,'15,10 - 14세,1998,806,400,406
'2915564000,  월산5동,'20,15 - 19세,1998,1439,740,699
'2915564000,  월산5동,'25,20 - 24세,1998,1455,696,759
'2915564000,  월산5동,'30,25 - 29세,1998,1326,681,645
'2915564000,  월산5동,'35,30 - 34세,1998,951,516,435
'2915564000,  월산5동,'40,35 - 39세,1998,902,423,479
'2915564000,  월산5동,'45,40 - 44세,1998,898,400,498
'2915564000,  월산5동,'50,45 - 49세,1998,760,355,405
'2915564000,  월산5동,'55,50 - 54세,1998,655,322,333
'2915564000,  월산5동,'60,55 - 59세,1998,495,260,235
'2915564000,  월산5동,'65,60 - 64세,1998,300,145,155
'2915564000,  월산5동,'70,65 - 69세,1998,198,76,122
'2915564000,  월산5동,'75,70 - 74세,1998,152,62,90
'2915564000,  월산5동,'80,75 - 79세,1998,120,35,85
'2915564000,  월산5동,'85,80 - 84세,1998,65,12,53
'2915564000,  월산5동,'90,85+ ,1998,33,6,27
'2915567000,  백운1동,'00,계,1998,13166,6476,6690
'2915567000,  백운1동,'05,0 - 4세,1998,838,454,384
'2915567000,  백운1동,'10,5 - 9세,1998,862,423,439
'2915567000,  백운1동,'15,10 - 14세,1998,933,469,464
'2915567000,  백운1동,'20,15 - 19세,1998,1471,733,738
'2915567000,  백운1동,'25,20 - 24세,1998,1360,701,659
'2915567000,  백운1동,'30,25 - 29세,1998,1262,680,582
'2915567000,  백운1동,'35,30 - 34세,1998,930,489,441
'2915567000,  백운1동,'40,35 - 39세,1998,1046,461,585
'2915567000,  백운1동,'45,40 - 44세,1998,1030,516,514
'2915567000,  백운1동,'50,45 - 49세,1998,827,390,437
'2915567000,  백운1동,'55,50 - 54세,1998,710,341,369
'2915567000,  백운1동,'60,55 - 59세,1998,618,310,308
'2915567000,  백운1동,'65,60 - 64세,1998,466,234,232
'2915567000,  백운1동,'70,65 - 69세,1998,297,118,179
'2915567000,  백운1동,'75,70 - 74세,1998,213,82,131
'2915567000,  백운1동,'80,75 - 79세,1998,155,48,107
'2915567000,  백운1동,'85,80 - 84세,1998,88,13,75
'2915567000,  백운1동,'90,85+ ,1998,60,14,46
'2915568000,  백운2동,'00,계,1998,9471,4690,4781
'2915568000,  백운2동,'05,0 - 4세,1998,558,295,263
'2915568000,  백운2동,'10,5 - 9세,1998,527,275,252
'2915568000,  백운2동,'15,10 - 14세,1998,616,298,318
'2915568000,  백운2동,'20,15 - 19세,1998,1116,578,538
'2915568000,  백운2동,'25,20 - 24세,1998,1128,590,538
'2915568000,  백운2동,'30,25 - 29세,1998,1034,576,458
'2915568000,  백운2동,'35,30 - 34세,1998,659,355,304
'2915568000,  백운2동,'40,35 - 39세,1998,663,310,353
'2915568000,  백운2동,'45,40 - 44세,1998,668,293,375
'2915568000,  백운2동,'50,45 - 49세,1998,601,278,323
'2915568000,  백운2동,'55,50 - 54세,1998,557,255,302
'2915568000,  백운2동,'60,55 - 59세,1998,505,265,240
'2915568000,  백운2동,'65,60 - 64세,1998,327,148,179
'2915568000,  백운2동,'70,65 - 69세,1998,183,83,100
'2915568000,  백운2동,'75,70 - 74세,1998,131,48,83
'2915568000,  백운2동,'80,75 - 79세,1998,105,20,85
'2915568000,  백운2동,'85,80 - 84세,1998,60,15,45
'2915568000,  백운2동,'90,85+ ,1998,33,8,25
'2915569000,  주월1동,'00,계,1998,30554,15070,15484
'2915569000,  주월1동,'05,0 - 4세,1998,2196,1162,1034
'2915569000,  주월1동,'10,5 - 9세,1998,2351,1262,1089
'2915569000,  주월1동,'15,10 - 14세,1998,2388,1255,1133
'2915569000,  주월1동,'20,15 - 19세,1998,3670,1839,1831
'2915569000,  주월1동,'25,20 - 24세,1998,3258,1630,1628
'2915569000,  주월1동,'30,25 - 29세,1998,2830,1473,1357
'2915569000,  주월1동,'35,30 - 34세,1998,2486,1216,1270
'2915569000,  주월1동,'40,35 - 39세,1998,2757,1328,1429
'2915569000,  주월1동,'45,40 - 44세,1998,2452,1091,1361
'2915569000,  주월1동,'50,45 - 49세,1998,1760,847,913
'2915569000,  주월1동,'55,50 - 54세,1998,1364,692,672
'2915569000,  주월1동,'60,55 - 59세,1998,1015,524,491
'2915569000,  주월1동,'65,60 - 64세,1998,695,323,372
'2915569000,  주월1동,'70,65 - 69세,1998,492,187,305
'2915569000,  주월1동,'75,70 - 74세,1998,328,118,210
'2915569000,  주월1동,'80,75 - 79세,1998,260,66,194
'2915569000,  주월1동,'85,80 - 84세,1998,147,39,108
'2915569000,  주월1동,'90,85+ ,1998,105,18,87
'2915570000,  주월2동,'00,계,1998,13815,6788,7027
'2915570000,  주월2동,'05,0 - 4세,1998,1048,541,507
'2915570000,  주월2동,'10,5 - 9세,1998,1020,537,483
'2915570000,  주월2동,'15,10 - 14세,1998,1114,562,552
'2915570000,  주월2동,'20,15 - 19세,1998,1617,832,785
'2915570000,  주월2동,'25,20 - 24세,1998,1407,651,756
'2915570000,  주월2동,'30,25 - 29세,1998,1355,693,662
'2915570000,  주월2동,'35,30 - 34세,1998,1165,575,590
'2915570000,  주월2동,'40,35 - 39세,1998,1216,575,641
'2915570000,  주월2동,'45,40 - 44세,1998,1076,509,567
'2915570000,  주월2동,'50,45 - 49세,1998,813,425,388
'2915570000,  주월2동,'55,50 - 54세,1998,673,350,323
'2915570000,  주월2동,'60,55 - 59세,1998,444,228,216
'2915570000,  주월2동,'65,60 - 64세,1998,288,132,156
'2915570000,  주월2동,'70,65 - 69세,1998,235,82,153
'2915570000,  주월2동,'75,70 - 74세,1998,135,51,84
'2915570000,  주월2동,'80,75 - 79세,1998,107,26,81
'2915570000,  주월2동,'85,80 - 84세,1998,57,11,46
'2915570000,  주월2동,'90,85+ ,1998,45,8,37
'2915571000,  효덕동,'00,계,1998,29891,14462,15429
'2915571000,  효덕동,'05,0 - 4세,1998,2067,1089,978
'2915571000,  효덕동,'10,5 - 9세,1998,2294,1192,1102
'2915571000,  효덕동,'15,10 - 14세,1998,2910,1503,1407
'2915571000,  효덕동,'20,15 - 19세,1998,3709,1823,1886
'2915571000,  효덕동,'25,20 - 24세,1998,2690,1326,1364
'2915571000,  효덕동,'30,25 - 29세,1998,2354,1189,1165
'2915571000,  효덕동,'35,30 - 34세,1998,2334,1108,1226
'2915571000,  효덕동,'40,35 - 39세,1998,2784,1237,1547
'2915571000,  효덕동,'45,40 - 44세,1998,2480,1146,1334
'2915571000,  효덕동,'50,45 - 49세,1998,1815,891,924
'2915571000,  효덕동,'55,50 - 54세,1998,1240,617,623
'2915571000,  효덕동,'60,55 - 59세,1998,1064,533,531
'2915571000,  효덕동,'65,60 - 64세,1998,708,332,376
'2915571000,  효덕동,'70,65 - 69세,1998,540,217,323
'2915571000,  효덕동,'75,70 - 74세,1998,367,127,240
'2915571000,  효덕동,'80,75 - 79세,1998,274,76,198
'2915571000,  효덕동,'85,80 - 84세,1998,148,33,115
'2915571000,  효덕동,'90,85+ ,1998,113,23,90
'2915572000,  송암동,'00,계,1998,8082,3991,4091
'2915572000,  송암동,'05,0 - 4세,1998,634,332,302
'2915572000,  송암동,'10,5 - 9세,1998,646,366,280
'2915572000,  송암동,'15,10 - 14세,1998,709,354,355
'2915572000,  송암동,'20,15 - 19세,1998,849,465,384
'2915572000,  송암동,'25,20 - 24세,1998,648,328,320
'2915572000,  송암동,'30,25 - 29세,1998,683,318,365
'2915572000,  송암동,'35,30 - 34세,1998,766,376,390
'2915572000,  송암동,'40,35 - 39세,1998,804,390,414
'2915572000,  송암동,'45,40 - 44세,1998,647,315,332
'2915572000,  송암동,'50,45 - 49세,1998,418,209,209
'2915572000,  송암동,'55,50 - 54세,1998,323,172,151
'2915572000,  송암동,'60,55 - 59세,1998,291,139,152
'2915572000,  송암동,'65,60 - 64세,1998,196,88,108
'2915572000,  송암동,'70,65 - 69세,1998,145,52,93
'2915572000,  송암동,'75,70 - 74세,1998,134,51,83
'2915572000,  송암동,'80,75 - 79세,1998,86,18,68
'2915572000,  송암동,'85,80 - 84세,1998,47,8,39
'2915572000,  송암동,'90,85+ ,1998,56,10,46
'2915573000,  대촌동,'00,계,1998,8319,4157,4162
'2915573000,  대촌동,'05,0 - 4세,1998,405,207,198
'2915573000,  대촌동,'10,5 - 9세,1998,407,210,197
'2915573000,  대촌동,'15,10 - 14세,1998,436,217,219
'2915573000,  대촌동,'20,15 - 19세,1998,781,403,378
'2915573000,  대촌동,'25,20 - 24세,1998,864,450,414
'2915573000,  대촌동,'30,25 - 29세,1998,741,467,274
'2915573000,  대촌동,'35,30 - 34세,1998,446,269,177
'2915573000,  대촌동,'40,35 - 39세,1998,523,303,220
'2915573000,  대촌동,'45,40 - 44세,1998,504,280,224
'2915573000,  대촌동,'50,45 - 49세,1998,478,236,242
'2915573000,  대촌동,'55,50 - 54세,1998,483,240,243
'2915573000,  대촌동,'60,55 - 59세,1998,590,251,339
'2915573000,  대촌동,'65,60 - 64세,1998,567,234,333
'2915573000,  대촌동,'70,65 - 69세,1998,423,174,249
'2915573000,  대촌동,'75,70 - 74세,1998,266,104,162
'2915573000,  대촌동,'80,75 - 79세,1998,225,70,155
'2915573000,  대촌동,'85,80 - 84세,1998,102,29,73
'2915573000,  대촌동,'90,85+ ,1998,78,13,65
'29170, 북구,'00,계,1998,473148,234738,238410
'29170, 북구,'05,0 - 4세,1998,38745,20120,18625
'29170, 북구,'10,5 - 9세,1998,37763,19774,17989
'29170, 북구,'15,10 - 14세,1998,35869,18619,17250
'29170, 북구,'20,15 - 19세,1998,47355,24453,22902
'29170, 북구,'25,20 - 24세,1998,44726,22543,22183
'29170, 북구,'30,25 - 29세,1998,48176,23949,24227
'29170, 북구,'35,30 - 34세,1998,44097,22342,21755
'29170, 북구,'40,35 - 39세,1998,44336,21975,22361
'29170, 북구,'45,40 - 44세,1998,35537,17376,18161
'29170, 북구,'50,45 - 49세,1998,25372,12543,12829
'29170, 북구,'55,50 - 54세,1998,19955,9832,10123
'29170, 북구,'60,55 - 59세,1998,17107,8297,8810
'29170, 북구,'65,60 - 64세,1998,12322,5655,6667
'29170, 북구,'70,65 - 69세,1998,8173,3251,4922
'29170, 북구,'75,70 - 74세,1998,5667,2049,3618
'29170, 북구,'80,75 - 79세,1998,4084,1190,2894
'29170, 북구,'85,80 - 84세,1998,2268,520,1748
'29170, 북구,'90,85+ ,1998,1596,250,1346
'2917051000,  중흥1동,'00,계,1998,7029,3627,3402
'2917051000,  중흥1동,'05,0 - 4세,1998,375,196,179
'2917051000,  중흥1동,'10,5 - 9세,1998,370,201,169
'2917051000,  중흥1동,'15,10 - 14세,1998,435,218,217
'2917051000,  중흥1동,'20,15 - 19세,1998,656,345,311
'2917051000,  중흥1동,'25,20 - 24세,1998,913,500,413
'2917051000,  중흥1동,'30,25 - 29세,1998,763,434,329
'2917051000,  중흥1동,'35,30 - 34세,1998,498,291,207
'2917051000,  중흥1동,'40,35 - 39세,1998,508,257,251
'2917051000,  중흥1동,'45,40 - 44세,1998,466,218,248
'2917051000,  중흥1동,'50,45 - 49세,1998,441,215,226
'2917051000,  중흥1동,'55,50 - 54세,1998,437,216,221
'2917051000,  중흥1동,'60,55 - 59세,1998,451,211,240
'2917051000,  중흥1동,'65,60 - 64세,1998,303,167,136
'2917051000,  중흥1동,'70,65 - 69세,1998,158,68,90
'2917051000,  중흥1동,'75,70 - 74세,1998,101,46,55
'2917051000,  중흥1동,'80,75 - 79세,1998,78,27,51
'2917051000,  중흥1동,'85,80 - 84세,1998,48,12,36
'2917051000,  중흥1동,'90,85+ ,1998,28,5,23
'2917052000,  중흥2동,'00,계,1998,13754,6817,6937
'2917052000,  중흥2동,'05,0 - 4세,1998,835,446,389
'2917052000,  중흥2동,'10,5 - 9세,1998,706,376,330
'2917052000,  중흥2동,'15,10 - 14세,1998,843,429,414
'2917052000,  중흥2동,'20,15 - 19세,1998,1440,728,712
'2917052000,  중흥2동,'25,20 - 24세,1998,1910,942,968
'2917052000,  중흥2동,'30,25 - 29세,1998,1644,911,733
'2917052000,  중흥2동,'35,30 - 34세,1998,904,484,420
'2917052000,  중흥2동,'40,35 - 39세,1998,892,424,468
'2917052000,  중흥2동,'45,40 - 44세,1998,848,384,464
'2917052000,  중흥2동,'50,45 - 49세,1998,885,392,493
'2917052000,  중흥2동,'55,50 - 54세,1998,839,391,448
'2917052000,  중흥2동,'60,55 - 59세,1998,774,385,389
'2917052000,  중흥2동,'65,60 - 64세,1998,506,267,239
'2917052000,  중흥2동,'70,65 - 69세,1998,274,130,144
'2917052000,  중흥2동,'75,70 - 74세,1998,204,86,118
'2917052000,  중흥2동,'80,75 - 79세,1998,120,23,97
'2917052000,  중흥2동,'85,80 - 84세,1998,75,15,60
'2917052000,  중흥2동,'90,85+ ,1998,55,4,51
'2917053000,  중흥3동,'00,계,1998,10330,5090,5240
'2917053000,  중흥3동,'05,0 - 4세,1998,575,285,290
'2917053000,  중흥3동,'10,5 - 9세,1998,541,290,251
'2917053000,  중흥3동,'15,10 - 14세,1998,597,310,287
'2917053000,  중흥3동,'20,15 - 19세,1998,1116,581,535
'2917053000,  중흥3동,'25,20 - 24세,1998,1353,664,689
'2917053000,  중흥3동,'30,25 - 29세,1998,1199,651,548
'2917053000,  중흥3동,'35,30 - 34세,1998,740,398,342
'2917053000,  중흥3동,'40,35 - 39세,1998,705,334,371
'2917053000,  중흥3동,'45,40 - 44세,1998,674,310,364
'2917053000,  중흥3동,'50,45 - 49세,1998,633,286,347
'2917053000,  중흥3동,'55,50 - 54세,1998,593,260,333
'2917053000,  중흥3동,'60,55 - 59세,1998,574,290,284
'2917053000,  중흥3동,'65,60 - 64세,1998,421,207,214
'2917053000,  중흥3동,'70,65 - 69세,1998,221,105,116
'2917053000,  중흥3동,'75,70 - 74세,1998,164,58,106
'2917053000,  중흥3동,'80,75 - 79세,1998,111,35,76
'2917053000,  중흥3동,'85,80 - 84세,1998,64,21,43
'2917053000,  중흥3동,'90,85+ ,1998,49,5,44
'2917055500,  중앙동,'00,계,1998,7211,3656,3555
'2917055500,  중앙동,'05,0 - 4세,1998,334,187,147
'2917055500,  중앙동,'10,5 - 9세,1998,426,240,186
'2917055500,  중앙동,'15,10 - 14세,1998,452,220,232
'2917055500,  중앙동,'20,15 - 19세,1998,733,381,352
'2917055500,  중앙동,'25,20 - 24세,1998,733,390,343
'2917055500,  중앙동,'30,25 - 29세,1998,678,388,290
'2917055500,  중앙동,'35,30 - 34세,1998,486,260,226
'2917055500,  중앙동,'40,35 - 39세,1998,582,301,281
'2917055500,  중앙동,'45,40 - 44세,1998,546,275,271
'2917055500,  중앙동,'50,45 - 49세,1998,481,225,256
'2917055500,  중앙동,'55,50 - 54세,1998,448,200,248
'2917055500,  중앙동,'60,55 - 59세,1998,427,215,212
'2917055500,  중앙동,'65,60 - 64세,1998,315,148,167
'2917055500,  중앙동,'70,65 - 69세,1998,222,111,111
'2917055500,  중앙동,'75,70 - 74세,1998,148,58,90
'2917055500,  중앙동,'80,75 - 79세,1998,103,36,67
'2917055500,  중앙동,'85,80 - 84세,1998,60,15,45
'2917055500,  중앙동,'90,85+ ,1998,37,6,31
'2917057000,  임동,'00,계,1998,11967,6067,5900
'2917057000,  임동,'05,0 - 4세,1998,671,364,307
'2917057000,  임동,'10,5 - 9세,1998,729,380,349
'2917057000,  임동,'15,10 - 14세,1998,781,403,378
'2917057000,  임동,'20,15 - 19세,1998,1242,658,584
'2917057000,  임동,'25,20 - 24세,1998,1454,750,704
'2917057000,  임동,'30,25 - 29세,1998,1249,671,578
'2917057000,  임동,'35,30 - 34세,1998,894,496,398
'2917057000,  임동,'40,35 - 39세,1998,901,452,449
'2917057000,  임동,'45,40 - 44세,1998,818,390,428
'2917057000,  임동,'50,45 - 49세,1998,720,342,378
'2917057000,  임동,'55,50 - 54세,1998,702,346,356
'2917057000,  임동,'60,55 - 59세,1998,661,349,312
'2917057000,  임동,'65,60 - 64세,1998,430,225,205
'2917057000,  임동,'70,65 - 69세,1998,283,111,172
'2917057000,  임동,'75,70 - 74세,1998,183,80,103
'2917057000,  임동,'80,75 - 79세,1998,134,27,107
'2917057000,  임동,'85,80 - 84세,1998,64,14,50
'2917057000,  임동,'90,85+ ,1998,51,9,42
'2917058000,  신안동,'00,계,1998,16652,8456,8196
'2917058000,  신안동,'05,0 - 4세,1998,1009,529,480
'2917058000,  신안동,'10,5 - 9세,1998,968,535,433
'2917058000,  신안동,'15,10 - 14세,1998,1053,552,501
'2917058000,  신안동,'20,15 - 19세,1998,1781,914,867
'2917058000,  신안동,'25,20 - 24세,1998,1999,1004,995
'2917058000,  신안동,'30,25 - 29세,1998,1944,1105,839
'2917058000,  신안동,'35,30 - 34세,1998,1297,719,578
'2917058000,  신안동,'40,35 - 39세,1998,1263,628,635
'2917058000,  신안동,'45,40 - 44세,1998,1139,549,590
'2917058000,  신안동,'50,45 - 49세,1998,982,451,531
'2917058000,  신안동,'55,50 - 54세,1998,911,423,488
'2917058000,  신안동,'60,55 - 59세,1998,848,439,409
'2917058000,  신안동,'65,60 - 64세,1998,592,301,291
'2917058000,  신안동,'70,65 - 69세,1998,352,169,183
'2917058000,  신안동,'75,70 - 74세,1998,184,72,112
'2917058000,  신안동,'80,75 - 79세,1998,153,40,113
'2917058000,  신안동,'85,80 - 84세,1998,103,16,87
'2917058000,  신안동,'90,85+ ,1998,74,10,64
'2917059000,  용봉동,'00,계,1998,29866,15009,14857
'2917059000,  용봉동,'05,0 - 4세,1998,2404,1233,1171
'2917059000,  용봉동,'10,5 - 9세,1998,2176,1151,1025
'2917059000,  용봉동,'15,10 - 14세,1998,2103,1087,1016
'2917059000,  용봉동,'20,15 - 19세,1998,2938,1536,1402
'2917059000,  용봉동,'25,20 - 24세,1998,3210,1639,1571
'2917059000,  용봉동,'30,25 - 29세,1998,3270,1706,1564
'2917059000,  용봉동,'35,30 - 34세,1998,2701,1398,1303
'2917059000,  용봉동,'40,35 - 39세,1998,2651,1329,1322
'2917059000,  용봉동,'45,40 - 44세,1998,2140,1062,1078
'2917059000,  용봉동,'50,45 - 49세,1998,1655,800,855
'2917059000,  용봉동,'55,50 - 54세,1998,1424,702,722
'2917059000,  용봉동,'60,55 - 59세,1998,1171,567,604
'2917059000,  용봉동,'65,60 - 64세,1998,792,394,398
'2917059000,  용봉동,'70,65 - 69세,1998,465,199,266
'2917059000,  용봉동,'75,70 - 74세,1998,319,129,190
'2917059000,  용봉동,'80,75 - 79세,1998,201,41,160
'2917059000,  용봉동,'85,80 - 84세,1998,140,25,115
'2917059000,  용봉동,'90,85+ ,1998,106,11,95
'2917060100,  운암1동,'00,계,1998,17508,8651,8857
'2917060100,  운암1동,'05,0 - 4세,1998,1227,649,578
'2917060100,  운암1동,'10,5 - 9세,1998,1186,625,561
'2917060100,  운암1동,'15,10 - 14세,1998,1411,769,642
'2917060100,  운암1동,'20,15 - 19세,1998,2164,1115,1049
'2917060100,  운암1동,'25,20 - 24세,1998,1885,924,961
'2917060100,  운암1동,'30,25 - 29세,1998,1637,831,806
'2917060100,  운암1동,'35,30 - 34세,1998,1343,651,692
'2917060100,  운암1동,'40,35 - 39세,1998,1519,721,798
'2917060100,  운암1동,'45,40 - 44세,1998,1581,724,857
'2917060100,  운암1동,'50,45 - 49세,1998,1137,583,554
'2917060100,  운암1동,'55,50 - 54세,1998,706,379,327
'2917060100,  운암1동,'60,55 - 59세,1998,552,265,287
'2917060100,  운암1동,'65,60 - 64세,1998,354,156,198
'2917060100,  운암1동,'70,65 - 69세,1998,275,99,176
'2917060100,  운암1동,'75,70 - 74세,1998,233,72,161
'2917060100,  운암1동,'80,75 - 79세,1998,163,48,115
'2917060100,  운암1동,'85,80 - 84세,1998,92,28,64
'2917060100,  운암1동,'90,85+ ,1998,43,12,31
'2917060200,  운암2동,'00,계,1998,22608,11230,11378
'2917060200,  운암2동,'05,0 - 4세,1998,1275,653,622
'2917060200,  운암2동,'10,5 - 9세,1998,1442,770,672
'2917060200,  운암2동,'15,10 - 14세,1998,1602,829,773
'2917060200,  운암2동,'20,15 - 19세,1998,2853,1451,1402
'2917060200,  운암2동,'25,20 - 24세,1998,2842,1443,1399
'2917060200,  운암2동,'30,25 - 29세,1998,2170,1222,948
'2917060200,  운암2동,'35,30 - 34세,1998,1589,818,771
'2917060200,  운암2동,'40,35 - 39세,1998,1770,820,950
'2917060200,  운암2동,'45,40 - 44세,1998,1811,781,1030
'2917060200,  운암2동,'50,45 - 49세,1998,1468,706,762
'2917060200,  운암2동,'55,50 - 54세,1998,1188,588,600
'2917060200,  운암2동,'60,55 - 59세,1998,943,503,440
'2917060200,  운암2동,'65,60 - 64세,1998,625,297,328
'2917060200,  운암2동,'70,65 - 69세,1998,372,166,206
'2917060200,  운암2동,'75,70 - 74세,1998,256,88,168
'2917060200,  운암2동,'80,75 - 79세,1998,205,57,148
'2917060200,  운암2동,'85,80 - 84세,1998,110,22,88
'2917060200,  운암2동,'90,85+ ,1998,87,16,71
'2917060300,  운암3동,'00,계,1998,19711,9666,10045
'2917060300,  운암3동,'05,0 - 4세,1998,1401,718,683
'2917060300,  운암3동,'10,5 - 9세,1998,1704,916,788
'2917060300,  운암3동,'15,10 - 14세,1998,1927,1014,913
'2917060300,  운암3동,'20,15 - 19세,1998,2316,1187,1129
'2917060300,  운암3동,'25,20 - 24세,1998,1539,746,793
'2917060300,  운암3동,'30,25 - 29세,1998,1533,694,839
'2917060300,  운암3동,'35,30 - 34세,1998,1602,782,820
'2917060300,  운암3동,'40,35 - 39세,1998,2094,950,1144
'2917060300,  운암3동,'45,40 - 44세,1998,1963,970,993
'2917060300,  운암3동,'50,45 - 49세,1998,1147,620,527
'2917060300,  운암3동,'55,50 - 54세,1998,753,390,363
'2917060300,  운암3동,'60,55 - 59세,1998,487,255,232
'2917060300,  운암3동,'65,60 - 64세,1998,380,154,226
'2917060300,  운암3동,'70,65 - 69세,1998,315,105,210
'2917060300,  운암3동,'75,70 - 74세,1998,225,72,153
'2917060300,  운암3동,'80,75 - 79세,1998,172,64,108
'2917060300,  운암3동,'85,80 - 84세,1998,86,17,69
'2917060300,  운암3동,'90,85+ ,1998,67,12,55
'2917061500,  동림동,'00,계,1998,18695,9264,9431
'2917061500,  동림동,'05,0 - 4세,1998,2092,1063,1029
'2917061500,  동림동,'10,5 - 9세,1998,1831,942,889
'2917061500,  동림동,'15,10 - 14세,1998,1352,712,640
'2917061500,  동림동,'20,15 - 19세,1998,1547,795,752
'2917061500,  동림동,'25,20 - 24세,1998,1344,630,714
'2917061500,  동림동,'30,25 - 29세,1998,2147,980,1167
'2917061500,  동림동,'35,30 - 34세,1998,2284,1171,1113
'2917061500,  동림동,'40,35 - 39세,1998,1961,1030,931
'2917061500,  동림동,'45,40 - 44세,1998,1350,669,681
'2917061500,  동림동,'50,45 - 49세,1998,812,445,367
'2917061500,  동림동,'55,50 - 54세,1998,553,279,274
'2917061500,  동림동,'60,55 - 59세,1998,457,218,239
'2917061500,  동림동,'65,60 - 64세,1998,314,136,178
'2917061500,  동림동,'70,65 - 69세,1998,228,68,160
'2917061500,  동림동,'75,70 - 74세,1998,188,68,120
'2917061500,  동림동,'80,75 - 79세,1998,131,38,93
'2917061500,  동림동,'85,80 - 84세,1998,58,14,44
'2917061500,  동림동,'90,85+ ,1998,46,6,40
'2917062000,  우산동,'00,계,1998,23735,11470,12265
'2917062000,  우산동,'05,0 - 4세,1998,1323,678,645
'2917062000,  우산동,'10,5 - 9세,1998,1406,756,650
'2917062000,  우산동,'15,10 - 14세,1998,1554,789,765
'2917062000,  우산동,'20,15 - 19세,1998,2930,1471,1459
'2917062000,  우산동,'25,20 - 24세,1998,3037,1553,1484
'2917062000,  우산동,'30,25 - 29세,1998,2380,1300,1080
'2917062000,  우산동,'35,30 - 34세,1998,1549,792,757
'2917062000,  우산동,'40,35 - 39세,1998,1634,766,868
'2917062000,  우산동,'45,40 - 44세,1998,1675,648,1027
'2917062000,  우산동,'50,45 - 49세,1998,1638,705,933
'2917062000,  우산동,'55,50 - 54세,1998,1414,676,738
'2917062000,  우산동,'60,55 - 59세,1998,1093,540,553
'2917062000,  우산동,'65,60 - 64세,1998,775,362,413
'2917062000,  우산동,'70,65 - 69세,1998,483,190,293
'2917062000,  우산동,'75,70 - 74세,1998,352,109,243
'2917062000,  우산동,'80,75 - 79세,1998,257,86,171
'2917062000,  우산동,'85,80 - 84세,1998,125,35,90
'2917062000,  우산동,'90,85+ ,1998,110,14,96
'2917063500,  풍향동,'00,계,1998,12194,6050,6144
'2917063500,  풍향동,'05,0 - 4세,1998,663,339,324
'2917063500,  풍향동,'10,5 - 9세,1998,670,336,334
'2917063500,  풍향동,'15,10 - 14세,1998,825,436,389
'2917063500,  풍향동,'20,15 - 19세,1998,1247,638,609
'2917063500,  풍향동,'25,20 - 24세,1998,1553,781,772
'2917063500,  풍향동,'30,25 - 29세,1998,1365,749,616
'2917063500,  풍향동,'35,30 - 34세,1998,828,451,377
'2917063500,  풍향동,'40,35 - 39세,1998,908,443,465
'2917063500,  풍향동,'45,40 - 44세,1998,763,359,404
'2917063500,  풍향동,'50,45 - 49세,1998,744,346,398
'2917063500,  풍향동,'55,50 - 54세,1998,682,316,366
'2917063500,  풍향동,'60,55 - 59세,1998,734,343,391
'2917063500,  풍향동,'65,60 - 64세,1998,493,240,253
'2917063500,  풍향동,'70,65 - 69세,1998,294,137,157
'2917063500,  풍향동,'75,70 - 74세,1998,175,80,95
'2917063500,  풍향동,'80,75 - 79세,1998,129,39,90
'2917063500,  풍향동,'85,80 - 84세,1998,70,9,61
'2917063500,  풍향동,'90,85+ ,1998,51,8,43
'2917065000,  문화동,'00,계,1998,20903,10086,10817
'2917065000,  문화동,'05,0 - 4세,1998,1385,709,676
'2917065000,  문화동,'10,5 - 9세,1998,1418,722,696
'2917065000,  문화동,'15,10 - 14세,1998,1556,778,778
'2917065000,  문화동,'20,15 - 19세,1998,2414,1253,1161
'2917065000,  문화동,'25,20 - 24세,1998,2280,1170,1110
'2917065000,  문화동,'30,25 - 29세,1998,1951,987,964
'2917065000,  문화동,'35,30 - 34세,1998,1563,801,762
'2917065000,  문화동,'40,35 - 39세,1998,1697,787,910
'2917065000,  문화동,'45,40 - 44세,1998,1553,682,871
'2917065000,  문화동,'50,45 - 49세,1998,1331,586,745
'2917065000,  문화동,'55,50 - 54세,1998,1043,498,545
'2917065000,  문화동,'60,55 - 59세,1998,875,400,475
'2917065000,  문화동,'65,60 - 64세,1998,619,276,343
'2917065000,  문화동,'70,65 - 69세,1998,480,204,276
'2917065000,  문화동,'75,70 - 74세,1998,298,105,193
'2917065000,  문화동,'80,75 - 79세,1998,244,82,162
'2917065000,  문화동,'85,80 - 84세,1998,122,34,88
'2917065000,  문화동,'90,85+ ,1998,74,12,62
'2917065600,  문흥1동,'00,계,1998,24665,12107,12558
'2917065600,  문흥1동,'05,0 - 4세,1998,2370,1221,1149
'2917065600,  문흥1동,'10,5 - 9세,1998,2755,1431,1324
'2917065600,  문흥1동,'15,10 - 14세,1998,2407,1243,1164
'2917065600,  문흥1동,'20,15 - 19세,1998,2168,1117,1051
'2917065600,  문흥1동,'25,20 - 24세,1998,1644,819,825
'2917065600,  문흥1동,'30,25 - 29세,1998,1975,889,1086
'2917065600,  문흥1동,'35,30 - 34세,1998,2476,1054,1422
'2917065600,  문흥1동,'40,35 - 39세,1998,3007,1473,1534
'2917065600,  문흥1동,'45,40 - 44세,1998,2144,1155,989
'2917065600,  문흥1동,'50,45 - 49세,1998,1182,606,576
'2917065600,  문흥1동,'55,50 - 54세,1998,721,401,320
'2917065600,  문흥1동,'60,55 - 59세,1998,531,271,260
'2917065600,  문흥1동,'65,60 - 64세,1998,423,178,245
'2917065600,  문흥1동,'70,65 - 69세,1998,318,101,217
'2917065600,  문흥1동,'75,70 - 74세,1998,225,72,153
'2917065600,  문흥1동,'80,75 - 79세,1998,149,41,108
'2917065600,  문흥1동,'85,80 - 84세,1998,100,23,77
'2917065600,  문흥1동,'90,85+ ,1998,70,12,58
'2917065700,  문흥2동,'00,계,1998,26004,12836,13168
'2917065700,  문흥2동,'05,0 - 4세,1998,2742,1418,1324
'2917065700,  문흥2동,'10,5 - 9세,1998,2653,1393,1260
'2917065700,  문흥2동,'15,10 - 14세,1998,2220,1153,1067
'2917065700,  문흥2동,'20,15 - 19세,1998,2056,1037,1019
'2917065700,  문흥2동,'25,20 - 24세,1998,1755,842,913
'2917065700,  문흥2동,'30,25 - 29세,1998,2651,1181,1470
'2917065700,  문흥2동,'35,30 - 34세,1998,3122,1514,1608
'2917065700,  문흥2동,'40,35 - 39세,1998,3014,1531,1483
'2917065700,  문흥2동,'45,40 - 44세,1998,1969,1053,916
'2917065700,  문흥2동,'50,45 - 49세,1998,1056,552,504
'2917065700,  문흥2동,'55,50 - 54세,1998,742,378,364
'2917065700,  문흥2동,'60,55 - 59세,1998,627,282,345
'2917065700,  문흥2동,'65,60 - 64세,1998,480,210,270
'2917065700,  문흥2동,'70,65 - 69세,1998,357,129,228
'2917065700,  문흥2동,'75,70 - 74세,1998,259,90,169
'2917065700,  문흥2동,'80,75 - 79세,1998,155,43,112
'2917065700,  문흥2동,'85,80 - 84세,1998,87,24,63
'2917065700,  문흥2동,'90,85+ ,1998,59,6,53
'2917066100,  두암1동,'00,계,1998,12119,5931,6188
'2917066100,  두암1동,'05,0 - 4세,1998,783,408,375
'2917066100,  두암1동,'10,5 - 9세,1998,739,379,360
'2917066100,  두암1동,'15,10 - 14세,1998,877,434,443
'2917066100,  두암1동,'20,15 - 19세,1998,1397,650,747
'2917066100,  두암1동,'25,20 - 24세,1998,1520,761,759
'2917066100,  두암1동,'30,25 - 29세,1998,1281,686,595
'2917066100,  두암1동,'35,30 - 34세,1998,901,484,417
'2917066100,  두암1동,'40,35 - 39세,1998,927,431,496
'2917066100,  두암1동,'45,40 - 44세,1998,862,396,466
'2917066100,  두암1동,'50,45 - 49세,1998,748,341,407
'2917066100,  두암1동,'55,50 - 54세,1998,668,322,346
'2917066100,  두암1동,'60,55 - 59세,1998,530,274,256
'2917066100,  두암1동,'65,60 - 64세,1998,366,192,174
'2917066100,  두암1동,'70,65 - 69세,1998,189,86,103
'2917066100,  두암1동,'75,70 - 74세,1998,132,46,86
'2917066100,  두암1동,'80,75 - 79세,1998,87,25,62
'2917066100,  두암1동,'85,80 - 84세,1998,67,9,58
'2917066100,  두암1동,'90,85+ ,1998,45,7,38
'2917066200,  두암2동,'00,계,1998,26132,12979,13153
'2917066200,  두암2동,'05,0 - 4세,1998,2079,1095,984
'2917066200,  두암2동,'10,5 - 9세,1998,2217,1178,1039
'2917066200,  두암2동,'15,10 - 14세,1998,2054,1052,1002
'2917066200,  두암2동,'20,15 - 19세,1998,2651,1386,1265
'2917066200,  두암2동,'25,20 - 24세,1998,2486,1250,1236
'2917066200,  두암2동,'30,25 - 29세,1998,2417,1214,1203
'2917066200,  두암2동,'35,30 - 34세,1998,2352,1119,1233
'2917066200,  두암2동,'40,35 - 39세,1998,2484,1230,1254
'2917066200,  두암2동,'45,40 - 44세,1998,2014,974,1040
'2917066200,  두암2동,'50,45 - 49세,1998,1512,749,763
'2917066200,  두암2동,'55,50 - 54세,1998,1105,559,546
'2917066200,  두암2동,'60,55 - 59세,1998,925,467,458
'2917066200,  두암2동,'65,60 - 64세,1998,647,302,345
'2917066200,  두암2동,'70,65 - 69세,1998,443,174,269
'2917066200,  두암2동,'75,70 - 74세,1998,309,119,190
'2917066200,  두암2동,'80,75 - 79세,1998,243,75,168
'2917066200,  두암2동,'85,80 - 84세,1998,114,22,92
'2917066200,  두암2동,'90,85+ ,1998,80,14,66
'2917066300,  두암3동,'00,계,1998,26844,12873,13971
'2917066300,  두암3동,'05,0 - 4세,1998,1853,1003,850
'2917066300,  두암3동,'10,5 - 9세,1998,2233,1121,1112
'2917066300,  두암3동,'15,10 - 14세,1998,2303,1200,1103
'2917066300,  두암3동,'20,15 - 19세,1998,3213,1644,1569
'2917066300,  두암3동,'25,20 - 24세,1998,2337,1208,1129
'2917066300,  두암3동,'30,25 - 29세,1998,2199,1101,1098
'2917066300,  두암3동,'35,30 - 34세,1998,2218,1017,1201
'2917066300,  두암3동,'40,35 - 39세,1998,2744,1241,1503
'2917066300,  두암3동,'45,40 - 44세,1998,2380,1110,1270
'2917066300,  두암3동,'50,45 - 49세,1998,1487,732,755
'2917066300,  두암3동,'55,50 - 54세,1998,1064,527,537
'2917066300,  두암3동,'60,55 - 59세,1998,864,370,494
'2917066300,  두암3동,'65,60 - 64세,1998,656,232,424
'2917066300,  두암3동,'70,65 - 69세,1998,484,163,321
'2917066300,  두암3동,'75,70 - 74세,1998,348,104,244
'2917066300,  두암3동,'80,75 - 79세,1998,239,66,173
'2917066300,  두암3동,'85,80 - 84세,1998,129,24,105
'2917066300,  두암3동,'90,85+ ,1998,93,10,83
'2917067000,  서산동,'00,계,1998,35788,17965,17823
'2917067000,  서산동,'05,0 - 4세,1998,4746,2419,2327
'2917067000,  서산동,'10,5 - 9세,1998,3881,2020,1861
'2917067000,  서산동,'15,10 - 14세,1998,2895,1536,1359
'2917067000,  서산동,'20,15 - 19세,1998,2471,1359,1112
'2917067000,  서산동,'25,20 - 24세,1998,1943,952,991
'2917067000,  서산동,'30,25 - 29세,1998,3893,1557,2336
'2917067000,  서산동,'35,30 - 34세,1998,5143,2627,2516
'2917067000,  서산동,'40,35 - 39세,1998,4094,2211,1883
'2917067000,  서산동,'45,40 - 44세,1998,2478,1367,1111
'2917067000,  서산동,'50,45 - 49세,1998,1223,671,552
'2917067000,  서산동,'55,50 - 54세,1998,785,388,397
'2917067000,  서산동,'60,55 - 59세,1998,728,326,402
'2917067000,  서산동,'65,60 - 64세,1998,548,232,316
'2917067000,  서산동,'70,65 - 69세,1998,358,116,242
'2917067000,  서산동,'75,70 - 74세,1998,242,96,146
'2917067000,  서산동,'80,75 - 79세,1998,183,50,133
'2917067000,  서산동,'85,80 - 84세,1998,111,24,87
'2917067000,  서산동,'90,85+ ,1998,66,14,52
'2917067300,  매곡동,'00,계,1998,12353,6195,6158
'2917067300,  매곡동,'05,0 - 4세,1998,1221,624,597
'2917067300,  매곡동,'10,5 - 9세,1998,1288,692,596
'2917067300,  매곡동,'15,10 - 14세,1998,1007,546,461
'2917067300,  매곡동,'20,15 - 19세,1998,1090,572,518
'2917067300,  매곡동,'25,20 - 24세,1998,751,397,354
'2917067300,  매곡동,'30,25 - 29세,1998,1070,467,603
'2917067300,  매곡동,'35,30 - 34세,1998,1406,676,730
'2917067300,  매곡동,'40,35 - 39세,1998,1497,771,726
'2917067300,  매곡동,'45,40 - 44세,1998,978,521,457
'2917067300,  매곡동,'50,45 - 49세,1998,553,306,247
'2917067300,  매곡동,'55,50 - 54세,1998,361,188,173
'2917067300,  매곡동,'60,55 - 59세,1998,321,152,169
'2917067300,  매곡동,'65,60 - 64세,1998,291,122,169
'2917067300,  매곡동,'70,65 - 69세,1998,181,62,119
'2917067300,  매곡동,'75,70 - 74세,1998,131,49,82
'2917067300,  매곡동,'80,75 - 79세,1998,109,30,79
'2917067300,  매곡동,'85,80 - 84세,1998,61,14,47
'2917067300,  매곡동,'90,85+ ,1998,37,6,31
'2917067600,  오치1동,'00,계,1998,15004,7565,7439
'2917067600,  오치1동,'05,0 - 4세,1998,1448,755,693
'2917067600,  오치1동,'10,5 - 9세,1998,1193,623,570
'2917067600,  오치1동,'15,10 - 14세,1998,1054,549,505
'2917067600,  오치1동,'20,15 - 19세,1998,1499,767,732
'2917067600,  오치1동,'25,20 - 24세,1998,1405,707,698
'2917067600,  오치1동,'30,25 - 29세,1998,1799,874,925
'2917067600,  오치1동,'35,30 - 34세,1998,1534,822,712
'2917067600,  오치1동,'40,35 - 39세,1998,1341,663,678
'2917067600,  오치1동,'45,40 - 44세,1998,1053,509,544
'2917067600,  오치1동,'50,45 - 49세,1998,771,412,359
'2917067600,  오치1동,'55,50 - 54세,1998,572,286,286
'2917067600,  오치1동,'60,55 - 59세,1998,473,253,220
'2917067600,  오치1동,'65,60 - 64세,1998,320,153,167
'2917067600,  오치1동,'70,65 - 69세,1998,228,98,130
'2917067600,  오치1동,'75,70 - 74세,1998,131,47,84
'2917067600,  오치1동,'80,75 - 79세,1998,93,24,69
'2917067600,  오치1동,'85,80 - 84세,1998,61,16,45
'2917067600,  오치1동,'90,85+ ,1998,29,7,22
'2917067700,  오치2동,'00,계,1998,20477,10056,10421
'2917067700,  오치2동,'05,0 - 4세,1998,1487,775,712
'2917067700,  오치2동,'10,5 - 9세,1998,1893,971,922
'2917067700,  오치2동,'15,10 - 14세,1998,1867,1008,859
'2917067700,  오치2동,'20,15 - 19세,1998,2274,1211,1063
'2917067700,  오치2동,'25,20 - 24세,1998,1629,842,787
'2917067700,  오치2동,'30,25 - 29세,1998,1881,898,983
'2917067700,  오치2동,'35,30 - 34세,1998,1881,882,999
'2917067700,  오치2동,'40,35 - 39세,1998,2251,1051,1200
'2917067700,  오치2동,'45,40 - 44세,1998,1767,870,897
'2917067700,  오치2동,'50,45 - 49세,1998,999,529,470
'2917067700,  오치2동,'55,50 - 54세,1998,752,378,374
'2917067700,  오치2동,'60,55 - 59세,1998,531,238,293
'2917067700,  오치2동,'65,60 - 64세,1998,419,161,258
'2917067700,  오치2동,'70,65 - 69세,1998,315,109,206
'2917067700,  오치2동,'75,70 - 74세,1998,242,74,168
'2917067700,  오치2동,'80,75 - 79세,1998,154,34,120
'2917067700,  오치2동,'85,80 - 84세,1998,81,18,63
'2917067700,  오치2동,'90,85+ ,1998,54,7,47
'2917068500,  석곡동,'00,계,1998,4166,2112,2054
'2917068500,  석곡동,'05,0 - 4세,1998,198,110,88
'2917068500,  석곡동,'10,5 - 9세,1998,180,99,81
'2917068500,  석곡동,'15,10 - 14세,1998,266,124,142
'2917068500,  석곡동,'20,15 - 19세,1998,377,203,174
'2917068500,  석곡동,'25,20 - 24세,1998,393,200,193
'2917068500,  석곡동,'30,25 - 29세,1998,391,234,157
'2917068500,  석곡동,'35,30 - 34세,1998,266,160,106
'2917068500,  석곡동,'40,35 - 39세,1998,301,167,134
'2917068500,  석곡동,'45,40 - 44세,1998,295,171,124
'2917068500,  석곡동,'50,45 - 49세,1998,203,115,88
'2917068500,  석곡동,'55,50 - 54세,1998,218,104,114
'2917068500,  석곡동,'60,55 - 59세,1998,281,121,160
'2917068500,  석곡동,'65,60 - 64세,1998,239,102,137
'2917068500,  석곡동,'70,65 - 69세,1998,180,61,119
'2917068500,  석곡동,'75,70 - 74세,1998,151,62,89
'2917068500,  석곡동,'80,75 - 79세,1998,122,45,77
'2917068500,  석곡동,'85,80 - 84세,1998,54,22,32
'2917068500,  석곡동,'90,85+ ,1998,51,12,39
'2917069500,  건국동,'00,계,1998,37433,18980,18453
'2917069500,  건국동,'05,0 - 4세,1998,4249,2243,2006
'2917069500,  건국동,'10,5 - 9세,1998,3158,1627,1531
'2917069500,  건국동,'15,10 - 14세,1998,2428,1228,1200
'2917069500,  건국동,'20,15 - 19세,1998,2782,1454,1328
'2917069500,  건국동,'25,20 - 24세,1998,2811,1429,1382
'2917069500,  건국동,'30,25 - 29세,1998,4689,2219,2470
'2917069500,  건국동,'35,30 - 34세,1998,4520,2475,2045
'2917069500,  건국동,'40,35 - 39세,1998,3591,1964,1627
'2917069500,  건국동,'45,40 - 44세,1998,2270,1229,1041
'2917069500,  건국동,'50,45 - 49세,1998,1564,828,736
'2917069500,  건국동,'55,50 - 54세,1998,1274,637,637
'2917069500,  건국동,'60,55 - 59세,1998,1249,563,686
'2917069500,  건국동,'65,60 - 64세,1998,1014,441,573
'2917069500,  건국동,'70,65 - 69세,1998,698,290,408
'2917069500,  건국동,'75,70 - 74세,1998,467,167,300
'2917069500,  건국동,'80,75 - 79세,1998,349,114,235
'2917069500,  건국동,'85,80 - 84세,1998,186,47,139
'2917069500,  건국동,'90,85+ ,1998,134,25,109
'29200, 광산구,'00,계,1998,240621,121366,119255
'29200, 광산구,'05,0 - 4세,1998,27803,14511,13292
'29200, 광산구,'10,5 - 9세,1998,24899,13164,11735
'29200, 광산구,'15,10 - 14세,1998,16732,8479,8253
'29200, 광산구,'20,15 - 19세,1998,16215,8200,8015
'29200, 광산구,'25,20 - 24세,1998,16830,8407,8423
'29200, 광산구,'30,25 - 29세,1998,26230,12365,13865
'29200, 광산구,'35,30 - 34세,1998,30346,15498,14848
'29200, 광산구,'40,35 - 39세,1998,25033,14160,10873
'29200, 광산구,'45,40 - 44세,1998,14488,8089,6399
'29200, 광산구,'50,45 - 49세,1998,8915,4654,4261
'29200, 광산구,'55,50 - 54세,1998,7404,3655,3749
'29200, 광산구,'60,55 - 59세,1998,7425,3334,4091
'29200, 광산구,'65,60 - 64세,1998,6361,2658,3703
'29200, 광산구,'70,65 - 69세,1998,4772,1810,2962
'29200, 광산구,'75,70 - 74세,1998,3164,1209,1955
'29200, 광산구,'80,75 - 79세,1998,2196,732,1464
'29200, 광산구,'85,80 - 84세,1998,1092,314,778
'29200, 광산구,'90,85+ ,1998,716,127,589
'2920051500,  송정1동,'00,계,1998,10508,5381,5127
'2920051500,  송정1동,'05,0 - 4세,1998,1278,702,576
'2920051500,  송정1동,'10,5 - 9세,1998,802,438,364
'2920051500,  송정1동,'15,10 - 14세,1998,525,273,252
'2920051500,  송정1동,'20,15 - 19세,1998,764,381,383
'2920051500,  송정1동,'25,20 - 24세,1998,982,507,475
'2920051500,  송정1동,'30,25 - 29세,1998,1396,648,748
'2920051500,  송정1동,'35,30 - 34세,1998,1311,765,546
'2920051500,  송정1동,'40,35 - 39세,1998,826,458,368
'2920051500,  송정1동,'45,40 - 44세,1998,541,280,261
'2920051500,  송정1동,'50,45 - 49세,1998,479,233,246
'2920051500,  송정1동,'55,50 - 54세,1998,427,211,216
'2920051500,  송정1동,'60,55 - 59세,1998,351,161,190
'2920051500,  송정1동,'65,60 - 64세,1998,301,120,181
'2920051500,  송정1동,'70,65 - 69세,1998,207,94,113
'2920051500,  송정1동,'75,70 - 74세,1998,144,60,84
'2920051500,  송정1동,'80,75 - 79세,1998,90,29,61
'2920051500,  송정1동,'85,80 - 84세,1998,51,12,39
'2920051500,  송정1동,'90,85+ ,1998,33,9,24
'2920052500,  송정2동,'00,계,1998,9777,4848,4929
'2920052500,  송정2동,'05,0 - 4세,1998,704,353,351
'2920052500,  송정2동,'10,5 - 9세,1998,661,348,313
'2920052500,  송정2동,'15,10 - 14세,1998,596,289,307
'2920052500,  송정2동,'20,15 - 19세,1998,915,471,444
'2920052500,  송정2동,'25,20 - 24세,1998,1059,531,528
'2920052500,  송정2동,'30,25 - 29세,1998,1050,534,516
'2920052500,  송정2동,'35,30 - 34세,1998,760,385,375
'2920052500,  송정2동,'40,35 - 39세,1998,763,422,341
'2920052500,  송정2동,'45,40 - 44세,1998,668,328,340
'2920052500,  송정2동,'50,45 - 49세,1998,584,275,309
'2920052500,  송정2동,'55,50 - 54세,1998,566,288,278
'2920052500,  송정2동,'60,55 - 59세,1998,487,225,262
'2920052500,  송정2동,'65,60 - 64세,1998,334,162,172
'2920052500,  송정2동,'70,65 - 69세,1998,259,100,159
'2920052500,  송정2동,'75,70 - 74세,1998,166,75,91
'2920052500,  송정2동,'80,75 - 79세,1998,121,43,78
'2920052500,  송정2동,'85,80 - 84세,1998,53,14,39
'2920052500,  송정2동,'90,85+ ,1998,31,5,26
'2920054000,  도산동,'00,계,1998,14895,7545,7350
'2920054000,  도산동,'05,0 - 4세,1998,1746,906,840
'2920054000,  도산동,'10,5 - 9세,1998,1394,779,615
'2920054000,  도산동,'15,10 - 14세,1998,871,422,449
'2920054000,  도산동,'20,15 - 19세,1998,1065,533,532
'2920054000,  도산동,'25,20 - 24세,1998,1206,595,611
'2920054000,  도산동,'30,25 - 29세,1998,1925,944,981
'2920054000,  도산동,'35,30 - 34세,1998,1872,1010,862
'2920054000,  도산동,'40,35 - 39세,1998,1360,758,602
'2920054000,  도산동,'45,40 - 44세,1998,799,434,365
'2920054000,  도산동,'50,45 - 49세,1998,622,294,328
'2920054000,  도산동,'55,50 - 54세,1998,492,252,240
'2920054000,  도산동,'60,55 - 59세,1998,504,228,276
'2920054000,  도산동,'65,60 - 64세,1998,391,177,214
'2920054000,  도산동,'70,65 - 69세,1998,254,100,154
'2920054000,  도산동,'75,70 - 74세,1998,160,61,99
'2920054000,  도산동,'80,75 - 79세,1998,117,26,91
'2920054000,  도산동,'85,80 - 84세,1998,71,21,50
'2920054000,  도산동,'90,85+ ,1998,46,5,41
'2920055000,  신흥동,'00,계,1998,4944,2532,2412
'2920055000,  신흥동,'05,0 - 4세,1998,391,203,188
'2920055000,  신흥동,'10,5 - 9세,1998,293,176,117
'2920055000,  신흥동,'15,10 - 14세,1998,282,154,128
'2920055000,  신흥동,'20,15 - 19세,1998,457,242,215
'2920055000,  신흥동,'25,20 - 24세,1998,526,266,260
'2920055000,  신흥동,'30,25 - 29세,1998,593,321,272
'2920055000,  신흥동,'35,30 - 34세,1998,391,227,164
'2920055000,  신흥동,'40,35 - 39세,1998,345,176,169
'2920055000,  신흥동,'45,40 - 44세,1998,331,180,151
'2920055000,  신흥동,'50,45 - 49세,1998,252,124,128
'2920055000,  신흥동,'55,50 - 54세,1998,257,111,146
'2920055000,  신흥동,'60,55 - 59세,1998,242,124,118
'2920055000,  신흥동,'65,60 - 64세,1998,192,84,108
'2920055000,  신흥동,'70,65 - 69세,1998,148,55,93
'2920055000,  신흥동,'75,70 - 74세,1998,109,49,60
'2920055000,  신흥동,'80,75 - 79세,1998,83,27,56
'2920055000,  신흥동,'85,80 - 84세,1998,34,12,22
'2920055000,  신흥동,'90,85+ ,1998,18,1,17
'2920056500,  어룡동,'00,계,1998,17586,8948,8638
'2920056500,  어룡동,'05,0 - 4세,1998,2051,1071,980
'2920056500,  어룡동,'10,5 - 9세,1998,1542,786,756
'2920056500,  어룡동,'15,10 - 14세,1998,1082,562,520
'2920056500,  어룡동,'20,15 - 19세,1998,1354,683,671
'2920056500,  어룡동,'25,20 - 24세,1998,1367,703,664
'2920056500,  어룡동,'30,25 - 29세,1998,2061,985,1076
'2920056500,  어룡동,'35,30 - 34세,1998,2216,1219,997
'2920056500,  어룡동,'40,35 - 39세,1998,1602,906,696
'2920056500,  어룡동,'45,40 - 44세,1998,1083,572,511
'2920056500,  어룡동,'50,45 - 49세,1998,778,427,351
'2920056500,  어룡동,'55,50 - 54세,1998,596,301,295
'2920056500,  어룡동,'60,55 - 59세,1998,548,251,297
'2920056500,  어룡동,'65,60 - 64세,1998,426,173,253
'2920056500,  어룡동,'70,65 - 69세,1998,356,129,227
'2920056500,  어룡동,'75,70 - 74세,1998,236,98,138
'2920056500,  어룡동,'80,75 - 79세,1998,155,52,103
'2920056500,  어룡동,'85,80 - 84세,1998,79,21,58
'2920056500,  어룡동,'90,85+ ,1998,54,9,45
'2920058000,  우산동,'00,계,1998,32958,16469,16489
'2920058000,  우산동,'05,0 - 4세,1998,3612,1888,1724
'2920058000,  우산동,'10,5 - 9세,1998,3613,1889,1724
'2920058000,  우산동,'15,10 - 14세,1998,2544,1336,1208
'2920058000,  우산동,'20,15 - 19세,1998,2522,1273,1249
'2920058000,  우산동,'25,20 - 24세,1998,2230,1154,1076
'2920058000,  우산동,'30,25 - 29세,1998,3505,1618,1887
'2920058000,  우산동,'35,30 - 34세,1998,4130,2006,2124
'2920058000,  우산동,'40,35 - 39세,1998,3567,2003,1564
'2920058000,  우산동,'45,40 - 44세,1998,2183,1184,999
'2920058000,  우산동,'50,45 - 49세,1998,1222,628,594
'2920058000,  우산동,'55,50 - 54세,1998,950,461,489
'2920058000,  우산동,'60,55 - 59세,1998,823,356,467
'2920058000,  우산동,'65,60 - 64세,1998,700,264,436
'2920058000,  우산동,'70,65 - 69세,1998,528,163,365
'2920058000,  우산동,'75,70 - 74세,1998,377,118,259
'2920058000,  우산동,'80,75 - 79세,1998,263,79,184
'2920058000,  우산동,'85,80 - 84세,1998,113,34,79
'2920058000,  우산동,'90,85+ ,1998,76,15,61
'2920060000,  월곡1동,'00,계,1998,18426,9295,9131
'2920060000,  월곡1동,'05,0 - 4세,1998,2168,1178,990
'2920060000,  월곡1동,'10,5 - 9세,1998,2207,1149,1058
'2920060000,  월곡1동,'15,10 - 14세,1998,1731,896,835
'2920060000,  월곡1동,'20,15 - 19세,1998,1190,602,588
'2920060000,  월곡1동,'25,20 - 24세,1998,1023,472,551
'2920060000,  월곡1동,'30,25 - 29세,1998,1868,870,998
'2920060000,  월곡1동,'35,30 - 34세,1998,2260,1066,1194
'2920060000,  월곡1동,'40,35 - 39세,1998,2354,1233,1121
'2920060000,  월곡1동,'45,40 - 44세,1998,1348,783,565
'2920060000,  월곡1동,'50,45 - 49세,1998,653,384,269
'2920060000,  월곡1동,'55,50 - 54세,1998,363,201,162
'2920060000,  월곡1동,'60,55 - 59세,1998,352,150,202
'2920060000,  월곡1동,'65,60 - 64세,1998,333,123,210
'2920060000,  월곡1동,'70,65 - 69세,1998,243,87,156
'2920060000,  월곡1동,'75,70 - 74세,1998,145,58,87
'2920060000,  월곡1동,'80,75 - 79세,1998,103,30,73
'2920060000,  월곡1동,'85,80 - 84세,1998,49,10,39
'2920060000,  월곡1동,'90,85+ ,1998,36,3,33
'2920061000,  월곡2동,'00,계,1998,14219,7256,6963
'2920061000,  월곡2동,'05,0 - 4세,1998,1769,915,854
'2920061000,  월곡2동,'10,5 - 9세,1998,1686,896,790
'2920061000,  월곡2동,'15,10 - 14세,1998,1118,572,546
'2920061000,  월곡2동,'20,15 - 19세,1998,917,459,458
'2920061000,  월곡2동,'25,20 - 24세,1998,948,449,499
'2920061000,  월곡2동,'30,25 - 29세,1998,1651,821,830
'2920061000,  월곡2동,'35,30 - 34세,1998,1840,903,937
'2920061000,  월곡2동,'40,35 - 39세,1998,1709,951,758
'2920061000,  월곡2동,'45,40 - 44세,1998,909,518,391
'2920061000,  월곡2동,'50,45 - 49세,1998,452,238,214
'2920061000,  월곡2동,'55,50 - 54세,1998,371,217,154
'2920061000,  월곡2동,'60,55 - 59세,1998,266,113,153
'2920061000,  월곡2동,'65,60 - 64세,1998,216,98,118
'2920061000,  월곡2동,'70,65 - 69세,1998,158,58,100
'2920061000,  월곡2동,'75,70 - 74세,1998,90,28,62
'2920061000,  월곡2동,'80,75 - 79세,1998,60,10,50
'2920061000,  월곡2동,'85,80 - 84세,1998,28,7,21
'2920061000,  월곡2동,'90,85+ ,1998,31,3,28
'2920062000,  비아동,'00,계,1998,54379,27079,27300
'2920062000,  비아동,'05,0 - 4세,1998,7428,3842,3586
'2920062000,  비아동,'10,5 - 9세,1998,7519,3972,3547
'2920062000,  비아동,'15,10 - 14세,1998,4524,2233,2291
'2920062000,  비아동,'20,15 - 19세,1998,2690,1350,1340
'2920062000,  비아동,'25,20 - 24세,1998,2405,1099,1306
'2920062000,  비아동,'30,25 - 29세,1998,5324,2219,3105
'2920062000,  비아동,'35,30 - 34세,1998,8026,3800,4226
'2920062000,  비아동,'40,35 - 39세,1998,7113,3964,3149
'2920062000,  비아동,'45,40 - 44세,1998,3359,2024,1335
'2920062000,  비아동,'50,45 - 49세,1998,1388,746,642
'2920062000,  비아동,'55,50 - 54세,1998,1012,479,533
'2920062000,  비아동,'60,55 - 59세,1998,1016,441,575
'2920062000,  비아동,'65,60 - 64세,1998,916,376,540
'2920062000,  비아동,'70,65 - 69세,1998,692,241,451
'2920062000,  비아동,'75,70 - 74세,1998,420,151,269
'2920062000,  비아동,'80,75 - 79세,1998,289,85,204
'2920062000,  비아동,'85,80 - 84세,1998,160,38,122
'2920062000,  비아동,'90,85+ ,1998,98,19,79
'2920063000,  신가동,'00,계,1998,37860,19129,18731
'2920063000,  신가동,'05,0 - 4세,1998,5522,2869,2653
'2920063000,  신가동,'10,5 - 9세,1998,4083,2155,1928
'2920063000,  신가동,'15,10 - 14세,1998,2266,1153,1113
'2920063000,  신가동,'20,15 - 19세,1998,2158,1057,1101
'2920063000,  신가동,'25,20 - 24세,1998,2441,1156,1285
'2920063000,  신가동,'30,25 - 29세,1998,4597,1955,2642
'2920063000,  신가동,'35,30 - 34세,1998,6058,3200,2858
'2920063000,  신가동,'40,35 - 39세,1998,3847,2330,1517
'2920063000,  신가동,'45,40 - 44세,1998,1935,1048,887
'2920063000,  신가동,'50,45 - 49세,1998,1232,661,571
'2920063000,  신가동,'55,50 - 54세,1998,948,459,489
'2920063000,  신가동,'60,55 - 59세,1998,892,419,473
'2920063000,  신가동,'65,60 - 64세,1998,663,276,387
'2920063000,  신가동,'70,65 - 69세,1998,507,192,315
'2920063000,  신가동,'75,70 - 74세,1998,310,97,213
'2920063000,  신가동,'80,75 - 79세,1998,215,64,151
'2920063000,  신가동,'85,80 - 84세,1998,108,25,83
'2920063000,  신가동,'90,85+ ,1998,78,13,65
'2920064000,  하남동,'00,계,1998,3847,2107,1740
'2920064000,  하남동,'05,0 - 4세,1998,210,107,103
'2920064000,  하남동,'10,5 - 9세,1998,212,109,103
'2920064000,  하남동,'15,10 - 14세,1998,214,102,112
'2920064000,  하남동,'20,15 - 19세,1998,335,185,150
'2920064000,  하남동,'25,20 - 24세,1998,375,222,153
'2920064000,  하남동,'30,25 - 29세,1998,420,286,134
'2920064000,  하남동,'35,30 - 34세,1998,293,184,109
'2920064000,  하남동,'40,35 - 39세,1998,333,204,129
'2920064000,  하남동,'45,40 - 44세,1998,225,132,93
'2920064000,  하남동,'50,45 - 49세,1998,181,100,81
'2920064000,  하남동,'55,50 - 54세,1998,194,97,97
'2920064000,  하남동,'60,55 - 59세,1998,232,107,125
'2920064000,  하남동,'65,60 - 64세,1998,210,87,123
'2920064000,  하남동,'70,65 - 69세,1998,169,78,91
'2920064000,  하남동,'75,70 - 74세,1998,109,45,64
'2920064000,  하남동,'80,75 - 79세,1998,76,36,40
'2920064000,  하남동,'85,80 - 84세,1998,32,17,15
'2920064000,  하남동,'90,85+ ,1998,27,9,18
'2920065000,  임곡동,'00,계,1998,3896,1963,1933
'2920065000,  임곡동,'05,0 - 4세,1998,211,112,99
'2920065000,  임곡동,'10,5 - 9세,1998,188,106,82
'2920065000,  임곡동,'15,10 - 14세,1998,197,103,94
'2920065000,  임곡동,'20,15 - 19세,1998,318,165,153
'2920065000,  임곡동,'25,20 - 24세,1998,386,179,207
'2920065000,  임곡동,'30,25 - 29세,1998,344,215,129
'2920065000,  임곡동,'35,30 - 34세,1998,258,152,106
'2920065000,  임곡동,'40,35 - 39세,1998,224,146,78
'2920065000,  임곡동,'45,40 - 44세,1998,194,106,88
'2920065000,  임곡동,'50,45 - 49세,1998,175,90,85
'2920065000,  임곡동,'55,50 - 54세,1998,225,101,124
'2920065000,  임곡동,'60,55 - 59세,1998,297,142,155
'2920065000,  임곡동,'65,60 - 64세,1998,289,126,163
'2920065000,  임곡동,'70,65 - 69세,1998,214,77,137
'2920065000,  임곡동,'75,70 - 74세,1998,138,60,78
'2920065000,  임곡동,'80,75 - 79세,1998,133,50,83
'2920065000,  임곡동,'85,80 - 84세,1998,69,26,43
'2920065000,  임곡동,'90,85+ ,1998,36,7,29
'2920066000,  동곡동,'00,계,1998,3572,1795,1777
'2920066000,  동곡동,'05,0 - 4세,1998,166,91,75
'2920066000,  동곡동,'10,5 - 9세,1998,172,89,83
'2920066000,  동곡동,'15,10 - 14세,1998,212,100,112
'2920066000,  동곡동,'20,15 - 19세,1998,329,160,169
'2920066000,  동곡동,'25,20 - 24세,1998,373,215,158
'2920066000,  동곡동,'30,25 - 29세,1998,317,180,137
'2920066000,  동곡동,'35,30 - 34세,1998,213,129,84
'2920066000,  동곡동,'40,35 - 39세,1998,216,132,84
'2920066000,  동곡동,'45,40 - 44세,1998,217,109,108
'2920066000,  동곡동,'50,45 - 49세,1998,196,103,93
'2920066000,  동곡동,'55,50 - 54세,1998,225,119,106
'2920066000,  동곡동,'60,55 - 59세,1998,262,115,147
'2920066000,  동곡동,'65,60 - 64세,1998,216,83,133
'2920066000,  동곡동,'70,65 - 69세,1998,184,74,110
'2920066000,  동곡동,'75,70 - 74세,1998,116,46,70
'2920066000,  동곡동,'80,75 - 79세,1998,92,34,58
'2920066000,  동곡동,'85,80 - 84세,1998,43,10,33
'2920066000,  동곡동,'90,85+ ,1998,23,6,17
'2920067000,  평동,'00,계,1998,6062,3077,2985
'2920067000,  평동,'05,0 - 4세,1998,246,120,126
'2920067000,  평동,'10,5 - 9세,1998,269,141,128
'2920067000,  평동,'15,10 - 14세,1998,271,123,148
'2920067000,  평동,'20,15 - 19세,1998,563,301,262
'2920067000,  평동,'25,20 - 24세,1998,689,385,304
'2920067000,  평동,'30,25 - 29세,1998,505,316,189
'2920067000,  평동,'35,30 - 34세,1998,316,195,121
'2920067000,  평동,'40,35 - 39세,1998,368,225,143
'2920067000,  평동,'45,40 - 44세,1998,367,204,163
'2920067000,  평동,'50,45 - 49세,1998,336,169,167
'2920067000,  평동,'55,50 - 54세,1998,369,165,204
'2920067000,  평동,'60,55 - 59세,1998,457,206,251
'2920067000,  평동,'65,60 - 64세,1998,452,188,264
'2920067000,  평동,'70,65 - 69세,1998,325,141,184
'2920067000,  평동,'75,70 - 74세,1998,246,92,154
'2920067000,  평동,'80,75 - 79세,1998,141,68,73
'2920067000,  평동,'85,80 - 84세,1998,80,29,51
'2920067000,  평동,'90,85+ ,1998,62,9,53
'2920068000,  삼도동,'00,계,1998,4217,2198,2019
'2920068000,  삼도동,'05,0 - 4세,1998,183,102,81
'2920068000,  삼도동,'10,5 - 9세,1998,179,81,98
'2920068000,  삼도동,'15,10 - 14세,1998,201,112,89
'2920068000,  삼도동,'20,15 - 19세,1998,377,208,169
'2920068000,  삼도동,'25,20 - 24세,1998,448,254,194
'2920068000,  삼도동,'30,25 - 29세,1998,348,234,114
'2920068000,  삼도동,'35,30 - 34세,1998,235,147,88
'2920068000,  삼도동,'40,35 - 39세,1998,246,154,92
'2920068000,  삼도동,'45,40 - 44세,1998,196,111,85
'2920068000,  삼도동,'50,45 - 49세,1998,218,115,103
'2920068000,  삼도동,'55,50 - 54세,1998,191,97,94
'2920068000,  삼도동,'60,55 - 59세,1998,345,148,197
'2920068000,  삼도동,'65,60 - 64세,1998,340,147,193
'2920068000,  삼도동,'70,65 - 69세,1998,279,109,170
'2920068000,  삼도동,'75,70 - 74세,1998,215,98,117
'2920068000,  삼도동,'80,75 - 79세,1998,134,55,79
'2920068000,  삼도동,'85,80 - 84세,1998,54,19,35
'2920068000,  삼도동,'90,85+ ,1998,28,7,21
'2920069000,  본량동,'00,계,1998,3475,1744,1731
'2920069000,  본량동,'05,0 - 4세,1998,118,52,66
'2920069000,  본량동,'10,5 - 9세,1998,79,50,29
'2920069000,  본량동,'15,10 - 14세,1998,98,49,49
'2920069000,  본량동,'20,15 - 19세,1998,261,130,131
'2920069000,  본량동,'25,20 - 24세,1998,372,220,152
'2920069000,  본량동,'30,25 - 29세,1998,326,219,107
'2920069000,  본량동,'35,30 - 34세,1998,167,110,57
'2920069000,  본량동,'40,35 - 39세,1998,160,98,62
'2920069000,  본량동,'45,40 - 44세,1998,133,76,57
'2920069000,  본량동,'50,45 - 49세,1998,147,67,80
'2920069000,  본량동,'55,50 - 54세,1998,218,96,122
'2920069000,  본량동,'60,55 - 59세,1998,351,148,203
'2920069000,  본량동,'65,60 - 64세,1998,382,174,208
'2920069000,  본량동,'70,65 - 69세,1998,249,112,137
'2920069000,  본량동,'75,70 - 74세,1998,183,73,110
'2920069000,  본량동,'80,75 - 79세,1998,124,44,80
'2920069000,  본량동,'85,80 - 84세,1998,68,19,49
'2920069000,  본량동,'90,85+ ,1998,39,7,32
'30,대전광역시,'00,계,1998,1341413,674563,666850
'30,대전광역시,'05,0 - 4세,1998,104052,54996,49056
'30,대전광역시,'10,5 - 9세,1998,105998,56685,49313
'30,대전광역시,'15,10 - 14세,1998,100901,53160,47741
'30,대전광역시,'20,15 - 19세,1998,123264,63759,59505
'30,대전광역시,'25,20 - 24세,1998,115313,57566,57747
'30,대전광역시,'30,25 - 29세,1998,134607,67674,66933
'30,대전광역시,'35,30 - 34세,1998,126548,63209,63339
'30,대전광역시,'40,35 - 39세,1998,134020,67474,66546
'30,대전광역시,'45,40 - 44세,1998,112351,57038,55313
'30,대전광역시,'50,45 - 49세,1998,74129,38365,35764
'30,대전광역시,'55,50 - 54세,1998,55416,28318,27098
'30,대전광역시,'60,55 - 59세,1998,49798,24443,25355
'30,대전광역시,'65,60 - 64세,1998,37705,17413,20292
'30,대전광역시,'70,65 - 69세,1998,25883,10362,15521
'30,대전광역시,'75,70 - 74세,1998,18098,6809,11289
'30,대전광역시,'80,75 - 79세,1998,12510,4379,8131
'30,대전광역시,'85,80 - 84세,1998,6709,1979,4730
'30,대전광역시,'90,85+ ,1998,4111,934,3177
'30110, 동구,'00,계,1998,260749,132027,128722
'30110, 동구,'05,0 - 4세,1998,17211,9087,8124
'30110, 동구,'10,5 - 9세,1998,16693,8903,7790
'30110, 동구,'15,10 - 14세,1998,17119,9094,8025
'30110, 동구,'20,15 - 19세,1998,25046,12917,12129
'30110, 동구,'25,20 - 24세,1998,26676,13645,13031
'30110, 동구,'30,25 - 29세,1998,27716,14920,12796
'30110, 동구,'35,30 - 34세,1998,22190,11634,10556
'30110, 동구,'40,35 - 39세,1998,22554,11595,10959
'30110, 동구,'45,40 - 44세,1998,20211,10062,10149
'30110, 동구,'50,45 - 49세,1998,15080,7483,7597
'30110, 동구,'55,50 - 54세,1998,12825,6346,6479
'30110, 동구,'60,55 - 59세,1998,12383,5979,6404
'30110, 동구,'65,60 - 64세,1998,9429,4438,4991
'30110, 동구,'70,65 - 69세,1998,6240,2554,3686
'30110, 동구,'75,70 - 74세,1998,4249,1681,2568
'30110, 동구,'80,75 - 79세,1998,2818,1055,1763
'30110, 동구,'85,80 - 84세,1998,1439,430,1009
'30110, 동구,'90,85+ ,1998,870,204,666
'3011051500,  중앙동,'00,계,1998,4279,2189,2090
'3011051500,  중앙동,'05,0 - 4세,1998,145,85,60
'3011051500,  중앙동,'10,5 - 9세,1998,146,63,83
'3011051500,  중앙동,'15,10 - 14세,1998,173,98,75
'3011051500,  중앙동,'20,15 - 19세,1998,382,208,174
'3011051500,  중앙동,'25,20 - 24세,1998,405,241,164
'3011051500,  중앙동,'30,25 - 29세,1998,371,222,149
'3011051500,  중앙동,'35,30 - 34세,1998,253,126,127
'3011051500,  중앙동,'40,35 - 39세,1998,318,173,145
'3011051500,  중앙동,'45,40 - 44세,1998,377,179,198
'3011051500,  중앙동,'50,45 - 49세,1998,359,181,178
'3011051500,  중앙동,'55,50 - 54세,1998,315,155,160
'3011051500,  중앙동,'60,55 - 59세,1998,357,167,190
'3011051500,  중앙동,'65,60 - 64세,1998,233,100,133
'3011051500,  중앙동,'70,65 - 69세,1998,190,81,109
'3011051500,  중앙동,'75,70 - 74세,1998,100,38,62
'3011051500,  중앙동,'80,75 - 79세,1998,89,43,46
'3011051500,  중앙동,'85,80 - 84세,1998,41,21,20
'3011051500,  중앙동,'90,85+ ,1998,25,8,17
'3011052000,  인동,'00,계,1998,6744,3409,3335
'3011052000,  인동,'05,0 - 4세,1998,358,188,170
'3011052000,  인동,'10,5 - 9세,1998,316,170,146
'3011052000,  인동,'15,10 - 14세,1998,362,190,172
'3011052000,  인동,'20,15 - 19세,1998,676,335,341
'3011052000,  인동,'25,20 - 24세,1998,733,405,328
'3011052000,  인동,'30,25 - 29세,1998,675,390,285
'3011052000,  인동,'35,30 - 34세,1998,455,238,217
'3011052000,  인동,'40,35 - 39세,1998,507,255,252
'3011052000,  인동,'45,40 - 44세,1998,557,255,302
'3011052000,  인동,'50,45 - 49세,1998,458,207,251
'3011052000,  인동,'55,50 - 54세,1998,411,209,202
'3011052000,  인동,'60,55 - 59세,1998,431,206,225
'3011052000,  인동,'65,60 - 64세,1998,266,138,128
'3011052000,  인동,'70,65 - 69세,1998,207,83,124
'3011052000,  인동,'75,70 - 74세,1998,153,59,94
'3011052000,  인동,'80,75 - 79세,1998,103,52,51
'3011052000,  인동,'85,80 - 84세,1998,52,19,33
'3011052000,  인동,'90,85+ ,1998,24,10,14
'3011053000,  효동,'00,계,1998,15964,8065,7899
'3011053000,  효동,'05,0 - 4세,1998,1154,599,555
'3011053000,  효동,'10,5 - 9세,1998,984,522,462
'3011053000,  효동,'15,10 - 14세,1998,1042,538,504
'3011053000,  효동,'20,15 - 19세,1998,1462,739,723
'3011053000,  효동,'25,20 - 24세,1998,1472,745,727
'3011053000,  효동,'30,25 - 29세,1998,1732,902,830
'3011053000,  효동,'35,30 - 34세,1998,1439,769,670
'3011053000,  효동,'40,35 - 39세,1998,1422,787,635
'3011053000,  효동,'45,40 - 44세,1998,1198,636,562
'3011053000,  효동,'50,45 - 49세,1998,856,421,435
'3011053000,  효동,'55,50 - 54세,1998,756,349,407
'3011053000,  효동,'60,55 - 59세,1998,805,386,419
'3011053000,  효동,'65,60 - 64세,1998,629,300,329
'3011053000,  효동,'70,65 - 69세,1998,425,178,247
'3011053000,  효동,'75,70 - 74세,1998,273,109,164
'3011053000,  효동,'80,75 - 79세,1998,168,52,116
'3011053000,  효동,'85,80 - 84세,1998,86,21,65
'3011053000,  효동,'90,85+ ,1998,61,12,49
'3011054000,  신흥동,'00,계,1998,6826,3468,3358
'3011054000,  신흥동,'05,0 - 4세,1998,351,173,178
'3011054000,  신흥동,'10,5 - 9세,1998,386,195,191
'3011054000,  신흥동,'15,10 - 14세,1998,474,254,220
'3011054000,  신흥동,'20,15 - 19세,1998,628,335,293
'3011054000,  신흥동,'25,20 - 24세,1998,739,382,357
'3011054000,  신흥동,'30,25 - 29세,1998,677,400,277
'3011054000,  신흥동,'35,30 - 34세,1998,469,257,212
'3011054000,  신흥동,'40,35 - 39세,1998,571,288,283
'3011054000,  신흥동,'45,40 - 44세,1998,495,250,245
'3011054000,  신흥동,'50,45 - 49세,1998,425,203,222
'3011054000,  신흥동,'55,50 - 54세,1998,380,177,203
'3011054000,  신흥동,'60,55 - 59세,1998,417,208,209
'3011054000,  신흥동,'65,60 - 64세,1998,300,140,160
'3011054000,  신흥동,'70,65 - 69세,1998,204,91,113
'3011054000,  신흥동,'75,70 - 74세,1998,145,58,87
'3011054000,  신흥동,'80,75 - 79세,1998,78,32,46
'3011054000,  신흥동,'85,80 - 84세,1998,60,13,47
'3011054000,  신흥동,'90,85+ ,1998,27,12,15
'3011055100,  판암1동,'00,계,1998,14470,7272,7198
'3011055100,  판암1동,'05,0 - 4세,1998,1126,619,507
'3011055100,  판암1동,'10,5 - 9세,1998,1082,585,497
'3011055100,  판암1동,'15,10 - 14세,1998,1108,593,515
'3011055100,  판암1동,'20,15 - 19세,1998,1382,710,672
'3011055100,  판암1동,'25,20 - 24세,1998,1209,617,592
'3011055100,  판암1동,'30,25 - 29세,1998,1324,662,662
'3011055100,  판암1동,'35,30 - 34세,1998,1349,686,663
'3011055100,  판암1동,'40,35 - 39세,1998,1357,672,685
'3011055100,  판암1동,'45,40 - 44세,1998,1283,650,633
'3011055100,  판암1동,'50,45 - 49세,1998,775,397,378
'3011055100,  판암1동,'55,50 - 54세,1998,619,295,324
'3011055100,  판암1동,'60,55 - 59세,1998,528,246,282
'3011055100,  판암1동,'65,60 - 64세,1998,468,214,254
'3011055100,  판암1동,'70,65 - 69세,1998,339,143,196
'3011055100,  판암1동,'75,70 - 74세,1998,240,97,143
'3011055100,  판암1동,'80,75 - 79세,1998,142,45,97
'3011055100,  판암1동,'85,80 - 84세,1998,79,25,54
'3011055100,  판암1동,'90,85+ ,1998,60,16,44
'3011055200,  판암2동,'00,계,1998,19079,9698,9381
'3011055200,  판암2동,'05,0 - 4세,1998,1346,736,610
'3011055200,  판암2동,'10,5 - 9세,1998,1681,904,777
'3011055200,  판암2동,'15,10 - 14세,1998,1625,900,725
'3011055200,  판암2동,'20,15 - 19세,1998,1830,937,893
'3011055200,  판암2동,'25,20 - 24세,1998,1500,818,682
'3011055200,  판암2동,'30,25 - 29세,1998,1679,814,865
'3011055200,  판암2동,'35,30 - 34세,1998,1905,895,1010
'3011055200,  판암2동,'40,35 - 39세,1998,2128,1125,1003
'3011055200,  판암2동,'45,40 - 44세,1998,1672,868,804
'3011055200,  판암2동,'50,45 - 49세,1998,964,514,450
'3011055200,  판암2동,'55,50 - 54세,1998,697,374,323
'3011055200,  판암2동,'60,55 - 59세,1998,671,289,382
'3011055200,  판암2동,'65,60 - 64세,1998,492,229,263
'3011055200,  판암2동,'70,65 - 69세,1998,347,113,234
'3011055200,  판암2동,'75,70 - 74세,1998,257,89,168
'3011055200,  판암2동,'80,75 - 79세,1998,178,63,115
'3011055200,  판암2동,'85,80 - 84세,1998,67,20,47
'3011055200,  판암2동,'90,85+ ,1998,40,10,30
'3011056000,  용운동,'00,계,1998,21416,10761,10655
'3011056000,  용운동,'05,0 - 4세,1998,1777,921,856
'3011056000,  용운동,'10,5 - 9세,1998,1597,828,769
'3011056000,  용운동,'15,10 - 14세,1998,1417,753,664
'3011056000,  용운동,'20,15 - 19세,1998,1943,985,958
'3011056000,  용운동,'25,20 - 24세,1998,2165,1077,1088
'3011056000,  용운동,'30,25 - 29세,1998,2394,1260,1134
'3011056000,  용운동,'35,30 - 34세,1998,2062,1058,1004
'3011056000,  용운동,'40,35 - 39세,1998,2019,1035,984
'3011056000,  용운동,'45,40 - 44세,1998,1630,816,814
'3011056000,  용운동,'50,45 - 49세,1998,1116,580,536
'3011056000,  용운동,'55,50 - 54세,1998,836,421,415
'3011056000,  용운동,'60,55 - 59세,1998,763,369,394
'3011056000,  용운동,'65,60 - 64세,1998,669,299,370
'3011056000,  용운동,'70,65 - 69세,1998,410,150,260
'3011056000,  용운동,'75,70 - 74세,1998,269,94,175
'3011056000,  용운동,'80,75 - 79세,1998,198,78,120
'3011056000,  용운동,'85,80 - 84세,1998,98,28,70
'3011056000,  용운동,'90,85+ ,1998,53,9,44
'3011057500,  대신동,'00,계,1998,7752,3900,3852
'3011057500,  대신동,'05,0 - 4세,1998,413,217,196
'3011057500,  대신동,'10,5 - 9세,1998,410,224,186
'3011057500,  대신동,'15,10 - 14세,1998,478,258,220
'3011057500,  대신동,'20,15 - 19세,1998,749,378,371
'3011057500,  대신동,'25,20 - 24세,1998,814,418,396
'3011057500,  대신동,'30,25 - 29세,1998,755,425,330
'3011057500,  대신동,'35,30 - 34세,1998,577,322,255
'3011057500,  대신동,'40,35 - 39세,1998,654,314,340
'3011057500,  대신동,'45,40 - 44세,1998,585,308,277
'3011057500,  대신동,'50,45 - 49세,1998,483,237,246
'3011057500,  대신동,'55,50 - 54세,1998,422,210,212
'3011057500,  대신동,'60,55 - 59세,1998,431,206,225
'3011057500,  대신동,'65,60 - 64세,1998,363,159,204
'3011057500,  대신동,'70,65 - 69세,1998,223,84,139
'3011057500,  대신동,'75,70 - 74세,1998,189,72,117
'3011057500,  대신동,'80,75 - 79세,1998,120,47,73
'3011057500,  대신동,'85,80 - 84세,1998,54,13,41
'3011057500,  대신동,'90,85+ ,1998,32,8,24
'3011058500,  대동,'00,계,1998,9955,5031,4924
'3011058500,  대동,'05,0 - 4세,1998,586,325,261
'3011058500,  대동,'10,5 - 9세,1998,538,295,243
'3011058500,  대동,'15,10 - 14세,1998,629,339,290
'3011058500,  대동,'20,15 - 19세,1998,995,500,495
'3011058500,  대동,'25,20 - 24세,1998,1122,559,563
'3011058500,  대동,'30,25 - 29세,1998,1092,603,489
'3011058500,  대동,'35,30 - 34세,1998,763,410,353
'3011058500,  대동,'40,35 - 39세,1998,767,395,372
'3011058500,  대동,'45,40 - 44세,1998,769,375,394
'3011058500,  대동,'50,45 - 49세,1998,518,258,260
'3011058500,  대동,'55,50 - 54세,1998,542,250,292
'3011058500,  대동,'60,55 - 59세,1998,541,257,284
'3011058500,  대동,'65,60 - 64세,1998,418,196,222
'3011058500,  대동,'70,65 - 69세,1998,295,122,173
'3011058500,  대동,'75,70 - 74세,1998,170,69,101
'3011058500,  대동,'80,75 - 79세,1998,113,51,62
'3011058500,  대동,'85,80 - 84세,1998,60,18,42
'3011058500,  대동,'90,85+ ,1998,37,9,28
'3011059000,  자양동,'00,계,1998,16188,8191,7997
'3011059000,  자양동,'05,0 - 4세,1998,936,515,421
'3011059000,  자양동,'10,5 - 9세,1998,876,462,414
'3011059000,  자양동,'15,10 - 14세,1998,1064,580,484
'3011059000,  자양동,'20,15 - 19세,1998,1757,919,838
'3011059000,  자양동,'25,20 - 24세,1998,1928,955,973
'3011059000,  자양동,'30,25 - 29세,1998,1776,989,787
'3011059000,  자양동,'35,30 - 34세,1998,1228,648,580
'3011059000,  자양동,'40,35 - 39세,1998,1294,606,688
'3011059000,  자양동,'45,40 - 44세,1998,1272,617,655
'3011059000,  자양동,'50,45 - 49세,1998,1027,474,553
'3011059000,  자양동,'55,50 - 54세,1998,878,464,414
'3011059000,  자양동,'60,55 - 59세,1998,719,378,341
'3011059000,  자양동,'65,60 - 64세,1998,519,231,288
'3011059000,  자양동,'70,65 - 69세,1998,375,159,216
'3011059000,  자양동,'75,70 - 74세,1998,233,97,136
'3011059000,  자양동,'80,75 - 79세,1998,139,51,88
'3011059000,  자양동,'85,80 - 84세,1998,99,32,67
'3011059000,  자양동,'90,85+ ,1998,68,14,54
'3011061000,  소제동,'00,계,1998,5415,2757,2658
'3011061000,  소제동,'05,0 - 4세,1998,307,170,137
'3011061000,  소제동,'10,5 - 9세,1998,288,156,132
'3011061000,  소제동,'15,10 - 14세,1998,306,162,144
'3011061000,  소제동,'20,15 - 19세,1998,546,281,265
'3011061000,  소제동,'25,20 - 24세,1998,566,293,273
'3011061000,  소제동,'30,25 - 29세,1998,593,337,256
'3011061000,  소제동,'35,30 - 34세,1998,400,236,164
'3011061000,  소제동,'40,35 - 39세,1998,389,214,175
'3011061000,  소제동,'45,40 - 44세,1998,369,180,189
'3011061000,  소제동,'50,45 - 49세,1998,304,149,155
'3011061000,  소제동,'55,50 - 54세,1998,276,125,151
'3011061000,  소제동,'60,55 - 59세,1998,341,164,177
'3011061000,  소제동,'65,60 - 64세,1998,256,113,143
'3011061000,  소제동,'70,65 - 69세,1998,198,79,119
'3011061000,  소제동,'75,70 - 74세,1998,123,52,71
'3011061000,  소제동,'80,75 - 79세,1998,93,30,63
'3011061000,  소제동,'85,80 - 84세,1998,44,11,33
'3011061000,  소제동,'90,85+ ,1998,16,5,11
'3011062000,  가양1동,'00,계,1998,19405,9765,9640
'3011062000,  가양1동,'05,0 - 4세,1998,1234,655,579
'3011062000,  가양1동,'10,5 - 9세,1998,1169,636,533
'3011062000,  가양1동,'15,10 - 14세,1998,1184,601,583
'3011062000,  가양1동,'20,15 - 19세,1998,1823,923,900
'3011062000,  가양1동,'25,20 - 24세,1998,2225,1121,1104
'3011062000,  가양1동,'30,25 - 29세,1998,2251,1214,1037
'3011062000,  가양1동,'35,30 - 34세,1998,1547,826,721
'3011062000,  가양1동,'40,35 - 39세,1998,1547,795,752
'3011062000,  가양1동,'45,40 - 44세,1998,1392,659,733
'3011062000,  가양1동,'50,45 - 49세,1998,1134,553,581
'3011062000,  가양1동,'55,50 - 54세,1998,1017,483,534
'3011062000,  가양1동,'60,55 - 59세,1998,1044,487,557
'3011062000,  가양1동,'65,60 - 64세,1998,753,397,356
'3011062000,  가양1동,'70,65 - 69세,1998,432,188,244
'3011062000,  가양1동,'75,70 - 74세,1998,290,126,164
'3011062000,  가양1동,'80,75 - 79세,1998,186,65,121
'3011062000,  가양1동,'85,80 - 84세,1998,104,23,81
'3011062000,  가양1동,'90,85+ ,1998,73,13,60
'3011063000,  가양2동,'00,계,1998,26755,13461,13294
'3011063000,  가양2동,'05,0 - 4세,1998,1903,1009,894
'3011063000,  가양2동,'10,5 - 9세,1998,2006,1069,937
'3011063000,  가양2동,'15,10 - 14세,1998,2079,1098,981
'3011063000,  가양2동,'20,15 - 19세,1998,2755,1444,1311
'3011063000,  가양2동,'25,20 - 24세,1998,2667,1304,1363
'3011063000,  가양2동,'30,25 - 29세,1998,2725,1392,1333
'3011063000,  가양2동,'35,30 - 34세,1998,2360,1191,1169
'3011063000,  가양2동,'40,35 - 39세,1998,2510,1211,1299
'3011063000,  가양2동,'45,40 - 44세,1998,2229,1112,1117
'3011063000,  가양2동,'50,45 - 49세,1998,1580,795,785
'3011063000,  가양2동,'55,50 - 54세,1998,1180,618,562
'3011063000,  가양2동,'60,55 - 59세,1998,977,482,495
'3011063000,  가양2동,'65,60 - 64세,1998,689,335,354
'3011063000,  가양2동,'70,65 - 69세,1998,412,160,252
'3011063000,  가양2동,'75,70 - 74세,1998,314,129,185
'3011063000,  가양2동,'80,75 - 79세,1998,205,69,136
'3011063000,  가양2동,'85,80 - 84세,1998,103,28,75
'3011063000,  가양2동,'90,85+ ,1998,61,15,46
'3011064000,  용전동,'00,계,1998,18110,9082,9028
'3011064000,  용전동,'05,0 - 4세,1998,1374,697,677
'3011064000,  용전동,'10,5 - 9세,1998,1239,678,561
'3011064000,  용전동,'15,10 - 14세,1998,1137,590,547
'3011064000,  용전동,'20,15 - 19세,1998,1643,846,797
'3011064000,  용전동,'25,20 - 24세,1998,1817,901,916
'3011064000,  용전동,'30,25 - 29세,1998,2055,1078,977
'3011064000,  용전동,'35,30 - 34세,1998,1708,865,843
'3011064000,  용전동,'40,35 - 39세,1998,1693,874,819
'3011064000,  용전동,'45,40 - 44세,1998,1436,677,759
'3011064000,  용전동,'50,45 - 49세,1998,1021,494,527
'3011064000,  용전동,'55,50 - 54세,1998,872,438,434
'3011064000,  용전동,'60,55 - 59세,1998,757,379,378
'3011064000,  용전동,'65,60 - 64세,1998,563,272,291
'3011064000,  용전동,'70,65 - 69세,1998,328,134,194
'3011064000,  용전동,'75,70 - 74세,1998,212,81,131
'3011064000,  용전동,'80,75 - 79세,1998,127,44,83
'3011064000,  용전동,'85,80 - 84세,1998,85,29,56
'3011064000,  용전동,'90,85+ ,1998,43,5,38
'3011065000,  성남1동,'00,계,1998,6753,3504,3249
'3011065000,  성남1동,'05,0 - 4세,1998,373,186,187
'3011065000,  성남1동,'10,5 - 9세,1998,371,202,169
'3011065000,  성남1동,'15,10 - 14세,1998,422,229,193
'3011065000,  성남1동,'20,15 - 19세,1998,655,337,318
'3011065000,  성남1동,'25,20 - 24세,1998,736,409,327
'3011065000,  성남1동,'30,25 - 29세,1998,719,423,296
'3011065000,  성남1동,'35,30 - 34세,1998,503,292,211
'3011065000,  성남1동,'40,35 - 39세,1998,534,282,252
'3011065000,  성남1동,'45,40 - 44세,1998,501,249,252
'3011065000,  성남1동,'50,45 - 49세,1998,418,220,198
'3011065000,  성남1동,'55,50 - 54세,1998,381,174,207
'3011065000,  성남1동,'60,55 - 59세,1998,364,188,176
'3011065000,  성남1동,'65,60 - 64세,1998,318,143,175
'3011065000,  성남1동,'70,65 - 69세,1998,185,68,117
'3011065000,  성남1동,'75,70 - 74세,1998,143,58,85
'3011065000,  성남1동,'80,75 - 79세,1998,70,28,42
'3011065000,  성남1동,'85,80 - 84세,1998,36,12,24
'3011065000,  성남1동,'90,85+ ,1998,24,4,20
'3011066000,  성남2동,'00,계,1998,7908,4016,3892
'3011066000,  성남2동,'05,0 - 4세,1998,439,214,225
'3011066000,  성남2동,'10,5 - 9세,1998,414,224,190
'3011066000,  성남2동,'15,10 - 14세,1998,479,269,210
'3011066000,  성남2동,'20,15 - 19세,1998,829,424,405
'3011066000,  성남2동,'25,20 - 24세,1998,804,420,384
'3011066000,  성남2동,'30,25 - 29세,1998,884,485,399
'3011066000,  성남2동,'35,30 - 34세,1998,632,340,292
'3011066000,  성남2동,'40,35 - 39세,1998,632,327,305
'3011066000,  성남2동,'45,40 - 44세,1998,617,330,287
'3011066000,  성남2동,'50,45 - 49세,1998,475,233,242
'3011066000,  성남2동,'55,50 - 54세,1998,409,197,212
'3011066000,  성남2동,'60,55 - 59세,1998,412,190,222
'3011066000,  성남2동,'65,60 - 64세,1998,321,154,167
'3011066000,  성남2동,'70,65 - 69세,1998,241,101,140
'3011066000,  성남2동,'75,70 - 74세,1998,141,56,85
'3011066000,  성남2동,'80,75 - 79세,1998,103,33,70
'3011066000,  성남2동,'85,80 - 84세,1998,49,12,37
'3011066000,  성남2동,'90,85+ ,1998,27,7,20
'3011067000,  홍도동,'00,계,1998,16018,8213,7805
'3011067000,  홍도동,'05,0 - 4세,1998,1295,664,631
'3011067000,  홍도동,'10,5 - 9세,1998,1108,605,503
'3011067000,  홍도동,'15,10 - 14세,1998,857,460,397
'3011067000,  홍도동,'20,15 - 19세,1998,1319,698,621
'3011067000,  홍도동,'25,20 - 24세,1998,1708,850,858
'3011067000,  홍도동,'30,25 - 29세,1998,2161,1136,1025
'3011067000,  홍도동,'35,30 - 34세,1998,1661,912,749
'3011067000,  홍도동,'40,35 - 39세,1998,1315,715,600
'3011067000,  홍도동,'45,40 - 44세,1998,1061,529,532
'3011067000,  홍도동,'50,45 - 49세,1998,853,409,444
'3011067000,  홍도동,'55,50 - 54세,1998,746,376,370
'3011067000,  홍도동,'60,55 - 59세,1998,668,335,333
'3011067000,  홍도동,'65,60 - 64세,1998,490,226,264
'3011067000,  홍도동,'70,65 - 69세,1998,312,137,175
'3011067000,  홍도동,'75,70 - 74세,1998,214,87,127
'3011067000,  홍도동,'80,75 - 79세,1998,140,43,97
'3011067000,  홍도동,'85,80 - 84세,1998,65,19,46
'3011067000,  홍도동,'90,85+ ,1998,45,12,33
'3011068000,  삼성1동,'00,계,1998,7772,3909,3863
'3011068000,  삼성1동,'05,0 - 4세,1998,369,189,180
'3011068000,  삼성1동,'10,5 - 9세,1998,396,208,188
'3011068000,  삼성1동,'15,10 - 14세,1998,480,253,227
'3011068000,  삼성1동,'20,15 - 19세,1998,774,400,374
'3011068000,  삼성1동,'25,20 - 24세,1998,869,427,442
'3011068000,  삼성1동,'30,25 - 29세,1998,778,448,330
'3011068000,  삼성1동,'35,30 - 34세,1998,554,293,261
'3011068000,  삼성1동,'40,35 - 39세,1998,590,320,270
'3011068000,  삼성1동,'45,40 - 44세,1998,630,292,338
'3011068000,  삼성1동,'50,45 - 49세,1998,517,254,263
'3011068000,  삼성1동,'55,50 - 54세,1998,451,223,228
'3011068000,  삼성1동,'60,55 - 59세,1998,449,215,234
'3011068000,  삼성1동,'65,60 - 64세,1998,351,154,197
'3011068000,  삼성1동,'70,65 - 69세,1998,232,101,131
'3011068000,  삼성1동,'75,70 - 74세,1998,142,63,79
'3011068000,  삼성1동,'80,75 - 79세,1998,110,44,66
'3011068000,  삼성1동,'85,80 - 84세,1998,48,16,32
'3011068000,  삼성1동,'90,85+ ,1998,32,9,23
'3011069000,  삼성2동,'00,계,1998,11722,6029,5693
'3011069000,  삼성2동,'05,0 - 4세,1998,688,358,330
'3011069000,  삼성2동,'10,5 - 9세,1998,718,385,333
'3011069000,  삼성2동,'15,10 - 14세,1998,722,376,346
'3011069000,  삼성2동,'20,15 - 19세,1998,1181,634,547
'3011069000,  삼성2동,'25,20 - 24세,1998,1281,680,601
'3011069000,  삼성2동,'30,25 - 29세,1998,1312,752,560
'3011069000,  삼성2동,'35,30 - 34세,1998,942,490,452
'3011069000,  삼성2동,'40,35 - 39세,1998,967,484,483
'3011069000,  삼성2동,'45,40 - 44세,1998,849,413,436
'3011069000,  삼성2동,'50,45 - 49세,1998,729,377,352
'3011069000,  삼성2동,'55,50 - 54세,1998,652,308,344
'3011069000,  삼성2동,'60,55 - 59세,1998,596,299,297
'3011069000,  삼성2동,'65,60 - 64세,1998,431,224,207
'3011069000,  삼성2동,'70,65 - 69세,1998,250,113,137
'3011069000,  삼성2동,'75,70 - 74세,1998,191,64,127
'3011069000,  삼성2동,'80,75 - 79세,1998,122,50,72
'3011069000,  삼성2동,'85,80 - 84세,1998,48,13,35
'3011069000,  삼성2동,'90,85+ ,1998,43,9,34
'3011072500,  대청동,'00,계,1998,3839,1970,1869
'3011072500,  대청동,'05,0 - 4세,1998,175,94,81
'3011072500,  대청동,'10,5 - 9세,1998,170,86,84
'3011072500,  대청동,'15,10 - 14세,1998,207,109,98
'3011072500,  대청동,'20,15 - 19세,1998,315,157,158
'3011072500,  대청동,'25,20 - 24세,1998,327,180,147
'3011072500,  대청동,'30,25 - 29세,1998,333,206,127
'3011072500,  대청동,'35,30 - 34세,1998,286,163,123
'3011072500,  대청동,'40,35 - 39세,1998,275,155,120
'3011072500,  대청동,'45,40 - 44세,1998,247,132,115
'3011072500,  대청동,'50,45 - 49세,1998,213,119,94
'3011072500,  대청동,'55,50 - 54세,1998,168,87,81
'3011072500,  대청동,'60,55 - 59세,1998,253,104,149
'3011072500,  대청동,'65,60 - 64세,1998,299,128,171
'3011072500,  대청동,'70,65 - 69세,1998,212,99,113
'3011072500,  대청동,'75,70 - 74세,1998,161,68,93
'3011072500,  대청동,'80,75 - 79세,1998,113,48,65
'3011072500,  대청동,'85,80 - 84세,1998,59,28,31
'3011072500,  대청동,'90,85+ ,1998,26,7,19
'3011074000,  산내동,'00,계,1998,14379,7337,7042
'3011074000,  산내동,'05,0 - 4세,1998,862,473,389
'3011074000,  산내동,'10,5 - 9세,1998,798,406,392
'3011074000,  산내동,'15,10 - 14세,1998,874,444,430
'3011074000,  산내동,'20,15 - 19세,1998,1402,727,675
'3011074000,  산내동,'25,20 - 24세,1998,1589,843,746
'3011074000,  산내동,'30,25 - 29세,1998,1430,782,648
'3011074000,  산내동,'35,30 - 34세,1998,1097,617,480
'3011074000,  산내동,'40,35 - 39세,1998,1065,568,497
'3011074000,  산내동,'45,40 - 44세,1998,1042,535,507
'3011074000,  산내동,'50,45 - 49세,1998,855,408,447
'3011074000,  산내동,'55,50 - 54세,1998,817,413,404
'3011074000,  산내동,'60,55 - 59세,1998,859,424,435
'3011074000,  산내동,'65,60 - 64세,1998,601,286,315
'3011074000,  산내동,'70,65 - 69세,1998,423,170,253
'3011074000,  산내동,'75,70 - 74세,1998,289,115,174
'3011074000,  산내동,'80,75 - 79세,1998,221,87,134
'3011074000,  산내동,'85,80 - 84세,1998,102,29,73
'3011074000,  산내동,'90,85+ ,1998,53,10,43
'30140, 중구,'00,계,1998,259044,129626,129418
'30140, 중구,'05,0 - 4세,1998,16820,8895,7925
'30140, 중구,'10,5 - 9세,1998,16373,8854,7519
'30140, 중구,'15,10 - 14세,1998,17213,9125,8088
'30140, 중구,'20,15 - 19세,1998,25570,13254,12316
'30140, 중구,'25,20 - 24세,1998,25622,12995,12627
'30140, 중구,'30,25 - 29세,1998,26540,13715,12825
'30140, 중구,'35,30 - 34세,1998,21316,10937,10379
'30140, 중구,'40,35 - 39세,1998,22212,11027,11185
'30140, 중구,'45,40 - 44세,1998,20764,10036,10728
'30140, 중구,'50,45 - 49세,1998,15874,7762,8112
'30140, 중구,'55,50 - 54세,1998,13299,6589,6710
'30140, 중구,'60,55 - 59세,1998,12318,5988,6330
'30140, 중구,'65,60 - 64세,1998,9257,4373,4884
'30140, 중구,'70,65 - 69세,1998,6158,2603,3555
'30140, 중구,'75,70 - 74세,1998,4337,1704,2633
'30140, 중구,'80,75 - 79세,1998,2883,1065,1818
'30140, 중구,'85,80 - 84세,1998,1551,496,1055
'30140, 중구,'90,85+ ,1998,937,208,729
'3014053500,  은행선화동,'00,계,1998,15794,7764,8030
'3014053500,  은행선화동,'05,0 - 4세,1998,684,358,326
'3014053500,  은행선화동,'10,5 - 9세,1998,724,386,338
'3014053500,  은행선화동,'15,10 - 14세,1998,901,476,425
'3014053500,  은행선화동,'20,15 - 19세,1998,1607,780,827
'3014053500,  은행선화동,'25,20 - 24세,1998,1830,910,920
'3014053500,  은행선화동,'30,25 - 29세,1998,1739,934,805
'3014053500,  은행선화동,'35,30 - 34세,1998,1059,560,499
'3014053500,  은행선화동,'40,35 - 39세,1998,1124,534,590
'3014053500,  은행선화동,'45,40 - 44세,1998,1303,606,697
'3014053500,  은행선화동,'50,45 - 49세,1998,1041,480,561
'3014053500,  은행선화동,'55,50 - 54세,1998,965,450,515
'3014053500,  은행선화동,'60,55 - 59세,1998,904,454,450
'3014053500,  은행선화동,'65,60 - 64세,1998,688,321,367
'3014053500,  은행선화동,'70,65 - 69세,1998,464,205,259
'3014053500,  은행선화동,'75,70 - 74세,1998,344,144,200
'3014053500,  은행선화동,'80,75 - 79세,1998,225,110,115
'3014053500,  은행선화동,'85,80 - 84세,1998,106,35,71
'3014053500,  은행선화동,'90,85+ ,1998,86,21,65
'3014055000,  목동,'00,계,1998,7388,3701,3687
'3014055000,  목동,'05,0 - 4세,1998,384,208,176
'3014055000,  목동,'10,5 - 9세,1998,379,215,164
'3014055000,  목동,'15,10 - 14세,1998,426,226,200
'3014055000,  목동,'20,15 - 19세,1998,734,381,353
'3014055000,  목동,'25,20 - 24세,1998,855,429,426
'3014055000,  목동,'30,25 - 29세,1998,829,477,352
'3014055000,  목동,'35,30 - 34세,1998,513,259,254
'3014055000,  목동,'40,35 - 39세,1998,566,277,289
'3014055000,  목동,'45,40 - 44세,1998,564,257,307
'3014055000,  목동,'50,45 - 49세,1998,457,217,240
'3014055000,  목동,'55,50 - 54세,1998,371,189,182
'3014055000,  목동,'60,55 - 59세,1998,426,198,228
'3014055000,  목동,'65,60 - 64세,1998,355,146,209
'3014055000,  목동,'70,65 - 69세,1998,219,103,116
'3014055000,  목동,'75,70 - 74세,1998,134,62,72
'3014055000,  목동,'80,75 - 79세,1998,99,36,63
'3014055000,  목동,'85,80 - 84세,1998,53,16,37
'3014055000,  목동,'90,85+ ,1998,24,5,19
'3014056000,  중촌동,'00,계,1998,19707,9680,10027
'3014056000,  중촌동,'05,0 - 4세,1998,1597,861,736
'3014056000,  중촌동,'10,5 - 9세,1998,1231,641,590
'3014056000,  중촌동,'15,10 - 14세,1998,1305,672,633
'3014056000,  중촌동,'20,15 - 19세,1998,1932,1018,914
'3014056000,  중촌동,'25,20 - 24세,1998,1963,975,988
'3014056000,  중촌동,'30,25 - 29세,1998,2200,1033,1167
'3014056000,  중촌동,'35,30 - 34세,1998,1803,906,897
'3014056000,  중촌동,'40,35 - 39세,1998,1712,849,863
'3014056000,  중촌동,'45,40 - 44세,1998,1609,767,842
'3014056000,  중촌동,'50,45 - 49세,1998,1178,558,620
'3014056000,  중촌동,'55,50 - 54세,1998,872,425,447
'3014056000,  중촌동,'60,55 - 59세,1998,770,378,392
'3014056000,  중촌동,'65,60 - 64세,1998,515,217,298
'3014056000,  중촌동,'70,65 - 69세,1998,362,150,212
'3014056000,  중촌동,'75,70 - 74세,1998,297,106,191
'3014056000,  중촌동,'80,75 - 79세,1998,189,75,114
'3014056000,  중촌동,'85,80 - 84세,1998,115,35,80
'3014056000,  중촌동,'90,85+ ,1998,57,14,43
'3014057500,  대흥동,'00,계,1998,13453,6705,6748
'3014057500,  대흥동,'05,0 - 4세,1998,580,302,278
'3014057500,  대흥동,'10,5 - 9세,1998,692,381,311
'3014057500,  대흥동,'15,10 - 14세,1998,933,511,422
'3014057500,  대흥동,'20,15 - 19세,1998,1486,828,658
'3014057500,  대흥동,'25,20 - 24세,1998,1346,681,665
'3014057500,  대흥동,'30,25 - 29세,1998,1288,726,562
'3014057500,  대흥동,'35,30 - 34세,1998,912,472,440
'3014057500,  대흥동,'40,35 - 39세,1998,1039,458,581
'3014057500,  대흥동,'45,40 - 44세,1998,1171,501,670
'3014057500,  대흥동,'50,45 - 49세,1998,918,458,460
'3014057500,  대흥동,'55,50 - 54세,1998,775,360,415
'3014057500,  대흥동,'60,55 - 59세,1998,718,348,370
'3014057500,  대흥동,'65,60 - 64세,1998,550,274,276
'3014057500,  대흥동,'70,65 - 69세,1998,401,169,232
'3014057500,  대흥동,'75,70 - 74세,1998,282,111,171
'3014057500,  대흥동,'80,75 - 79세,1998,196,80,116
'3014057500,  대흥동,'85,80 - 84세,1998,105,34,71
'3014057500,  대흥동,'90,85+ ,1998,61,11,50
'3014060500,  문창동,'00,계,1998,9002,4511,4491
'3014060500,  문창동,'05,0 - 4세,1998,487,272,215
'3014060500,  문창동,'10,5 - 9세,1998,460,255,205
'3014060500,  문창동,'15,10 - 14세,1998,561,298,263
'3014060500,  문창동,'20,15 - 19세,1998,933,463,470
'3014060500,  문창동,'25,20 - 24세,1998,901,461,440
'3014060500,  문창동,'30,25 - 29세,1998,926,513,413
'3014060500,  문창동,'35,30 - 34세,1998,685,368,317
'3014060500,  문창동,'40,35 - 39세,1998,754,368,386
'3014060500,  문창동,'45,40 - 44세,1998,737,346,391
'3014060500,  문창동,'50,45 - 49세,1998,514,257,257
'3014060500,  문창동,'55,50 - 54세,1998,506,240,266
'3014060500,  문창동,'60,55 - 59세,1998,555,255,300
'3014060500,  문창동,'65,60 - 64세,1998,347,168,179
'3014060500,  문창동,'70,65 - 69세,1998,258,96,162
'3014060500,  문창동,'75,70 - 74세,1998,182,83,99
'3014060500,  문창동,'80,75 - 79세,1998,100,32,68
'3014060500,  문창동,'85,80 - 84세,1998,63,26,37
'3014060500,  문창동,'90,85+ ,1998,33,10,23
'3014062000,  석교동,'00,계,1998,26412,13411,13001
'3014062000,  석교동,'05,0 - 4세,1998,1802,948,854
'3014062000,  석교동,'10,5 - 9세,1998,1908,1034,874
'3014062000,  석교동,'15,10 - 14세,1998,1874,976,898
'3014062000,  석교동,'20,15 - 19세,1998,2525,1314,1211
'3014062000,  석교동,'25,20 - 24세,1998,2586,1329,1257
'3014062000,  석교동,'30,25 - 29세,1998,2697,1421,1276
'3014062000,  석교동,'35,30 - 34세,1998,2218,1126,1092
'3014062000,  석교동,'40,35 - 39세,1998,2419,1229,1190
'3014062000,  석교동,'45,40 - 44세,1998,2056,1043,1013
'3014062000,  석교동,'50,45 - 49세,1998,1562,786,776
'3014062000,  석교동,'55,50 - 54세,1998,1272,640,632
'3014062000,  석교동,'60,55 - 59세,1998,1170,590,580
'3014062000,  석교동,'65,60 - 64세,1998,889,415,474
'3014062000,  석교동,'70,65 - 69세,1998,595,262,333
'3014062000,  석교동,'75,70 - 74세,1998,399,145,254
'3014062000,  석교동,'80,75 - 79세,1998,240,87,153
'3014062000,  석교동,'85,80 - 84세,1998,122,45,77
'3014062000,  석교동,'90,85+ ,1998,78,21,57
'3014063000,  대사동,'00,계,1998,8962,4550,4412
'3014063000,  대사동,'05,0 - 4세,1998,457,250,207
'3014063000,  대사동,'10,5 - 9세,1998,395,228,167
'3014063000,  대사동,'15,10 - 14세,1998,511,266,245
'3014063000,  대사동,'20,15 - 19세,1998,864,467,397
'3014063000,  대사동,'25,20 - 24세,1998,956,505,451
'3014063000,  대사동,'30,25 - 29세,1998,918,523,395
'3014063000,  대사동,'35,30 - 34세,1998,587,319,268
'3014063000,  대사동,'40,35 - 39세,1998,673,329,344
'3014063000,  대사동,'45,40 - 44세,1998,625,301,324
'3014063000,  대사동,'50,45 - 49세,1998,570,271,299
'3014063000,  대사동,'55,50 - 54세,1998,543,264,279
'3014063000,  대사동,'60,55 - 59세,1998,580,267,313
'3014063000,  대사동,'65,60 - 64세,1998,449,211,238
'3014063000,  대사동,'70,65 - 69세,1998,331,159,172
'3014063000,  대사동,'75,70 - 74세,1998,235,97,138
'3014063000,  대사동,'80,75 - 79세,1998,146,57,89
'3014063000,  대사동,'85,80 - 84세,1998,83,28,55
'3014063000,  대사동,'90,85+ ,1998,39,8,31
'3014064000,  부사동,'00,계,1998,10730,5425,5305
'3014064000,  부사동,'05,0 - 4세,1998,576,281,295
'3014064000,  부사동,'10,5 - 9세,1998,580,319,261
'3014064000,  부사동,'15,10 - 14세,1998,633,327,306
'3014064000,  부사동,'20,15 - 19세,1998,1166,629,537
'3014064000,  부사동,'25,20 - 24세,1998,1189,613,576
'3014064000,  부사동,'30,25 - 29세,1998,1131,622,509
'3014064000,  부사동,'35,30 - 34세,1998,788,436,352
'3014064000,  부사동,'40,35 - 39세,1998,801,413,388
'3014064000,  부사동,'45,40 - 44세,1998,803,375,428
'3014064000,  부사동,'50,45 - 49세,1998,654,305,349
'3014064000,  부사동,'55,50 - 54세,1998,605,311,294
'3014064000,  부사동,'60,55 - 59세,1998,640,310,330
'3014064000,  부사동,'65,60 - 64세,1998,466,228,238
'3014064000,  부사동,'70,65 - 69세,1998,260,100,160
'3014064000,  부사동,'75,70 - 74세,1998,215,90,125
'3014064000,  부사동,'80,75 - 79세,1998,129,43,86
'3014064000,  부사동,'85,80 - 84세,1998,58,17,41
'3014064000,  부사동,'90,85+ ,1998,36,6,30
'3014065500,  용두동,'00,계,1998,12691,6391,6300
'3014065500,  용두동,'05,0 - 4세,1998,767,435,332
'3014065500,  용두동,'10,5 - 9세,1998,649,357,292
'3014065500,  용두동,'15,10 - 14세,1998,708,368,340
'3014065500,  용두동,'20,15 - 19세,1998,1205,609,596
'3014065500,  용두동,'25,20 - 24세,1998,1403,720,683
'3014065500,  용두동,'30,25 - 29세,1998,1396,744,652
'3014065500,  용두동,'35,30 - 34세,1998,1026,567,459
'3014065500,  용두동,'40,35 - 39세,1998,924,482,442
'3014065500,  용두동,'45,40 - 44세,1998,949,461,488
'3014065500,  용두동,'50,45 - 49세,1998,762,363,399
'3014065500,  용두동,'55,50 - 54세,1998,708,344,364
'3014065500,  용두동,'60,55 - 59세,1998,722,325,397
'3014065500,  용두동,'65,60 - 64세,1998,555,270,285
'3014065500,  용두동,'70,65 - 69세,1998,363,153,210
'3014065500,  용두동,'75,70 - 74세,1998,257,99,158
'3014065500,  용두동,'80,75 - 79세,1998,166,54,112
'3014065500,  용두동,'85,80 - 84세,1998,78,25,53
'3014065500,  용두동,'90,85+ ,1998,53,15,38
'3014067000,  오류동,'00,계,1998,12501,6091,6410
'3014067000,  오류동,'05,0 - 4세,1998,724,381,343
'3014067000,  오류동,'10,5 - 9세,1998,842,449,393
'3014067000,  오류동,'15,10 - 14세,1998,861,457,404
'3014067000,  오류동,'20,15 - 19세,1998,1228,592,636
'3014067000,  오류동,'25,20 - 24세,1998,1160,613,547
'3014067000,  오류동,'30,25 - 29세,1998,1176,583,593
'3014067000,  오류동,'35,30 - 34세,1998,927,450,477
'3014067000,  오류동,'40,35 - 39세,1998,1025,453,572
'3014067000,  오류동,'45,40 - 44세,1998,1040,513,527
'3014067000,  오류동,'50,45 - 49세,1998,811,380,431
'3014067000,  오류동,'55,50 - 54세,1998,701,325,376
'3014067000,  오류동,'60,55 - 59세,1998,605,298,307
'3014067000,  오류동,'65,60 - 64세,1998,521,247,274
'3014067000,  오류동,'70,65 - 69세,1998,337,156,181
'3014067000,  오류동,'75,70 - 74세,1998,229,83,146
'3014067000,  오류동,'80,75 - 79세,1998,165,65,100
'3014067000,  오류동,'85,80 - 84세,1998,95,32,63
'3014067000,  오류동,'90,85+ ,1998,54,14,40
'3014068000,  태평1동,'00,계,1998,8601,4340,4261
'3014068000,  태평1동,'05,0 - 4세,1998,587,327,260
'3014068000,  태평1동,'10,5 - 9세,1998,587,328,259
'3014068000,  태평1동,'15,10 - 14세,1998,616,312,304
'3014068000,  태평1동,'20,15 - 19세,1998,870,450,420
'3014068000,  태평1동,'25,20 - 24세,1998,865,430,435
'3014068000,  태평1동,'30,25 - 29세,1998,890,460,430
'3014068000,  태평1동,'35,30 - 34세,1998,707,355,352
'3014068000,  태평1동,'40,35 - 39세,1998,798,415,383
'3014068000,  태평1동,'45,40 - 44세,1998,719,354,365
'3014068000,  태평1동,'50,45 - 49세,1998,526,263,263
'3014068000,  태평1동,'55,50 - 54세,1998,408,195,213
'3014068000,  태평1동,'60,55 - 59세,1998,360,192,168
'3014068000,  태평1동,'65,60 - 64세,1998,253,112,141
'3014068000,  태평1동,'70,65 - 69세,1998,168,68,100
'3014068000,  태평1동,'75,70 - 74세,1998,113,45,68
'3014068000,  태평1동,'80,75 - 79세,1998,71,19,52
'3014068000,  태평1동,'85,80 - 84세,1998,37,8,29
'3014068000,  태평1동,'90,85+ ,1998,26,7,19
'3014069000,  태평2동,'00,계,1998,16204,7968,8236
'3014069000,  태평2동,'05,0 - 4세,1998,995,483,512
'3014069000,  태평2동,'10,5 - 9세,1998,1074,578,496
'3014069000,  태평2동,'15,10 - 14세,1998,1126,620,506
'3014069000,  태평2동,'20,15 - 19세,1998,1643,832,811
'3014069000,  태평2동,'25,20 - 24세,1998,1643,798,845
'3014069000,  태평2동,'30,25 - 29세,1998,1565,793,772
'3014069000,  태평2동,'35,30 - 34세,1998,1210,610,600
'3014069000,  태평2동,'40,35 - 39세,1998,1377,653,724
'3014069000,  태평2동,'45,40 - 44세,1998,1383,631,752
'3014069000,  태평2동,'50,45 - 49세,1998,1160,556,604
'3014069000,  태평2동,'55,50 - 54세,1998,888,456,432
'3014069000,  태평2동,'60,55 - 59세,1998,692,355,337
'3014069000,  태평2동,'65,60 - 64세,1998,525,264,261
'3014069000,  태평2동,'70,65 - 69세,1998,319,132,187
'3014069000,  태평2동,'75,70 - 74세,1998,251,91,160
'3014069000,  태평2동,'80,75 - 79세,1998,193,75,118
'3014069000,  태평2동,'85,80 - 84세,1998,106,28,78
'3014069000,  태평2동,'90,85+ ,1998,54,13,41
'3014070000,  유천1동,'00,계,1998,9360,4656,4704
'3014070000,  유천1동,'05,0 - 4세,1998,491,275,216
'3014070000,  유천1동,'10,5 - 9세,1998,535,296,239
'3014070000,  유천1동,'15,10 - 14세,1998,568,297,271
'3014070000,  유천1동,'20,15 - 19세,1998,884,418,466
'3014070000,  유천1동,'25,20 - 24세,1998,1047,525,522
'3014070000,  유천1동,'30,25 - 29세,1998,998,558,440
'3014070000,  유천1동,'35,30 - 34세,1998,668,339,329
'3014070000,  유천1동,'40,35 - 39세,1998,759,380,379
'3014070000,  유천1동,'45,40 - 44세,1998,748,350,398
'3014070000,  유천1동,'50,45 - 49세,1998,662,302,360
'3014070000,  유천1동,'55,50 - 54세,1998,572,280,292
'3014070000,  유천1동,'60,55 - 59세,1998,523,245,278
'3014070000,  유천1동,'65,60 - 64세,1998,338,167,171
'3014070000,  유천1동,'70,65 - 69세,1998,220,103,117
'3014070000,  유천1동,'75,70 - 74세,1998,157,64,93
'3014070000,  유천1동,'80,75 - 79세,1998,99,32,67
'3014070000,  유천1동,'85,80 - 84세,1998,56,18,38
'3014070000,  유천1동,'90,85+ ,1998,35,7,28
'3014071000,  유천2동,'00,계,1998,19284,9601,9683
'3014071000,  유천2동,'05,0 - 4세,1998,1147,602,545
'3014071000,  유천2동,'10,5 - 9세,1998,1183,654,529
'3014071000,  유천2동,'15,10 - 14세,1998,1352,699,653
'3014071000,  유천2동,'20,15 - 19세,1998,1961,1008,953
'3014071000,  유천2동,'25,20 - 24세,1998,2014,1025,989
'3014071000,  유천2동,'30,25 - 29세,1998,1883,960,923
'3014071000,  유천2동,'35,30 - 34세,1998,1375,707,668
'3014071000,  유천2동,'40,35 - 39세,1998,1586,747,839
'3014071000,  유천2동,'45,40 - 44세,1998,1655,799,856
'3014071000,  유천2동,'50,45 - 49세,1998,1314,635,679
'3014071000,  유천2동,'55,50 - 54세,1998,1101,578,523
'3014071000,  유천2동,'60,55 - 59세,1998,946,466,480
'3014071000,  유천2동,'65,60 - 64세,1998,684,329,355
'3014071000,  유천2동,'70,65 - 69세,1998,420,183,237
'3014071000,  유천2동,'75,70 - 74세,1998,278,99,179
'3014071000,  유천2동,'80,75 - 79세,1998,193,61,132
'3014071000,  유천2동,'85,80 - 84세,1998,118,32,86
'3014071000,  유천2동,'90,85+ ,1998,74,17,57
'3014072000,  문화1동,'00,계,1998,16236,8131,8105
'3014072000,  문화1동,'05,0 - 4세,1998,1381,711,670
'3014072000,  문화1동,'10,5 - 9세,1998,1071,571,500
'3014072000,  문화1동,'15,10 - 14세,1998,1000,547,453
'3014072000,  문화1동,'20,15 - 19세,1998,1547,817,730
'3014072000,  문화1동,'25,20 - 24세,1998,1401,692,709
'3014072000,  문화1동,'30,25 - 29세,1998,1672,832,840
'3014072000,  문화1동,'35,30 - 34세,1998,1635,845,790
'3014072000,  문화1동,'40,35 - 39세,1998,1427,745,682
'3014072000,  문화1동,'45,40 - 44세,1998,1193,560,633
'3014072000,  문화1동,'50,45 - 49세,1998,915,462,453
'3014072000,  문화1동,'55,50 - 54세,1998,743,371,372
'3014072000,  문화1동,'60,55 - 59세,1998,711,323,388
'3014072000,  문화1동,'65,60 - 64세,1998,589,286,303
'3014072000,  문화1동,'70,65 - 69세,1998,379,141,238
'3014072000,  문화1동,'75,70 - 74세,1998,251,113,138
'3014072000,  문화1동,'80,75 - 79세,1998,169,75,94
'3014072000,  문화1동,'85,80 - 84세,1998,83,27,56
'3014072000,  문화1동,'90,85+ ,1998,69,13,56
'3014073000,  문화2동,'00,계,1998,19927,10043,9884
'3014073000,  문화2동,'05,0 - 4세,1998,1711,920,791
'3014073000,  문화2동,'10,5 - 9세,1998,1672,886,786
'3014073000,  문화2동,'15,10 - 14세,1998,1495,800,695
'3014073000,  문화2동,'20,15 - 19세,1998,1710,939,771
'3014073000,  문화2동,'25,20 - 24세,1998,1513,754,759
'3014073000,  문화2동,'30,25 - 29세,1998,2028,931,1097
'3014073000,  문화2동,'35,30 - 34세,1998,2175,1084,1091
'3014073000,  문화2동,'40,35 - 39세,1998,2169,1115,1054
'3014073000,  문화2동,'45,40 - 44세,1998,1506,809,697
'3014073000,  문화2동,'50,45 - 49세,1998,948,457,491
'3014073000,  문화2동,'55,50 - 54세,1998,797,389,408
'3014073000,  문화2동,'60,55 - 59세,1998,730,358,372
'3014073000,  문화2동,'65,60 - 64세,1998,539,259,280
'3014073000,  문화2동,'70,65 - 69세,1998,385,161,224
'3014073000,  문화2동,'75,70 - 74세,1998,240,94,146
'3014073000,  문화2동,'80,75 - 79세,1998,172,58,114
'3014073000,  문화2동,'85,80 - 84세,1998,81,24,57
'3014073000,  문화2동,'90,85+ ,1998,56,5,51
'3014074000,  산성동,'00,계,1998,32792,16658,16134
'3014074000,  산성동,'05,0 - 4세,1998,2450,1281,1169
'3014074000,  산성동,'10,5 - 9세,1998,2391,1276,1115
'3014074000,  산성동,'15,10 - 14세,1998,2343,1273,1070
'3014074000,  산성동,'20,15 - 19세,1998,3275,1709,1566
'3014074000,  산성동,'25,20 - 24세,1998,2950,1535,1415
'3014074000,  산성동,'30,25 - 29세,1998,3204,1605,1599
'3014074000,  산성동,'35,30 - 34세,1998,3028,1534,1494
'3014074000,  산성동,'40,35 - 39세,1998,3059,1580,1479
'3014074000,  산성동,'45,40 - 44세,1998,2703,1363,1340
'3014074000,  산성동,'50,45 - 49세,1998,1882,1012,870
'3014074000,  산성동,'55,50 - 54세,1998,1472,772,700
'3014074000,  산성동,'60,55 - 59세,1998,1266,626,640
'3014074000,  산성동,'65,60 - 64세,1998,994,459,535
'3014074000,  산성동,'70,65 - 69세,1998,677,262,415
'3014074000,  산성동,'75,70 - 74세,1998,473,178,295
'3014074000,  산성동,'80,75 - 79세,1998,331,106,225
'3014074000,  산성동,'85,80 - 84세,1998,192,66,126
'3014074000,  산성동,'90,85+ ,1998,102,21,81
'30170, 서구,'00,계,1998,463024,231164,231860
'30170, 서구,'05,0 - 4세,1998,36672,19505,17167
'30170, 서구,'10,5 - 9세,1998,39952,21286,18666
'30170, 서구,'15,10 - 14세,1998,38885,20595,18290
'30170, 서구,'20,15 - 19세,1998,43785,22805,20980
'30170, 서구,'25,20 - 24세,1998,36869,17912,18957
'30170, 서구,'30,25 - 29세,1998,43448,20641,22807
'30170, 서구,'35,30 - 34세,1998,43660,20923,22737
'30170, 서구,'40,35 - 39세,1998,49894,24328,25566
'30170, 서구,'45,40 - 44세,1998,42427,21514,20913
'30170, 서구,'50,45 - 49세,1998,26061,13932,12129
'30170, 서구,'55,50 - 54세,1998,17370,9177,8193
'30170, 서구,'60,55 - 59세,1998,14145,7204,6941
'30170, 서구,'65,60 - 64세,1998,10250,4686,5564
'30170, 서구,'70,65 - 69세,1998,7321,2789,4532
'30170, 서구,'75,70 - 74세,1998,5096,1817,3279
'30170, 서구,'80,75 - 79세,1998,3783,1181,2602
'30170, 서구,'85,80 - 84세,1998,2060,576,1484
'30170, 서구,'90,85+ ,1998,1346,293,1053
'3017051000,  복수동,'00,계,1998,12048,5895,6153
'3017051000,  복수동,'05,0 - 4세,1998,976,492,484
'3017051000,  복수동,'10,5 - 9세,1998,1018,532,486
'3017051000,  복수동,'15,10 - 14세,1998,949,502,447
'3017051000,  복수동,'20,15 - 19세,1998,1286,636,650
'3017051000,  복수동,'25,20 - 24세,1998,1037,489,548
'3017051000,  복수동,'30,25 - 29세,1998,1088,486,602
'3017051000,  복수동,'35,30 - 34세,1998,1110,541,569
'3017051000,  복수동,'40,35 - 39세,1998,1212,588,624
'3017051000,  복수동,'45,40 - 44세,1998,1060,517,543
'3017051000,  복수동,'50,45 - 49세,1998,719,405,314
'3017051000,  복수동,'55,50 - 54세,1998,429,215,214
'3017051000,  복수동,'60,55 - 59세,1998,396,200,196
'3017051000,  복수동,'65,60 - 64세,1998,258,113,145
'3017051000,  복수동,'70,65 - 69세,1998,190,86,104
'3017051000,  복수동,'75,70 - 74세,1998,142,37,105
'3017051000,  복수동,'80,75 - 79세,1998,95,31,64
'3017051000,  복수동,'85,80 - 84세,1998,54,19,35
'3017051000,  복수동,'90,85+ ,1998,29,6,23
'3017052000,  도마1동,'00,계,1998,26999,13646,13353
'3017052000,  도마1동,'05,0 - 4세,1998,1924,1060,864
'3017052000,  도마1동,'10,5 - 9세,1998,1732,854,878
'3017052000,  도마1동,'15,10 - 14세,1998,1751,980,771
'3017052000,  도마1동,'20,15 - 19세,1998,2710,1451,1259
'3017052000,  도마1동,'25,20 - 24세,1998,3059,1488,1571
'3017052000,  도마1동,'30,25 - 29세,1998,3035,1624,1411
'3017052000,  도마1동,'35,30 - 34세,1998,2338,1197,1141
'3017052000,  도마1동,'40,35 - 39세,1998,2223,1138,1085
'3017052000,  도마1동,'45,40 - 44세,1998,2080,974,1106
'3017052000,  도마1동,'50,45 - 49세,1998,1601,788,813
'3017052000,  도마1동,'55,50 - 54세,1998,1319,654,665
'3017052000,  도마1동,'60,55 - 59세,1998,1164,619,545
'3017052000,  도마1동,'65,60 - 64세,1998,792,380,412
'3017052000,  도마1동,'70,65 - 69세,1998,511,193,318
'3017052000,  도마1동,'75,70 - 74세,1998,305,119,186
'3017052000,  도마1동,'80,75 - 79세,1998,228,71,157
'3017052000,  도마1동,'85,80 - 84세,1998,140,36,104
'3017052000,  도마1동,'90,85+ ,1998,87,20,67
'3017053000,  도마2동,'00,계,1998,28218,14191,14027
'3017053000,  도마2동,'05,0 - 4세,1998,1636,863,773
'3017053000,  도마2동,'10,5 - 9세,1998,1915,1021,894
'3017053000,  도마2동,'15,10 - 14세,1998,2093,1137,956
'3017053000,  도마2동,'20,15 - 19세,1998,3230,1710,1520
'3017053000,  도마2동,'25,20 - 24세,1998,3140,1569,1571
'3017053000,  도마2동,'30,25 - 29세,1998,2584,1368,1216
'3017053000,  도마2동,'35,30 - 34세,1998,2042,1005,1037
'3017053000,  도마2동,'40,35 - 39세,1998,2475,1156,1319
'3017053000,  도마2동,'45,40 - 44세,1998,2513,1213,1300
'3017053000,  도마2동,'50,45 - 49세,1998,1860,932,928
'3017053000,  도마2동,'55,50 - 54세,1998,1412,730,682
'3017053000,  도마2동,'60,55 - 59세,1998,1124,584,540
'3017053000,  도마2동,'65,60 - 64세,1998,818,391,427
'3017053000,  도마2동,'70,65 - 69세,1998,531,213,318
'3017053000,  도마2동,'75,70 - 74세,1998,356,150,206
'3017053000,  도마2동,'80,75 - 79세,1998,266,83,183
'3017053000,  도마2동,'85,80 - 84세,1998,131,47,84
'3017053000,  도마2동,'90,85+ ,1998,92,19,73
'3017053500,  정림동,'00,계,1998,22756,11464,11292
'3017053500,  정림동,'05,0 - 4세,1998,2090,1105,985
'3017053500,  정림동,'10,5 - 9세,1998,2406,1267,1139
'3017053500,  정림동,'15,10 - 14세,1998,1995,1028,967
'3017053500,  정림동,'20,15 - 19세,1998,1904,1006,898
'3017053500,  정림동,'25,20 - 24세,1998,1457,721,736
'3017053500,  정림동,'30,25 - 29세,1998,1920,864,1056
'3017053500,  정림동,'35,30 - 34세,1998,2509,1171,1338
'3017053500,  정림동,'40,35 - 39세,1998,2885,1475,1410
'3017053500,  정림동,'45,40 - 44세,1998,1912,1055,857
'3017053500,  정림동,'50,45 - 49세,1998,1043,586,457
'3017053500,  정림동,'55,50 - 54세,1998,667,330,337
'3017053500,  정림동,'60,55 - 59세,1998,590,302,288
'3017053500,  정림동,'65,60 - 64세,1998,480,216,264
'3017053500,  정림동,'70,65 - 69세,1998,321,126,195
'3017053500,  정림동,'75,70 - 74세,1998,255,103,152
'3017053500,  정림동,'80,75 - 79세,1998,171,67,104
'3017053500,  정림동,'85,80 - 84세,1998,90,28,62
'3017053500,  정림동,'90,85+ ,1998,61,14,47
'3017054000,  변동,'00,계,1998,21225,10722,10503
'3017054000,  변동,'05,0 - 4세,1998,1633,867,766
'3017054000,  변동,'10,5 - 9세,1998,1442,769,673
'3017054000,  변동,'15,10 - 14세,1998,1434,795,639
'3017054000,  변동,'20,15 - 19세,1998,2128,1099,1029
'3017054000,  변동,'25,20 - 24세,1998,2234,1085,1149
'3017054000,  변동,'30,25 - 29세,1998,2400,1234,1166
'3017054000,  변동,'35,30 - 34세,1998,1947,1039,908
'3017054000,  변동,'40,35 - 39세,1998,1800,902,898
'3017054000,  변동,'45,40 - 44세,1998,1591,747,844
'3017054000,  변동,'50,45 - 49세,1998,1321,663,658
'3017054000,  변동,'55,50 - 54세,1998,995,509,486
'3017054000,  변동,'60,55 - 59세,1998,841,433,408
'3017054000,  변동,'65,60 - 64세,1998,548,252,296
'3017054000,  변동,'70,65 - 69세,1998,366,152,214
'3017054000,  변동,'75,70 - 74세,1998,228,92,136
'3017054000,  변동,'80,75 - 79세,1998,155,46,109
'3017054000,  변동,'85,80 - 84세,1998,95,27,68
'3017054000,  변동,'90,85+ ,1998,67,11,56
'3017055000,  용문동,'00,계,1998,16039,8092,7947
'3017055000,  용문동,'05,0 - 4세,1998,1188,648,540
'3017055000,  용문동,'10,5 - 9세,1998,958,519,439
'3017055000,  용문동,'15,10 - 14세,1998,944,482,462
'3017055000,  용문동,'20,15 - 19세,1998,1543,795,748
'3017055000,  용문동,'25,20 - 24세,1998,1763,893,870
'3017055000,  용문동,'30,25 - 29세,1998,1860,951,909
'3017055000,  용문동,'35,30 - 34세,1998,1434,767,667
'3017055000,  용문동,'40,35 - 39세,1998,1262,634,628
'3017055000,  용문동,'45,40 - 44세,1998,1179,574,605
'3017055000,  용문동,'50,45 - 49세,1998,990,507,483
'3017055000,  용문동,'55,50 - 54세,1998,797,382,415
'3017055000,  용문동,'60,55 - 59세,1998,741,369,372
'3017055000,  용문동,'65,60 - 64세,1998,544,263,281
'3017055000,  용문동,'70,65 - 69세,1998,331,153,178
'3017055000,  용문동,'75,70 - 74세,1998,217,78,139
'3017055000,  용문동,'80,75 - 79세,1998,141,44,97
'3017055000,  용문동,'85,80 - 84세,1998,97,26,71
'3017055000,  용문동,'90,85+ ,1998,50,7,43
'3017055500,  탄방동,'00,계,1998,26486,13031,13455
'3017055500,  탄방동,'05,0 - 4세,1998,2226,1206,1020
'3017055500,  탄방동,'10,5 - 9세,1998,2314,1228,1086
'3017055500,  탄방동,'15,10 - 14세,1998,2168,1142,1026
'3017055500,  탄방동,'20,15 - 19세,1998,2234,1184,1050
'3017055500,  탄방동,'25,20 - 24세,1998,1938,837,1101
'3017055500,  탄방동,'30,25 - 29세,1998,3092,1437,1655
'3017055500,  탄방동,'35,30 - 34세,1998,2726,1273,1453
'3017055500,  탄방동,'40,35 - 39세,1998,3084,1493,1591
'3017055500,  탄방동,'45,40 - 44세,1998,2376,1210,1166
'3017055500,  탄방동,'50,45 - 49세,1998,1345,706,639
'3017055500,  탄방동,'55,50 - 54세,1998,829,439,390
'3017055500,  탄방동,'60,55 - 59세,1998,630,318,312
'3017055500,  탄방동,'65,60 - 64세,1998,535,237,298
'3017055500,  탄방동,'70,65 - 69세,1998,408,142,266
'3017055500,  탄방동,'75,70 - 74세,1998,253,103,150
'3017055500,  탄방동,'80,75 - 79세,1998,177,47,130
'3017055500,  탄방동,'85,80 - 84세,1998,96,19,77
'3017055500,  탄방동,'90,85+ ,1998,55,10,45
'3017056000,  괴정동,'00,계,1998,17272,8689,8583
'3017056000,  괴정동,'05,0 - 4세,1998,1218,647,571
'3017056000,  괴정동,'10,5 - 9세,1998,1199,650,549
'3017056000,  괴정동,'15,10 - 14세,1998,1089,568,521
'3017056000,  괴정동,'20,15 - 19세,1998,1714,885,829
'3017056000,  괴정동,'25,20 - 24세,1998,1760,918,842
'3017056000,  괴정동,'30,25 - 29세,1998,1837,917,920
'3017056000,  괴정동,'35,30 - 34세,1998,1514,792,722
'3017056000,  괴정동,'40,35 - 39세,1998,1466,746,720
'3017056000,  괴정동,'45,40 - 44세,1998,1362,649,713
'3017056000,  괴정동,'50,45 - 49세,1998,1074,535,539
'3017056000,  괴정동,'55,50 - 54세,1998,849,414,435
'3017056000,  괴정동,'60,55 - 59세,1998,765,383,382
'3017056000,  괴정동,'65,60 - 64세,1998,543,275,268
'3017056000,  괴정동,'70,65 - 69세,1998,354,142,212
'3017056000,  괴정동,'75,70 - 74세,1998,214,90,124
'3017056000,  괴정동,'80,75 - 79세,1998,167,46,121
'3017056000,  괴정동,'85,80 - 84세,1998,77,24,53
'3017056000,  괴정동,'90,85+ ,1998,70,8,62
'3017057000,  가장동,'00,계,1998,8143,4122,4021
'3017057000,  가장동,'05,0 - 4세,1998,557,267,290
'3017057000,  가장동,'10,5 - 9세,1998,594,306,288
'3017057000,  가장동,'15,10 - 14세,1998,535,293,242
'3017057000,  가장동,'20,15 - 19세,1998,810,437,373
'3017057000,  가장동,'25,20 - 24세,1998,824,428,396
'3017057000,  가장동,'30,25 - 29세,1998,893,480,413
'3017057000,  가장동,'35,30 - 34세,1998,708,353,355
'3017057000,  가장동,'40,35 - 39세,1998,687,355,332
'3017057000,  가장동,'45,40 - 44세,1998,629,320,309
'3017057000,  가장동,'50,45 - 49세,1998,509,233,276
'3017057000,  가장동,'55,50 - 54세,1998,437,219,218
'3017057000,  가장동,'60,55 - 59세,1998,344,189,155
'3017057000,  가장동,'65,60 - 64세,1998,261,116,145
'3017057000,  가장동,'70,65 - 69세,1998,147,65,82
'3017057000,  가장동,'75,70 - 74세,1998,86,26,60
'3017057000,  가장동,'80,75 - 79세,1998,70,16,54
'3017057000,  가장동,'85,80 - 84세,1998,33,14,19
'3017057000,  가장동,'90,85+ ,1998,19,5,14
'3017057500,  내동,'00,계,1998,25570,12754,12816
'3017057500,  내동,'05,0 - 4세,1998,1951,1043,908
'3017057500,  내동,'10,5 - 9세,1998,2281,1231,1050
'3017057500,  내동,'15,10 - 14세,1998,2194,1152,1042
'3017057500,  내동,'20,15 - 19세,1998,2518,1311,1207
'3017057500,  내동,'25,20 - 24세,1998,2095,1044,1051
'3017057500,  내동,'30,25 - 29세,1998,2214,1057,1157
'3017057500,  내동,'35,30 - 34세,1998,2281,1055,1226
'3017057500,  내동,'40,35 - 39세,1998,2747,1328,1419
'3017057500,  내동,'45,40 - 44세,1998,2416,1197,1219
'3017057500,  내동,'50,45 - 49세,1998,1525,799,726
'3017057500,  내동,'55,50 - 54세,1998,994,552,442
'3017057500,  내동,'60,55 - 59세,1998,765,380,385
'3017057500,  내동,'65,60 - 64세,1998,522,244,278
'3017057500,  내동,'70,65 - 69세,1998,393,151,242
'3017057500,  내동,'75,70 - 74세,1998,298,104,194
'3017057500,  내동,'80,75 - 79세,1998,219,69,150
'3017057500,  내동,'85,80 - 84세,1998,86,22,64
'3017057500,  내동,'90,85+ ,1998,71,15,56
'3017058100,  갈마1동,'00,계,1998,21817,10872,10945
'3017058100,  갈마1동,'05,0 - 4세,1998,1488,756,732
'3017058100,  갈마1동,'10,5 - 9세,1998,1736,950,786
'3017058100,  갈마1동,'15,10 - 14세,1998,2054,1102,952
'3017058100,  갈마1동,'20,15 - 19세,1998,2144,1090,1054
'3017058100,  갈마1동,'25,20 - 24세,1998,1848,862,986
'3017058100,  갈마1동,'30,25 - 29세,1998,2211,1142,1069
'3017058100,  갈마1동,'35,30 - 34세,1998,1750,852,898
'3017058100,  갈마1동,'40,35 - 39세,1998,2321,1057,1264
'3017058100,  갈마1동,'45,40 - 44세,1998,2217,1153,1064
'3017058100,  갈마1동,'50,45 - 49세,1998,1181,631,550
'3017058100,  갈마1동,'55,50 - 54세,1998,830,448,382
'3017058100,  갈마1동,'60,55 - 59세,1998,624,310,314
'3017058100,  갈마1동,'65,60 - 64세,1998,456,218,238
'3017058100,  갈마1동,'70,65 - 69세,1998,332,124,208
'3017058100,  갈마1동,'75,70 - 74세,1998,246,71,175
'3017058100,  갈마1동,'80,75 - 79세,1998,189,63,126
'3017058100,  갈마1동,'85,80 - 84세,1998,116,26,90
'3017058100,  갈마1동,'90,85+ ,1998,74,17,57
'3017058200,  갈마2동,'00,계,1998,24016,11790,12226
'3017058200,  갈마2동,'05,0 - 4세,1998,2538,1388,1150
'3017058200,  갈마2동,'10,5 - 9세,1998,2194,1170,1024
'3017058200,  갈마2동,'15,10 - 14세,1998,1681,817,864
'3017058200,  갈마2동,'20,15 - 19세,1998,1729,888,841
'3017058200,  갈마2동,'25,20 - 24세,1998,1908,757,1151
'3017058200,  갈마2동,'30,25 - 29세,1998,3220,1469,1751
'3017058200,  갈마2동,'35,30 - 34세,1998,2965,1451,1514
'3017058200,  갈마2동,'40,35 - 39세,1998,2682,1396,1286
'3017058200,  갈마2동,'45,40 - 44세,1998,1809,934,875
'3017058200,  갈마2동,'50,45 - 49세,1998,1021,525,496
'3017058200,  갈마2동,'55,50 - 54세,1998,660,337,323
'3017058200,  갈마2동,'60,55 - 59세,1998,543,289,254
'3017058200,  갈마2동,'65,60 - 64세,1998,335,139,196
'3017058200,  갈마2동,'70,65 - 69세,1998,273,103,170
'3017058200,  갈마2동,'75,70 - 74세,1998,197,65,132
'3017058200,  갈마2동,'80,75 - 79세,1998,133,40,93
'3017058200,  갈마2동,'85,80 - 84세,1998,74,10,64
'3017058200,  갈마2동,'90,85+ ,1998,54,12,42
'3017058600,  월평1동,'00,계,1998,12474,6159,6315
'3017058600,  월평1동,'05,0 - 4세,1998,1317,708,609
'3017058600,  월평1동,'10,5 - 9세,1998,937,486,451
'3017058600,  월평1동,'15,10 - 14세,1998,656,360,296
'3017058600,  월평1동,'20,15 - 19세,1998,828,393,435
'3017058600,  월평1동,'25,20 - 24세,1998,1263,548,715
'3017058600,  월평1동,'30,25 - 29세,1998,2298,1104,1194
'3017058600,  월평1동,'35,30 - 34세,1998,1556,829,727
'3017058600,  월평1동,'40,35 - 39세,1998,1125,568,557
'3017058600,  월평1동,'45,40 - 44세,1998,828,402,426
'3017058600,  월평1동,'50,45 - 49세,1998,510,248,262
'3017058600,  월평1동,'55,50 - 54세,1998,366,185,181
'3017058600,  월평1동,'60,55 - 59세,1998,274,142,132
'3017058600,  월평1동,'65,60 - 64세,1998,192,89,103
'3017058600,  월평1동,'70,65 - 69세,1998,118,39,79
'3017058600,  월평1동,'75,70 - 74세,1998,82,30,52
'3017058600,  월평1동,'80,75 - 79세,1998,65,19,46
'3017058600,  월평1동,'85,80 - 84세,1998,38,7,31
'3017058600,  월평1동,'90,85+ ,1998,21,2,19
'3017058700,  월평2동,'00,계,1998,24936,12399,12537
'3017058700,  월평2동,'05,0 - 4세,1998,1540,858,682
'3017058700,  월평2동,'10,5 - 9세,1998,2342,1243,1099
'3017058700,  월평2동,'15,10 - 14세,1998,2396,1290,1106
'3017058700,  월평2동,'20,15 - 19세,1998,2792,1422,1370
'3017058700,  월평2동,'25,20 - 24세,1998,1796,948,848
'3017058700,  월평2동,'30,25 - 29세,1998,1681,769,912
'3017058700,  월평2동,'35,30 - 34세,1998,2053,901,1152
'3017058700,  월평2동,'40,35 - 39세,1998,2816,1337,1479
'3017058700,  월평2동,'45,40 - 44세,1998,2624,1336,1288
'3017058700,  월평2동,'50,45 - 49세,1998,1543,847,696
'3017058700,  월평2동,'55,50 - 54세,1998,968,527,441
'3017058700,  월평2동,'60,55 - 59세,1998,741,363,378
'3017058700,  월평2동,'65,60 - 64세,1998,540,221,319
'3017058700,  월평2동,'70,65 - 69세,1998,410,140,270
'3017058700,  월평2동,'75,70 - 74세,1998,297,97,200
'3017058700,  월평2동,'80,75 - 79세,1998,215,66,149
'3017058700,  월평2동,'85,80 - 84세,1998,113,18,95
'3017058700,  월평2동,'90,85+ ,1998,69,16,53
'3017058800,  월평3동,'00,계,1998,29754,14860,14894
'3017058800,  월평3동,'05,0 - 4세,1998,2064,1054,1010
'3017058800,  월평3동,'10,5 - 9세,1998,3330,1836,1494
'3017058800,  월평3동,'15,10 - 14세,1998,3620,1928,1692
'3017058800,  월평3동,'20,15 - 19세,1998,2939,1543,1396
'3017058800,  월평3동,'25,20 - 24세,1998,1458,734,724
'3017058800,  월평3동,'30,25 - 29세,1998,1458,653,805
'3017058800,  월평3동,'35,30 - 34세,1998,2408,911,1497
'3017058800,  월평3동,'40,35 - 39세,1998,4395,2035,2360
'3017058800,  월평3동,'45,40 - 44세,1998,3644,1976,1668
'3017058800,  월평3동,'50,45 - 49세,1998,1669,981,688
'3017058800,  월평3동,'55,50 - 54세,1998,808,477,331
'3017058800,  월평3동,'60,55 - 59세,1998,559,292,267
'3017058800,  월평3동,'65,60 - 64세,1998,431,180,251
'3017058800,  월평3동,'70,65 - 69세,1998,347,110,237
'3017058800,  월평3동,'75,70 - 74세,1998,259,72,187
'3017058800,  월평3동,'80,75 - 79세,1998,204,44,160
'3017058800,  월평3동,'85,80 - 84세,1998,104,25,79
'3017058800,  월평3동,'90,85+ ,1998,57,9,48
'3017059000,  가수원동,'00,계,1998,38022,19089,18933
'3017059000,  가수원동,'05,0 - 4세,1998,4111,2181,1930
'3017059000,  가수원동,'10,5 - 9세,1998,3608,1872,1736
'3017059000,  가수원동,'15,10 - 14세,1998,2818,1477,1341
'3017059000,  가수원동,'20,15 - 19세,1998,2772,1406,1366
'3017059000,  가수원동,'25,20 - 24세,1998,2458,1183,1275
'3017059000,  가수원동,'30,25 - 29세,1998,4038,1768,2270
'3017059000,  가수원동,'35,30 - 34세,1998,4659,2392,2267
'3017059000,  가수원동,'40,35 - 39세,1998,4191,2253,1938
'3017059000,  가수원동,'45,40 - 44세,1998,2862,1524,1338
'3017059000,  가수원동,'50,45 - 49세,1998,1675,890,785
'3017059000,  가수원동,'55,50 - 54세,1998,1192,639,553
'3017059000,  가수원동,'60,55 - 59세,1998,1100,518,582
'3017059000,  가수원동,'65,60 - 64세,1998,861,384,477
'3017059000,  가수원동,'70,65 - 69세,1998,657,238,419
'3017059000,  가수원동,'75,70 - 74세,1998,439,166,273
'3017059000,  가수원동,'80,75 - 79세,1998,319,126,193
'3017059000,  가수원동,'85,80 - 84세,1998,163,50,113
'3017059000,  가수원동,'90,85+ ,1998,99,22,77
'3017060000,  기성동,'00,계,1998,5164,2696,2468
'3017060000,  기성동,'05,0 - 4세,1998,213,110,103
'3017060000,  기성동,'10,5 - 9세,1998,247,138,109
'3017060000,  기성동,'15,10 - 14세,1998,257,126,131
'3017060000,  기성동,'20,15 - 19세,1998,468,255,213
'3017060000,  기성동,'25,20 - 24세,1998,553,310,243
'3017060000,  기성동,'30,25 - 29세,1998,419,268,151
'3017060000,  기성동,'35,30 - 34세,1998,304,181,123
'3017060000,  기성동,'40,35 - 39세,1998,338,195,143
'3017060000,  기성동,'45,40 - 44세,1998,340,192,148
'3017060000,  기성동,'50,45 - 49세,1998,258,139,119
'3017060000,  기성동,'55,50 - 54세,1998,267,133,134
'3017060000,  기성동,'60,55 - 59세,1998,374,175,199
'3017060000,  기성동,'65,60 - 64세,1998,337,159,178
'3017060000,  기성동,'70,65 - 69세,1998,233,89,144
'3017060000,  기성동,'75,70 - 74세,1998,226,94,132
'3017060000,  기성동,'80,75 - 79세,1998,170,67,103
'3017060000,  기성동,'85,80 - 84세,1998,98,40,58
'3017060000,  기성동,'90,85+ ,1998,62,25,37
'3017061000,  삼천동,'00,계,1998,27588,13577,14011
'3017061000,  삼천동,'05,0 - 4세,1998,1269,672,597
'3017061000,  삼천동,'10,5 - 9세,1998,1903,1025,878
'3017061000,  삼천동,'15,10 - 14세,1998,2765,1471,1294
'3017061000,  삼천동,'20,15 - 19세,1998,3555,1882,1673
'3017061000,  삼천동,'25,20 - 24세,1998,2489,1259,1230
'3017061000,  삼천동,'30,25 - 29세,1998,1839,921,918
'3017061000,  삼천동,'35,30 - 34세,1998,1499,642,857
'3017061000,  삼천동,'40,35 - 39세,1998,2597,1075,1522
'3017061000,  삼천동,'45,40 - 44세,1998,3161,1437,1724
'3017061000,  삼천동,'50,45 - 49세,1998,2175,1133,1042
'3017061000,  삼천동,'55,50 - 54세,1998,1445,797,648
'3017061000,  삼천동,'60,55 - 59세,1998,951,500,451
'3017061000,  삼천동,'65,60 - 64세,1998,637,321,316
'3017061000,  삼천동,'70,65 - 69세,1998,433,174,259
'3017061000,  삼천동,'75,70 - 74세,1998,323,112,211
'3017061000,  삼천동,'80,75 - 79세,1998,268,87,181
'3017061000,  삼천동,'85,80 - 84세,1998,156,39,117
'3017061000,  삼천동,'90,85+ ,1998,123,30,93
'3017063000,  둔산1동,'00,계,1998,19260,9547,9713
'3017063000,  둔산1동,'05,0 - 4세,1998,748,408,340
'3017063000,  둔산1동,'10,5 - 9세,1998,1516,843,673
'3017063000,  둔산1동,'15,10 - 14세,1998,2208,1147,1061
'3017063000,  둔산1동,'20,15 - 19세,1998,2513,1317,1196
'3017063000,  둔산1동,'25,20 - 24세,1998,1488,765,723
'3017063000,  둔산1동,'30,25 - 29세,1998,877,429,448
'3017063000,  둔산1동,'35,30 - 34세,1998,774,303,471
'3017063000,  둔산1동,'40,35 - 39세,1998,1871,737,1134
'3017063000,  둔산1동,'45,40 - 44세,1998,2482,1159,1323
'3017063000,  둔산1동,'50,45 - 49세,1998,1616,900,716
'3017063000,  둔산1동,'55,50 - 54세,1998,981,554,427
'3017063000,  둔산1동,'60,55 - 59세,1998,749,403,346
'3017063000,  둔산1동,'65,60 - 64세,1998,462,229,233
'3017063000,  둔산1동,'70,65 - 69세,1998,366,158,208
'3017063000,  둔산1동,'75,70 - 74세,1998,231,86,145
'3017063000,  둔산1동,'80,75 - 79세,1998,186,59,127
'3017063000,  둔산1동,'85,80 - 84세,1998,106,32,74
'3017063000,  둔산1동,'90,85+ ,1998,86,18,68
'3017064000,  둔산2동,'00,계,1998,39117,19485,19632
'3017064000,  둔산2동,'05,0 - 4세,1998,4233,2242,1991
'3017064000,  둔산2동,'10,5 - 9세,1998,4466,2365,2101
'3017064000,  둔산2동,'15,10 - 14세,1998,3787,1991,1796
'3017064000,  둔산2동,'20,15 - 19세,1998,2895,1522,1373
'3017064000,  둔산2동,'25,20 - 24세,1998,1553,741,812
'3017064000,  둔산2동,'30,25 - 29세,1998,2872,1064,1808
'3017064000,  둔산2동,'35,30 - 34세,1998,4887,2229,2658
'3017064000,  둔산2동,'40,35 - 39세,1998,5619,2790,2829
'3017064000,  둔산2동,'45,40 - 44세,1998,3924,2151,1773
'3017064000,  둔산2동,'50,45 - 49세,1998,1765,1101,664
'3017064000,  둔산2동,'55,50 - 54세,1998,797,457,340
'3017064000,  둔산2동,'60,55 - 59세,1998,618,311,307
'3017064000,  둔산2동,'65,60 - 64세,1998,467,164,303
'3017064000,  둔산2동,'70,65 - 69세,1998,441,138,303
'3017064000,  둔산2동,'75,70 - 74세,1998,322,90,232
'3017064000,  둔산2동,'80,75 - 79세,1998,246,59,187
'3017064000,  둔산2동,'85,80 - 84세,1998,148,50,98
'3017064000,  둔산2동,'90,85+ ,1998,77,20,57
'3017065000,  만년동,'00,계,1998,16120,8084,8036
'3017065000,  만년동,'05,0 - 4세,1998,1752,930,822
'3017065000,  만년동,'10,5 - 9세,1998,1814,981,833
'3017065000,  만년동,'15,10 - 14세,1998,1491,807,684
'3017065000,  만년동,'20,15 - 19세,1998,1073,573,500
'3017065000,  만년동,'25,20 - 24세,1998,748,333,415
'3017065000,  만년동,'30,25 - 29세,1998,1612,636,976
'3017065000,  만년동,'35,30 - 34세,1998,2196,1039,1157
'3017065000,  만년동,'40,35 - 39세,1998,2098,1070,1028
'3017065000,  만년동,'45,40 - 44세,1998,1418,794,624
'3017065000,  만년동,'50,45 - 49세,1998,661,383,278
'3017065000,  만년동,'55,50 - 54세,1998,328,179,149
'3017065000,  만년동,'60,55 - 59세,1998,252,124,128
'3017065000,  만년동,'65,60 - 64세,1998,231,95,136
'3017065000,  만년동,'70,65 - 69세,1998,159,53,106
'3017065000,  만년동,'75,70 - 74세,1998,120,32,88
'3017065000,  만년동,'80,75 - 79세,1998,99,31,68
'3017065000,  만년동,'85,80 - 84세,1998,45,17,28
'3017065000,  만년동,'90,85+ ,1998,23,7,16
'30200, 유성구,'00,계,1998,150016,76291,73725
'30200, 유성구,'05,0 - 4세,1998,15040,7965,7075
'30200, 유성구,'10,5 - 9세,1998,15444,8094,7350
'30200, 유성구,'15,10 - 14세,1998,12038,6216,5822
'30200, 유성구,'20,15 - 19세,1998,10566,5378,5188
'30200, 유성구,'25,20 - 24세,1998,9004,4555,4449
'30200, 유성구,'30,25 - 29세,1998,14800,7323,7477
'30200, 유성구,'35,30 - 34세,1998,17578,8627,8951
'30200, 유성구,'40,35 - 39세,1998,17826,9441,8385
'30200, 유성구,'45,40 - 44세,1998,12341,6695,5646
'30200, 유성구,'50,45 - 49세,1998,6486,3654,2832
'30200, 유성구,'55,50 - 54세,1998,4273,2309,1964
'30200, 유성구,'60,55 - 59세,1998,3912,1871,2041
'30200, 유성구,'65,60 - 64세,1998,3515,1491,2024
'30200, 유성구,'70,65 - 69세,1998,2690,1058,1632
'30200, 유성구,'75,70 - 74세,1998,1948,738,1210
'30200, 유성구,'80,75 - 79세,1998,1351,507,844
'30200, 유성구,'85,80 - 84세,1998,761,247,514
'30200, 유성구,'90,85+ ,1998,443,122,321
'3020052000,  진잠동,'00,계,1998,21343,10882,10461
'3020052000,  진잠동,'05,0 - 4세,1998,2305,1233,1072
'3020052000,  진잠동,'10,5 - 9세,1998,1787,965,822
'3020052000,  진잠동,'15,10 - 14세,1998,1216,621,595
'3020052000,  진잠동,'20,15 - 19세,1998,1535,774,761
'3020052000,  진잠동,'25,20 - 24세,1998,1510,767,743
'3020052000,  진잠동,'30,25 - 29세,1998,2380,1085,1295
'3020052000,  진잠동,'35,30 - 34세,1998,2668,1404,1264
'3020052000,  진잠동,'40,35 - 39세,1998,1995,1166,829
'3020052000,  진잠동,'45,40 - 44세,1998,1388,744,644
'3020052000,  진잠동,'50,45 - 49세,1998,913,522,391
'3020052000,  진잠동,'55,50 - 54세,1998,767,385,382
'3020052000,  진잠동,'60,55 - 59세,1998,769,370,399
'3020052000,  진잠동,'65,60 - 64세,1998,702,297,405
'3020052000,  진잠동,'70,65 - 69세,1998,522,221,301
'3020052000,  진잠동,'75,70 - 74세,1998,367,135,232
'3020052000,  진잠동,'80,75 - 79세,1998,272,115,157
'3020052000,  진잠동,'85,80 - 84세,1998,157,48,109
'3020052000,  진잠동,'90,85+ ,1998,90,30,60
'3020053000,  온천1동,'00,계,1998,18801,9688,9113
'3020053000,  온천1동,'05,0 - 4세,1998,1401,754,647
'3020053000,  온천1동,'10,5 - 9세,1998,1241,628,613
'3020053000,  온천1동,'15,10 - 14세,1998,1086,591,495
'3020053000,  온천1동,'20,15 - 19세,1998,1595,836,759
'3020053000,  온천1동,'25,20 - 24세,1998,1783,963,820
'3020053000,  온천1동,'30,25 - 29세,1998,2154,1150,1004
'3020053000,  온천1동,'35,30 - 34세,1998,1758,937,821
'3020053000,  온천1동,'40,35 - 39세,1998,1704,928,776
'3020053000,  온천1동,'45,40 - 44세,1998,1356,707,649
'3020053000,  온천1동,'50,45 - 49세,1998,1001,490,511
'3020053000,  온천1동,'55,50 - 54세,1998,877,441,436
'3020053000,  온천1동,'60,55 - 59세,1998,876,420,456
'3020053000,  온천1동,'65,60 - 64세,1998,686,324,362
'3020053000,  온천1동,'70,65 - 69세,1998,488,217,271
'3020053000,  온천1동,'75,70 - 74세,1998,319,137,182
'3020053000,  온천1동,'80,75 - 79세,1998,249,97,152
'3020053000,  온천1동,'85,80 - 84세,1998,141,45,96
'3020053000,  온천1동,'90,85+ ,1998,86,23,63
'3020054000,  온천2동,'00,계,1998,30712,15884,14828
'3020054000,  온천2동,'05,0 - 4세,1998,2093,1132,961
'3020054000,  온천2동,'10,5 - 9세,1998,2902,1522,1380
'3020054000,  온천2동,'15,10 - 14세,1998,2855,1459,1396
'3020054000,  온천2동,'20,15 - 19세,1998,2500,1274,1226
'3020054000,  온천2동,'25,20 - 24세,1998,2413,1271,1142
'3020054000,  온천2동,'30,25 - 29세,1998,2973,1832,1141
'3020054000,  온천2동,'35,30 - 34세,1998,2523,1228,1295
'3020054000,  온천2동,'40,35 - 39세,1998,3647,1736,1911
'3020054000,  온천2동,'45,40 - 44세,1998,2921,1584,1337
'3020054000,  온천2동,'50,45 - 49세,1998,1555,876,679
'3020054000,  온천2동,'55,50 - 54세,1998,1054,569,485
'3020054000,  온천2동,'60,55 - 59세,1998,908,442,466
'3020054000,  온천2동,'65,60 - 64세,1998,808,353,455
'3020054000,  온천2동,'70,65 - 69세,1998,581,239,342
'3020054000,  온천2동,'75,70 - 74세,1998,406,160,246
'3020054000,  온천2동,'80,75 - 79세,1998,315,130,185
'3020054000,  온천2동,'85,80 - 84세,1998,168,53,115
'3020054000,  온천2동,'90,85+ ,1998,90,24,66
'3020055000,  신성동,'00,계,1998,24062,12221,11841
'3020055000,  신성동,'05,0 - 4세,1998,2445,1256,1189
'3020055000,  신성동,'10,5 - 9세,1998,3123,1596,1527
'3020055000,  신성동,'15,10 - 14세,1998,2352,1264,1088
'3020055000,  신성동,'20,15 - 19세,1998,1576,800,776
'3020055000,  신성동,'25,20 - 24세,1998,987,501,486
'3020055000,  신성동,'30,25 - 29세,1998,1994,980,1014
'3020055000,  신성동,'35,30 - 34세,1998,2983,1334,1649
'3020055000,  신성동,'40,35 - 39세,1998,3498,1830,1668
'3020055000,  신성동,'45,40 - 44세,1998,2232,1187,1045
'3020055000,  신성동,'50,45 - 49세,1998,1086,648,438
'3020055000,  신성동,'55,50 - 54세,1998,510,327,183
'3020055000,  신성동,'60,55 - 59세,1998,313,169,144
'3020055000,  신성동,'65,60 - 64세,1998,275,107,168
'3020055000,  신성동,'70,65 - 69세,1998,227,82,145
'3020055000,  신성동,'75,70 - 74세,1998,193,62,131
'3020055000,  신성동,'80,75 - 79세,1998,148,42,106
'3020055000,  신성동,'85,80 - 84세,1998,75,26,49
'3020055000,  신성동,'90,85+ ,1998,45,10,35
'3020057000,  전민동,'00,계,1998,26337,13180,13157
'3020057000,  전민동,'05,0 - 4세,1998,2574,1371,1203
'3020057000,  전민동,'10,5 - 9세,1998,3310,1783,1527
'3020057000,  전민동,'15,10 - 14세,1998,2931,1498,1433
'3020057000,  전민동,'20,15 - 19세,1998,1944,996,948
'3020057000,  전민동,'25,20 - 24세,1998,822,385,437
'3020057000,  전민동,'30,25 - 29세,1998,1633,721,912
'3020057000,  전민동,'35,30 - 34세,1998,2907,1214,1693
'3020057000,  전민동,'40,35 - 39세,1998,3852,1892,1960
'3020057000,  전민동,'45,40 - 44세,1998,2934,1638,1296
'3020057000,  전민동,'50,45 - 49세,1998,1162,709,453
'3020057000,  전민동,'55,50 - 54세,1998,503,304,199
'3020057000,  전민동,'60,55 - 59세,1998,383,186,197
'3020057000,  전민동,'65,60 - 64세,1998,414,147,267
'3020057000,  전민동,'70,65 - 69세,1998,367,130,237
'3020057000,  전민동,'75,70 - 74세,1998,283,104,179
'3020057000,  전민동,'80,75 - 79세,1998,162,55,107
'3020057000,  전민동,'85,80 - 84세,1998,93,31,62
'3020057000,  전민동,'90,85+ ,1998,63,16,47
'3020058000,  구즉동,'00,계,1998,28761,14436,14325
'3020058000,  구즉동,'05,0 - 4세,1998,4222,2219,2003
'3020058000,  구즉동,'10,5 - 9세,1998,3081,1600,1481
'3020058000,  구즉동,'15,10 - 14세,1998,1598,783,815
'3020058000,  구즉동,'20,15 - 19세,1998,1416,698,718
'3020058000,  구즉동,'25,20 - 24세,1998,1489,668,821
'3020058000,  구즉동,'30,25 - 29세,1998,3666,1555,2111
'3020058000,  구즉동,'35,30 - 34세,1998,4739,2510,2229
'3020058000,  구즉동,'40,35 - 39세,1998,3130,1889,1241
'3020058000,  구즉동,'45,40 - 44세,1998,1510,835,675
'3020058000,  구즉동,'50,45 - 49세,1998,769,409,360
'3020058000,  구즉동,'55,50 - 54세,1998,562,283,279
'3020058000,  구즉동,'60,55 - 59세,1998,663,284,379
'3020058000,  구즉동,'65,60 - 64세,1998,630,263,367
'3020058000,  구즉동,'70,65 - 69세,1998,505,169,336
'3020058000,  구즉동,'75,70 - 74세,1998,380,140,240
'3020058000,  구즉동,'80,75 - 79세,1998,205,68,137
'3020058000,  구즉동,'85,80 - 84세,1998,127,44,83
'3020058000,  구즉동,'90,85+ ,1998,69,19,50
'30230, 대덕구,'00,계,1998,208580,105455,103125
'30230, 대덕구,'05,0 - 4세,1998,18309,9544,8765
'30230, 대덕구,'10,5 - 9세,1998,17536,9548,7988
'30230, 대덕구,'15,10 - 14세,1998,15646,8130,7516
'30230, 대덕구,'20,15 - 19세,1998,18297,9405,8892
'30230, 대덕구,'25,20 - 24세,1998,17142,8459,8683
'30230, 대덕구,'30,25 - 29세,1998,22103,11075,11028
'30230, 대덕구,'35,30 - 34세,1998,21804,11088,10716
'30230, 대덕구,'40,35 - 39세,1998,21534,11083,10451
'30230, 대덕구,'45,40 - 44세,1998,16608,8731,7877
'30230, 대덕구,'50,45 - 49세,1998,10628,5534,5094
'30230, 대덕구,'55,50 - 54세,1998,7649,3897,3752
'30230, 대덕구,'60,55 - 59세,1998,7040,3401,3639
'30230, 대덕구,'65,60 - 64세,1998,5254,2425,2829
'30230, 대덕구,'70,65 - 69세,1998,3474,1358,2116
'30230, 대덕구,'75,70 - 74세,1998,2468,869,1599
'30230, 대덕구,'80,75 - 79세,1998,1675,571,1104
'30230, 대덕구,'85,80 - 84세,1998,898,230,668
'30230, 대덕구,'90,85+ ,1998,515,107,408
'3023051000,  오정동,'00,계,1998,23598,12134,11464
'3023051000,  오정동,'05,0 - 4세,1998,1666,842,824
'3023051000,  오정동,'10,5 - 9세,1998,1677,897,780
'3023051000,  오정동,'15,10 - 14세,1998,1605,856,749
'3023051000,  오정동,'20,15 - 19세,1998,2216,1142,1074
'3023051000,  오정동,'25,20 - 24세,1998,2492,1268,1224
'3023051000,  오정동,'30,25 - 29세,1998,2702,1516,1186
'3023051000,  오정동,'35,30 - 34세,1998,2143,1127,1016
'3023051000,  오정동,'40,35 - 39세,1998,2192,1120,1072
'3023051000,  오정동,'45,40 - 44세,1998,1834,944,890
'3023051000,  오정동,'50,45 - 49세,1998,1356,684,672
'3023051000,  오정동,'55,50 - 54세,1998,1117,566,551
'3023051000,  오정동,'60,55 - 59세,1998,948,495,453
'3023051000,  오정동,'65,60 - 64세,1998,614,307,307
'3023051000,  오정동,'70,65 - 69세,1998,408,169,239
'3023051000,  오정동,'75,70 - 74세,1998,288,100,188
'3023051000,  오정동,'80,75 - 79세,1998,178,69,109
'3023051000,  오정동,'85,80 - 84세,1998,107,22,85
'3023051000,  오정동,'90,85+ ,1998,55,10,45
'3023052000,  대화동,'00,계,1998,12484,6417,6067
'3023052000,  대화동,'05,0 - 4세,1998,739,404,335
'3023052000,  대화동,'10,5 - 9세,1998,828,476,352
'3023052000,  대화동,'15,10 - 14세,1998,986,494,492
'3023052000,  대화동,'20,15 - 19세,1998,1312,649,663
'3023052000,  대화동,'25,20 - 24세,1998,1303,667,636
'3023052000,  대화동,'30,25 - 29세,1998,1245,712,533
'3023052000,  대화동,'35,30 - 34세,1998,1046,555,491
'3023052000,  대화동,'40,35 - 39세,1998,1151,552,599
'3023052000,  대화동,'45,40 - 44세,1998,1058,558,500
'3023052000,  대화동,'50,45 - 49세,1998,755,417,338
'3023052000,  대화동,'55,50 - 54세,1998,583,292,291
'3023052000,  대화동,'60,55 - 59세,1998,549,263,286
'3023052000,  대화동,'65,60 - 64세,1998,364,171,193
'3023052000,  대화동,'70,65 - 69세,1998,221,92,129
'3023052000,  대화동,'75,70 - 74세,1998,158,59,99
'3023052000,  대화동,'80,75 - 79세,1998,96,30,66
'3023052000,  대화동,'85,80 - 84세,1998,60,17,43
'3023052000,  대화동,'90,85+ ,1998,30,9,21
'3023053000,  회덕1동,'00,계,1998,24925,12502,12423
'3023053000,  회덕1동,'05,0 - 4세,1998,2380,1191,1189
'3023053000,  회덕1동,'10,5 - 9세,1998,2034,1105,929
'3023053000,  회덕1동,'15,10 - 14세,1998,1781,924,857
'3023053000,  회덕1동,'20,15 - 19세,1998,1984,997,987
'3023053000,  회덕1동,'25,20 - 24세,1998,1838,924,914
'3023053000,  회덕1동,'30,25 - 29세,1998,2620,1255,1365
'3023053000,  회덕1동,'35,30 - 34세,1998,2705,1385,1320
'3023053000,  회덕1동,'40,35 - 39세,1998,2636,1372,1264
'3023053000,  회덕1동,'45,40 - 44세,1998,1869,1024,845
'3023053000,  회덕1동,'50,45 - 49세,1998,1189,619,570
'3023053000,  회덕1동,'55,50 - 54세,1998,928,465,463
'3023053000,  회덕1동,'60,55 - 59세,1998,931,422,509
'3023053000,  회덕1동,'65,60 - 64세,1998,748,343,405
'3023053000,  회덕1동,'70,65 - 69세,1998,537,222,315
'3023053000,  회덕1동,'75,70 - 74세,1998,324,118,206
'3023053000,  회덕1동,'80,75 - 79세,1998,237,89,148
'3023053000,  회덕1동,'85,80 - 84세,1998,117,30,87
'3023053000,  회덕1동,'90,85+ ,1998,67,17,50
'3023054000,  회덕2동,'00,계,1998,28605,14481,14124
'3023054000,  회덕2동,'05,0 - 4세,1998,2616,1381,1235
'3023054000,  회덕2동,'10,5 - 9세,1998,2219,1202,1017
'3023054000,  회덕2동,'15,10 - 14세,1998,1959,1035,924
'3023054000,  회덕2동,'20,15 - 19세,1998,2575,1306,1269
'3023054000,  회덕2동,'25,20 - 24세,1998,2372,1155,1217
'3023054000,  회덕2동,'30,25 - 29세,1998,3234,1598,1636
'3023054000,  회덕2동,'35,30 - 34세,1998,3019,1601,1418
'3023054000,  회덕2동,'40,35 - 39세,1998,2774,1431,1343
'3023054000,  회덕2동,'45,40 - 44세,1998,2305,1156,1149
'3023054000,  회덕2동,'50,45 - 49세,1998,1522,797,725
'3023054000,  회덕2동,'55,50 - 54세,1998,1101,552,549
'3023054000,  회덕2동,'60,55 - 59세,1998,1009,498,511
'3023054000,  회덕2동,'65,60 - 64세,1998,739,361,378
'3023054000,  회덕2동,'70,65 - 69세,1998,441,175,266
'3023054000,  회덕2동,'75,70 - 74세,1998,318,117,201
'3023054000,  회덕2동,'80,75 - 79세,1998,219,75,144
'3023054000,  회덕2동,'85,80 - 84세,1998,112,26,86
'3023054000,  회덕2동,'90,85+ ,1998,71,15,56
'3023054600,  중리동,'00,계,1998,27621,13876,13745
'3023054600,  중리동,'05,0 - 4세,1998,2662,1420,1242
'3023054600,  중리동,'10,5 - 9세,1998,2239,1215,1024
'3023054600,  중리동,'15,10 - 14세,1998,1956,982,974
'3023054600,  중리동,'20,15 - 19세,1998,2258,1199,1059
'3023054600,  중리동,'25,20 - 24세,1998,2377,1115,1262
'3023054600,  중리동,'30,25 - 29세,1998,3502,1669,1833
'3023054600,  중리동,'35,30 - 34세,1998,3176,1636,1540
'3023054600,  중리동,'40,35 - 39세,1998,2760,1419,1341
'3023054600,  중리동,'45,40 - 44세,1998,2118,1094,1024
'3023054600,  중리동,'50,45 - 49세,1998,1396,691,705
'3023054600,  중리동,'55,50 - 54세,1998,912,485,427
'3023054600,  중리동,'60,55 - 59세,1998,790,397,393
'3023054600,  중리동,'65,60 - 64세,1998,569,260,309
'3023054600,  중리동,'70,65 - 69세,1998,320,130,190
'3023054600,  중리동,'75,70 - 74세,1998,226,71,155
'3023054600,  중리동,'80,75 - 79세,1998,193,62,131
'3023054600,  중리동,'85,80 - 84세,1998,105,22,83
'3023054600,  중리동,'90,85+ ,1998,62,9,53
'3023055000,  신탄진동,'00,계,1998,16655,8518,8137
'3023055000,  신탄진동,'05,0 - 4세,1998,1427,740,687
'3023055000,  신탄진동,'10,5 - 9세,1998,1480,805,675
'3023055000,  신탄진동,'15,10 - 14세,1998,1066,543,523
'3023055000,  신탄진동,'20,15 - 19세,1998,1402,734,668
'3023055000,  신탄진동,'25,20 - 24세,1998,1433,749,684
'3023055000,  신탄진동,'30,25 - 29세,1998,1639,859,780
'3023055000,  신탄진동,'35,30 - 34세,1998,1740,885,855
'3023055000,  신탄진동,'40,35 - 39세,1998,1566,855,711
'3023055000,  신탄진동,'45,40 - 44세,1998,1235,628,607
'3023055000,  신탄진동,'50,45 - 49세,1998,844,446,398
'3023055000,  신탄진동,'55,50 - 54세,1998,682,340,342
'3023055000,  신탄진동,'60,55 - 59세,1998,718,339,379
'3023055000,  신탄진동,'65,60 - 64세,1998,546,268,278
'3023055000,  신탄진동,'70,65 - 69세,1998,350,139,211
'3023055000,  신탄진동,'75,70 - 74세,1998,250,100,150
'3023055000,  신탄진동,'80,75 - 79세,1998,156,56,100
'3023055000,  신탄진동,'85,80 - 84세,1998,75,25,50
'3023055000,  신탄진동,'90,85+ ,1998,46,7,39
'3023056000,  석봉동,'00,계,1998,8536,4355,4181
'3023056000,  석봉동,'05,0 - 4세,1998,796,407,389
'3023056000,  석봉동,'10,5 - 9세,1998,731,403,328
'3023056000,  석봉동,'15,10 - 14세,1998,633,322,311
'3023056000,  석봉동,'20,15 - 19세,1998,755,381,374
'3023056000,  석봉동,'25,20 - 24세,1998,688,332,356
'3023056000,  석봉동,'30,25 - 29세,1998,896,454,442
'3023056000,  석봉동,'35,30 - 34세,1998,855,462,393
'3023056000,  석봉동,'40,35 - 39세,1998,850,436,414
'3023056000,  석봉동,'45,40 - 44세,1998,631,338,293
'3023056000,  석봉동,'50,45 - 49세,1998,450,239,211
'3023056000,  석봉동,'55,50 - 54세,1998,311,164,147
'3023056000,  석봉동,'60,55 - 59세,1998,314,149,165
'3023056000,  석봉동,'65,60 - 64세,1998,219,102,117
'3023056000,  석봉동,'70,65 - 69세,1998,164,77,87
'3023056000,  석봉동,'75,70 - 74세,1998,108,42,66
'3023056000,  석봉동,'80,75 - 79세,1998,69,23,46
'3023056000,  석봉동,'85,80 - 84세,1998,40,18,22
'3023056000,  석봉동,'90,85+ ,1998,26,6,20
'3023057000,  덕암동,'00,계,1998,19340,9858,9482
'3023057000,  덕암동,'05,0 - 4세,1998,2088,1081,1007
'3023057000,  덕암동,'10,5 - 9세,1998,1764,929,835
'3023057000,  덕암동,'15,10 - 14세,1998,1412,708,704
'3023057000,  덕암동,'20,15 - 19세,1998,1435,725,710
'3023057000,  덕암동,'25,20 - 24세,1998,1408,661,747
'3023057000,  덕암동,'30,25 - 29세,1998,2294,1166,1128
'3023057000,  덕암동,'35,30 - 34세,1998,2236,1169,1067
'3023057000,  덕암동,'40,35 - 39세,1998,1958,1084,874
'3023057000,  덕암동,'45,40 - 44세,1998,1351,737,614
'3023057000,  덕암동,'50,45 - 49세,1998,846,466,380
'3023057000,  덕암동,'55,50 - 54세,1998,595,323,272
'3023057000,  덕암동,'60,55 - 59세,1998,627,299,328
'3023057000,  덕암동,'65,60 - 64세,1998,516,245,271
'3023057000,  덕암동,'70,65 - 69세,1998,303,108,195
'3023057000,  덕암동,'75,70 - 74세,1998,224,81,143
'3023057000,  덕암동,'80,75 - 79세,1998,145,41,104
'3023057000,  덕암동,'85,80 - 84세,1998,80,21,59
'3023057000,  덕암동,'90,85+ ,1998,58,14,44
'3023058000,  목상동,'00,계,1998,6303,3377,2926
'3023058000,  목상동,'05,0 - 4세,1998,712,380,332
'3023058000,  목상동,'10,5 - 9세,1998,668,373,295
'3023058000,  목상동,'15,10 - 14세,1998,506,263,243
'3023058000,  목상동,'20,15 - 19세,1998,408,213,195
'3023058000,  목상동,'25,20 - 24세,1998,420,235,185
'3023058000,  목상동,'30,25 - 29세,1998,802,438,364
'3023058000,  목상동,'35,30 - 34세,1998,851,427,424
'3023058000,  목상동,'40,35 - 39세,1998,739,424,315
'3023058000,  목상동,'45,40 - 44세,1998,381,240,141
'3023058000,  목상동,'50,45 - 49세,1998,220,117,103
'3023058000,  목상동,'55,50 - 54세,1998,136,74,62
'3023058000,  목상동,'60,55 - 59세,1998,137,69,68
'3023058000,  목상동,'65,60 - 64세,1998,108,45,63
'3023058000,  목상동,'70,65 - 69세,1998,77,30,47
'3023058000,  목상동,'75,70 - 74세,1998,73,29,44
'3023058000,  목상동,'80,75 - 79세,1998,39,11,28
'3023058000,  목상동,'85,80 - 84세,1998,19,8,11
'3023058000,  목상동,'90,85+ ,1998,7,1,6
'3023060000,  법1동,'00,계,1998,18768,9184,9584
'3023060000,  법1동,'05,0 - 4세,1998,1641,858,783
'3023060000,  법1동,'10,5 - 9세,1998,1561,865,696
'3023060000,  법1동,'15,10 - 14세,1998,1481,809,672
'3023060000,  법1동,'20,15 - 19세,1998,1710,884,826
'3023060000,  법1동,'25,20 - 24세,1998,1451,734,717
'3023060000,  법1동,'30,25 - 29세,1998,1802,805,997
'3023060000,  법1동,'35,30 - 34세,1998,1968,962,1006
'3023060000,  법1동,'40,35 - 39세,1998,1935,967,968
'3023060000,  법1동,'45,40 - 44세,1998,1634,813,821
'3023060000,  법1동,'50,45 - 49세,1998,975,471,504
'3023060000,  법1동,'55,50 - 54세,1998,701,315,386
'3023060000,  법1동,'60,55 - 59세,1998,562,254,308
'3023060000,  법1동,'65,60 - 64세,1998,440,170,270
'3023060000,  법1동,'70,65 - 69세,1998,340,114,226
'3023060000,  법1동,'75,70 - 74세,1998,269,77,192
'3023060000,  법1동,'80,75 - 79세,1998,152,51,101
'3023060000,  법1동,'85,80 - 84세,1998,102,25,77
'3023060000,  법1동,'90,85+ ,1998,44,10,34
'3023061000,  법2동,'00,계,1998,21745,10753,10992
'3023061000,  법2동,'05,0 - 4세,1998,1582,840,742
'3023061000,  법2동,'10,5 - 9세,1998,2335,1278,1057
'3023061000,  법2동,'15,10 - 14세,1998,2261,1194,1067
'3023061000,  법2동,'20,15 - 19세,1998,2242,1175,1067
'3023061000,  법2동,'25,20 - 24세,1998,1360,619,741
'3023061000,  법2동,'30,25 - 29세,1998,1367,603,764
'3023061000,  법2동,'35,30 - 34세,1998,2065,879,1186
'3023061000,  법2동,'40,35 - 39세,1998,2973,1423,1550
'3023061000,  법2동,'45,40 - 44세,1998,2192,1199,993
'3023061000,  법2동,'50,45 - 49세,1998,1075,587,488
'3023061000,  법2동,'55,50 - 54세,1998,583,321,262
'3023061000,  법2동,'60,55 - 59세,1998,455,216,239
'3023061000,  법2동,'65,60 - 64세,1998,391,153,238
'3023061000,  법2동,'70,65 - 69세,1998,313,102,211
'3023061000,  법2동,'75,70 - 74세,1998,230,75,155
'3023061000,  법2동,'80,75 - 79세,1998,191,64,127
'3023061000,  법2동,'85,80 - 84세,1998,81,16,65
'3023061000,  법2동,'90,85+ ,1998,49,9,40
'31,울산광역시,'00,계,1998,1015249,520696,494553
'31,울산광역시,'05,0 - 4세,1998,90552,48852,41700
'31,울산광역시,'10,5 - 9세,1998,91750,50349,41401
'31,울산광역시,'15,10 - 14세,1998,77541,41255,36286
'31,울산광역시,'20,15 - 19세,1998,89144,45842,43302
'31,울산광역시,'25,20 - 24세,1998,73812,37316,36496
'31,울산광역시,'30,25 - 29세,1998,97979,47202,50777
'31,울산광역시,'35,30 - 34세,1998,113000,57292,55708
'31,울산광역시,'40,35 - 39세,1998,112434,58612,53822
'31,울산광역시,'45,40 - 44세,1998,87098,45605,41493
'31,울산광역시,'50,45 - 49세,1998,55439,29968,25471
'31,울산광역시,'55,50 - 54세,1998,36895,19950,16945
'31,울산광역시,'60,55 - 59세,1998,31025,16108,14917
'31,울산광역시,'65,60 - 64세,1998,21199,9761,11438
'31,울산광역시,'70,65 - 69세,1998,14367,5787,8580
'31,울산광역시,'75,70 - 74세,1998,10229,3375,6854
'31,울산광역시,'80,75 - 79세,1998,6844,1990,4854
'31,울산광역시,'85,80 - 84세,1998,3779,1000,2779
'31,울산광역시,'90,85+ ,1998,2162,432,1730
'31110, 중구,'00,계,1998,232129,118820,113309
'31110, 중구,'05,0 - 4세,1998,18687,10206,8481
'31110, 중구,'10,5 - 9세,1998,19066,10451,8615
'31110, 중구,'15,10 - 14세,1998,17720,9560,8160
'31110, 중구,'20,15 - 19세,1998,21587,11244,10343
'31110, 중구,'25,20 - 24세,1998,18400,9440,8960
'31110, 중구,'30,25 - 29세,1998,22763,11121,11642
'31110, 중구,'35,30 - 34세,1998,23685,12068,11617
'31110, 중구,'40,35 - 39세,1998,24652,12470,12182
'31110, 중구,'45,40 - 44세,1998,20734,10495,10239
'31110, 중구,'50,45 - 49세,1998,13960,7363,6597
'31110, 중구,'55,50 - 54세,1998,9437,4915,4522
'31110, 중구,'60,55 - 59세,1998,8018,4180,3838
'31110, 중구,'65,60 - 64세,1998,5277,2496,2781
'31110, 중구,'70,65 - 69세,1998,3293,1404,1889
'31110, 중구,'75,70 - 74세,1998,2170,736,1434
'31110, 중구,'80,75 - 79세,1998,1427,390,1037
'31110, 중구,'85,80 - 84세,1998,794,186,608
'31110, 중구,'90,85+ ,1998,459,95,364
'3111051000,  학성동,'00,계,1998,14845,7620,7225
'3111051000,  학성동,'05,0 - 4세,1998,719,395,324
'3111051000,  학성동,'10,5 - 9세,1998,839,472,367
'3111051000,  학성동,'15,10 - 14세,1998,1002,539,463
'3111051000,  학성동,'20,15 - 19세,1998,1588,846,742
'3111051000,  학성동,'25,20 - 24세,1998,1618,853,765
'3111051000,  학성동,'30,25 - 29세,1998,1403,792,611
'3111051000,  학성동,'35,30 - 34세,1998,1106,607,499
'3111051000,  학성동,'40,35 - 39세,1998,1261,576,685
'3111051000,  학성동,'45,40 - 44세,1998,1391,681,710
'3111051000,  학성동,'50,45 - 49세,1998,1078,503,575
'3111051000,  학성동,'55,50 - 54세,1998,890,456,434
'3111051000,  학성동,'60,55 - 59세,1998,822,421,401
'3111051000,  학성동,'65,60 - 64세,1998,481,240,241
'3111051000,  학성동,'70,65 - 69세,1998,275,128,147
'3111051000,  학성동,'75,70 - 74세,1998,167,60,107
'3111051000,  학성동,'80,75 - 79세,1998,101,29,72
'3111051000,  학성동,'85,80 - 84세,1998,66,14,52
'3111051000,  학성동,'90,85+ ,1998,38,8,30
'3111052000,  반구1동,'00,계,1998,20088,10570,9518
'3111052000,  반구1동,'05,0 - 4세,1998,1809,1001,808
'3111052000,  반구1동,'10,5 - 9세,1998,1772,990,782
'3111052000,  반구1동,'15,10 - 14세,1998,1521,810,711
'3111052000,  반구1동,'20,15 - 19세,1998,1852,970,882
'3111052000,  반구1동,'25,20 - 24세,1998,1553,809,744
'3111052000,  반구1동,'30,25 - 29세,1998,2087,1075,1012
'3111052000,  반구1동,'35,30 - 34세,1998,2281,1217,1064
'3111052000,  반구1동,'40,35 - 39세,1998,2230,1158,1072
'3111052000,  반구1동,'45,40 - 44세,1998,1703,879,824
'3111052000,  반구1동,'50,45 - 49세,1998,1139,633,506
'3111052000,  반구1동,'55,50 - 54세,1998,721,405,316
'3111052000,  반구1동,'60,55 - 59세,1998,541,290,251
'3111052000,  반구1동,'65,60 - 64세,1998,342,160,182
'3111052000,  반구1동,'70,65 - 69세,1998,209,83,126
'3111052000,  반구1동,'75,70 - 74세,1998,141,42,99
'3111052000,  반구1동,'80,75 - 79세,1998,109,30,79
'3111052000,  반구1동,'85,80 - 84세,1998,54,12,42
'3111052000,  반구1동,'90,85+ ,1998,24,6,18
'3111053000,  반구2동,'00,계,1998,11663,6038,5625
'3111053000,  반구2동,'05,0 - 4세,1998,798,444,354
'3111053000,  반구2동,'10,5 - 9세,1998,729,387,342
'3111053000,  반구2동,'15,10 - 14세,1998,817,473,344
'3111053000,  반구2동,'20,15 - 19세,1998,1298,690,608
'3111053000,  반구2동,'25,20 - 24세,1998,1208,654,554
'3111053000,  반구2동,'30,25 - 29세,1998,1154,617,537
'3111053000,  반구2동,'35,30 - 34세,1998,1023,545,478
'3111053000,  반구2동,'40,35 - 39세,1998,1076,512,564
'3111053000,  반구2동,'45,40 - 44세,1998,1044,470,574
'3111053000,  반구2동,'50,45 - 49세,1998,850,433,417
'3111053000,  반구2동,'55,50 - 54세,1998,580,314,266
'3111053000,  반구2동,'60,55 - 59세,1998,484,257,227
'3111053000,  반구2동,'65,60 - 64세,1998,228,122,106
'3111053000,  반구2동,'70,65 - 69세,1998,137,58,79
'3111053000,  반구2동,'75,70 - 74세,1998,96,23,73
'3111053000,  반구2동,'80,75 - 79세,1998,68,19,49
'3111053000,  반구2동,'85,80 - 84세,1998,49,11,38
'3111053000,  반구2동,'90,85+ ,1998,24,9,15
'3111054000,  복산1동,'00,계,1998,14171,7249,6922
'3111054000,  복산1동,'05,0 - 4세,1998,822,440,382
'3111054000,  복산1동,'10,5 - 9세,1998,1034,567,467
'3111054000,  복산1동,'15,10 - 14세,1998,1197,649,548
'3111054000,  복산1동,'20,15 - 19세,1998,1494,801,693
'3111054000,  복산1동,'25,20 - 24세,1998,1216,639,577
'3111054000,  복산1동,'30,25 - 29세,1998,1202,625,577
'3111054000,  복산1동,'35,30 - 34세,1998,1171,580,591
'3111054000,  복산1동,'40,35 - 39세,1998,1436,686,750
'3111054000,  복산1동,'45,40 - 44세,1998,1422,745,677
'3111054000,  복산1동,'50,45 - 49세,1998,955,491,464
'3111054000,  복산1동,'55,50 - 54세,1998,662,337,325
'3111054000,  복산1동,'60,55 - 59세,1998,579,288,291
'3111054000,  복산1동,'65,60 - 64세,1998,387,184,203
'3111054000,  복산1동,'70,65 - 69세,1998,253,111,142
'3111054000,  복산1동,'75,70 - 74세,1998,175,67,108
'3111054000,  복산1동,'80,75 - 79세,1998,91,24,67
'3111054000,  복산1동,'85,80 - 84세,1998,42,10,32
'3111054000,  복산1동,'90,85+ ,1998,33,5,28
'3111055000,  복산2동,'00,계,1998,13602,7034,6568
'3111055000,  복산2동,'05,0 - 4세,1998,1010,554,456
'3111055000,  복산2동,'10,5 - 9세,1998,1118,621,497
'3111055000,  복산2동,'15,10 - 14세,1998,1107,588,519
'3111055000,  복산2동,'20,15 - 19세,1998,1509,821,688
'3111055000,  복산2동,'25,20 - 24세,1998,1073,580,493
'3111055000,  복산2동,'30,25 - 29세,1998,1209,600,609
'3111055000,  복산2동,'35,30 - 34세,1998,1247,620,627
'3111055000,  복산2동,'40,35 - 39세,1998,1382,665,717
'3111055000,  복산2동,'45,40 - 44세,1998,1423,689,734
'3111055000,  복산2동,'50,45 - 49세,1998,964,548,416
'3111055000,  복산2동,'55,50 - 54세,1998,505,284,221
'3111055000,  복산2동,'60,55 - 59세,1998,386,210,176
'3111055000,  복산2동,'65,60 - 64세,1998,264,118,146
'3111055000,  복산2동,'70,65 - 69세,1998,170,76,94
'3111055000,  복산2동,'75,70 - 74세,1998,106,31,75
'3111055000,  복산2동,'80,75 - 79세,1998,64,18,46
'3111055000,  복산2동,'85,80 - 84세,1998,45,8,37
'3111055000,  복산2동,'90,85+ ,1998,20,3,17
'3111056000,  북정동,'00,계,1998,6628,3383,3245
'3111056000,  북정동,'05,0 - 4세,1998,657,347,310
'3111056000,  북정동,'10,5 - 9세,1998,484,243,241
'3111056000,  북정동,'15,10 - 14세,1998,365,209,156
'3111056000,  북정동,'20,15 - 19세,1998,476,237,239
'3111056000,  북정동,'25,20 - 24세,1998,489,264,225
'3111056000,  북정동,'30,25 - 29세,1998,777,366,411
'3111056000,  북정동,'35,30 - 34세,1998,835,455,380
'3111056000,  북정동,'40,35 - 39세,1998,628,354,274
'3111056000,  북정동,'45,40 - 44세,1998,491,254,237
'3111056000,  북정동,'50,45 - 49세,1998,340,172,168
'3111056000,  북정동,'55,50 - 54세,1998,277,143,134
'3111056000,  북정동,'60,55 - 59세,1998,250,121,129
'3111056000,  북정동,'65,60 - 64세,1998,222,95,127
'3111056000,  북정동,'70,65 - 69세,1998,124,55,69
'3111056000,  북정동,'75,70 - 74세,1998,98,37,61
'3111056000,  북정동,'80,75 - 79세,1998,62,19,43
'3111056000,  북정동,'85,80 - 84세,1998,32,9,23
'3111056000,  북정동,'90,85+ ,1998,21,3,18
'3111057000,  옥교동,'00,계,1998,9466,4665,4801
'3111057000,  옥교동,'05,0 - 4세,1998,466,245,221
'3111057000,  옥교동,'10,5 - 9세,1998,507,256,251
'3111057000,  옥교동,'15,10 - 14세,1998,565,289,276
'3111057000,  옥교동,'20,15 - 19세,1998,892,457,435
'3111057000,  옥교동,'25,20 - 24세,1998,994,518,476
'3111057000,  옥교동,'30,25 - 29세,1998,924,511,413
'3111057000,  옥교동,'35,30 - 34세,1998,703,353,350
'3111057000,  옥교동,'40,35 - 39세,1998,782,370,412
'3111057000,  옥교동,'45,40 - 44세,1998,830,402,428
'3111057000,  옥교동,'50,45 - 49세,1998,723,327,396
'3111057000,  옥교동,'55,50 - 54세,1998,604,282,322
'3111057000,  옥교동,'60,55 - 59세,1998,546,283,263
'3111057000,  옥교동,'65,60 - 64세,1998,372,185,187
'3111057000,  옥교동,'70,65 - 69세,1998,240,90,150
'3111057000,  옥교동,'75,70 - 74세,1998,137,52,85
'3111057000,  옥교동,'80,75 - 79세,1998,102,30,72
'3111057000,  옥교동,'85,80 - 84세,1998,48,9,39
'3111057000,  옥교동,'90,85+ ,1998,31,6,25
'3111058000,  성남동,'00,계,1998,8578,4313,4265
'3111058000,  성남동,'05,0 - 4세,1998,395,221,174
'3111058000,  성남동,'10,5 - 9세,1998,487,277,210
'3111058000,  성남동,'15,10 - 14세,1998,532,279,253
'3111058000,  성남동,'20,15 - 19세,1998,865,437,428
'3111058000,  성남동,'25,20 - 24세,1998,816,428,388
'3111058000,  성남동,'30,25 - 29세,1998,891,484,407
'3111058000,  성남동,'35,30 - 34세,1998,644,328,316
'3111058000,  성남동,'40,35 - 39세,1998,732,335,397
'3111058000,  성남동,'45,40 - 44세,1998,803,403,400
'3111058000,  성남동,'50,45 - 49세,1998,593,280,313
'3111058000,  성남동,'55,50 - 54세,1998,537,255,282
'3111058000,  성남동,'60,55 - 59세,1998,450,221,229
'3111058000,  성남동,'65,60 - 64세,1998,335,177,158
'3111058000,  성남동,'70,65 - 69세,1998,204,98,106
'3111058000,  성남동,'75,70 - 74세,1998,136,42,94
'3111058000,  성남동,'80,75 - 79세,1998,92,32,60
'3111058000,  성남동,'85,80 - 84세,1998,40,11,29
'3111058000,  성남동,'90,85+ ,1998,26,5,21
'3111059000,  우정동,'00,계,1998,26979,13583,13396
'3111059000,  우정동,'05,0 - 4세,1998,2120,1165,955
'3111059000,  우정동,'10,5 - 9세,1998,2200,1183,1017
'3111059000,  우정동,'15,10 - 14세,1998,1892,998,894
'3111059000,  우정동,'20,15 - 19세,1998,2473,1276,1197
'3111059000,  우정동,'25,20 - 24세,1998,2189,1118,1071
'3111059000,  우정동,'30,25 - 29세,1998,2488,1194,1294
'3111059000,  우정동,'35,30 - 34세,1998,2683,1321,1362
'3111059000,  우정동,'40,35 - 39세,1998,2826,1436,1390
'3111059000,  우정동,'45,40 - 44세,1998,2532,1259,1273
'3111059000,  우정동,'50,45 - 49세,1998,1744,866,878
'3111059000,  우정동,'55,50 - 54세,1998,1174,570,604
'3111059000,  우정동,'60,55 - 59세,1998,982,515,467
'3111059000,  우정동,'65,60 - 64세,1998,709,335,374
'3111059000,  우정동,'70,65 - 69세,1998,407,189,218
'3111059000,  우정동,'75,70 - 74세,1998,265,91,174
'3111059000,  우정동,'80,75 - 79세,1998,149,38,111
'3111059000,  우정동,'85,80 - 84세,1998,83,20,63
'3111059000,  우정동,'90,85+ ,1998,63,9,54
'3111060000,  태화동,'00,계,1998,27723,14050,13673
'3111060000,  태화동,'05,0 - 4세,1998,2043,1135,908
'3111060000,  태화동,'10,5 - 9세,1998,2579,1426,1153
'3111060000,  태화동,'15,10 - 14세,1998,2495,1311,1184
'3111060000,  태화동,'20,15 - 19세,1998,2614,1320,1294
'3111060000,  태화동,'25,20 - 24세,1998,1926,1004,922
'3111060000,  태화동,'30,25 - 29세,1998,2208,1065,1143
'3111060000,  태화동,'35,30 - 34세,1998,2710,1257,1453
'3111060000,  태화동,'40,35 - 39세,1998,3219,1567,1652
'3111060000,  태화동,'45,40 - 44세,1998,2801,1436,1365
'3111060000,  태화동,'50,45 - 49세,1998,1675,921,754
'3111060000,  태화동,'55,50 - 54세,1998,1058,569,489
'3111060000,  태화동,'60,55 - 59세,1998,891,468,423
'3111060000,  태화동,'65,60 - 64세,1998,583,279,304
'3111060000,  태화동,'70,65 - 69세,1998,350,131,219
'3111060000,  태화동,'75,70 - 74세,1998,253,81,172
'3111060000,  태화동,'80,75 - 79세,1998,175,46,129
'3111060000,  태화동,'85,80 - 84세,1998,100,24,76
'3111060000,  태화동,'90,85+ ,1998,43,10,33
'3111061000,  다운동,'00,계,1998,28884,14857,14027
'3111061000,  다운동,'05,0 - 4세,1998,3797,2079,1718
'3111061000,  다운동,'10,5 - 9세,1998,2806,1562,1244
'3111061000,  다운동,'15,10 - 14세,1998,1954,1105,849
'3111061000,  다운동,'20,15 - 19세,1998,1697,898,799
'3111061000,  다운동,'25,20 - 24세,1998,1703,770,933
'3111061000,  다운동,'30,25 - 29세,1998,3839,1585,2254
'3111061000,  다운동,'35,30 - 34세,1998,4162,2227,1935
'3111061000,  다운동,'40,35 - 39세,1998,3257,1800,1457
'3111061000,  다운동,'45,40 - 44세,1998,1793,959,834
'3111061000,  다운동,'50,45 - 49세,1998,1086,574,512
'3111061000,  다운동,'55,50 - 54세,1998,760,387,373
'3111061000,  다운동,'60,55 - 59세,1998,779,400,379
'3111061000,  다운동,'65,60 - 64세,1998,481,224,257
'3111061000,  다운동,'70,65 - 69세,1998,308,132,176
'3111061000,  다운동,'75,70 - 74세,1998,204,84,120
'3111061000,  다운동,'80,75 - 79세,1998,141,32,109
'3111061000,  다운동,'85,80 - 84세,1998,81,25,56
'3111061000,  다운동,'90,85+ ,1998,36,14,22
'3111062000,  병영1동,'00,계,1998,21720,11053,10667
'3111062000,  병영1동,'05,0 - 4세,1998,1725,945,780
'3111062000,  병영1동,'10,5 - 9세,1998,1614,872,742
'3111062000,  병영1동,'15,10 - 14세,1998,1836,974,862
'3111062000,  병영1동,'20,15 - 19세,1998,2332,1179,1153
'3111062000,  병영1동,'25,20 - 24세,1998,1811,876,935
'3111062000,  병영1동,'30,25 - 29세,1998,2139,1058,1081
'3111062000,  병영1동,'35,30 - 34세,1998,2104,1125,979
'3111062000,  병영1동,'40,35 - 39세,1998,2256,1090,1166
'3111062000,  병영1동,'45,40 - 44세,1998,2060,1015,1045
'3111062000,  병영1동,'50,45 - 49세,1998,1356,746,610
'3111062000,  병영1동,'55,50 - 54세,1998,817,449,368
'3111062000,  병영1동,'60,55 - 59세,1998,632,347,285
'3111062000,  병영1동,'65,60 - 64세,1998,384,168,216
'3111062000,  병영1동,'70,65 - 69세,1998,258,101,157
'3111062000,  병영1동,'75,70 - 74세,1998,178,58,120
'3111062000,  병영1동,'80,75 - 79세,1998,122,32,90
'3111062000,  병영1동,'85,80 - 84세,1998,53,12,41
'3111062000,  병영1동,'90,85+ ,1998,43,6,37
'3111063000,  병영2동,'00,계,1998,22065,11435,10630
'3111063000,  병영2동,'05,0 - 4세,1998,1962,1058,904
'3111063000,  병영2동,'10,5 - 9세,1998,2441,1345,1096
'3111063000,  병영2동,'15,10 - 14세,1998,1970,1069,901
'3111063000,  병영2동,'20,15 - 19세,1998,1796,961,835
'3111063000,  병영2동,'25,20 - 24세,1998,1318,657,661
'3111063000,  병영2동,'30,25 - 29세,1998,2029,930,1099
'3111063000,  병영2동,'35,30 - 34세,1998,2536,1190,1346
'3111063000,  병영2동,'40,35 - 39세,1998,2995,1638,1357
'3111063000,  병영2동,'45,40 - 44세,1998,1849,1028,821
'3111063000,  병영2동,'50,45 - 49세,1998,1003,597,406
'3111063000,  병영2동,'55,50 - 54세,1998,608,303,305
'3111063000,  병영2동,'60,55 - 59세,1998,534,284,250
'3111063000,  병영2동,'65,60 - 64세,1998,369,154,215
'3111063000,  병영2동,'70,65 - 69세,1998,270,113,157
'3111063000,  병영2동,'75,70 - 74세,1998,167,53,114
'3111063000,  병영2동,'80,75 - 79세,1998,105,31,74
'3111063000,  병영2동,'85,80 - 84세,1998,71,15,56
'3111063000,  병영2동,'90,85+ ,1998,42,9,33
'3111064000,  약사동,'00,계,1998,5717,2970,2747
'3111064000,  약사동,'05,0 - 4세,1998,364,177,187
'3111064000,  약사동,'10,5 - 9세,1998,456,250,206
'3111064000,  약사동,'15,10 - 14세,1998,467,267,200
'3111064000,  약사동,'20,15 - 19세,1998,701,351,350
'3111064000,  약사동,'25,20 - 24세,1998,486,270,216
'3111064000,  약사동,'30,25 - 29세,1998,413,219,194
'3111064000,  약사동,'35,30 - 34세,1998,480,243,237
'3111064000,  약사동,'40,35 - 39세,1998,572,283,289
'3111064000,  약사동,'45,40 - 44세,1998,592,275,317
'3111064000,  약사동,'50,45 - 49세,1998,454,272,182
'3111064000,  약사동,'55,50 - 54세,1998,244,161,83
'3111064000,  약사동,'60,55 - 59세,1998,142,75,67
'3111064000,  약사동,'65,60 - 64세,1998,120,55,65
'3111064000,  약사동,'70,65 - 69세,1998,88,39,49
'3111064000,  약사동,'75,70 - 74세,1998,47,15,32
'3111064000,  약사동,'80,75 - 79세,1998,46,10,36
'3111064000,  약사동,'85,80 - 84세,1998,30,6,24
'3111064000,  약사동,'90,85+ ,1998,15,2,13
'31140, 남구,'00,계,1998,321480,164313,157167
'31140, 남구,'05,0 - 4세,1998,25968,13927,12041
'31140, 남구,'10,5 - 9세,1998,28229,15581,12648
'31140, 남구,'15,10 - 14세,1998,26602,14197,12405
'31140, 남구,'20,15 - 19세,1998,30878,15946,14932
'31140, 남구,'25,20 - 24세,1998,23572,12086,11486
'31140, 남구,'30,25 - 29세,1998,29853,14458,15395
'31140, 남구,'35,30 - 34세,1998,33553,16663,16890
'31140, 남구,'40,35 - 39세,1998,35755,17719,18036
'31140, 남구,'45,40 - 44세,1998,30542,15544,14998
'31140, 남구,'50,45 - 49세,1998,19305,10380,8925
'31140, 남구,'55,50 - 54세,1998,12389,6786,5603
'31140, 남구,'60,55 - 59세,1998,9613,5185,4428
'31140, 남구,'65,60 - 64세,1998,5878,2825,3053
'31140, 남구,'70,65 - 69세,1998,3633,1469,2164
'31140, 남구,'75,70 - 74세,1998,2581,784,1797
'31140, 남구,'80,75 - 79세,1998,1656,443,1213
'31140, 남구,'85,80 - 84세,1998,960,228,732
'31140, 남구,'90,85+ ,1998,513,92,421
'3114051000,  신정1동,'00,계,1998,19727,9868,9859
'3114051000,  신정1동,'05,0 - 4세,1998,964,512,452
'3114051000,  신정1동,'10,5 - 9세,1998,1158,675,483
'3114051000,  신정1동,'15,10 - 14세,1998,1425,758,667
'3114051000,  신정1동,'20,15 - 19세,1998,2255,1164,1091
'3114051000,  신정1동,'25,20 - 24세,1998,1947,1004,943
'3114051000,  신정1동,'30,25 - 29세,1998,1748,934,814
'3114051000,  신정1동,'35,30 - 34세,1998,1423,700,723
'3114051000,  신정1동,'40,35 - 39세,1998,1791,814,977
'3114051000,  신정1동,'45,40 - 44세,1998,1977,868,1109
'3114051000,  신정1동,'50,45 - 49세,1998,1587,787,800
'3114051000,  신정1동,'55,50 - 54세,1998,1128,569,559
'3114051000,  신정1동,'60,55 - 59세,1998,954,518,436
'3114051000,  신정1동,'65,60 - 64세,1998,541,275,266
'3114051000,  신정1동,'70,65 - 69세,1998,290,127,163
'3114051000,  신정1동,'75,70 - 74세,1998,235,77,158
'3114051000,  신정1동,'80,75 - 79세,1998,154,52,102
'3114051000,  신정1동,'85,80 - 84세,1998,98,25,73
'3114051000,  신정1동,'90,85+ ,1998,52,9,43
'3114052000,  신정2동,'00,계,1998,21798,11169,10629
'3114052000,  신정2동,'05,0 - 4세,1998,1337,723,614
'3114052000,  신정2동,'10,5 - 9세,1998,1631,902,729
'3114052000,  신정2동,'15,10 - 14세,1998,1766,920,846
'3114052000,  신정2동,'20,15 - 19세,1998,2528,1363,1165
'3114052000,  신정2동,'25,20 - 24세,1998,1872,983,889
'3114052000,  신정2동,'30,25 - 29세,1998,1707,928,779
'3114052000,  신정2동,'35,30 - 34세,1998,1919,948,971
'3114052000,  신정2동,'40,35 - 39세,1998,2172,1026,1146
'3114052000,  신정2동,'45,40 - 44세,1998,2236,1019,1217
'3114052000,  신정2동,'50,45 - 49세,1998,1670,877,793
'3114052000,  신정2동,'55,50 - 54세,1998,1096,623,473
'3114052000,  신정2동,'60,55 - 59세,1998,809,448,361
'3114052000,  신정2동,'65,60 - 64세,1998,391,205,186
'3114052000,  신정2동,'70,65 - 69세,1998,249,90,159
'3114052000,  신정2동,'75,70 - 74세,1998,189,58,131
'3114052000,  신정2동,'80,75 - 79세,1998,115,36,79
'3114052000,  신정2동,'85,80 - 84세,1998,67,14,53
'3114052000,  신정2동,'90,85+ ,1998,44,6,38
'3114053000,  신정3동,'00,계,1998,17507,8776,8731
'3114053000,  신정3동,'05,0 - 4세,1998,935,483,452
'3114053000,  신정3동,'10,5 - 9세,1998,1217,663,554
'3114053000,  신정3동,'15,10 - 14세,1998,1246,676,570
'3114053000,  신정3동,'20,15 - 19세,1998,1887,966,921
'3114053000,  신정3동,'25,20 - 24세,1998,1725,927,798
'3114053000,  신정3동,'30,25 - 29세,1998,1719,898,821
'3114053000,  신정3동,'35,30 - 34세,1998,1409,695,714
'3114053000,  신정3동,'40,35 - 39세,1998,1626,752,874
'3114053000,  신정3동,'45,40 - 44세,1998,1656,762,894
'3114053000,  신정3동,'50,45 - 49세,1998,1309,644,665
'3114053000,  신정3동,'55,50 - 54세,1998,917,460,457
'3114053000,  신정3동,'60,55 - 59세,1998,772,406,366
'3114053000,  신정3동,'65,60 - 64세,1998,482,249,233
'3114053000,  신정3동,'70,65 - 69세,1998,245,92,153
'3114053000,  신정3동,'75,70 - 74세,1998,178,55,123
'3114053000,  신정3동,'80,75 - 79세,1998,93,30,63
'3114053000,  신정3동,'85,80 - 84세,1998,71,14,57
'3114053000,  신정3동,'90,85+ ,1998,20,4,16
'3114054000,  신정4동,'00,계,1998,22706,11662,11044
'3114054000,  신정4동,'05,0 - 4세,1998,1471,809,662
'3114054000,  신정4동,'10,5 - 9세,1998,1934,1124,810
'3114054000,  신정4동,'15,10 - 14세,1998,1995,1053,942
'3114054000,  신정4동,'20,15 - 19세,1998,2399,1250,1149
'3114054000,  신정4동,'25,20 - 24세,1998,1886,976,910
'3114054000,  신정4동,'30,25 - 29세,1998,1906,980,926
'3114054000,  신정4동,'35,30 - 34세,1998,2073,974,1099
'3114054000,  신정4동,'40,35 - 39세,1998,2417,1156,1261
'3114054000,  신정4동,'45,40 - 44세,1998,2190,1092,1098
'3114054000,  신정4동,'50,45 - 49세,1998,1504,804,700
'3114054000,  신정4동,'55,50 - 54세,1998,1047,557,490
'3114054000,  신정4동,'60,55 - 59세,1998,774,446,328
'3114054000,  신정4동,'65,60 - 64세,1998,430,228,202
'3114054000,  신정4동,'70,65 - 69세,1998,257,101,156
'3114054000,  신정4동,'75,70 - 74세,1998,193,57,136
'3114054000,  신정4동,'80,75 - 79세,1998,119,28,91
'3114054000,  신정4동,'85,80 - 84세,1998,71,20,51
'3114054000,  신정4동,'90,85+ ,1998,40,7,33
'3114055000,  신정5동,'00,계,1998,9266,4780,4486
'3114055000,  신정5동,'05,0 - 4세,1998,689,386,303
'3114055000,  신정5동,'10,5 - 9세,1998,709,412,297
'3114055000,  신정5동,'15,10 - 14세,1998,684,378,306
'3114055000,  신정5동,'20,15 - 19세,1998,843,402,441
'3114055000,  신정5동,'25,20 - 24세,1998,818,411,407
'3114055000,  신정5동,'30,25 - 29세,1998,1004,526,478
'3114055000,  신정5동,'35,30 - 34세,1998,964,468,496
'3114055000,  신정5동,'40,35 - 39세,1998,1007,499,508
'3114055000,  신정5동,'45,40 - 44세,1998,813,440,373
'3114055000,  신정5동,'50,45 - 49세,1998,553,288,265
'3114055000,  신정5동,'55,50 - 54세,1998,409,215,194
'3114055000,  신정5동,'60,55 - 59세,1998,307,174,133
'3114055000,  신정5동,'65,60 - 64세,1998,192,93,99
'3114055000,  신정5동,'70,65 - 69세,1998,112,49,63
'3114055000,  신정5동,'75,70 - 74세,1998,65,14,51
'3114055000,  신정5동,'80,75 - 79세,1998,48,15,33
'3114055000,  신정5동,'85,80 - 84세,1998,32,8,24
'3114055000,  신정5동,'90,85+ ,1998,17,2,15
'3114056000,  달동,'00,계,1998,28731,14426,14305
'3114056000,  달동,'05,0 - 4세,1998,2161,1159,1002
'3114056000,  달동,'10,5 - 9세,1998,2707,1481,1226
'3114056000,  달동,'15,10 - 14세,1998,2549,1326,1223
'3114056000,  달동,'20,15 - 19세,1998,2942,1458,1484
'3114056000,  달동,'25,20 - 24세,1998,2048,1027,1021
'3114056000,  달동,'30,25 - 29세,1998,2418,1146,1272
'3114056000,  달동,'35,30 - 34세,1998,3064,1426,1638
'3114056000,  달동,'40,35 - 39세,1998,3542,1752,1790
'3114056000,  달동,'45,40 - 44세,1998,2764,1439,1325
'3114056000,  달동,'50,45 - 49세,1998,1591,834,757
'3114056000,  달동,'55,50 - 54세,1998,946,516,430
'3114056000,  달동,'60,55 - 59세,1998,736,380,356
'3114056000,  달동,'65,60 - 64세,1998,465,220,245
'3114056000,  달동,'70,65 - 69세,1998,316,125,191
'3114056000,  달동,'75,70 - 74세,1998,227,78,149
'3114056000,  달동,'80,75 - 79세,1998,128,34,94
'3114056000,  달동,'85,80 - 84세,1998,78,17,61
'3114056000,  달동,'90,85+ ,1998,49,8,41
'3114057000,  삼산동,'00,계,1998,34535,17590,16945
'3114057000,  삼산동,'05,0 - 4세,1998,3396,1782,1614
'3114057000,  삼산동,'10,5 - 9세,1998,3429,1859,1570
'3114057000,  삼산동,'15,10 - 14세,1998,3090,1694,1396
'3114057000,  삼산동,'20,15 - 19세,1998,3161,1615,1546
'3114057000,  삼산동,'25,20 - 24세,1998,1901,933,968
'3114057000,  삼산동,'30,25 - 29세,1998,3144,1315,1829
'3114057000,  삼산동,'35,30 - 34세,1998,4048,2025,2023
'3114057000,  삼산동,'40,35 - 39세,1998,4157,2080,2077
'3114057000,  삼산동,'45,40 - 44세,1998,3411,1753,1658
'3114057000,  삼산동,'50,45 - 49세,1998,1973,1134,839
'3114057000,  삼산동,'55,50 - 54세,1998,1059,634,425
'3114057000,  삼산동,'60,55 - 59세,1998,680,393,287
'3114057000,  삼산동,'65,60 - 64세,1998,348,153,195
'3114057000,  삼산동,'70,65 - 69세,1998,262,104,158
'3114057000,  삼산동,'75,70 - 74세,1998,208,57,151
'3114057000,  삼산동,'80,75 - 79세,1998,156,36,120
'3114057000,  삼산동,'85,80 - 84세,1998,72,14,58
'3114057000,  삼산동,'90,85+ ,1998,40,9,31
'3114058000,  무거1동,'00,계,1998,30672,15643,15029
'3114058000,  무거1동,'05,0 - 4세,1998,3491,1878,1613
'3114058000,  무거1동,'10,5 - 9세,1998,3119,1662,1457
'3114058000,  무거1동,'15,10 - 14세,1998,2328,1249,1079
'3114058000,  무거1동,'20,15 - 19세,1998,2134,1133,1001
'3114058000,  무거1동,'25,20 - 24세,1998,1762,865,897
'3114058000,  무거1동,'30,25 - 29세,1998,3538,1542,1996
'3114058000,  무거1동,'35,30 - 34세,1998,4188,2125,2063
'3114058000,  무거1동,'40,35 - 39세,1998,3578,1887,1691
'3114058000,  무거1동,'45,40 - 44세,1998,2454,1342,1112
'3114058000,  무거1동,'50,45 - 49세,1998,1257,695,562
'3114058000,  무거1동,'55,50 - 54세,1998,832,441,391
'3114058000,  무거1동,'60,55 - 59세,1998,726,390,336
'3114058000,  무거1동,'65,60 - 64세,1998,476,198,278
'3114058000,  무거1동,'70,65 - 69세,1998,312,116,196
'3114058000,  무거1동,'75,70 - 74세,1998,236,70,166
'3114058000,  무거1동,'80,75 - 79세,1998,129,30,99
'3114058000,  무거1동,'85,80 - 84세,1998,74,13,61
'3114058000,  무거1동,'90,85+ ,1998,38,7,31
'3114059000,  무거2동,'00,계,1998,26403,13613,12790
'3114059000,  무거2동,'05,0 - 4세,1998,3213,1720,1493
'3114059000,  무거2동,'10,5 - 9세,1998,2836,1546,1290
'3114059000,  무거2동,'15,10 - 14세,1998,1925,1048,877
'3114059000,  무거2동,'20,15 - 19세,1998,1688,868,820
'3114059000,  무거2동,'25,20 - 24세,1998,1497,789,708
'3114059000,  무거2동,'30,25 - 29세,1998,2966,1303,1663
'3114059000,  무거2동,'35,30 - 34세,1998,3886,1969,1917
'3114059000,  무거2동,'40,35 - 39세,1998,3173,1705,1468
'3114059000,  무거2동,'45,40 - 44세,1998,1995,1104,891
'3114059000,  무거2동,'50,45 - 49세,1998,1058,576,482
'3114059000,  무거2동,'55,50 - 54세,1998,634,352,282
'3114059000,  무거2동,'60,55 - 59세,1998,581,289,292
'3114059000,  무거2동,'65,60 - 64세,1998,389,176,213
'3114059000,  무거2동,'70,65 - 69세,1998,231,86,145
'3114059000,  무거2동,'75,70 - 74세,1998,151,39,112
'3114059000,  무거2동,'80,75 - 79세,1998,95,25,70
'3114059000,  무거2동,'85,80 - 84세,1998,59,15,44
'3114059000,  무거2동,'90,85+ ,1998,26,3,23
'3114060000,  옥동,'00,계,1998,26118,13345,12773
'3114060000,  옥동,'05,0 - 4세,1998,1783,945,838
'3114060000,  옥동,'10,5 - 9세,1998,2527,1446,1081
'3114060000,  옥동,'15,10 - 14세,1998,2911,1561,1350
'3114060000,  옥동,'20,15 - 19세,1998,2970,1609,1361
'3114060000,  옥동,'25,20 - 24세,1998,1489,773,716
'3114060000,  옥동,'30,25 - 29세,1998,1642,719,923
'3114060000,  옥동,'35,30 - 34세,1998,2261,1040,1221
'3114060000,  옥동,'40,35 - 39세,1998,3171,1409,1762
'3114060000,  옥동,'45,40 - 44세,1998,3318,1714,1604
'3114060000,  옥동,'50,45 - 49세,1998,1711,1019,692
'3114060000,  옥동,'55,50 - 54세,1998,834,505,329
'3114060000,  옥동,'60,55 - 59세,1998,479,275,204
'3114060000,  옥동,'65,60 - 64세,1998,318,129,189
'3114060000,  옥동,'70,65 - 69세,1998,233,80,153
'3114060000,  옥동,'75,70 - 74세,1998,214,64,150
'3114060000,  옥동,'80,75 - 79세,1998,136,27,109
'3114060000,  옥동,'85,80 - 84세,1998,88,25,63
'3114060000,  옥동,'90,85+ ,1998,33,5,28
'3114062000,  야음2동,'00,계,1998,28506,14688,13818
'3114062000,  야음2동,'05,0 - 4세,1998,2191,1208,983
'3114062000,  야음2동,'10,5 - 9세,1998,2405,1320,1085
'3114062000,  야음2동,'15,10 - 14세,1998,2291,1206,1085
'3114062000,  야음2동,'20,15 - 19세,1998,2835,1425,1410
'3114062000,  야음2동,'25,20 - 24세,1998,2246,1169,1077
'3114062000,  야음2동,'30,25 - 29세,1998,2633,1332,1301
'3114062000,  야음2동,'35,30 - 34세,1998,2816,1434,1382
'3114062000,  야음2동,'40,35 - 39세,1998,3112,1568,1544
'3114062000,  야음2동,'45,40 - 44세,1998,2653,1330,1323
'3114062000,  야음2동,'50,45 - 49세,1998,1800,962,838
'3114062000,  야음2동,'55,50 - 54세,1998,1208,671,537
'3114062000,  야음2동,'60,55 - 59세,1998,937,512,425
'3114062000,  야음2동,'65,60 - 64세,1998,577,284,293
'3114062000,  야음2동,'70,65 - 69세,1998,322,148,174
'3114062000,  야음2동,'75,70 - 74세,1998,193,52,141
'3114062000,  야음2동,'80,75 - 79세,1998,163,38,125
'3114062000,  야음2동,'85,80 - 84세,1998,70,18,52
'3114062000,  야음2동,'90,85+ ,1998,54,11,43
'3114063000,  야음3동,'00,계,1998,15064,7732,7332
'3114063000,  야음3동,'05,0 - 4세,1998,1456,796,660
'3114063000,  야음3동,'10,5 - 9세,1998,1544,854,690
'3114063000,  야음3동,'15,10 - 14세,1998,1331,730,601
'3114063000,  야음3동,'20,15 - 19세,1998,1296,673,623
'3114063000,  야음3동,'25,20 - 24세,1998,875,439,436
'3114063000,  야음3동,'30,25 - 29세,1998,1395,639,756
'3114063000,  야음3동,'35,30 - 34세,1998,1720,835,885
'3114063000,  야음3동,'40,35 - 39세,1998,1884,933,951
'3114063000,  야음3동,'45,40 - 44세,1998,1454,788,666
'3114063000,  야음3동,'50,45 - 49세,1998,772,425,347
'3114063000,  야음3동,'55,50 - 54세,1998,462,263,199
'3114063000,  야음3동,'60,55 - 59세,1998,292,163,129
'3114063000,  야음3동,'65,60 - 64세,1998,190,79,111
'3114063000,  야음3동,'70,65 - 69세,1998,142,49,93
'3114063000,  야음3동,'75,70 - 74세,1998,115,35,80
'3114063000,  야음3동,'80,75 - 79세,1998,81,20,61
'3114063000,  야음3동,'85,80 - 84세,1998,35,9,26
'3114063000,  야음3동,'90,85+ ,1998,20,2,18
'3114064000,  선암동,'00,계,1998,19275,9925,9350
'3114064000,  선암동,'05,0 - 4세,1998,1569,849,720
'3114064000,  선암동,'10,5 - 9세,1998,1657,890,767
'3114064000,  선암동,'15,10 - 14세,1998,1689,855,834
'3114064000,  선암동,'20,15 - 19세,1998,1861,973,888
'3114064000,  선암동,'25,20 - 24세,1998,1298,658,640
'3114064000,  선암동,'30,25 - 29세,1998,1755,862,893
'3114064000,  선암동,'35,30 - 34세,1998,1954,985,969
'3114064000,  선암동,'40,35 - 39세,1998,2217,1119,1098
'3114064000,  선암동,'45,40 - 44세,1998,1825,993,832
'3114064000,  선암동,'50,45 - 49세,1998,1134,629,505
'3114064000,  선암동,'55,50 - 54세,1998,679,407,272
'3114064000,  선암동,'60,55 - 59세,1998,533,248,285
'3114064000,  선암동,'65,60 - 64세,1998,430,209,221
'3114064000,  선암동,'70,65 - 69세,1998,299,134,165
'3114064000,  선암동,'75,70 - 74세,1998,158,45,113
'3114064000,  선암동,'80,75 - 79세,1998,119,38,81
'3114064000,  선암동,'85,80 - 84세,1998,68,23,45
'3114064000,  선암동,'90,85+ ,1998,30,8,22
'3114067000,  야음장생포동,'00,계,1998,21172,11096,10076
'3114067000,  야음장생포동,'05,0 - 4세,1998,1312,677,635
'3114067000,  야음장생포동,'10,5 - 9세,1998,1356,747,609
'3114067000,  야음장생포동,'15,10 - 14세,1998,1372,743,629
'3114067000,  야음장생포동,'20,15 - 19세,1998,2079,1047,1032
'3114067000,  야음장생포동,'25,20 - 24세,1998,2208,1132,1076
'3114067000,  야음장생포동,'30,25 - 29세,1998,2278,1334,944
'3114067000,  야음장생포동,'35,30 - 34세,1998,1828,1039,789
'3114067000,  야음장생포동,'40,35 - 39세,1998,1908,1019,889
'3114067000,  야음장생포동,'45,40 - 44세,1998,1796,900,896
'3114067000,  야음장생포동,'50,45 - 49세,1998,1386,706,680
'3114067000,  야음장생포동,'55,50 - 54세,1998,1138,573,565
'3114067000,  야음장생포동,'60,55 - 59세,1998,1033,543,490
'3114067000,  야음장생포동,'65,60 - 64세,1998,649,327,322
'3114067000,  야음장생포동,'70,65 - 69세,1998,363,168,195
'3114067000,  야음장생포동,'75,70 - 74세,1998,219,83,136
'3114067000,  야음장생포동,'80,75 - 79세,1998,120,34,86
'3114067000,  야음장생포동,'85,80 - 84세,1998,77,13,64
'3114067000,  야음장생포동,'90,85+ ,1998,50,11,39
'31170, 동구,'00,계,1998,189484,98029,91455
'31170, 동구,'05,0 - 4세,1998,15457,8318,7139
'31170, 동구,'10,5 - 9세,1998,16994,9505,7489
'31170, 동구,'15,10 - 14세,1998,17494,9339,8155
'31170, 동구,'20,15 - 19세,1998,19405,9811,9594
'31170, 동구,'25,20 - 24세,1998,14176,7099,7077
'31170, 동구,'30,25 - 29세,1998,16177,8002,8175
'31170, 동구,'35,30 - 34세,1998,18834,9308,9526
'31170, 동구,'40,35 - 39세,1998,22802,11217,11585
'31170, 동구,'45,40 - 44세,1998,18789,10111,8678
'31170, 동구,'50,45 - 49세,1998,11342,6513,4829
'31170, 동구,'55,50 - 54세,1998,6674,3980,2694
'31170, 동구,'60,55 - 59세,1998,4293,2444,1849
'31170, 동구,'65,60 - 64세,1998,2351,1069,1282
'31170, 동구,'70,65 - 69세,1998,1622,574,1048
'31170, 동구,'75,70 - 74세,1998,1308,345,963
'31170, 동구,'80,75 - 79세,1998,993,219,774
'31170, 동구,'85,80 - 84세,1998,490,124,366
'31170, 동구,'90,85+ ,1998,283,51,232
'3117051000,  방어동,'00,계,1998,27771,14357,13414
'3117051000,  방어동,'05,0 - 4세,1998,2413,1283,1130
'3117051000,  방어동,'10,5 - 9세,1998,2282,1212,1070
'3117051000,  방어동,'15,10 - 14세,1998,2208,1199,1009
'3117051000,  방어동,'20,15 - 19세,1998,2599,1301,1298
'3117051000,  방어동,'25,20 - 24세,1998,2075,1038,1037
'3117051000,  방어동,'30,25 - 29세,1998,2682,1351,1331
'3117051000,  방어동,'35,30 - 34세,1998,2905,1509,1396
'3117051000,  방어동,'40,35 - 39세,1998,3073,1582,1491
'3117051000,  방어동,'45,40 - 44세,1998,2600,1423,1177
'3117051000,  방어동,'50,45 - 49세,1998,1557,871,686
'3117051000,  방어동,'55,50 - 54세,1998,1064,600,464
'3117051000,  방어동,'60,55 - 59세,1998,807,438,369
'3117051000,  방어동,'65,60 - 64세,1998,522,235,287
'3117051000,  방어동,'70,65 - 69세,1998,371,153,218
'3117051000,  방어동,'75,70 - 74세,1998,285,88,197
'3117051000,  방어동,'80,75 - 79세,1998,197,48,149
'3117051000,  방어동,'85,80 - 84세,1998,81,19,62
'3117051000,  방어동,'90,85+ ,1998,50,7,43
'3117052000,  일산동,'00,계,1998,11151,5821,5330
'3117052000,  일산동,'05,0 - 4세,1998,781,391,390
'3117052000,  일산동,'10,5 - 9세,1998,687,404,283
'3117052000,  일산동,'15,10 - 14세,1998,718,382,336
'3117052000,  일산동,'20,15 - 19세,1998,1305,677,628
'3117052000,  일산동,'25,20 - 24세,1998,1149,600,549
'3117052000,  일산동,'30,25 - 29세,1998,1113,630,483
'3117052000,  일산동,'35,30 - 34세,1998,969,554,415
'3117052000,  일산동,'40,35 - 39세,1998,986,482,504
'3117052000,  일산동,'45,40 - 44세,1998,1033,489,544
'3117052000,  일산동,'50,45 - 49세,1998,796,451,345
'3117052000,  일산동,'55,50 - 54세,1998,545,312,233
'3117052000,  일산동,'60,55 - 59세,1998,386,201,185
'3117052000,  일산동,'65,60 - 64세,1998,247,124,123
'3117052000,  일산동,'70,65 - 69세,1998,145,62,83
'3117052000,  일산동,'75,70 - 74세,1998,119,34,85
'3117052000,  일산동,'80,75 - 79세,1998,91,14,77
'3117052000,  일산동,'85,80 - 84세,1998,48,9,39
'3117052000,  일산동,'90,85+ ,1998,33,5,28
'3117053000,  화정동,'00,계,1998,25707,13217,12490
'3117053000,  화정동,'05,0 - 4세,1998,2224,1179,1045
'3117053000,  화정동,'10,5 - 9세,1998,2203,1219,984
'3117053000,  화정동,'15,10 - 14세,1998,2268,1182,1086
'3117053000,  화정동,'20,15 - 19세,1998,2636,1304,1332
'3117053000,  화정동,'25,20 - 24세,1998,2113,1100,1013
'3117053000,  화정동,'30,25 - 29세,1998,2409,1206,1203
'3117053000,  화정동,'35,30 - 34세,1998,2540,1266,1274
'3117053000,  화정동,'40,35 - 39세,1998,3001,1509,1492
'3117053000,  화정동,'45,40 - 44세,1998,2377,1275,1102
'3117053000,  화정동,'50,45 - 49세,1998,1480,824,656
'3117053000,  화정동,'55,50 - 54세,1998,909,516,393
'3117053000,  화정동,'60,55 - 59세,1998,577,325,252
'3117053000,  화정동,'65,60 - 64세,1998,336,144,192
'3117053000,  화정동,'70,65 - 69세,1998,225,69,156
'3117053000,  화정동,'75,70 - 74세,1998,186,48,138
'3117053000,  화정동,'80,75 - 79세,1998,122,29,93
'3117053000,  화정동,'85,80 - 84세,1998,64,17,47
'3117053000,  화정동,'90,85+ ,1998,37,5,32
'3117054000,  대송동,'00,계,1998,17947,9301,8646
'3117054000,  대송동,'05,0 - 4세,1998,1979,1039,940
'3117054000,  대송동,'10,5 - 9세,1998,1969,1110,859
'3117054000,  대송동,'15,10 - 14세,1998,1797,964,833
'3117054000,  대송동,'20,15 - 19세,1998,1399,704,695
'3117054000,  대송동,'25,20 - 24세,1998,945,464,481
'3117054000,  대송동,'30,25 - 29세,1998,1669,707,962
'3117054000,  대송동,'35,30 - 34세,1998,2284,1136,1148
'3117054000,  대송동,'40,35 - 39세,1998,2537,1338,1199
'3117054000,  대송동,'45,40 - 44세,1998,1583,891,692
'3117054000,  대송동,'50,45 - 49세,1998,726,450,276
'3117054000,  대송동,'55,50 - 54세,1998,345,211,134
'3117054000,  대송동,'60,55 - 59세,1998,229,137,92
'3117054000,  대송동,'65,60 - 64세,1998,156,59,97
'3117054000,  대송동,'70,65 - 69세,1998,106,33,73
'3117054000,  대송동,'75,70 - 74세,1998,92,22,70
'3117054000,  대송동,'80,75 - 79세,1998,78,21,57
'3117054000,  대송동,'85,80 - 84세,1998,32,6,26
'3117054000,  대송동,'90,85+ ,1998,21,9,12
'3117055000,  전하1동,'00,계,1998,16484,8577,7907
'3117055000,  전하1동,'05,0 - 4세,1998,1328,717,611
'3117055000,  전하1동,'10,5 - 9세,1998,1206,670,536
'3117055000,  전하1동,'15,10 - 14세,1998,1201,625,576
'3117055000,  전하1동,'20,15 - 19세,1998,1700,847,853
'3117055000,  전하1동,'25,20 - 24세,1998,1526,798,728
'3117055000,  전하1동,'30,25 - 29세,1998,1619,871,748
'3117055000,  전하1동,'35,30 - 34세,1998,1680,901,779
'3117055000,  전하1동,'40,35 - 39세,1998,1591,829,762
'3117055000,  전하1동,'45,40 - 44세,1998,1442,681,761
'3117055000,  전하1동,'50,45 - 49세,1998,1180,608,572
'3117055000,  전하1동,'55,50 - 54세,1998,742,448,294
'3117055000,  전하1동,'60,55 - 59세,1998,531,315,216
'3117055000,  전하1동,'65,60 - 64세,1998,257,128,129
'3117055000,  전하1동,'70,65 - 69세,1998,160,67,93
'3117055000,  전하1동,'75,70 - 74세,1998,130,37,93
'3117055000,  전하1동,'80,75 - 79세,1998,116,23,93
'3117055000,  전하1동,'85,80 - 84세,1998,42,9,33
'3117055000,  전하1동,'90,85+ ,1998,33,3,30
'3117056000,  전하2동,'00,계,1998,12730,6608,6122
'3117056000,  전하2동,'05,0 - 4세,1998,1235,658,577
'3117056000,  전하2동,'10,5 - 9세,1998,1151,651,500
'3117056000,  전하2동,'15,10 - 14세,1998,981,541,440
'3117056000,  전하2동,'20,15 - 19세,1998,1233,620,613
'3117056000,  전하2동,'25,20 - 24세,1998,992,506,486
'3117056000,  전하2동,'30,25 - 29세,1998,1197,554,643
'3117056000,  전하2동,'35,30 - 34세,1998,1427,727,700
'3117056000,  전하2동,'40,35 - 39세,1998,1432,731,701
'3117056000,  전하2동,'45,40 - 44세,1998,1147,607,540
'3117056000,  전하2동,'50,45 - 49세,1998,753,413,340
'3117056000,  전하2동,'55,50 - 54세,1998,474,280,194
'3117056000,  전하2동,'60,55 - 59세,1998,292,158,134
'3117056000,  전하2동,'65,60 - 64세,1998,148,75,73
'3117056000,  전하2동,'70,65 - 69세,1998,90,31,59
'3117056000,  전하2동,'75,70 - 74세,1998,75,26,49
'3117056000,  전하2동,'80,75 - 79세,1998,49,13,36
'3117056000,  전하2동,'85,80 - 84세,1998,33,12,21
'3117056000,  전하2동,'90,85+ ,1998,21,5,16
'3117057000,  전하3동,'00,계,1998,13917,7162,6755
'3117057000,  전하3동,'05,0 - 4세,1998,1154,615,539
'3117057000,  전하3동,'10,5 - 9세,1998,1190,645,545
'3117057000,  전하3동,'15,10 - 14세,1998,1232,648,584
'3117057000,  전하3동,'20,15 - 19세,1998,1476,760,716
'3117057000,  전하3동,'25,20 - 24세,1998,1106,547,559
'3117057000,  전하3동,'30,25 - 29세,1998,1248,599,649
'3117057000,  전하3동,'35,30 - 34세,1998,1390,695,695
'3117057000,  전하3동,'40,35 - 39세,1998,1583,784,799
'3117057000,  전하3동,'45,40 - 44세,1998,1335,681,654
'3117057000,  전하3동,'50,45 - 49세,1998,908,526,382
'3117057000,  전하3동,'55,50 - 54세,1998,504,300,204
'3117057000,  전하3동,'60,55 - 59세,1998,326,194,132
'3117057000,  전하3동,'65,60 - 64세,1998,164,79,85
'3117057000,  전하3동,'70,65 - 69세,1998,106,37,69
'3117057000,  전하3동,'75,70 - 74세,1998,80,18,62
'3117057000,  전하3동,'80,75 - 79세,1998,65,17,48
'3117057000,  전하3동,'85,80 - 84세,1998,39,14,25
'3117057000,  전하3동,'90,85+ ,1998,11,3,8
'3117058000,  남목1동,'00,계,1998,14600,7521,7079
'3117058000,  남목1동,'05,0 - 4세,1998,1052,588,464
'3117058000,  남목1동,'10,5 - 9세,1998,1347,788,559
'3117058000,  남목1동,'15,10 - 14세,1998,1468,761,707
'3117058000,  남목1동,'20,15 - 19세,1998,1612,823,789
'3117058000,  남목1동,'25,20 - 24세,1998,1031,509,522
'3117058000,  남목1동,'30,25 - 29세,1998,1050,506,544
'3117058000,  남목1동,'35,30 - 34세,1998,1356,640,716
'3117058000,  남목1동,'40,35 - 39세,1998,1858,896,962
'3117058000,  남목1동,'45,40 - 44세,1998,1518,813,705
'3117058000,  남목1동,'50,45 - 49세,1998,904,517,387
'3117058000,  남목1동,'55,50 - 54세,1998,547,330,217
'3117058000,  남목1동,'60,55 - 59세,1998,323,174,149
'3117058000,  남목1동,'65,60 - 64세,1998,163,67,96
'3117058000,  남목1동,'70,65 - 69세,1998,150,52,98
'3117058000,  남목1동,'75,70 - 74세,1998,88,25,63
'3117058000,  남목1동,'80,75 - 79세,1998,74,18,56
'3117058000,  남목1동,'85,80 - 84세,1998,33,8,25
'3117058000,  남목1동,'90,85+ ,1998,26,6,20
'3117059000,  남목2동,'00,계,1998,30289,15687,14602
'3117059000,  남목2동,'05,0 - 4세,1998,1934,1093,841
'3117059000,  남목2동,'10,5 - 9세,1998,2692,1536,1156
'3117059000,  남목2동,'15,10 - 14세,1998,3411,1829,1582
'3117059000,  남목2동,'20,15 - 19세,1998,3754,1901,1853
'3117059000,  남목2동,'25,20 - 24세,1998,2215,1051,1164
'3117059000,  남목2동,'30,25 - 29세,1998,2059,1058,1001
'3117059000,  남목2동,'35,30 - 34세,1998,2440,1125,1315
'3117059000,  남목2동,'40,35 - 39세,1998,3839,1645,2194
'3117059000,  남목2동,'45,40 - 44세,1998,3718,2025,1693
'3117059000,  남목2동,'50,45 - 49세,1998,2073,1261,812
'3117059000,  남목2동,'55,50 - 54세,1998,1038,690,348
'3117059000,  남목2동,'60,55 - 59세,1998,473,300,173
'3117059000,  남목2동,'65,60 - 64세,1998,189,90,99
'3117059000,  남목2동,'70,65 - 69세,1998,129,29,100
'3117059000,  남목2동,'75,70 - 74세,1998,131,17,114
'3117059000,  남목2동,'80,75 - 79세,1998,105,20,85
'3117059000,  남목2동,'85,80 - 84세,1998,62,13,49
'3117059000,  남목2동,'90,85+ ,1998,27,4,23
'3117060000,  남목3동,'00,계,1998,18888,9778,9110
'3117060000,  남목3동,'05,0 - 4세,1998,1357,755,602
'3117060000,  남목3동,'10,5 - 9세,1998,2267,1270,997
'3117060000,  남목3동,'15,10 - 14세,1998,2210,1208,1002
'3117060000,  남목3동,'20,15 - 19세,1998,1691,874,817
'3117060000,  남목3동,'25,20 - 24세,1998,1024,486,538
'3117060000,  남목3동,'30,25 - 29세,1998,1131,520,611
'3117060000,  남목3동,'35,30 - 34세,1998,1843,755,1088
'3117060000,  남목3동,'40,35 - 39세,1998,2902,1421,1481
'3117060000,  남목3동,'45,40 - 44세,1998,2036,1226,810
'3117060000,  남목3동,'50,45 - 49세,1998,965,592,373
'3117060000,  남목3동,'55,50 - 54세,1998,506,293,213
'3117060000,  남목3동,'60,55 - 59세,1998,349,202,147
'3117060000,  남목3동,'65,60 - 64세,1998,169,68,101
'3117060000,  남목3동,'70,65 - 69세,1998,140,41,99
'3117060000,  남목3동,'75,70 - 74세,1998,122,30,92
'3117060000,  남목3동,'80,75 - 79세,1998,96,16,80
'3117060000,  남목3동,'85,80 - 84세,1998,56,17,39
'3117060000,  남목3동,'90,85+ ,1998,24,4,20
'31200, 북구,'00,계,1998,117184,60945,56239
'31200, 북구,'05,0 - 4세,1998,15361,8330,7031
'31200, 북구,'10,5 - 9세,1998,13786,7426,6360
'31200, 북구,'15,10 - 14세,1998,7202,3816,3386
'31200, 북구,'20,15 - 19세,1998,6523,3313,3210
'31200, 북구,'25,20 - 24세,1998,6230,3111,3119
'31200, 북구,'30,25 - 29세,1998,12845,5610,7235
'31200, 북구,'35,30 - 34세,1998,18659,9695,8964
'31200, 북구,'40,35 - 39세,1998,14117,8585,5532
'31200, 북구,'45,40 - 44세,1998,6714,3778,2936
'31200, 북구,'50,45 - 49세,1998,3905,2126,1779
'31200, 북구,'55,50 - 54세,1998,2845,1470,1375
'31200, 북구,'60,55 - 59세,1998,2783,1365,1418
'31200, 북구,'65,60 - 64세,1998,2129,953,1176
'31200, 북구,'70,65 - 69세,1998,1565,606,959
'31200, 북구,'75,70 - 74세,1998,1077,357,720
'31200, 북구,'80,75 - 79세,1998,789,236,553
'31200, 북구,'85,80 - 84세,1998,420,117,303
'31200, 북구,'90,85+ ,1998,234,51,183
'3120051000,  농소1동,'00,계,1998,16800,8577,8223
'3120051000,  농소1동,'05,0 - 4세,1998,1848,1005,843
'3120051000,  농소1동,'10,5 - 9세,1998,2014,1076,938
'3120051000,  농소1동,'15,10 - 14세,1998,1178,612,566
'3120051000,  농소1동,'20,15 - 19세,1998,1107,549,558
'3120051000,  농소1동,'25,20 - 24세,1998,1025,509,516
'3120051000,  농소1동,'30,25 - 29세,1998,1470,624,846
'3120051000,  농소1동,'35,30 - 34세,1998,2326,1104,1222
'3120051000,  농소1동,'40,35 - 39세,1998,2077,1240,837
'3120051000,  농소1동,'45,40 - 44세,1998,1097,627,470
'3120051000,  농소1동,'50,45 - 49세,1998,647,342,305
'3120051000,  농소1동,'55,50 - 54세,1998,484,249,235
'3120051000,  농소1동,'60,55 - 59세,1998,476,247,229
'3120051000,  농소1동,'65,60 - 64세,1998,364,164,200
'3120051000,  농소1동,'70,65 - 69세,1998,270,96,174
'3120051000,  농소1동,'75,70 - 74세,1998,169,56,113
'3120051000,  농소1동,'80,75 - 79세,1998,140,53,87
'3120051000,  농소1동,'85,80 - 84세,1998,67,18,49
'3120051000,  농소1동,'90,85+ ,1998,41,6,35
'3120052000,  농소2동,'00,계,1998,22743,11711,11032
'3120052000,  농소2동,'05,0 - 4세,1998,3524,1932,1592
'3120052000,  농소2동,'10,5 - 9세,1998,3449,1836,1613
'3120052000,  농소2동,'15,10 - 14세,1998,1329,680,649
'3120052000,  농소2동,'20,15 - 19세,1998,828,406,422
'3120052000,  농소2동,'25,20 - 24세,1998,872,398,474
'3120052000,  농소2동,'30,25 - 29세,1998,2300,815,1485
'3120052000,  농소2동,'35,30 - 34세,1998,4352,2092,2260
'3120052000,  농소2동,'40,35 - 39세,1998,3136,2073,1063
'3120052000,  농소2동,'45,40 - 44세,1998,962,583,379
'3120052000,  농소2동,'50,45 - 49세,1998,458,252,206
'3120052000,  농소2동,'55,50 - 54세,1998,336,170,166
'3120052000,  농소2동,'60,55 - 59세,1998,381,171,210
'3120052000,  농소2동,'65,60 - 64세,1998,317,132,185
'3120052000,  농소2동,'70,65 - 69세,1998,200,78,122
'3120052000,  농소2동,'75,70 - 74세,1998,142,45,97
'3120052000,  농소2동,'80,75 - 79세,1998,89,27,62
'3120052000,  농소2동,'85,80 - 84세,1998,44,15,29
'3120052000,  농소2동,'90,85+ ,1998,24,6,18
'3120053000,  농소3동,'00,계,1998,20596,10611,9985
'3120053000,  농소3동,'05,0 - 4세,1998,3590,1915,1675
'3120053000,  농소3동,'10,5 - 9세,1998,2451,1321,1130
'3120053000,  농소3동,'15,10 - 14세,1998,908,517,391
'3120053000,  농소3동,'20,15 - 19세,1998,715,349,366
'3120053000,  농소3동,'25,20 - 24세,1998,788,352,436
'3120053000,  농소3동,'30,25 - 29세,1998,2896,1064,1832
'3120053000,  농소3동,'35,30 - 34세,1998,4003,2198,1805
'3120053000,  농소3동,'40,35 - 39세,1998,2288,1451,837
'3120053000,  농소3동,'45,40 - 44세,1998,816,496,320
'3120053000,  농소3동,'50,45 - 49세,1998,444,229,215
'3120053000,  농소3동,'55,50 - 54세,1998,357,180,177
'3120053000,  농소3동,'60,55 - 59세,1998,417,188,229
'3120053000,  농소3동,'65,60 - 64세,1998,335,149,186
'3120053000,  농소3동,'70,65 - 69세,1998,242,102,140
'3120053000,  농소3동,'75,70 - 74세,1998,133,42,91
'3120053000,  농소3동,'80,75 - 79세,1998,115,36,79
'3120053000,  농소3동,'85,80 - 84세,1998,67,11,56
'3120053000,  농소3동,'90,85+ ,1998,31,11,20
'3120054000,  강동동,'00,계,1998,5485,2804,2681
'3120054000,  강동동,'05,0 - 4세,1998,329,190,139
'3120054000,  강동동,'10,5 - 9세,1998,269,139,130
'3120054000,  강동동,'15,10 - 14세,1998,267,146,121
'3120054000,  강동동,'20,15 - 19세,1998,432,235,197
'3120054000,  강동동,'25,20 - 24세,1998,512,302,210
'3120054000,  강동동,'30,25 - 29세,1998,528,311,217
'3120054000,  강동동,'35,30 - 34세,1998,431,258,173
'3120054000,  강동동,'40,35 - 39세,1998,380,202,178
'3120054000,  강동동,'45,40 - 44세,1998,372,201,171
'3120054000,  강동동,'50,45 - 49세,1998,287,146,141
'3120054000,  강동동,'55,50 - 54세,1998,253,124,129
'3120054000,  강동동,'60,55 - 59세,1998,340,158,182
'3120054000,  강동동,'65,60 - 64세,1998,318,129,189
'3120054000,  강동동,'70,65 - 69세,1998,289,109,180
'3120054000,  강동동,'75,70 - 74세,1998,193,71,122
'3120054000,  강동동,'80,75 - 79세,1998,155,43,112
'3120054000,  강동동,'85,80 - 84세,1998,90,31,59
'3120054000,  강동동,'90,85+ ,1998,40,9,31
'3120056000,  효문동,'00,계,1998,16334,8586,7748
'3120056000,  효문동,'05,0 - 4세,1998,1877,1043,834
'3120056000,  효문동,'10,5 - 9세,1998,1871,995,876
'3120056000,  효문동,'15,10 - 14세,1998,1113,588,525
'3120056000,  효문동,'20,15 - 19세,1998,995,506,489
'3120056000,  효문동,'25,20 - 24세,1998,968,518,450
'3120056000,  효문동,'30,25 - 29세,1998,1616,743,873
'3120056000,  효문동,'35,30 - 34세,1998,2408,1247,1161
'3120056000,  효문동,'40,35 - 39세,1998,2060,1229,831
'3120056000,  효문동,'45,40 - 44세,1998,1072,606,466
'3120056000,  효문동,'50,45 - 49세,1998,603,331,272
'3120056000,  효문동,'55,50 - 54세,1998,436,236,200
'3120056000,  효문동,'60,55 - 59세,1998,404,198,206
'3120056000,  효문동,'65,60 - 64세,1998,326,148,178
'3120056000,  효문동,'70,65 - 69세,1998,213,84,129
'3120056000,  효문동,'75,70 - 74세,1998,170,62,108
'3120056000,  효문동,'80,75 - 79세,1998,96,23,73
'3120056000,  효문동,'85,80 - 84세,1998,65,23,42
'3120056000,  효문동,'90,85+ ,1998,41,6,35
'3120057000,  송정동,'00,계,1998,13038,6692,6346
'3120057000,  송정동,'05,0 - 4세,1998,1756,958,798
'3120057000,  송정동,'10,5 - 9세,1998,1693,902,791
'3120057000,  송정동,'15,10 - 14세,1998,985,531,454
'3120057000,  송정동,'20,15 - 19세,1998,690,337,353
'3120057000,  송정동,'25,20 - 24세,1998,539,259,280
'3120057000,  송정동,'30,25 - 29세,1998,1220,481,739
'3120057000,  송정동,'35,30 - 34세,1998,2007,991,1016
'3120057000,  송정동,'40,35 - 39세,1998,1842,1052,790
'3120057000,  송정동,'45,40 - 44세,1998,841,497,344
'3120057000,  송정동,'50,45 - 49세,1998,399,223,176
'3120057000,  송정동,'55,50 - 54세,1998,277,146,131
'3120057000,  송정동,'60,55 - 59세,1998,231,113,118
'3120057000,  송정동,'65,60 - 64세,1998,201,89,112
'3120057000,  송정동,'70,65 - 69세,1998,129,52,77
'3120057000,  송정동,'75,70 - 74세,1998,109,31,78
'3120057000,  송정동,'80,75 - 79세,1998,65,20,45
'3120057000,  송정동,'85,80 - 84세,1998,31,4,27
'3120057000,  송정동,'90,85+ ,1998,23,6,17
'3120058000,  양정동,'00,계,1998,12293,6752,5541
'3120058000,  양정동,'05,0 - 4세,1998,1498,798,700
'3120058000,  양정동,'10,5 - 9세,1998,1227,671,556
'3120058000,  양정동,'15,10 - 14세,1998,732,387,345
'3120058000,  양정동,'20,15 - 19세,1998,829,439,390
'3120058000,  양정동,'25,20 - 24세,1998,743,376,367
'3120058000,  양정동,'30,25 - 29세,1998,1707,1013,694
'3120058000,  양정동,'35,30 - 34세,1998,1965,1142,823
'3120058000,  양정동,'40,35 - 39세,1998,1350,806,544
'3120058000,  양정동,'45,40 - 44세,1998,755,381,374
'3120058000,  양정동,'50,45 - 49세,1998,515,293,222
'3120058000,  양정동,'55,50 - 54세,1998,318,160,158
'3120058000,  양정동,'60,55 - 59세,1998,249,135,114
'3120058000,  양정동,'65,60 - 64세,1998,120,64,56
'3120058000,  양정동,'70,65 - 69세,1998,109,39,70
'3120058000,  양정동,'75,70 - 74세,1998,70,23,47
'3120058000,  양정동,'80,75 - 79세,1998,64,16,48
'3120058000,  양정동,'85,80 - 84세,1998,27,6,21
'3120058000,  양정동,'90,85+ ,1998,15,3,12
'3120059000,  염포동,'00,계,1998,9895,5212,4683
'3120059000,  염포동,'05,0 - 4세,1998,939,489,450
'3120059000,  염포동,'10,5 - 9세,1998,812,486,326
'3120059000,  염포동,'15,10 - 14세,1998,690,355,335
'3120059000,  염포동,'20,15 - 19세,1998,927,492,435
'3120059000,  염포동,'25,20 - 24세,1998,783,397,386
'3120059000,  염포동,'30,25 - 29세,1998,1108,559,549
'3120059000,  염포동,'35,30 - 34세,1998,1167,663,504
'3120059000,  염포동,'40,35 - 39세,1998,984,532,452
'3120059000,  염포동,'45,40 - 44세,1998,799,387,412
'3120059000,  염포동,'50,45 - 49세,1998,552,310,242
'3120059000,  염포동,'55,50 - 54세,1998,384,205,179
'3120059000,  염포동,'60,55 - 59세,1998,285,155,130
'3120059000,  염포동,'65,60 - 64세,1998,148,78,70
'3120059000,  염포동,'70,65 - 69세,1998,113,46,67
'3120059000,  염포동,'75,70 - 74세,1998,91,27,64
'3120059000,  염포동,'80,75 - 79세,1998,65,18,47
'3120059000,  염포동,'85,80 - 84세,1998,29,9,20
'3120059000,  염포동,'90,85+ ,1998,19,4,15
'31710, 울주군,'00,계,1998,154972,78589,76383
'31710, 울주군,'05,0 - 4세,1998,15079,8071,7008
'31710, 울주군,'10,5 - 9세,1998,13675,7386,6289
'31710, 울주군,'15,10 - 14세,1998,8523,4343,4180
'31710, 울주군,'20,15 - 19세,1998,10751,5528,5223
'31710, 울주군,'25,20 - 24세,1998,11434,5580,5854
'31710, 울주군,'30,25 - 29세,1998,16341,8011,8330
'31710, 울주군,'35,30 - 34세,1998,18269,9558,8711
'31710, 울주군,'40,35 - 39세,1998,15108,8621,6487
'31710, 울주군,'45,40 - 44세,1998,10319,5677,4642
'31710, 울주군,'50,45 - 49세,1998,6927,3586,3341
'31710, 울주군,'55,50 - 54세,1998,5550,2799,2751
'31710, 울주군,'60,55 - 59세,1998,6318,2934,3384
'31710, 울주군,'65,60 - 64세,1998,5564,2418,3146
'31710, 울주군,'70,65 - 69세,1998,4254,1734,2520
'31710, 울주군,'75,70 - 74세,1998,3093,1153,1940
'31710, 울주군,'80,75 - 79세,1998,1979,702,1277
'31710, 울주군,'85,80 - 84세,1998,1115,345,770
'31710, 울주군,'90,85+ ,1998,673,143,530
'3171025000,  온산읍,'00,계,1998,23523,12149,11374
'3171025000,  온산읍,'05,0 - 4세,1998,2735,1463,1272
'3171025000,  온산읍,'10,5 - 9세,1998,2218,1171,1047
'3171025000,  온산읍,'15,10 - 14세,1998,1243,622,621
'3171025000,  온산읍,'20,15 - 19세,1998,1640,835,805
'3171025000,  온산읍,'25,20 - 24세,1998,1626,801,825
'3171025000,  온산읍,'30,25 - 29세,1998,2968,1504,1464
'3171025000,  온산읍,'35,30 - 34세,1998,3084,1657,1427
'3171025000,  온산읍,'40,35 - 39세,1998,2353,1376,977
'3171025000,  온산읍,'45,40 - 44세,1998,1551,840,711
'3171025000,  온산읍,'50,45 - 49세,1998,986,550,436
'3171025000,  온산읍,'55,50 - 54세,1998,693,369,324
'3171025000,  온산읍,'60,55 - 59세,1998,708,337,371
'3171025000,  온산읍,'65,60 - 64세,1998,586,252,334
'3171025000,  온산읍,'70,65 - 69세,1998,451,177,274
'3171025000,  온산읍,'75,70 - 74세,1998,307,87,220
'3171025000,  온산읍,'80,75 - 79세,1998,196,58,138
'3171025000,  온산읍,'85,80 - 84세,1998,117,38,79
'3171025000,  온산읍,'90,85+ ,1998,61,12,49
'3171025300,  언양읍,'00,계,1998,23589,11962,11627
'3171025300,  언양읍,'05,0 - 4세,1998,2359,1278,1081
'3171025300,  언양읍,'10,5 - 9세,1998,2363,1303,1060
'3171025300,  언양읍,'15,10 - 14세,1998,1445,733,712
'3171025300,  언양읍,'20,15 - 19세,1998,1671,893,778
'3171025300,  언양읍,'25,20 - 24세,1998,1638,814,824
'3171025300,  언양읍,'30,25 - 29세,1998,2430,1121,1309
'3171025300,  언양읍,'35,30 - 34세,1998,2802,1413,1389
'3171025300,  언양읍,'40,35 - 39세,1998,2355,1342,1013
'3171025300,  언양읍,'45,40 - 44세,1998,1583,851,732
'3171025300,  언양읍,'50,45 - 49세,1998,1033,534,499
'3171025300,  언양읍,'55,50 - 54세,1998,836,413,423
'3171025300,  언양읍,'60,55 - 59세,1998,842,393,449
'3171025300,  언양읍,'65,60 - 64세,1998,742,314,428
'3171025300,  언양읍,'70,65 - 69세,1998,593,252,341
'3171025300,  언양읍,'75,70 - 74세,1998,409,164,245
'3171025300,  언양읍,'80,75 - 79세,1998,263,87,176
'3171025300,  언양읍,'85,80 - 84세,1998,148,41,107
'3171025300,  언양읍,'90,85+ ,1998,77,16,61
'3171031000,  서생면,'00,계,1998,7686,3842,3844
'3171031000,  서생면,'05,0 - 4세,1998,396,210,186
'3171031000,  서생면,'10,5 - 9세,1998,383,224,159
'3171031000,  서생면,'15,10 - 14세,1998,393,192,201
'3171031000,  서생면,'20,15 - 19세,1998,710,353,357
'3171031000,  서생면,'25,20 - 24세,1998,773,414,359
'3171031000,  서생면,'30,25 - 29세,1998,656,417,239
'3171031000,  서생면,'35,30 - 34세,1998,481,262,219
'3171031000,  서생면,'40,35 - 39세,1998,536,282,254
'3171031000,  서생면,'45,40 - 44세,1998,602,310,292
'3171031000,  서생면,'50,45 - 49세,1998,458,218,240
'3171031000,  서생면,'55,50 - 54세,1998,470,250,220
'3171031000,  서생면,'60,55 - 59세,1998,487,221,266
'3171031000,  서생면,'65,60 - 64세,1998,433,182,251
'3171031000,  서생면,'70,65 - 69세,1998,346,134,212
'3171031000,  서생면,'75,70 - 74세,1998,259,92,167
'3171031000,  서생면,'80,75 - 79세,1998,147,50,97
'3171031000,  서생면,'85,80 - 84세,1998,93,24,69
'3171031000,  서생면,'90,85+ ,1998,63,7,56
'3171032000,  온양면,'00,계,1998,19486,9933,9553
'3171032000,  온양면,'05,0 - 4세,1998,2263,1221,1042
'3171032000,  온양면,'10,5 - 9세,1998,2051,1069,982
'3171032000,  온양면,'15,10 - 14세,1998,1094,575,519
'3171032000,  온양면,'20,15 - 19세,1998,1177,578,599
'3171032000,  온양면,'25,20 - 24세,1998,1094,540,554
'3171032000,  온양면,'30,25 - 29세,1998,2178,1005,1173
'3171032000,  온양면,'35,30 - 34세,1998,2683,1374,1309
'3171032000,  온양면,'40,35 - 39세,1998,2138,1262,876
'3171032000,  온양면,'45,40 - 44세,1998,1278,735,543
'3171032000,  온양면,'50,45 - 49세,1998,698,383,315
'3171032000,  온양면,'55,50 - 54세,1998,580,297,283
'3171032000,  온양면,'60,55 - 59세,1998,619,278,341
'3171032000,  온양면,'65,60 - 64세,1998,568,246,322
'3171032000,  온양면,'70,65 - 69세,1998,410,155,255
'3171032000,  온양면,'75,70 - 74세,1998,326,118,208
'3171032000,  온양면,'80,75 - 79세,1998,165,53,112
'3171032000,  온양면,'85,80 - 84세,1998,96,29,67
'3171032000,  온양면,'90,85+ ,1998,68,15,53
'3171033000,  청량면,'00,계,1998,11366,5902,5464
'3171033000,  청량면,'05,0 - 4세,1998,821,426,395
'3171033000,  청량면,'10,5 - 9세,1998,750,407,343
'3171033000,  청량면,'15,10 - 14세,1998,553,282,271
'3171033000,  청량면,'20,15 - 19세,1998,938,487,451
'3171033000,  청량면,'25,20 - 24세,1998,1014,498,516
'3171033000,  청량면,'30,25 - 29세,1998,1195,652,543
'3171033000,  청량면,'35,30 - 34세,1998,1100,684,416
'3171033000,  청량면,'40,35 - 39세,1998,955,563,392
'3171033000,  청량면,'45,40 - 44세,1998,830,450,380
'3171033000,  청량면,'50,45 - 49세,1998,643,332,311
'3171033000,  청량면,'55,50 - 54세,1998,501,253,248
'3171033000,  청량면,'60,55 - 59세,1998,608,278,330
'3171033000,  청량면,'65,60 - 64세,1998,503,248,255
'3171033000,  청량면,'70,65 - 69세,1998,394,158,236
'3171033000,  청량면,'75,70 - 74세,1998,261,90,171
'3171033000,  청량면,'80,75 - 79세,1998,159,58,101
'3171033000,  청량면,'85,80 - 84세,1998,93,29,64
'3171033000,  청량면,'90,85+ ,1998,48,7,41
'3171034000,  웅촌면,'00,계,1998,10650,5391,5259
'3171034000,  웅촌면,'05,0 - 4세,1998,942,519,423
'3171034000,  웅촌면,'10,5 - 9세,1998,687,357,330
'3171034000,  웅촌면,'15,10 - 14세,1998,506,257,249
'3171034000,  웅촌면,'20,15 - 19세,1998,796,426,370
'3171034000,  웅촌면,'25,20 - 24세,1998,847,435,412
'3171034000,  웅촌면,'30,25 - 29세,1998,1122,538,584
'3171034000,  웅촌면,'35,30 - 34세,1998,1207,685,522
'3171034000,  웅촌면,'40,35 - 39세,1998,929,537,392
'3171034000,  웅촌면,'45,40 - 44세,1998,716,393,323
'3171034000,  웅촌면,'50,45 - 49세,1998,565,268,297
'3171034000,  웅촌면,'55,50 - 54세,1998,444,224,220
'3171034000,  웅촌면,'60,55 - 59세,1998,512,223,289
'3171034000,  웅촌면,'65,60 - 64세,1998,461,202,259
'3171034000,  웅촌면,'70,65 - 69세,1998,348,142,206
'3171034000,  웅촌면,'75,70 - 74세,1998,261,90,171
'3171034000,  웅촌면,'80,75 - 79세,1998,162,59,103
'3171034000,  웅촌면,'85,80 - 84세,1998,93,29,64
'3171034000,  웅촌면,'90,85+ ,1998,52,7,45
'3171035000,  범서면,'00,계,1998,23668,12010,11658
'3171035000,  범서면,'05,0 - 4세,1998,2885,1513,1372
'3171035000,  범서면,'10,5 - 9세,1998,2673,1450,1223
'3171035000,  범서면,'15,10 - 14세,1998,1471,736,735
'3171035000,  범서면,'20,15 - 19세,1998,1401,729,672
'3171035000,  범서면,'25,20 - 24세,1998,1176,571,605
'3171035000,  범서면,'30,25 - 29세,1998,2378,960,1418
'3171035000,  범서면,'35,30 - 34세,1998,3438,1721,1717
'3171035000,  범서면,'40,35 - 39세,1998,2943,1748,1195
'3171035000,  범서면,'45,40 - 44세,1998,1588,951,637
'3171035000,  범서면,'50,45 - 49세,1998,835,437,398
'3171035000,  범서면,'55,50 - 54세,1998,602,304,298
'3171035000,  범서면,'60,55 - 59세,1998,650,294,356
'3171035000,  범서면,'65,60 - 64세,1998,564,227,337
'3171035000,  범서면,'70,65 - 69세,1998,410,178,232
'3171035000,  범서면,'75,70 - 74세,1998,254,90,164
'3171035000,  범서면,'80,75 - 79세,1998,191,51,140
'3171035000,  범서면,'85,80 - 84세,1998,129,34,95
'3171035000,  범서면,'90,85+ ,1998,80,16,64
'3171036000,  두동면,'00,계,1998,4605,2361,2244
'3171036000,  두동면,'05,0 - 4세,1998,203,111,92
'3171036000,  두동면,'10,5 - 9세,1998,191,120,71
'3171036000,  두동면,'15,10 - 14세,1998,176,99,77
'3171036000,  두동면,'20,15 - 19세,1998,335,178,157
'3171036000,  두동면,'25,20 - 24세,1998,430,243,187
'3171036000,  두동면,'30,25 - 29세,1998,439,271,168
'3171036000,  두동면,'35,30 - 34세,1998,341,213,128
'3171036000,  두동면,'40,35 - 39세,1998,304,178,126
'3171036000,  두동면,'45,40 - 44세,1998,307,161,146
'3171036000,  두동면,'50,45 - 49세,1998,251,127,124
'3171036000,  두동면,'55,50 - 54세,1998,220,97,123
'3171036000,  두동면,'60,55 - 59세,1998,350,150,200
'3171036000,  두동면,'65,60 - 64세,1998,351,151,200
'3171036000,  두동면,'70,65 - 69세,1998,263,102,161
'3171036000,  두동면,'75,70 - 74세,1998,178,78,100
'3171036000,  두동면,'80,75 - 79세,1998,139,47,92
'3171036000,  두동면,'85,80 - 84세,1998,78,24,54
'3171036000,  두동면,'90,85+ ,1998,49,11,38
'3171037000,  두서면,'00,계,1998,4318,2140,2178
'3171037000,  두서면,'05,0 - 4세,1998,181,93,88
'3171037000,  두서면,'10,5 - 9세,1998,190,105,85
'3171037000,  두서면,'15,10 - 14세,1998,214,125,89
'3171037000,  두서면,'20,15 - 19세,1998,336,161,175
'3171037000,  두서면,'25,20 - 24세,1998,416,227,189
'3171037000,  두서면,'30,25 - 29세,1998,378,232,146
'3171037000,  두서면,'35,30 - 34세,1998,242,155,87
'3171037000,  두서면,'40,35 - 39세,1998,257,128,129
'3171037000,  두서면,'45,40 - 44세,1998,263,147,116
'3171037000,  두서면,'50,45 - 49세,1998,252,124,128
'3171037000,  두서면,'55,50 - 54세,1998,234,109,125
'3171037000,  두서면,'60,55 - 59세,1998,337,170,167
'3171037000,  두서면,'65,60 - 64세,1998,324,124,200
'3171037000,  두서면,'70,65 - 69세,1998,260,97,163
'3171037000,  두서면,'75,70 - 74세,1998,186,62,124
'3171037000,  두서면,'80,75 - 79세,1998,138,48,90
'3171037000,  두서면,'85,80 - 84세,1998,67,24,43
'3171037000,  두서면,'90,85+ ,1998,43,9,34
'3171038000,  상북면,'00,계,1998,10096,4944,5152
'3171038000,  상북면,'05,0 - 4세,1998,932,496,436
'3171038000,  상북면,'10,5 - 9세,1998,753,399,354
'3171038000,  상북면,'15,10 - 14세,1998,488,260,228
'3171038000,  상북면,'20,15 - 19세,1998,604,333,271
'3171038000,  상북면,'25,20 - 24세,1998,781,385,396
'3171038000,  상북면,'30,25 - 29세,1998,1028,513,515
'3171038000,  상북면,'35,30 - 34세,1998,1156,520,636
'3171038000,  상북면,'40,35 - 39세,1998,945,379,566
'3171038000,  상북면,'45,40 - 44세,1998,570,248,322
'3171038000,  상북면,'50,45 - 49세,1998,460,230,230
'3171038000,  상북면,'55,50 - 54세,1998,380,202,178
'3171038000,  상북면,'60,55 - 59세,1998,511,245,266
'3171038000,  상북면,'65,60 - 64세,1998,461,225,236
'3171038000,  상북면,'70,65 - 69세,1998,370,191,179
'3171038000,  상북면,'75,70 - 74세,1998,302,147,155
'3171038000,  상북면,'80,75 - 79세,1998,196,103,93
'3171038000,  상북면,'85,80 - 84세,1998,102,46,56
'3171038000,  상북면,'90,85+ ,1998,57,22,35
'3171039000,  삼남면,'00,계,1998,14104,6992,7112
'3171039000,  삼남면,'05,0 - 4세,1998,1277,707,570
'3171039000,  삼남면,'10,5 - 9세,1998,1342,737,605
'3171039000,  삼남면,'15,10 - 14세,1998,855,413,442
'3171039000,  삼남면,'20,15 - 19세,1998,1003,481,522
'3171039000,  삼남면,'25,20 - 24세,1998,1463,543,920
'3171039000,  삼남면,'30,25 - 29세,1998,1406,695,711
'3171039000,  삼남면,'35,30 - 34세,1998,1626,811,815
'3171039000,  삼남면,'40,35 - 39세,1998,1265,754,511
'3171039000,  삼남면,'45,40 - 44세,1998,893,514,379
'3171039000,  삼남면,'50,45 - 49세,1998,643,330,313
'3171039000,  삼남면,'55,50 - 54세,1998,501,248,253
'3171039000,  삼남면,'60,55 - 59세,1998,529,262,267
'3171039000,  삼남면,'65,60 - 64세,1998,437,188,249
'3171039000,  삼남면,'70,65 - 69세,1998,314,112,202
'3171039000,  삼남면,'75,70 - 74세,1998,249,97,152
'3171039000,  삼남면,'80,75 - 79세,1998,162,66,96
'3171039000,  삼남면,'85,80 - 84세,1998,81,20,61
'3171039000,  삼남면,'90,85+ ,1998,58,14,44
'3171040000,  삼동면,'00,계,1998,1881,963,918
'3171040000,  삼동면,'05,0 - 4세,1998,85,34,51
'3171040000,  삼동면,'10,5 - 9세,1998,74,44,30
'3171040000,  삼동면,'15,10 - 14세,1998,85,49,36
'3171040000,  삼동면,'20,15 - 19세,1998,140,74,66
'3171040000,  삼동면,'25,20 - 24세,1998,176,109,67
'3171040000,  삼동면,'30,25 - 29세,1998,163,103,60
'3171040000,  삼동면,'35,30 - 34세,1998,109,63,46
'3171040000,  삼동면,'40,35 - 39세,1998,128,72,56
'3171040000,  삼동면,'45,40 - 44세,1998,138,77,61
'3171040000,  삼동면,'50,45 - 49세,1998,103,53,50
'3171040000,  삼동면,'55,50 - 54세,1998,89,33,56
'3171040000,  삼동면,'60,55 - 59세,1998,165,83,82
'3171040000,  삼동면,'65,60 - 64세,1998,134,59,75
'3171040000,  삼동면,'70,65 - 69세,1998,95,36,59
'3171040000,  삼동면,'75,70 - 74세,1998,101,38,63
'3171040000,  삼동면,'80,75 - 79세,1998,61,22,39
'3171040000,  삼동면,'85,80 - 84세,1998,18,7,11
'3171040000,  삼동면,'90,85+ ,1998,17,7,10
'41,경기도,'00,계,1998,8672632,4383917,4288715
'41,경기도,'05,0 - 4세,1998,747637,391957,355680
'41,경기도,'10,5 - 9세,1998,760338,397629,362709
'41,경기도,'15,10 - 14세,1998,615607,317359,298248
'41,경기도,'20,15 - 19세,1998,641936,328321,313615
'41,경기도,'25,20 - 24세,1998,605422,303968,301454
'41,경기도,'30,25 - 29세,1998,874921,431432,443489
'41,경기도,'35,30 - 34세,1998,956317,480028,476289
'41,경기도,'40,35 - 39세,1998,972038,513810,458228
'41,경기도,'45,40 - 44세,1998,708578,383969,324609
'41,경기도,'50,45 - 49세,1998,417142,221413,195729
'41,경기도,'55,50 - 54세,1998,337320,171730,165590
'41,경기도,'60,55 - 59세,1998,316605,151903,164702
'41,경기도,'65,60 - 64세,1998,262073,119189,142884
'41,경기도,'70,65 - 69세,1998,181071,73925,107146
'41,경기도,'75,70 - 74세,1998,122329,45475,76854
'41,경기도,'80,75 - 79세,1998,84081,31146,52935
'41,경기도,'85,80 - 84세,1998,43485,13909,29576
'41,경기도,'90,85+ ,1998,25732,6754,18978
'41110, 수원시,'00,계,1998,854084,429761,424323
'41110, 수원시,'05,0 - 4세,1998,78051,40870,37181
'41110, 수원시,'10,5 - 9세,1998,77223,40766,36457
'41110, 수원시,'15,10 - 14세,1998,62763,32405,30358
'41110, 수원시,'20,15 - 19세,1998,65772,33722,32050
'41110, 수원시,'25,20 - 24세,1998,63697,30405,33292
'41110, 수원시,'30,25 - 29세,1998,93158,45981,47177
'41110, 수원시,'35,30 - 34세,1998,98634,48967,49667
'41110, 수원시,'40,35 - 39세,1998,96950,50474,46476
'41110, 수원시,'45,40 - 44세,1998,68425,36063,32362
'41110, 수원시,'50,45 - 49세,1998,40894,21666,19228
'41110, 수원시,'55,50 - 54세,1998,30460,15805,14655
'41110, 수원시,'60,55 - 59세,1998,24911,12174,12737
'41110, 수원시,'65,60 - 64세,1998,19161,8666,10495
'41110, 수원시,'70,65 - 69세,1998,13094,5034,8060
'41110, 수원시,'75,70 - 74세,1998,9339,3266,6073
'41110, 수원시,'80,75 - 79세,1998,6276,2065,4211
'41110, 수원시,'85,80 - 84세,1998,3282,949,2333
'41110, 수원시,'90,85+ ,1998,1994,483,1511
'41111, 장안구,'00,계,1998,266490,133689,132801
'41111, 장안구,'05,0 - 4세,1998,23058,12091,10967
'41111, 장안구,'10,5 - 9세,1998,22100,11659,10441
'41111, 장안구,'15,10 - 14세,1998,18680,9631,9049
'41111, 장안구,'20,15 - 19세,1998,21789,11158,10631
'41111, 장안구,'25,20 - 24세,1998,20163,9905,10258
'41111, 장안구,'30,25 - 29세,1998,28674,14166,14508
'41111, 장안구,'35,30 - 34세,1998,29392,14802,14590
'41111, 장안구,'40,35 - 39세,1998,28689,14733,13956
'41111, 장안구,'45,40 - 44세,1998,21537,11056,10481
'41111, 장안구,'50,45 - 49세,1998,13865,7238,6627
'41111, 장안구,'55,50 - 54세,1998,10615,5451,5164
'41111, 장안구,'60,55 - 59세,1998,8955,4360,4595
'41111, 장안구,'65,60 - 64세,1998,6871,3119,3752
'41111, 장안구,'70,65 - 69세,1998,4722,1904,2818
'41111, 장안구,'75,70 - 74세,1998,3311,1198,2113
'41111, 장안구,'80,75 - 79세,1998,2197,712,1485
'41111, 장안구,'85,80 - 84세,1998,1148,348,800
'41111, 장안구,'90,85+ ,1998,724,158,566
'4111153000,  신안동,'00,계,1998,7218,3509,3709
'4111153000,  신안동,'05,0 - 4세,1998,369,199,170
'4111153000,  신안동,'10,5 - 9세,1998,418,203,215
'4111153000,  신안동,'15,10 - 14세,1998,434,213,221
'4111153000,  신안동,'20,15 - 19세,1998,613,302,311
'4111153000,  신안동,'25,20 - 24세,1998,623,321,302
'4111153000,  신안동,'30,25 - 29세,1998,792,400,392
'4111153000,  신안동,'35,30 - 34세,1998,595,309,286
'4111153000,  신안동,'40,35 - 39세,1998,615,322,293
'4111153000,  신안동,'45,40 - 44세,1998,590,276,314
'4111153000,  신안동,'50,45 - 49세,1998,458,226,232
'4111153000,  신안동,'55,50 - 54세,1998,435,197,238
'4111153000,  신안동,'60,55 - 59세,1998,417,180,237
'4111153000,  신안동,'65,60 - 64세,1998,338,161,177
'4111153000,  신안동,'70,65 - 69세,1998,202,94,108
'4111153000,  신안동,'75,70 - 74세,1998,133,51,82
'4111153000,  신안동,'80,75 - 79세,1998,110,32,78
'4111153000,  신안동,'85,80 - 84세,1998,49,18,31
'4111153000,  신안동,'90,85+ ,1998,27,5,22
'4111154000,  화서1동,'00,계,1998,29443,14610,14833
'4111154000,  화서1동,'05,0 - 4세,1998,2339,1229,1110
'4111154000,  화서1동,'10,5 - 9세,1998,2342,1271,1071
'4111154000,  화서1동,'15,10 - 14세,1998,2006,1026,980
'4111154000,  화서1동,'20,15 - 19세,1998,2572,1258,1314
'4111154000,  화서1동,'25,20 - 24세,1998,2541,1186,1355
'4111154000,  화서1동,'30,25 - 29세,1998,3395,1670,1725
'4111154000,  화서1동,'35,30 - 34세,1998,2990,1488,1502
'4111154000,  화서1동,'40,35 - 39세,1998,2959,1503,1456
'4111154000,  화서1동,'45,40 - 44세,1998,2323,1133,1190
'4111154000,  화서1동,'50,45 - 49세,1998,1662,859,803
'4111154000,  화서1동,'55,50 - 54세,1998,1288,653,635
'4111154000,  화서1동,'60,55 - 59세,1998,1053,544,509
'4111154000,  화서1동,'65,60 - 64세,1998,732,363,369
'4111154000,  화서1동,'70,65 - 69세,1998,451,163,288
'4111154000,  화서1동,'75,70 - 74세,1998,340,118,222
'4111154000,  화서1동,'80,75 - 79세,1998,250,84,166
'4111154000,  화서1동,'85,80 - 84세,1998,115,40,75
'4111154000,  화서1동,'90,85+ ,1998,85,22,63
'4111155000,  화서2동,'00,계,1998,16139,8073,8066
'4111155000,  화서2동,'05,0 - 4세,1998,1634,816,818
'4111155000,  화서2동,'10,5 - 9세,1998,1687,886,801
'4111155000,  화서2동,'15,10 - 14세,1998,1192,605,587
'4111155000,  화서2동,'20,15 - 19세,1998,1171,592,579
'4111155000,  화서2동,'25,20 - 24세,1998,1035,531,504
'4111155000,  화서2동,'30,25 - 29세,1998,1474,630,844
'4111155000,  화서2동,'35,30 - 34세,1998,2027,974,1053
'4111155000,  화서2동,'40,35 - 39세,1998,2060,1130,930
'4111155000,  화서2동,'45,40 - 44세,1998,1220,668,552
'4111155000,  화서2동,'50,45 - 49세,1998,783,416,367
'4111155000,  화서2동,'55,50 - 54세,1998,550,290,260
'4111155000,  화서2동,'60,55 - 59세,1998,455,230,225
'4111155000,  화서2동,'65,60 - 64세,1998,300,128,172
'4111155000,  화서2동,'70,65 - 69세,1998,217,84,133
'4111155000,  화서2동,'75,70 - 74세,1998,161,51,110
'4111155000,  화서2동,'80,75 - 79세,1998,89,22,67
'4111155000,  화서2동,'85,80 - 84세,1998,48,13,35
'4111155000,  화서2동,'90,85+ ,1998,36,7,29
'4111156000,  파장동,'00,계,1998,25757,12952,12805
'4111156000,  파장동,'05,0 - 4세,1998,2105,1117,988
'4111156000,  파장동,'10,5 - 9세,1998,2104,1122,982
'4111156000,  파장동,'15,10 - 14세,1998,1892,961,931
'4111156000,  파장동,'20,15 - 19세,1998,2275,1156,1119
'4111156000,  파장동,'25,20 - 24세,1998,1996,992,1004
'4111156000,  파장동,'30,25 - 29세,1998,2581,1261,1320
'4111156000,  파장동,'35,30 - 34세,1998,2734,1345,1389
'4111156000,  파장동,'40,35 - 39세,1998,2808,1454,1354
'4111156000,  파장동,'45,40 - 44세,1998,2173,1116,1057
'4111156000,  파장동,'50,45 - 49세,1998,1396,736,660
'4111156000,  파장동,'55,50 - 54세,1998,1109,594,515
'4111156000,  파장동,'60,55 - 59세,1998,903,460,443
'4111156000,  파장동,'65,60 - 64세,1998,625,283,342
'4111156000,  파장동,'70,65 - 69세,1998,390,138,252
'4111156000,  파장동,'75,70 - 74세,1998,308,120,188
'4111156000,  파장동,'80,75 - 79세,1998,184,54,130
'4111156000,  파장동,'85,80 - 84세,1998,115,31,84
'4111156000,  파장동,'90,85+ ,1998,59,12,47
'4111156600,  율천동,'00,계,1998,40001,20507,19494
'4111156600,  율천동,'05,0 - 4세,1998,5144,2721,2423
'4111156600,  율천동,'10,5 - 9세,1998,4018,2131,1887
'4111156600,  율천동,'15,10 - 14세,1998,2424,1274,1150
'4111156600,  율천동,'20,15 - 19세,1998,2120,1090,1030
'4111156600,  율천동,'25,20 - 24세,1998,2130,1018,1112
'4111156600,  율천동,'30,25 - 29세,1998,5272,2564,2708
'4111156600,  율천동,'35,30 - 34세,1998,6145,3226,2919
'4111156600,  율천동,'40,35 - 39세,1998,4632,2554,2078
'4111156600,  율천동,'45,40 - 44세,1998,2594,1450,1144
'4111156600,  율천동,'50,45 - 49세,1998,1401,758,643
'4111156600,  율천동,'55,50 - 54세,1998,928,479,449
'4111156600,  율천동,'60,55 - 59세,1998,834,352,482
'4111156600,  율천동,'65,60 - 64세,1998,834,351,483
'4111156600,  율천동,'70,65 - 69세,1998,647,243,404
'4111156600,  율천동,'75,70 - 74세,1998,410,153,257
'4111156600,  율천동,'80,75 - 79세,1998,268,91,177
'4111156600,  율천동,'85,80 - 84세,1998,131,40,91
'4111156600,  율천동,'90,85+ ,1998,69,12,57
'4111157100,  정자1동,'00,계,1998,27628,13772,13856
'4111157100,  정자1동,'05,0 - 4세,1998,2461,1304,1157
'4111157100,  정자1동,'10,5 - 9세,1998,2533,1338,1195
'4111157100,  정자1동,'15,10 - 14세,1998,2176,1122,1054
'4111157100,  정자1동,'20,15 - 19세,1998,2276,1174,1102
'4111157100,  정자1동,'25,20 - 24세,1998,1778,858,920
'4111157100,  정자1동,'30,25 - 29세,1998,2628,1237,1391
'4111157100,  정자1동,'35,30 - 34세,1998,3008,1454,1554
'4111157100,  정자1동,'40,35 - 39세,1998,3371,1661,1710
'4111157100,  정자1동,'45,40 - 44세,1998,2490,1316,1174
'4111157100,  정자1동,'50,45 - 49세,1998,1431,783,648
'4111157100,  정자1동,'55,50 - 54세,1998,965,506,459
'4111157100,  정자1동,'60,55 - 59세,1998,749,364,385
'4111157100,  정자1동,'65,60 - 64세,1998,606,247,359
'4111157100,  정자1동,'70,65 - 69세,1998,430,154,276
'4111157100,  정자1동,'75,70 - 74세,1998,339,118,221
'4111157100,  정자1동,'80,75 - 79세,1998,220,82,138
'4111157100,  정자1동,'85,80 - 84세,1998,118,39,79
'4111157100,  정자1동,'90,85+ ,1998,49,15,34
'4111157200,  정자2동,'00,계,1998,20584,10344,10240
'4111157200,  정자2동,'05,0 - 4세,1998,1513,780,733
'4111157200,  정자2동,'10,5 - 9세,1998,1529,802,727
'4111157200,  정자2동,'15,10 - 14세,1998,1501,799,702
'4111157200,  정자2동,'20,15 - 19세,1998,1903,997,906
'4111157200,  정자2동,'25,20 - 24세,1998,1821,937,884
'4111157200,  정자2동,'30,25 - 29세,1998,2160,1089,1071
'4111157200,  정자2동,'35,30 - 34세,1998,1934,979,955
'4111157200,  정자2동,'40,35 - 39세,1998,2016,988,1028
'4111157200,  정자2동,'45,40 - 44세,1998,1747,874,873
'4111157200,  정자2동,'50,45 - 49세,1998,1252,627,625
'4111157200,  정자2동,'55,50 - 54세,1998,967,485,482
'4111157200,  정자2동,'60,55 - 59세,1998,796,400,396
'4111157200,  정자2동,'65,60 - 64세,1998,579,279,300
'4111157200,  정자2동,'70,65 - 69세,1998,332,136,196
'4111157200,  정자2동,'75,70 - 74세,1998,237,86,151
'4111157200,  정자2동,'80,75 - 79세,1998,160,51,109
'4111157200,  정자2동,'85,80 - 84세,1998,88,24,64
'4111157200,  정자2동,'90,85+ ,1998,49,11,38
'4111158000,  영화동,'00,계,1998,23878,11787,12091
'4111158000,  영화동,'05,0 - 4세,1998,1604,803,801
'4111158000,  영화동,'10,5 - 9세,1998,1400,764,636
'4111158000,  영화동,'15,10 - 14세,1998,1437,749,688
'4111158000,  영화동,'20,15 - 19세,1998,2188,1116,1072
'4111158000,  영화동,'25,20 - 24세,1998,2309,1097,1212
'4111158000,  영화동,'30,25 - 29세,1998,2890,1506,1384
'4111158000,  영화동,'35,30 - 34세,1998,2241,1167,1074
'4111158000,  영화동,'40,35 - 39세,1998,2104,1026,1078
'4111158000,  영화동,'45,40 - 44세,1998,1889,876,1013
'4111158000,  영화동,'50,45 - 49세,1998,1489,716,773
'4111158000,  영화동,'55,50 - 54세,1998,1268,616,652
'4111158000,  영화동,'60,55 - 59세,1998,1036,489,547
'4111158000,  영화동,'65,60 - 64세,1998,815,411,404
'4111158000,  영화동,'70,65 - 69세,1998,474,215,259
'4111158000,  영화동,'75,70 - 74세,1998,314,122,192
'4111158000,  영화동,'80,75 - 79세,1998,217,64,153
'4111158000,  영화동,'85,80 - 84세,1998,115,29,86
'4111158000,  영화동,'90,85+ ,1998,88,21,67
'4111159100,  송죽동,'00,계,1998,20274,10206,10068
'4111159100,  송죽동,'05,0 - 4세,1998,1685,893,792
'4111159100,  송죽동,'10,5 - 9세,1998,1729,887,842
'4111159100,  송죽동,'15,10 - 14세,1998,1667,831,836
'4111159100,  송죽동,'20,15 - 19세,1998,1758,899,859
'4111159100,  송죽동,'25,20 - 24세,1998,1454,722,732
'4111159100,  송죽동,'30,25 - 29세,1998,2024,1005,1019
'4111159100,  송죽동,'35,30 - 34세,1998,2204,1077,1127
'4111159100,  송죽동,'40,35 - 39세,1998,2394,1201,1193
'4111159100,  송죽동,'45,40 - 44세,1998,1849,982,867
'4111159100,  송죽동,'50,45 - 49세,1998,1022,560,462
'4111159100,  송죽동,'55,50 - 54세,1998,694,378,316
'4111159100,  송죽동,'60,55 - 59세,1998,611,317,294
'4111159100,  송죽동,'65,60 - 64세,1998,460,200,260
'4111159100,  송죽동,'70,65 - 69세,1998,301,122,179
'4111159100,  송죽동,'75,70 - 74세,1998,185,57,128
'4111159100,  송죽동,'80,75 - 79세,1998,128,41,87
'4111159100,  송죽동,'85,80 - 84세,1998,69,25,44
'4111159100,  송죽동,'90,85+ ,1998,40,9,31
'4111159600,  조원동,'00,계,1998,25664,12914,12750
'4111159600,  조원동,'05,0 - 4세,1998,2020,1071,949
'4111159600,  조원동,'10,5 - 9세,1998,2155,1121,1034
'4111159600,  조원동,'15,10 - 14세,1998,2001,1025,976
'4111159600,  조원동,'20,15 - 19세,1998,2167,1161,1006
'4111159600,  조원동,'25,20 - 24세,1998,1896,977,919
'4111159600,  조원동,'30,25 - 29세,1998,2342,1136,1206
'4111159600,  조원동,'35,30 - 34세,1998,2590,1286,1304
'4111159600,  조원동,'40,35 - 39세,1998,2839,1436,1403
'4111159600,  조원동,'45,40 - 44세,1998,2196,1141,1055
'4111159600,  조원동,'50,45 - 49세,1998,1341,734,607
'4111159600,  조원동,'55,50 - 54세,1998,1000,525,475
'4111159600,  조원동,'60,55 - 59세,1998,844,424,420
'4111159600,  조원동,'65,60 - 64세,1998,690,275,415
'4111159600,  조원동,'70,65 - 69세,1998,648,277,371
'4111159600,  조원동,'75,70 - 74세,1998,420,178,242
'4111159600,  조원동,'80,75 - 79세,1998,268,85,183
'4111159600,  조원동,'85,80 - 84세,1998,142,41,101
'4111159600,  조원동,'90,85+ ,1998,105,21,84
'4111160000,  연무동,'00,계,1998,29904,15015,14889
'4111160000,  연무동,'05,0 - 4세,1998,2184,1158,1026
'4111160000,  연무동,'10,5 - 9세,1998,2185,1134,1051
'4111160000,  연무동,'15,10 - 14세,1998,1950,1026,924
'4111160000,  연무동,'20,15 - 19세,1998,2746,1413,1333
'4111160000,  연무동,'25,20 - 24세,1998,2580,1266,1314
'4111160000,  연무동,'30,25 - 29세,1998,3116,1668,1448
'4111160000,  연무동,'35,30 - 34세,1998,2924,1497,1427
'4111160000,  연무동,'40,35 - 39세,1998,2891,1458,1433
'4111160000,  연무동,'45,40 - 44세,1998,2466,1224,1242
'4111160000,  연무동,'50,45 - 49세,1998,1630,823,807
'4111160000,  연무동,'55,50 - 54세,1998,1411,728,683
'4111160000,  연무동,'60,55 - 59세,1998,1257,600,657
'4111160000,  연무동,'65,60 - 64세,1998,892,421,471
'4111160000,  연무동,'70,65 - 69세,1998,630,278,352
'4111160000,  연무동,'75,70 - 74세,1998,464,144,320
'4111160000,  연무동,'80,75 - 79세,1998,303,106,197
'4111160000,  연무동,'85,80 - 84세,1998,158,48,110
'4111160000,  연무동,'90,85+ ,1998,117,23,94
'41113, 권선구,'00,계,1998,296787,149954,146833
'41113, 권선구,'05,0 - 4세,1998,26465,13821,12644
'41113, 권선구,'10,5 - 9세,1998,27114,14297,12817
'41113, 권선구,'15,10 - 14세,1998,22177,11456,10721
'41113, 권선구,'20,15 - 19세,1998,23139,11869,11270
'41113, 권선구,'25,20 - 24세,1998,22209,10716,11493
'41113, 권선구,'30,25 - 29세,1998,31140,15472,15668
'41113, 권선구,'35,30 - 34세,1998,33776,16771,17005
'41113, 권선구,'40,35 - 39세,1998,33799,17740,16059
'41113, 권선구,'45,40 - 44세,1998,23800,12586,11214
'41113, 권선구,'50,45 - 49세,1998,14592,7738,6854
'41113, 권선구,'55,50 - 54세,1998,10839,5667,5172
'41113, 권선구,'60,55 - 59세,1998,8997,4441,4556
'41113, 권선구,'65,60 - 64세,1998,6869,3161,3708
'41113, 권선구,'70,65 - 69세,1998,4570,1783,2787
'41113, 권선구,'75,70 - 74세,1998,3235,1137,2098
'41113, 권선구,'80,75 - 79세,1998,2214,780,1434
'41113, 권선구,'85,80 - 84세,1998,1166,343,823
'41113, 권선구,'90,85+ ,1998,686,176,510
'4111351000,  매교동,'00,계,1998,11641,5871,5770
'4111351000,  매교동,'05,0 - 4세,1998,763,397,366
'4111351000,  매교동,'10,5 - 9세,1998,608,332,276
'4111351000,  매교동,'15,10 - 14세,1998,629,334,295
'4111351000,  매교동,'20,15 - 19세,1998,961,484,477
'4111351000,  매교동,'25,20 - 24세,1998,1277,601,676
'4111351000,  매교동,'30,25 - 29세,1998,1459,810,649
'4111351000,  매교동,'35,30 - 34세,1998,1060,591,469
'4111351000,  매교동,'40,35 - 39세,1998,945,492,453
'4111351000,  매교동,'45,40 - 44세,1998,889,435,454
'4111351000,  매교동,'50,45 - 49세,1998,663,306,357
'4111351000,  매교동,'55,50 - 54세,1998,637,293,344
'4111351000,  매교동,'60,55 - 59세,1998,613,304,309
'4111351000,  매교동,'65,60 - 64세,1998,480,238,242
'4111351000,  매교동,'70,65 - 69세,1998,263,110,153
'4111351000,  매교동,'75,70 - 74세,1998,158,54,104
'4111351000,  매교동,'80,75 - 79세,1998,129,61,68
'4111351000,  매교동,'85,80 - 84세,1998,72,21,51
'4111351000,  매교동,'90,85+ ,1998,35,8,27
'4111352000,  세류1동,'00,계,1998,12597,6345,6252
'4111352000,  세류1동,'05,0 - 4세,1998,868,455,413
'4111352000,  세류1동,'10,5 - 9세,1998,739,362,377
'4111352000,  세류1동,'15,10 - 14세,1998,755,378,377
'4111352000,  세류1동,'20,15 - 19세,1998,1104,582,522
'4111352000,  세류1동,'25,20 - 24세,1998,1417,672,745
'4111352000,  세류1동,'30,25 - 29세,1998,1581,864,717
'4111352000,  세류1동,'35,30 - 34세,1998,1181,634,547
'4111352000,  세류1동,'40,35 - 39세,1998,1048,563,485
'4111352000,  세류1동,'45,40 - 44세,1998,943,455,488
'4111352000,  세류1동,'50,45 - 49세,1998,693,345,348
'4111352000,  세류1동,'55,50 - 54세,1998,625,298,327
'4111352000,  세류1동,'60,55 - 59세,1998,577,282,295
'4111352000,  세류1동,'65,60 - 64세,1998,418,214,204
'4111352000,  세류1동,'70,65 - 69세,1998,247,97,150
'4111352000,  세류1동,'75,70 - 74세,1998,198,75,123
'4111352000,  세류1동,'80,75 - 79세,1998,121,43,78
'4111352000,  세류1동,'85,80 - 84세,1998,50,16,34
'4111352000,  세류1동,'90,85+ ,1998,32,10,22
'4111353000,  세류2동,'00,계,1998,33699,17231,16468
'4111353000,  세류2동,'05,0 - 4세,1998,2868,1468,1400
'4111353000,  세류2동,'10,5 - 9세,1998,2616,1407,1209
'4111353000,  세류2동,'15,10 - 14세,1998,2394,1282,1112
'4111353000,  세류2동,'20,15 - 19세,1998,2891,1511,1380
'4111353000,  세류2동,'25,20 - 24세,1998,2982,1414,1568
'4111353000,  세류2동,'30,25 - 29세,1998,4090,2159,1931
'4111353000,  세류2동,'35,30 - 34세,1998,3603,1896,1707
'4111353000,  세류2동,'40,35 - 39세,1998,3508,1823,1685
'4111353000,  세류2동,'45,40 - 44세,1998,2693,1372,1321
'4111353000,  세류2동,'50,45 - 49세,1998,1765,930,835
'4111353000,  세류2동,'55,50 - 54세,1998,1351,700,651
'4111353000,  세류2동,'60,55 - 59세,1998,992,489,503
'4111353000,  세류2동,'65,60 - 64세,1998,777,364,413
'4111353000,  세류2동,'70,65 - 69세,1998,481,191,290
'4111353000,  세류2동,'75,70 - 74세,1998,285,102,183
'4111353000,  세류2동,'80,75 - 79세,1998,211,73,138
'4111353000,  세류2동,'85,80 - 84세,1998,117,35,82
'4111353000,  세류2동,'90,85+ ,1998,75,15,60
'4111354000,  세류3동,'00,계,1998,26691,13451,13240
'4111354000,  세류3동,'05,0 - 4세,1998,2157,1112,1045
'4111354000,  세류3동,'10,5 - 9세,1998,2030,1054,976
'4111354000,  세류3동,'15,10 - 14세,1998,1935,1020,915
'4111354000,  세류3동,'20,15 - 19세,1998,2321,1219,1102
'4111354000,  세류3동,'25,20 - 24세,1998,2466,1183,1283
'4111354000,  세류3동,'30,25 - 29세,1998,3013,1542,1471
'4111354000,  세류3동,'35,30 - 34세,1998,2729,1400,1329
'4111354000,  세류3동,'40,35 - 39세,1998,2728,1373,1355
'4111354000,  세류3동,'45,40 - 44세,1998,2012,1006,1006
'4111354000,  세류3동,'50,45 - 49세,1998,1501,756,745
'4111354000,  세류3동,'55,50 - 54세,1998,1154,618,536
'4111354000,  세류3동,'60,55 - 59세,1998,931,466,465
'4111354000,  세류3동,'65,60 - 64세,1998,639,299,340
'4111354000,  세류3동,'70,65 - 69세,1998,398,166,232
'4111354000,  세류3동,'75,70 - 74세,1998,310,110,200
'4111354000,  세류3동,'80,75 - 79세,1998,199,71,128
'4111354000,  세류3동,'85,80 - 84세,1998,103,36,67
'4111354000,  세류3동,'90,85+ ,1998,65,20,45
'4111355000,  평동,'00,계,1998,28725,14757,13968
'4111355000,  평동,'05,0 - 4세,1998,2645,1403,1242
'4111355000,  평동,'10,5 - 9세,1998,2549,1331,1218
'4111355000,  평동,'15,10 - 14세,1998,2019,1008,1011
'4111355000,  평동,'20,15 - 19세,1998,2290,1149,1141
'4111355000,  평동,'25,20 - 24세,1998,2243,1121,1122
'4111355000,  평동,'30,25 - 29세,1998,3019,1537,1482
'4111355000,  평동,'35,30 - 34세,1998,3458,1835,1623
'4111355000,  평동,'40,35 - 39세,1998,3058,1651,1407
'4111355000,  평동,'45,40 - 44세,1998,2079,1129,950
'4111355000,  평동,'50,45 - 49세,1998,1384,736,648
'4111355000,  평동,'55,50 - 54세,1998,1100,598,502
'4111355000,  평동,'60,55 - 59세,1998,937,472,465
'4111355000,  평동,'65,60 - 64세,1998,734,353,381
'4111355000,  평동,'70,65 - 69세,1998,490,212,278
'4111355000,  평동,'75,70 - 74세,1998,346,117,229
'4111355000,  평동,'80,75 - 79세,1998,191,47,144
'4111355000,  평동,'85,80 - 84세,1998,124,40,84
'4111355000,  평동,'90,85+ ,1998,59,18,41
'4111356000,  서둔동,'00,계,1998,24053,12205,11848
'4111356000,  서둔동,'05,0 - 4세,1998,1868,987,881
'4111356000,  서둔동,'10,5 - 9세,1998,1784,910,874
'4111356000,  서둔동,'15,10 - 14세,1998,1733,885,848
'4111356000,  서둔동,'20,15 - 19세,1998,2092,1072,1020
'4111356000,  서둔동,'25,20 - 24세,1998,1901,967,934
'4111356000,  서둔동,'30,25 - 29세,1998,2714,1453,1261
'4111356000,  서둔동,'35,30 - 34세,1998,2396,1251,1145
'4111356000,  서둔동,'40,35 - 39세,1998,2423,1233,1190
'4111356000,  서둔동,'45,40 - 44세,1998,1975,1014,961
'4111356000,  서둔동,'50,45 - 49세,1998,1311,720,591
'4111356000,  서둔동,'55,50 - 54세,1998,990,508,482
'4111356000,  서둔동,'60,55 - 59세,1998,917,453,464
'4111356000,  서둔동,'65,60 - 64세,1998,688,298,390
'4111356000,  서둔동,'70,65 - 69세,1998,504,195,309
'4111356000,  서둔동,'75,70 - 74세,1998,341,124,217
'4111356000,  서둔동,'80,75 - 79세,1998,225,83,142
'4111356000,  서둔동,'85,80 - 84세,1998,116,34,82
'4111356000,  서둔동,'90,85+ ,1998,75,18,57
'4111357000,  매산동,'00,계,1998,7937,3971,3966
'4111357000,  매산동,'05,0 - 4세,1998,488,265,223
'4111357000,  매산동,'10,5 - 9세,1998,409,214,195
'4111357000,  매산동,'15,10 - 14세,1998,451,235,216
'4111357000,  매산동,'20,15 - 19세,1998,689,330,359
'4111357000,  매산동,'25,20 - 24세,1998,824,406,418
'4111357000,  매산동,'30,25 - 29세,1998,958,539,419
'4111357000,  매산동,'35,30 - 34세,1998,639,355,284
'4111357000,  매산동,'40,35 - 39세,1998,686,352,334
'4111357000,  매산동,'45,40 - 44세,1998,626,292,334
'4111357000,  매산동,'50,45 - 49세,1998,512,247,265
'4111357000,  매산동,'55,50 - 54세,1998,411,196,215
'4111357000,  매산동,'60,55 - 59세,1998,412,194,218
'4111357000,  매산동,'65,60 - 64세,1998,305,133,172
'4111357000,  매산동,'70,65 - 69세,1998,209,86,123
'4111357000,  매산동,'75,70 - 74세,1998,155,64,91
'4111357000,  매산동,'80,75 - 79세,1998,87,35,52
'4111357000,  매산동,'85,80 - 84세,1998,54,23,31
'4111357000,  매산동,'90,85+ ,1998,22,5,17
'4111358000,  고등동,'00,계,1998,26436,13164,13272
'4111358000,  고등동,'05,0 - 4세,1998,1988,1034,954
'4111358000,  고등동,'10,5 - 9세,1998,1586,826,760
'4111358000,  고등동,'15,10 - 14세,1998,1474,735,739
'4111358000,  고등동,'20,15 - 19세,1998,2294,1164,1130
'4111358000,  고등동,'25,20 - 24세,1998,2843,1325,1518
'4111358000,  고등동,'30,25 - 29세,1998,3465,1799,1666
'4111358000,  고등동,'35,30 - 34세,1998,2572,1413,1159
'4111358000,  고등동,'40,35 - 39세,1998,2225,1131,1094
'4111358000,  고등동,'45,40 - 44세,1998,1933,923,1010
'4111358000,  고등동,'50,45 - 49세,1998,1541,729,812
'4111358000,  고등동,'55,50 - 54세,1998,1356,672,684
'4111358000,  고등동,'60,55 - 59세,1998,1159,576,583
'4111358000,  고등동,'65,60 - 64세,1998,764,371,393
'4111358000,  고등동,'70,65 - 69세,1998,517,221,296
'4111358000,  고등동,'75,70 - 74세,1998,311,121,190
'4111358000,  고등동,'80,75 - 79세,1998,194,74,120
'4111358000,  고등동,'85,80 - 84세,1998,139,31,108
'4111358000,  고등동,'90,85+ ,1998,75,19,56
'4111361500,  권선동,'00,계,1998,26008,13045,12963
'4111361500,  권선동,'05,0 - 4세,1998,2306,1187,1119
'4111361500,  권선동,'10,5 - 9세,1998,2724,1458,1266
'4111361500,  권선동,'15,10 - 14세,1998,2241,1157,1084
'4111361500,  권선동,'20,15 - 19세,1998,2160,1110,1050
'4111361500,  권선동,'25,20 - 24세,1998,1680,792,888
'4111361500,  권선동,'30,25 - 29세,1998,2460,1149,1311
'4111361500,  권선동,'35,30 - 34세,1998,3105,1478,1627
'4111361500,  권선동,'40,35 - 39세,1998,3255,1655,1600
'4111361500,  권선동,'45,40 - 44세,1998,2268,1209,1059
'4111361500,  권선동,'50,45 - 49세,1998,1309,717,592
'4111361500,  권선동,'55,50 - 54세,1998,770,444,326
'4111361500,  권선동,'60,55 - 59세,1998,508,261,247
'4111361500,  권선동,'65,60 - 64세,1998,422,179,243
'4111361500,  권선동,'70,65 - 69세,1998,289,88,201
'4111361500,  권선동,'75,70 - 74세,1998,219,62,157
'4111361500,  권선동,'80,75 - 79세,1998,163,62,101
'4111361500,  권선동,'85,80 - 84세,1998,83,22,61
'4111361500,  권선동,'90,85+ ,1998,46,15,31
'4111365000,  구운동,'00,계,1998,53255,26824,26431
'4111365000,  구운동,'05,0 - 4세,1998,5868,3062,2806
'4111365000,  구운동,'10,5 - 9세,1998,6540,3483,3057
'4111365000,  구운동,'15,10 - 14세,1998,4375,2263,2112
'4111365000,  구운동,'20,15 - 19세,1998,3124,1598,1526
'4111365000,  구운동,'25,20 - 24세,1998,2527,1250,1277
'4111365000,  구운동,'30,25 - 29세,1998,4721,2041,2680
'4111365000,  구운동,'35,30 - 34세,1998,7115,3229,3886
'4111365000,  구운동,'40,35 - 39세,1998,7511,4073,3438
'4111365000,  구운동,'45,40 - 44세,1998,4221,2407,1814
'4111365000,  구운동,'50,45 - 49세,1998,2013,1131,882
'4111365000,  구운동,'55,50 - 54세,1998,1355,717,638
'4111365000,  구운동,'60,55 - 59세,1998,1108,526,582
'4111365000,  구운동,'65,60 - 64세,1998,965,410,555
'4111365000,  구운동,'70,65 - 69세,1998,666,249,417
'4111365000,  구운동,'75,70 - 74세,1998,490,170,320
'4111365000,  구운동,'80,75 - 79세,1998,377,140,237
'4111365000,  구운동,'85,80 - 84세,1998,168,49,119
'4111365000,  구운동,'90,85+ ,1998,111,26,85
'4111369000,  곡선동,'00,계,1998,38286,19370,18916
'4111369000,  곡선동,'05,0 - 4세,1998,3840,2043,1797
'4111369000,  곡선동,'10,5 - 9세,1998,4680,2495,2185
'4111369000,  곡선동,'15,10 - 14세,1998,3689,1933,1756
'4111369000,  곡선동,'20,15 - 19세,1998,2795,1441,1354
'4111369000,  곡선동,'25,20 - 24세,1998,1635,774,861
'4111369000,  곡선동,'30,25 - 29세,1998,3013,1279,1734
'4111369000,  곡선동,'35,30 - 34세,1998,4874,2197,2677
'4111369000,  곡선동,'40,35 - 39세,1998,5456,2842,2614
'4111369000,  곡선동,'45,40 - 44세,1998,3646,2058,1588
'4111369000,  곡선동,'50,45 - 49세,1998,1615,965,650
'4111369000,  곡선동,'55,50 - 54세,1998,851,503,348
'4111369000,  곡선동,'60,55 - 59세,1998,603,306,297
'4111369000,  곡선동,'65,60 - 64세,1998,484,214,270
'4111369000,  곡선동,'70,65 - 69세,1998,353,108,245
'4111369000,  곡선동,'75,70 - 74세,1998,319,99,220
'4111369000,  곡선동,'80,75 - 79세,1998,245,69,176
'4111369000,  곡선동,'85,80 - 84세,1998,113,26,87
'4111369000,  곡선동,'90,85+ ,1998,75,18,57
'4111370000,  입북동,'00,계,1998,7459,3720,3739
'4111370000,  입북동,'05,0 - 4세,1998,806,408,398
'4111370000,  입북동,'10,5 - 9세,1998,849,425,424
'4111370000,  입북동,'15,10 - 14세,1998,482,226,256
'4111370000,  입북동,'20,15 - 19세,1998,418,209,209
'4111370000,  입북동,'25,20 - 24세,1998,414,211,203
'4111370000,  입북동,'30,25 - 29세,1998,647,300,347
'4111370000,  입북동,'35,30 - 34세,1998,1044,492,552
'4111370000,  입북동,'40,35 - 39세,1998,956,552,404
'4111370000,  입북동,'45,40 - 44세,1998,515,286,229
'4111370000,  입북동,'50,45 - 49세,1998,285,156,129
'4111370000,  입북동,'55,50 - 54세,1998,239,120,119
'4111370000,  입북동,'60,55 - 59세,1998,240,112,128
'4111370000,  입북동,'65,60 - 64세,1998,193,88,105
'4111370000,  입북동,'70,65 - 69세,1998,153,60,93
'4111370000,  입북동,'75,70 - 74세,1998,103,39,64
'4111370000,  입북동,'80,75 - 79세,1998,72,22,50
'4111370000,  입북동,'85,80 - 84세,1998,27,10,17
'4111370000,  입북동,'90,85+ ,1998,16,4,12
'41115, 팔달구,'00,계,1998,290807,146118,144689
'41115, 팔달구,'05,0 - 4세,1998,28528,14958,13570
'41115, 팔달구,'10,5 - 9세,1998,28009,14810,13199
'41115, 팔달구,'15,10 - 14세,1998,21906,11318,10588
'41115, 팔달구,'20,15 - 19세,1998,20844,10695,10149
'41115, 팔달구,'25,20 - 24세,1998,21325,9784,11541
'41115, 팔달구,'30,25 - 29세,1998,33344,16343,17001
'41115, 팔달구,'35,30 - 34세,1998,35466,17394,18072
'41115, 팔달구,'40,35 - 39세,1998,34462,18001,16461
'41115, 팔달구,'45,40 - 44세,1998,23088,12421,10667
'41115, 팔달구,'50,45 - 49세,1998,12437,6690,5747
'41115, 팔달구,'55,50 - 54세,1998,9006,4687,4319
'41115, 팔달구,'60,55 - 59세,1998,6959,3373,3586
'41115, 팔달구,'65,60 - 64세,1998,5421,2386,3035
'41115, 팔달구,'70,65 - 69세,1998,3802,1347,2455
'41115, 팔달구,'75,70 - 74세,1998,2793,931,1862
'41115, 팔달구,'80,75 - 79세,1998,1865,573,1292
'41115, 팔달구,'85,80 - 84세,1998,968,258,710
'41115, 팔달구,'90,85+ ,1998,584,149,435
'4111551000,  팔달동,'00,계,1998,4351,2149,2202
'4111551000,  팔달동,'05,0 - 4세,1998,205,106,99
'4111551000,  팔달동,'10,5 - 9세,1998,191,92,99
'4111551000,  팔달동,'15,10 - 14세,1998,236,117,119
'4111551000,  팔달동,'20,15 - 19세,1998,419,219,200
'4111551000,  팔달동,'25,20 - 24세,1998,474,229,245
'4111551000,  팔달동,'30,25 - 29세,1998,484,255,229
'4111551000,  팔달동,'35,30 - 34세,1998,309,176,133
'4111551000,  팔달동,'40,35 - 39세,1998,308,151,157
'4111551000,  팔달동,'45,40 - 44세,1998,347,154,193
'4111551000,  팔달동,'50,45 - 49세,1998,354,174,180
'4111551000,  팔달동,'55,50 - 54세,1998,303,151,152
'4111551000,  팔달동,'60,55 - 59세,1998,263,131,132
'4111551000,  팔달동,'65,60 - 64세,1998,166,86,80
'4111551000,  팔달동,'70,65 - 69세,1998,98,45,53
'4111551000,  팔달동,'75,70 - 74세,1998,81,32,49
'4111551000,  팔달동,'80,75 - 79세,1998,60,19,41
'4111551000,  팔달동,'85,80 - 84세,1998,31,9,22
'4111551000,  팔달동,'90,85+ ,1998,22,3,19
'4111552000,  남향동,'00,계,1998,6451,3185,3266
'4111552000,  남향동,'05,0 - 4세,1998,331,153,178
'4111552000,  남향동,'10,5 - 9세,1998,363,166,197
'4111552000,  남향동,'15,10 - 14세,1998,372,199,173
'4111552000,  남향동,'20,15 - 19세,1998,618,309,309
'4111552000,  남향동,'25,20 - 24세,1998,629,315,314
'4111552000,  남향동,'30,25 - 29세,1998,669,378,291
'4111552000,  남향동,'35,30 - 34세,1998,542,274,268
'4111552000,  남향동,'40,35 - 39세,1998,535,273,262
'4111552000,  남향동,'45,40 - 44세,1998,545,285,260
'4111552000,  남향동,'50,45 - 49세,1998,394,195,199
'4111552000,  남향동,'55,50 - 54세,1998,369,170,199
'4111552000,  남향동,'60,55 - 59세,1998,362,178,184
'4111552000,  남향동,'65,60 - 64세,1998,270,119,151
'4111552000,  남향동,'70,65 - 69세,1998,173,64,109
'4111552000,  남향동,'75,70 - 74세,1998,138,58,80
'4111552000,  남향동,'80,75 - 79세,1998,72,28,44
'4111552000,  남향동,'85,80 - 84세,1998,48,18,30
'4111552000,  남향동,'90,85+ ,1998,21,3,18
'4111555000,  이의동,'00,계,1998,3074,1627,1447
'4111555000,  이의동,'05,0 - 4세,1998,155,67,88
'4111555000,  이의동,'10,5 - 9세,1998,151,80,71
'4111555000,  이의동,'15,10 - 14세,1998,204,104,100
'4111555000,  이의동,'20,15 - 19세,1998,283,146,137
'4111555000,  이의동,'25,20 - 24세,1998,302,179,123
'4111555000,  이의동,'30,25 - 29세,1998,273,167,106
'4111555000,  이의동,'35,30 - 34세,1998,213,128,85
'4111555000,  이의동,'40,35 - 39세,1998,280,144,136
'4111555000,  이의동,'45,40 - 44세,1998,274,168,106
'4111555000,  이의동,'50,45 - 49세,1998,204,109,95
'4111555000,  이의동,'55,50 - 54세,1998,176,83,93
'4111555000,  이의동,'60,55 - 59세,1998,172,91,81
'4111555000,  이의동,'65,60 - 64세,1998,149,73,76
'4111555000,  이의동,'70,65 - 69세,1998,93,39,54
'4111555000,  이의동,'75,70 - 74세,1998,62,23,39
'4111555000,  이의동,'80,75 - 79세,1998,39,15,24
'4111555000,  이의동,'85,80 - 84세,1998,29,8,21
'4111555000,  이의동,'90,85+ ,1998,15,3,12
'4111557000,  매탄1동,'00,계,1998,21477,10771,10706
'4111557000,  매탄1동,'05,0 - 4세,1998,1825,944,881
'4111557000,  매탄1동,'10,5 - 9세,1998,1982,1100,882
'4111557000,  매탄1동,'15,10 - 14세,1998,1630,853,777
'4111557000,  매탄1동,'20,15 - 19세,1998,1648,872,776
'4111557000,  매탄1동,'25,20 - 24세,1998,1904,811,1093
'4111557000,  매탄1동,'30,25 - 29세,1998,2609,1319,1290
'4111557000,  매탄1동,'35,30 - 34세,1998,2271,1096,1175
'4111557000,  매탄1동,'40,35 - 39세,1998,2422,1246,1176
'4111557000,  매탄1동,'45,40 - 44세,1998,1807,933,874
'4111557000,  매탄1동,'50,45 - 49세,1998,1025,557,468
'4111557000,  매탄1동,'55,50 - 54세,1998,740,397,343
'4111557000,  매탄1동,'60,55 - 59세,1998,480,237,243
'4111557000,  매탄1동,'65,60 - 64세,1998,386,158,228
'4111557000,  매탄1동,'70,65 - 69세,1998,284,108,176
'4111557000,  매탄1동,'75,70 - 74세,1998,219,74,145
'4111557000,  매탄1동,'80,75 - 79세,1998,122,36,86
'4111557000,  매탄1동,'85,80 - 84세,1998,72,13,59
'4111557000,  매탄1동,'90,85+ ,1998,51,17,34
'4111558000,  매탄2동,'00,계,1998,17834,8917,8917
'4111558000,  매탄2동,'05,0 - 4세,1998,1382,710,672
'4111558000,  매탄2동,'10,5 - 9세,1998,1618,856,762
'4111558000,  매탄2동,'15,10 - 14세,1998,1511,777,734
'4111558000,  매탄2동,'20,15 - 19세,1998,1596,827,769
'4111558000,  매탄2동,'25,20 - 24세,1998,1442,603,839
'4111558000,  매탄2동,'30,25 - 29세,1998,2089,1109,980
'4111558000,  매탄2동,'35,30 - 34세,1998,1767,858,909
'4111558000,  매탄2동,'40,35 - 39세,1998,2077,1010,1067
'4111558000,  매탄2동,'45,40 - 44세,1998,1592,848,744
'4111558000,  매탄2동,'50,45 - 49세,1998,882,474,408
'4111558000,  매탄2동,'55,50 - 54세,1998,568,323,245
'4111558000,  매탄2동,'60,55 - 59세,1998,430,220,210
'4111558000,  매탄2동,'65,60 - 64세,1998,308,143,165
'4111558000,  매탄2동,'70,65 - 69세,1998,215,65,150
'4111558000,  매탄2동,'75,70 - 74세,1998,156,46,110
'4111558000,  매탄2동,'80,75 - 79세,1998,102,19,83
'4111558000,  매탄2동,'85,80 - 84세,1998,62,17,45
'4111558000,  매탄2동,'90,85+ ,1998,37,12,25
'4111559000,  매탄3동,'00,계,1998,27695,14097,13598
'4111559000,  매탄3동,'05,0 - 4세,1998,2659,1407,1252
'4111559000,  매탄3동,'10,5 - 9세,1998,2638,1344,1294
'4111559000,  매탄3동,'15,10 - 14세,1998,2201,1127,1074
'4111559000,  매탄3동,'20,15 - 19세,1998,2078,1088,990
'4111559000,  매탄3동,'25,20 - 24세,1998,2132,1040,1092
'4111559000,  매탄3동,'30,25 - 29세,1998,3192,1652,1540
'4111559000,  매탄3동,'35,30 - 34세,1998,3220,1616,1604
'4111559000,  매탄3동,'40,35 - 39세,1998,3273,1688,1585
'4111559000,  매탄3동,'45,40 - 44세,1998,2256,1206,1050
'4111559000,  매탄3동,'50,45 - 49세,1998,1200,681,519
'4111559000,  매탄3동,'55,50 - 54세,1998,830,453,377
'4111559000,  매탄3동,'60,55 - 59세,1998,576,283,293
'4111559000,  매탄3동,'65,60 - 64세,1998,493,222,271
'4111559000,  매탄3동,'70,65 - 69세,1998,364,108,256
'4111559000,  매탄3동,'75,70 - 74세,1998,270,92,178
'4111559000,  매탄3동,'80,75 - 79세,1998,173,58,115
'4111559000,  매탄3동,'85,80 - 84세,1998,97,27,70
'4111559000,  매탄3동,'90,85+ ,1998,43,5,38
'4111559100,  매탄4동,'00,계,1998,27426,13779,13647
'4111559100,  매탄4동,'05,0 - 4세,1998,2659,1399,1260
'4111559100,  매탄4동,'10,5 - 9세,1998,2739,1435,1304
'4111559100,  매탄4동,'15,10 - 14세,1998,2556,1328,1228
'4111559100,  매탄4동,'20,15 - 19세,1998,2202,1135,1067
'4111559100,  매탄4동,'25,20 - 24세,1998,1876,759,1117
'4111559100,  매탄4동,'30,25 - 29세,1998,2952,1472,1480
'4111559100,  매탄4동,'35,30 - 34세,1998,3133,1509,1624
'4111559100,  매탄4동,'40,35 - 39세,1998,3504,1760,1744
'4111559100,  매탄4동,'45,40 - 44세,1998,2568,1386,1182
'4111559100,  매탄4동,'50,45 - 49세,1998,1211,712,499
'4111559100,  매탄4동,'55,50 - 54세,1998,605,359,246
'4111559100,  매탄4동,'60,55 - 59세,1998,368,194,174
'4111559100,  매탄4동,'65,60 - 64세,1998,309,114,195
'4111559100,  매탄4동,'70,65 - 69세,1998,283,78,205
'4111559100,  매탄4동,'75,70 - 74세,1998,196,70,126
'4111559100,  매탄4동,'80,75 - 79세,1998,147,41,106
'4111559100,  매탄4동,'85,80 - 84세,1998,68,14,54
'4111559100,  매탄4동,'90,85+ ,1998,50,14,36
'4111560000,  원천동,'00,계,1998,81289,40974,40315
'4111560000,  원천동,'05,0 - 4세,1998,10994,5770,5224
'4111560000,  원천동,'10,5 - 9세,1998,10199,5387,4812
'4111560000,  원천동,'15,10 - 14세,1998,6120,3178,2942
'4111560000,  원천동,'20,15 - 19세,1998,3694,1872,1822
'4111560000,  원천동,'25,20 - 24세,1998,3432,1553,1879
'4111560000,  원천동,'30,25 - 29세,1998,8934,3670,5264
'4111560000,  원천동,'35,30 - 34세,1998,13202,6318,6884
'4111560000,  원천동,'40,35 - 39세,1998,11356,6361,4995
'4111560000,  원천동,'45,40 - 44세,1998,5646,3339,2307
'4111560000,  원천동,'50,45 - 49세,1998,2216,1252,964
'4111560000,  원천동,'55,50 - 54세,1998,1469,765,704
'4111560000,  원천동,'60,55 - 59세,1998,1081,503,578
'4111560000,  원천동,'65,60 - 64세,1998,1008,410,598
'4111560000,  원천동,'70,65 - 69세,1998,749,250,499
'4111560000,  원천동,'75,70 - 74세,1998,559,174,385
'4111560000,  원천동,'80,75 - 79세,1998,361,109,252
'4111560000,  원천동,'85,80 - 84세,1998,168,38,130
'4111560000,  원천동,'90,85+ ,1998,101,25,76
'4111570000,  지동,'00,계,1998,20543,10175,10368
'4111570000,  지동,'05,0 - 4세,1998,1433,742,691
'4111570000,  지동,'10,5 - 9세,1998,1289,662,627
'4111570000,  지동,'15,10 - 14세,1998,1228,630,598
'4111570000,  지동,'20,15 - 19세,1998,1688,856,832
'4111570000,  지동,'25,20 - 24세,1998,2331,1031,1300
'4111570000,  지동,'30,25 - 29세,1998,2760,1526,1234
'4111570000,  지동,'35,30 - 34세,1998,1897,1002,895
'4111570000,  지동,'40,35 - 39세,1998,1747,865,882
'4111570000,  지동,'45,40 - 44세,1998,1493,736,757
'4111570000,  지동,'50,45 - 49세,1998,1064,516,548
'4111570000,  지동,'55,50 - 54세,1998,982,479,503
'4111570000,  지동,'60,55 - 59세,1998,931,431,500
'4111570000,  지동,'65,60 - 64세,1998,657,323,334
'4111570000,  지동,'70,65 - 69세,1998,403,154,249
'4111570000,  지동,'75,70 - 74세,1998,287,104,183
'4111570000,  지동,'80,75 - 79세,1998,193,64,129
'4111570000,  지동,'85,80 - 84세,1998,103,34,69
'4111570000,  지동,'90,85+ ,1998,57,20,37
'4111571000,  우만1동,'00,계,1998,28471,14212,14259
'4111571000,  우만1동,'05,0 - 4세,1998,2618,1388,1230
'4111571000,  우만1동,'10,5 - 9세,1998,2354,1283,1071
'4111571000,  우만1동,'15,10 - 14세,1998,2021,1046,975
'4111571000,  우만1동,'20,15 - 19세,1998,2455,1240,1215
'4111571000,  우만1동,'25,20 - 24세,1998,2511,1223,1288
'4111571000,  우만1동,'30,25 - 29세,1998,3428,1741,1687
'4111571000,  우만1동,'35,30 - 34세,1998,3310,1674,1636
'4111571000,  우만1동,'40,35 - 39세,1998,3028,1538,1490
'4111571000,  우만1동,'45,40 - 44세,1998,2154,1063,1091
'4111571000,  우만1동,'50,45 - 49세,1998,1275,625,650
'4111571000,  우만1동,'55,50 - 54세,1998,1011,510,501
'4111571000,  우만1동,'60,55 - 59세,1998,753,338,415
'4111571000,  우만1동,'65,60 - 64세,1998,532,227,305
'4111571000,  우만1동,'70,65 - 69세,1998,370,137,233
'4111571000,  우만1동,'75,70 - 74세,1998,272,74,198
'4111571000,  우만1동,'80,75 - 79세,1998,217,65,152
'4111571000,  우만1동,'85,80 - 84세,1998,97,25,72
'4111571000,  우만1동,'90,85+ ,1998,65,15,50
'4111572000,  우만2동,'00,계,1998,12402,6195,6207
'4111572000,  우만2동,'05,0 - 4세,1998,1032,543,489
'4111572000,  우만2동,'10,5 - 9세,1998,1136,605,531
'4111572000,  우만2동,'15,10 - 14세,1998,1003,521,482
'4111572000,  우만2동,'20,15 - 19세,1998,950,479,471
'4111572000,  우만2동,'25,20 - 24세,1998,898,446,452
'4111572000,  우만2동,'30,25 - 29세,1998,1366,671,695
'4111572000,  우만2동,'35,30 - 34세,1998,1372,665,707
'4111572000,  우만2동,'40,35 - 39세,1998,1454,686,768
'4111572000,  우만2동,'45,40 - 44세,1998,1128,606,522
'4111572000,  우만2동,'50,45 - 49세,1998,591,326,265
'4111572000,  우만2동,'55,50 - 54세,1998,412,220,192
'4111572000,  우만2동,'60,55 - 59세,1998,345,164,181
'4111572000,  우만2동,'65,60 - 64세,1998,242,110,132
'4111572000,  우만2동,'70,65 - 69세,1998,177,58,119
'4111572000,  우만2동,'75,70 - 74세,1998,115,39,76
'4111572000,  우만2동,'80,75 - 79세,1998,102,33,69
'4111572000,  우만2동,'85,80 - 84세,1998,42,13,29
'4111572000,  우만2동,'90,85+ ,1998,37,10,27
'4111573000,  인계동,'00,계,1998,39794,20037,19757
'4111573000,  인계동,'05,0 - 4세,1998,3235,1729,1506
'4111573000,  인계동,'10,5 - 9세,1998,3349,1800,1549
'4111573000,  인계동,'15,10 - 14세,1998,2824,1438,1386
'4111573000,  인계동,'20,15 - 19세,1998,3213,1652,1561
'4111573000,  인계동,'25,20 - 24세,1998,3394,1595,1799
'4111573000,  인계동,'30,25 - 29세,1998,4588,2383,2205
'4111573000,  인계동,'35,30 - 34세,1998,4230,2078,2152
'4111573000,  인계동,'40,35 - 39세,1998,4478,2279,2199
'4111573000,  인계동,'45,40 - 44세,1998,3278,1697,1581
'4111573000,  인계동,'50,45 - 49세,1998,2021,1069,952
'4111573000,  인계동,'55,50 - 54세,1998,1541,777,764
'4111573000,  인계동,'60,55 - 59세,1998,1198,603,595
'4111573000,  인계동,'65,60 - 64세,1998,901,401,500
'4111573000,  인계동,'70,65 - 69세,1998,593,241,352
'4111573000,  인계동,'75,70 - 74세,1998,438,145,293
'4111573000,  인계동,'80,75 - 79세,1998,277,86,191
'4111573000,  인계동,'85,80 - 84세,1998,151,42,109
'4111573000,  인계동,'90,85+ ,1998,85,22,63
'41130, 성남시,'00,계,1998,921227,463228,457999
'41130, 성남시,'05,0 - 4세,1998,68671,36019,32652
'41130, 성남시,'10,5 - 9세,1998,73349,38759,34590
'41130, 성남시,'15,10 - 14세,1998,68038,35203,32835
'41130, 성남시,'20,15 - 19세,1998,76501,39078,37423
'41130, 성남시,'25,20 - 24세,1998,71061,35423,35638
'41130, 성남시,'30,25 - 29세,1998,96135,47701,48434
'41130, 성남시,'35,30 - 34세,1998,91673,46103,45570
'41130, 성남시,'40,35 - 39세,1998,97438,48771,48667
'41130, 성남시,'45,40 - 44세,1998,81222,42556,38666
'41130, 성남시,'50,45 - 49세,1998,51203,26756,24447
'41130, 성남시,'55,50 - 54세,1998,41860,20883,20977
'41130, 성남시,'60,55 - 59세,1998,36325,18575,17750
'41130, 성남시,'65,60 - 64세,1998,25549,12204,13345
'41130, 성남시,'70,65 - 69세,1998,16738,6852,9886
'41130, 성남시,'75,70 - 74세,1998,11189,4014,7175
'41130, 성남시,'80,75 - 79세,1998,7761,2582,5179
'41130, 성남시,'85,80 - 84세,1998,4071,1152,2919
'41130, 성남시,'90,85+ ,1998,2443,597,1846
'41131, 수정구,'00,계,1998,258028,130788,127240
'41131, 수정구,'05,0 - 4세,1998,20480,10684,9796
'41131, 수정구,'10,5 - 9세,1998,18425,9719,8706
'41131, 수정구,'15,10 - 14세,1998,15737,8118,7619
'41131, 수정구,'20,15 - 19세,1998,20942,10679,10263
'41131, 수정구,'25,20 - 24세,1998,22925,11328,11597
'41131, 수정구,'30,25 - 29세,1998,31777,16215,15562
'41131, 수정구,'35,30 - 34세,1998,27645,14753,12892
'41131, 수정구,'40,35 - 39세,1998,25318,13332,11986
'41131, 수정구,'45,40 - 44세,1998,19808,10397,9411
'41131, 수정구,'50,45 - 49세,1998,13544,6805,6739
'41131, 수정구,'55,50 - 54세,1998,11704,5752,5952
'41131, 수정구,'60,55 - 59세,1998,10879,5426,5453
'41131, 수정구,'65,60 - 64세,1998,7679,3636,4043
'41131, 수정구,'70,65 - 69세,1998,4547,1858,2689
'41131, 수정구,'75,70 - 74세,1998,2948,1047,1901
'41131, 수정구,'80,75 - 79세,1998,2041,640,1401
'41131, 수정구,'85,80 - 84세,1998,1027,258,769
'41131, 수정구,'90,85+ ,1998,602,141,461
'4113151000,  신흥1동,'00,계,1998,19610,9998,9612
'4113151000,  신흥1동,'05,0 - 4세,1998,1472,732,740
'4113151000,  신흥1동,'10,5 - 9세,1998,1145,626,519
'4113151000,  신흥1동,'15,10 - 14세,1998,991,529,462
'4113151000,  신흥1동,'20,15 - 19세,1998,1652,848,804
'4113151000,  신흥1동,'25,20 - 24세,1998,2007,998,1009
'4113151000,  신흥1동,'30,25 - 29세,1998,2689,1416,1273
'4113151000,  신흥1동,'35,30 - 34세,1998,2095,1183,912
'4113151000,  신흥1동,'40,35 - 39세,1998,1696,911,785
'4113151000,  신흥1동,'45,40 - 44세,1998,1495,754,741
'4113151000,  신흥1동,'50,45 - 49세,1998,1122,535,587
'4113151000,  신흥1동,'55,50 - 54세,1998,923,440,483
'4113151000,  신흥1동,'60,55 - 59세,1998,924,455,469
'4113151000,  신흥1동,'65,60 - 64세,1998,580,263,317
'4113151000,  신흥1동,'70,65 - 69세,1998,346,135,211
'4113151000,  신흥1동,'75,70 - 74세,1998,213,91,122
'4113151000,  신흥1동,'80,75 - 79세,1998,159,52,107
'4113151000,  신흥1동,'85,80 - 84세,1998,59,18,41
'4113151000,  신흥1동,'90,85+ ,1998,42,12,30
'4113152000,  신흥2동,'00,계,1998,34544,17326,17218
'4113152000,  신흥2동,'05,0 - 4세,1998,2925,1562,1363
'4113152000,  신흥2동,'10,5 - 9세,1998,2855,1555,1300
'4113152000,  신흥2동,'15,10 - 14세,1998,2325,1172,1153
'4113152000,  신흥2동,'20,15 - 19세,1998,2739,1365,1374
'4113152000,  신흥2동,'25,20 - 24세,1998,2677,1337,1340
'4113152000,  신흥2동,'30,25 - 29세,1998,3696,1799,1897
'4113152000,  신흥2동,'35,30 - 34세,1998,3828,1862,1966
'4113152000,  신흥2동,'40,35 - 39세,1998,3895,2027,1868
'4113152000,  신흥2동,'45,40 - 44세,1998,2825,1489,1336
'4113152000,  신흥2동,'50,45 - 49세,1998,1792,920,872
'4113152000,  신흥2동,'55,50 - 54세,1998,1422,716,706
'4113152000,  신흥2동,'60,55 - 59세,1998,1221,610,611
'4113152000,  신흥2동,'65,60 - 64세,1998,892,415,477
'4113152000,  신흥2동,'70,65 - 69세,1998,573,205,368
'4113152000,  신흥2동,'75,70 - 74세,1998,378,138,240
'4113152000,  신흥2동,'80,75 - 79세,1998,299,94,205
'4113152000,  신흥2동,'85,80 - 84세,1998,120,37,83
'4113152000,  신흥2동,'90,85+ ,1998,82,23,59
'4113153000,  신흥3동,'00,계,1998,14605,7358,7247
'4113153000,  신흥3동,'05,0 - 4세,1998,1034,523,511
'4113153000,  신흥3동,'10,5 - 9세,1998,943,496,447
'4113153000,  신흥3동,'15,10 - 14세,1998,827,434,393
'4113153000,  신흥3동,'20,15 - 19세,1998,1222,630,592
'4113153000,  신흥3동,'25,20 - 24세,1998,1508,747,761
'4113153000,  신흥3동,'30,25 - 29세,1998,1885,983,902
'4113153000,  신흥3동,'35,30 - 34세,1998,1425,741,684
'4113153000,  신흥3동,'40,35 - 39세,1998,1325,694,631
'4113153000,  신흥3동,'45,40 - 44세,1998,1210,614,596
'4113153000,  신흥3동,'50,45 - 49세,1998,798,393,405
'4113153000,  신흥3동,'55,50 - 54세,1998,727,351,376
'4113153000,  신흥3동,'60,55 - 59세,1998,643,326,317
'4113153000,  신흥3동,'65,60 - 64세,1998,441,216,225
'4113153000,  신흥3동,'70,65 - 69세,1998,247,104,143
'4113153000,  신흥3동,'75,70 - 74세,1998,166,51,115
'4113153000,  신흥3동,'80,75 - 79세,1998,113,34,79
'4113153000,  신흥3동,'85,80 - 84세,1998,52,12,40
'4113153000,  신흥3동,'90,85+ ,1998,39,9,30
'4113154000,  태평1동,'00,계,1998,19657,9985,9672
'4113154000,  태평1동,'05,0 - 4세,1998,1533,783,750
'4113154000,  태평1동,'10,5 - 9세,1998,1241,657,584
'4113154000,  태평1동,'15,10 - 14세,1998,1027,534,493
'4113154000,  태평1동,'20,15 - 19세,1998,1417,704,713
'4113154000,  태평1동,'25,20 - 24세,1998,1893,921,972
'4113154000,  태평1동,'30,25 - 29세,1998,2912,1494,1418
'4113154000,  태평1동,'35,30 - 34세,1998,2104,1187,917
'4113154000,  태평1동,'40,35 - 39세,1998,1750,957,793
'4113154000,  태평1동,'45,40 - 44세,1998,1388,726,662
'4113154000,  태평1동,'50,45 - 49세,1998,1027,482,545
'4113154000,  태평1동,'55,50 - 54세,1998,980,474,506
'4113154000,  태평1동,'60,55 - 59세,1998,977,490,487
'4113154000,  태평1동,'65,60 - 64세,1998,607,295,312
'4113154000,  태평1동,'70,65 - 69세,1998,376,138,238
'4113154000,  태평1동,'75,70 - 74세,1998,190,74,116
'4113154000,  태평1동,'80,75 - 79세,1998,126,44,82
'4113154000,  태평1동,'85,80 - 84세,1998,61,18,43
'4113154000,  태평1동,'90,85+ ,1998,48,7,41
'4113155000,  태평2동,'00,계,1998,23457,11941,11516
'4113155000,  태평2동,'05,0 - 4세,1998,2093,1127,966
'4113155000,  태평2동,'10,5 - 9세,1998,1821,925,896
'4113155000,  태평2동,'15,10 - 14세,1998,1434,720,714
'4113155000,  태평2동,'20,15 - 19세,1998,1819,905,914
'4113155000,  태평2동,'25,20 - 24세,1998,2008,1015,993
'4113155000,  태평2동,'30,25 - 29세,1998,2995,1505,1490
'4113155000,  태평2동,'35,30 - 34세,1998,2679,1447,1232
'4113155000,  태평2동,'40,35 - 39세,1998,2366,1277,1089
'4113155000,  태평2동,'45,40 - 44세,1998,1703,888,815
'4113155000,  태평2동,'50,45 - 49세,1998,1144,592,552
'4113155000,  태평2동,'55,50 - 54세,1998,956,458,498
'4113155000,  태평2동,'60,55 - 59세,1998,898,449,449
'4113155000,  태평2동,'65,60 - 64세,1998,631,304,327
'4113155000,  태평2동,'70,65 - 69세,1998,374,166,208
'4113155000,  태평2동,'75,70 - 74세,1998,229,75,154
'4113155000,  태평2동,'80,75 - 79세,1998,159,50,109
'4113155000,  태평2동,'85,80 - 84세,1998,94,20,74
'4113155000,  태평2동,'90,85+ ,1998,54,18,36
'4113156000,  태평3동,'00,계,1998,19438,9846,9592
'4113156000,  태평3동,'05,0 - 4세,1998,1520,778,742
'4113156000,  태평3동,'10,5 - 9세,1998,1446,756,690
'4113156000,  태평3동,'15,10 - 14세,1998,1298,688,610
'4113156000,  태평3동,'20,15 - 19세,1998,1511,771,740
'4113156000,  태평3동,'25,20 - 24세,1998,1688,793,895
'4113156000,  태평3동,'30,25 - 29세,1998,2429,1248,1181
'4113156000,  태평3동,'35,30 - 34세,1998,2157,1163,994
'4113156000,  태평3동,'40,35 - 39세,1998,1970,1018,952
'4113156000,  태평3동,'45,40 - 44세,1998,1425,757,668
'4113156000,  태평3동,'50,45 - 49세,1998,1012,529,483
'4113156000,  태평3동,'55,50 - 54세,1998,841,414,427
'4113156000,  태평3동,'60,55 - 59세,1998,780,391,389
'4113156000,  태평3동,'65,60 - 64세,1998,600,276,324
'4113156000,  태평3동,'70,65 - 69세,1998,333,131,202
'4113156000,  태평3동,'75,70 - 74세,1998,189,70,119
'4113156000,  태평3동,'80,75 - 79세,1998,141,35,106
'4113156000,  태평3동,'85,80 - 84세,1998,67,21,46
'4113156000,  태평3동,'90,85+ ,1998,31,7,24
'4113156100,  태평4동,'00,계,1998,20216,10297,9919
'4113156100,  태평4동,'05,0 - 4세,1998,1639,885,754
'4113156100,  태평4동,'10,5 - 9세,1998,1588,846,742
'4113156100,  태평4동,'15,10 - 14세,1998,1362,704,658
'4113156100,  태평4동,'20,15 - 19세,1998,1696,882,814
'4113156100,  태평4동,'25,20 - 24세,1998,1660,824,836
'4113156100,  태평4동,'30,25 - 29세,1998,2312,1173,1139
'4113156100,  태평4동,'35,30 - 34세,1998,2093,1093,1000
'4113156100,  태평4동,'40,35 - 39세,1998,2147,1106,1041
'4113156100,  태평4동,'45,40 - 44세,1998,1561,843,718
'4113156100,  태평4동,'50,45 - 49세,1998,1024,542,482
'4113156100,  태평4동,'55,50 - 54세,1998,884,427,457
'4113156100,  태평4동,'60,55 - 59세,1998,799,396,403
'4113156100,  태평4동,'65,60 - 64세,1998,593,275,318
'4113156100,  태평4동,'70,65 - 69세,1998,358,154,204
'4113156100,  태평4동,'75,70 - 74세,1998,249,91,158
'4113156100,  태평4동,'80,75 - 79세,1998,133,39,94
'4113156100,  태평4동,'85,80 - 84세,1998,85,9,76
'4113156100,  태평4동,'90,85+ ,1998,33,8,25
'4113157000,  수진1동,'00,계,1998,21821,10974,10847
'4113157000,  수진1동,'05,0 - 4세,1998,1694,903,791
'4113157000,  수진1동,'10,5 - 9세,1998,1388,692,696
'4113157000,  수진1동,'15,10 - 14세,1998,1221,622,599
'4113157000,  수진1동,'20,15 - 19세,1998,1870,938,932
'4113157000,  수진1동,'25,20 - 24세,1998,2102,988,1114
'4113157000,  수진1동,'30,25 - 29세,1998,2840,1488,1352
'4113157000,  수진1동,'35,30 - 34세,1998,2330,1301,1029
'4113157000,  수진1동,'40,35 - 39세,1998,2029,1044,985
'4113157000,  수진1동,'45,40 - 44세,1998,1646,857,789
'4113157000,  수진1동,'50,45 - 49세,1998,1123,554,569
'4113157000,  수진1동,'55,50 - 54세,1998,1021,482,539
'4113157000,  수진1동,'60,55 - 59세,1998,961,472,489
'4113157000,  수진1동,'65,60 - 64세,1998,659,318,341
'4113157000,  수진1동,'70,65 - 69세,1998,400,170,230
'4113157000,  수진1동,'75,70 - 74세,1998,243,69,174
'4113157000,  수진1동,'80,75 - 79세,1998,173,53,120
'4113157000,  수진1동,'85,80 - 84세,1998,79,17,62
'4113157000,  수진1동,'90,85+ ,1998,42,6,36
'4113158000,  수진2동,'00,계,1998,19975,10083,9892
'4113158000,  수진2동,'05,0 - 4세,1998,1420,705,715
'4113158000,  수진2동,'10,5 - 9세,1998,1510,780,730
'4113158000,  수진2동,'15,10 - 14세,1998,1348,719,629
'4113158000,  수진2동,'20,15 - 19세,1998,1705,893,812
'4113158000,  수진2동,'25,20 - 24세,1998,1770,889,881
'4113158000,  수진2동,'30,25 - 29세,1998,2371,1168,1203
'4113158000,  수진2동,'35,30 - 34세,1998,2106,1103,1003
'4113158000,  수진2동,'40,35 - 39세,1998,2055,1071,984
'4113158000,  수진2동,'45,40 - 44세,1998,1579,831,748
'4113158000,  수진2동,'50,45 - 49세,1998,1053,513,540
'4113158000,  수진2동,'55,50 - 54세,1998,901,464,437
'4113158000,  수진2동,'60,55 - 59세,1998,825,421,404
'4113158000,  수진2동,'65,60 - 64세,1998,558,258,300
'4113158000,  수진2동,'70,65 - 69세,1998,290,120,170
'4113158000,  수진2동,'75,70 - 74세,1998,221,83,138
'4113158000,  수진2동,'80,75 - 79세,1998,143,41,102
'4113158000,  수진2동,'85,80 - 84세,1998,69,14,55
'4113158000,  수진2동,'90,85+ ,1998,51,10,41
'4113159000,  단대동,'00,계,1998,19231,9772,9459
'4113159000,  단대동,'05,0 - 4세,1998,1642,878,764
'4113159000,  단대동,'10,5 - 9세,1998,1423,777,646
'4113159000,  단대동,'15,10 - 14세,1998,1238,643,595
'4113159000,  단대동,'20,15 - 19세,1998,1547,828,719
'4113159000,  단대동,'25,20 - 24세,1998,1589,753,836
'4113159000,  단대동,'30,25 - 29세,1998,2240,1139,1101
'4113159000,  단대동,'35,30 - 34세,1998,2153,1117,1036
'4113159000,  단대동,'40,35 - 39세,1998,1974,1029,945
'4113159000,  단대동,'45,40 - 44세,1998,1422,748,674
'4113159000,  단대동,'50,45 - 49세,1998,918,460,458
'4113159000,  단대동,'55,50 - 54세,1998,881,444,437
'4113159000,  단대동,'60,55 - 59세,1998,778,375,403
'4113159000,  단대동,'65,60 - 64세,1998,581,275,306
'4113159000,  단대동,'70,65 - 69세,1998,356,154,202
'4113159000,  단대동,'75,70 - 74세,1998,207,71,136
'4113159000,  단대동,'80,75 - 79세,1998,161,55,106
'4113159000,  단대동,'85,80 - 84세,1998,76,20,56
'4113159000,  단대동,'90,85+ ,1998,45,6,39
'4113160000,  산성동,'00,계,1998,19482,9887,9595
'4113160000,  산성동,'05,0 - 4세,1998,1585,778,807
'4113160000,  산성동,'10,5 - 9세,1998,1308,690,618
'4113160000,  산성동,'15,10 - 14세,1998,1129,586,543
'4113160000,  산성동,'20,15 - 19세,1998,1672,826,846
'4113160000,  산성동,'25,20 - 24세,1998,1903,974,929
'4113160000,  산성동,'30,25 - 29세,1998,2560,1311,1249
'4113160000,  산성동,'35,30 - 34세,1998,2027,1130,897
'4113160000,  산성동,'40,35 - 39세,1998,1773,939,834
'4113160000,  산성동,'45,40 - 44세,1998,1484,775,709
'4113160000,  산성동,'50,45 - 49세,1998,974,490,484
'4113160000,  산성동,'55,50 - 54세,1998,881,444,437
'4113160000,  산성동,'60,55 - 59세,1998,879,430,449
'4113160000,  산성동,'65,60 - 64세,1998,539,261,278
'4113160000,  산성동,'70,65 - 69세,1998,306,130,176
'4113160000,  산성동,'75,70 - 74세,1998,213,62,151
'4113160000,  산성동,'80,75 - 79세,1998,139,34,105
'4113160000,  산성동,'85,80 - 84세,1998,76,17,59
'4113160000,  산성동,'90,85+ ,1998,34,10,24
'4113161000,  양지동,'00,계,1998,11239,5648,5591
'4113161000,  양지동,'05,0 - 4세,1998,934,502,432
'4113161000,  양지동,'10,5 - 9세,1998,796,410,386
'4113161000,  양지동,'15,10 - 14세,1998,661,326,335
'4113161000,  양지동,'20,15 - 19세,1998,951,506,445
'4113161000,  양지동,'25,20 - 24세,1998,972,460,512
'4113161000,  양지동,'30,25 - 29세,1998,1271,624,647
'4113161000,  양지동,'35,30 - 34세,1998,1195,632,563
'4113161000,  양지동,'40,35 - 39세,1998,1040,544,496
'4113161000,  양지동,'45,40 - 44세,1998,893,476,417
'4113161000,  양지동,'50,45 - 49세,1998,652,325,327
'4113161000,  양지동,'55,50 - 54세,1998,497,233,264
'4113161000,  양지동,'60,55 - 59세,1998,465,241,224
'4113161000,  양지동,'65,60 - 64세,1998,346,159,187
'4113161000,  양지동,'70,65 - 69세,1998,217,90,127
'4113161000,  양지동,'75,70 - 74세,1998,158,58,100
'4113161000,  양지동,'80,75 - 79세,1998,97,36,61
'4113161000,  양지동,'85,80 - 84세,1998,65,20,45
'4113161000,  양지동,'90,85+ ,1998,29,6,23
'4113162000,  복정동,'00,계,1998,4623,2417,2206
'4113162000,  복정동,'05,0 - 4세,1998,347,169,178
'4113162000,  복정동,'10,5 - 9세,1998,254,139,115
'4113162000,  복정동,'15,10 - 14세,1998,188,110,78
'4113162000,  복정동,'20,15 - 19세,1998,336,167,169
'4113162000,  복정동,'25,20 - 24세,1998,389,217,172
'4113162000,  복정동,'30,25 - 29세,1998,463,250,213
'4113162000,  복정동,'35,30 - 34세,1998,511,283,228
'4113162000,  복정동,'40,35 - 39세,1998,384,223,161
'4113162000,  복정동,'45,40 - 44세,1998,335,187,148
'4113162000,  복정동,'50,45 - 49세,1998,312,158,154
'4113162000,  복정동,'55,50 - 54세,1998,265,135,130
'4113162000,  복정동,'60,55 - 59세,1998,262,139,123
'4113162000,  복정동,'65,60 - 64세,1998,231,118,113
'4113162000,  복정동,'70,65 - 69세,1998,119,49,70
'4113162000,  복정동,'75,70 - 74세,1998,91,34,57
'4113162000,  복정동,'80,75 - 79세,1998,70,22,48
'4113162000,  복정동,'85,80 - 84세,1998,39,10,29
'4113162000,  복정동,'90,85+ ,1998,27,7,20
'4113163000,  신촌동,'00,계,1998,3984,2015,1969
'4113163000,  신촌동,'05,0 - 4세,1998,278,153,125
'4113163000,  신촌동,'10,5 - 9세,1998,321,175,146
'4113163000,  신촌동,'15,10 - 14세,1998,316,151,165
'4113163000,  신촌동,'20,15 - 19세,1998,316,163,153
'4113163000,  신촌동,'25,20 - 24세,1998,280,138,142
'4113163000,  신촌동,'30,25 - 29세,1998,484,245,239
'4113163000,  신촌동,'35,30 - 34세,1998,421,227,194
'4113163000,  신촌동,'40,35 - 39세,1998,397,212,185
'4113163000,  신촌동,'45,40 - 44세,1998,337,168,169
'4113163000,  신촌동,'50,45 - 49세,1998,209,108,101
'4113163000,  신촌동,'55,50 - 54세,1998,141,78,63
'4113163000,  신촌동,'60,55 - 59세,1998,123,53,70
'4113163000,  신촌동,'65,60 - 64세,1998,126,58,68
'4113163000,  신촌동,'70,65 - 69세,1998,90,35,55
'4113163000,  신촌동,'75,70 - 74세,1998,64,25,39
'4113163000,  신촌동,'80,75 - 79세,1998,43,15,28
'4113163000,  신촌동,'85,80 - 84세,1998,25,7,18
'4113163000,  신촌동,'90,85+ ,1998,13,4,9
'4113164000,  고등동,'00,계,1998,2956,1551,1405
'4113164000,  고등동,'05,0 - 4세,1998,148,89,59
'4113164000,  고등동,'10,5 - 9세,1998,179,92,87
'4113164000,  고등동,'15,10 - 14세,1998,180,97,83
'4113164000,  고등동,'20,15 - 19세,1998,231,120,111
'4113164000,  고등동,'25,20 - 24세,1998,256,147,109
'4113164000,  고등동,'30,25 - 29세,1998,290,168,122
'4113164000,  고등동,'35,30 - 34세,1998,244,131,113
'4113164000,  고등동,'40,35 - 39세,1998,255,135,120
'4113164000,  고등동,'45,40 - 44세,1998,243,131,112
'4113164000,  고등동,'50,45 - 49세,1998,181,90,91
'4113164000,  고등동,'55,50 - 54세,1998,194,94,100
'4113164000,  고등동,'60,55 - 59세,1998,177,90,87
'4113164000,  고등동,'65,60 - 64세,1998,163,80,83
'4113164000,  고등동,'70,65 - 69세,1998,69,37,32
'4113164000,  고등동,'75,70 - 74세,1998,65,27,38
'4113164000,  고등동,'80,75 - 79세,1998,36,14,22
'4113164000,  고등동,'85,80 - 84세,1998,29,6,23
'4113164000,  고등동,'90,85+ ,1998,16,3,13
'4113165000,  시흥동,'00,계,1998,3190,1690,1500
'4113165000,  시흥동,'05,0 - 4세,1998,216,117,99
'4113165000,  시흥동,'10,5 - 9세,1998,207,103,104
'4113165000,  시흥동,'15,10 - 14세,1998,192,83,109
'4113165000,  시흥동,'20,15 - 19세,1998,258,133,125
'4113165000,  시흥동,'25,20 - 24세,1998,223,127,96
'4113165000,  시흥동,'30,25 - 29세,1998,340,204,136
'4113165000,  시흥동,'35,30 - 34세,1998,277,153,124
'4113165000,  시흥동,'40,35 - 39세,1998,262,145,117
'4113165000,  시흥동,'45,40 - 44세,1998,262,153,109
'4113165000,  시흥동,'50,45 - 49세,1998,203,114,89
'4113165000,  시흥동,'55,50 - 54세,1998,190,98,92
'4113165000,  시흥동,'60,55 - 59세,1998,167,88,79
'4113165000,  시흥동,'65,60 - 64세,1998,132,65,67
'4113165000,  시흥동,'70,65 - 69세,1998,93,40,53
'4113165000,  시흥동,'75,70 - 74세,1998,72,28,44
'4113165000,  시흥동,'80,75 - 79세,1998,49,22,27
'4113165000,  시흥동,'85,80 - 84세,1998,31,12,19
'4113165000,  시흥동,'90,85+ ,1998,16,5,11
'41133, 중원구,'00,계,1998,276600,140601,135999
'41133, 중원구,'05,0 - 4세,1998,21465,11243,10222
'41133, 중원구,'10,5 - 9세,1998,21960,11497,10463
'41133, 중원구,'15,10 - 14세,1998,19138,9855,9283
'41133, 중원구,'20,15 - 19세,1998,23822,12080,11742
'41133, 중원구,'25,20 - 24세,1998,23418,11499,11919
'41133, 중원구,'30,25 - 29세,1998,30830,15879,14951
'41133, 중원구,'35,30 - 34세,1998,29672,15295,14377
'41133, 중원구,'40,35 - 39세,1998,29581,15692,13889
'41133, 중원구,'45,40 - 44세,1998,22282,11877,10405
'41133, 중원구,'50,45 - 49세,1998,14345,7511,6834
'41133, 중원구,'55,50 - 54세,1998,11635,5857,5778
'41133, 중원구,'60,55 - 59세,1998,10265,5096,5169
'41133, 중원구,'65,60 - 64세,1998,7172,3350,3822
'41133, 중원구,'70,65 - 69세,1998,4523,1806,2717
'41133, 중원구,'75,70 - 74세,1998,2973,1002,1971
'41133, 중원구,'80,75 - 79세,1998,1986,652,1334
'41133, 중원구,'85,80 - 84세,1998,974,280,694
'41133, 중원구,'90,85+ ,1998,559,130,429
'4113351000,  성남동,'00,계,1998,26815,13590,13225
'4113351000,  성남동,'05,0 - 4세,1998,1812,925,887
'4113351000,  성남동,'10,5 - 9세,1998,1800,942,858
'4113351000,  성남동,'15,10 - 14세,1998,1779,958,821
'4113351000,  성남동,'20,15 - 19세,1998,2511,1302,1209
'4113351000,  성남동,'25,20 - 24세,1998,2354,1175,1179
'4113351000,  성남동,'30,25 - 29세,1998,2984,1559,1425
'4113351000,  성남동,'35,30 - 34세,1998,2706,1401,1305
'4113351000,  성남동,'40,35 - 39세,1998,2593,1310,1283
'4113351000,  성남동,'45,40 - 44세,1998,2225,1133,1092
'4113351000,  성남동,'50,45 - 49세,1998,1579,823,756
'4113351000,  성남동,'55,50 - 54세,1998,1346,665,681
'4113351000,  성남동,'60,55 - 59세,1998,1156,589,567
'4113351000,  성남동,'65,60 - 64세,1998,819,386,433
'4113351000,  성남동,'70,65 - 69세,1998,448,194,254
'4113351000,  성남동,'75,70 - 74세,1998,326,115,211
'4113351000,  성남동,'80,75 - 79세,1998,210,68,142
'4113351000,  성남동,'85,80 - 84세,1998,109,31,78
'4113351000,  성남동,'90,85+ ,1998,58,14,44
'4113352000,  중동,'00,계,1998,28615,14444,14171
'4113352000,  중동,'05,0 - 4세,1998,2016,1050,966
'4113352000,  중동,'10,5 - 9세,1998,1818,971,847
'4113352000,  중동,'15,10 - 14세,1998,1606,840,766
'4113352000,  중동,'20,15 - 19세,1998,2540,1286,1254
'4113352000,  중동,'25,20 - 24세,1998,2777,1313,1464
'4113352000,  중동,'30,25 - 29세,1998,3531,1912,1619
'4113352000,  중동,'35,30 - 34세,1998,2756,1484,1272
'4113352000,  중동,'40,35 - 39세,1998,2598,1396,1202
'4113352000,  중동,'45,40 - 44세,1998,2187,1109,1078
'4113352000,  중동,'50,45 - 49세,1998,1612,766,846
'4113352000,  중동,'55,50 - 54세,1998,1473,699,774
'4113352000,  중동,'60,55 - 59세,1998,1393,658,735
'4113352000,  중동,'65,60 - 64세,1998,975,486,489
'4113352000,  중동,'70,65 - 69세,1998,564,223,341
'4113352000,  중동,'75,70 - 74세,1998,361,132,229
'4113352000,  중동,'80,75 - 79세,1998,227,70,157
'4113352000,  중동,'85,80 - 84세,1998,117,32,85
'4113352000,  중동,'90,85+ ,1998,64,17,47
'4113353000,  금광1동,'00,계,1998,29864,15053,14811
'4113353000,  금광1동,'05,0 - 4세,1998,2189,1150,1039
'4113353000,  금광1동,'10,5 - 9세,1998,2407,1270,1137
'4113353000,  금광1동,'15,10 - 14세,1998,2067,1018,1049
'4113353000,  금광1동,'20,15 - 19세,1998,2706,1335,1371
'4113353000,  금광1동,'25,20 - 24세,1998,2711,1284,1427
'4113353000,  금광1동,'30,25 - 29세,1998,3316,1695,1621
'4113353000,  금광1동,'35,30 - 34세,1998,3122,1599,1523
'4113353000,  금광1동,'40,35 - 39세,1998,3246,1744,1502
'4113353000,  금광1동,'45,40 - 44세,1998,2416,1285,1131
'4113353000,  금광1동,'50,45 - 49세,1998,1618,857,761
'4113353000,  금광1동,'55,50 - 54세,1998,1149,587,562
'4113353000,  금광1동,'60,55 - 59세,1998,1078,528,550
'4113353000,  금광1동,'65,60 - 64세,1998,715,327,388
'4113353000,  금광1동,'70,65 - 69세,1998,455,178,277
'4113353000,  금광1동,'75,70 - 74세,1998,311,95,216
'4113353000,  금광1동,'80,75 - 79세,1998,228,75,153
'4113353000,  금광1동,'85,80 - 84세,1998,79,18,61
'4113353000,  금광1동,'90,85+ ,1998,51,8,43
'4113354000,  금광2동,'00,계,1998,33778,16889,16889
'4113354000,  금광2동,'05,0 - 4세,1998,2640,1384,1256
'4113354000,  금광2동,'10,5 - 9세,1998,2633,1361,1272
'4113354000,  금광2동,'15,10 - 14세,1998,2430,1197,1233
'4113354000,  금광2동,'20,15 - 19세,1998,2878,1419,1459
'4113354000,  금광2동,'25,20 - 24세,1998,2984,1387,1597
'4113354000,  금광2동,'30,25 - 29세,1998,3806,1943,1863
'4113354000,  금광2동,'35,30 - 34세,1998,3467,1752,1715
'4113354000,  금광2동,'40,35 - 39세,1998,3564,1839,1725
'4113354000,  금광2동,'45,40 - 44세,1998,2789,1506,1283
'4113354000,  금광2동,'50,45 - 49세,1998,1732,903,829
'4113354000,  금광2동,'55,50 - 54세,1998,1378,706,672
'4113354000,  금광2동,'60,55 - 59세,1998,1195,596,599
'4113354000,  금광2동,'65,60 - 64세,1998,874,417,457
'4113354000,  금광2동,'70,65 - 69세,1998,554,234,320
'4113354000,  금광2동,'75,70 - 74세,1998,370,111,259
'4113354000,  금광2동,'80,75 - 79세,1998,264,79,185
'4113354000,  금광2동,'85,80 - 84세,1998,128,35,93
'4113354000,  금광2동,'90,85+ ,1998,92,20,72
'4113355000,  은행1동,'00,계,1998,15431,7702,7729
'4113355000,  은행1동,'05,0 - 4세,1998,1379,707,672
'4113355000,  은행1동,'10,5 - 9세,1998,1366,692,674
'4113355000,  은행1동,'15,10 - 14세,1998,1073,559,514
'4113355000,  은행1동,'20,15 - 19세,1998,1188,574,614
'4113355000,  은행1동,'25,20 - 24세,1998,1198,561,637
'4113355000,  은행1동,'30,25 - 29세,1998,1811,883,928
'4113355000,  은행1동,'35,30 - 34세,1998,1710,867,843
'4113355000,  은행1동,'40,35 - 39세,1998,1707,895,812
'4113355000,  은행1동,'45,40 - 44세,1998,1215,657,558
'4113355000,  은행1동,'50,45 - 49세,1998,689,357,332
'4113355000,  은행1동,'55,50 - 54세,1998,597,300,297
'4113355000,  은행1동,'60,55 - 59세,1998,528,257,271
'4113355000,  은행1동,'65,60 - 64세,1998,392,191,201
'4113355000,  은행1동,'70,65 - 69세,1998,236,94,142
'4113355000,  은행1동,'75,70 - 74세,1998,147,43,104
'4113355000,  은행1동,'80,75 - 79세,1998,106,40,66
'4113355000,  은행1동,'85,80 - 84세,1998,59,16,43
'4113355000,  은행1동,'90,85+ ,1998,30,9,21
'4113356000,  은행2동,'00,계,1998,42924,21760,21164
'4113356000,  은행2동,'05,0 - 4세,1998,3934,2061,1873
'4113356000,  은행2동,'10,5 - 9세,1998,3519,1848,1671
'4113356000,  은행2동,'15,10 - 14세,1998,2488,1303,1185
'4113356000,  은행2동,'20,15 - 19세,1998,3220,1685,1535
'4113356000,  은행2동,'25,20 - 24세,1998,3463,1648,1815
'4113356000,  은행2동,'30,25 - 29세,1998,5323,2634,2689
'4113356000,  은행2동,'35,30 - 34세,1998,5155,2670,2485
'4113356000,  은행2동,'40,35 - 39세,1998,4431,2408,2023
'4113356000,  은행2동,'45,40 - 44세,1998,3068,1627,1441
'4113356000,  은행2동,'50,45 - 49세,1998,2000,1024,976
'4113356000,  은행2동,'55,50 - 54세,1998,1796,839,957
'4113356000,  은행2동,'60,55 - 59세,1998,1654,814,840
'4113356000,  은행2동,'65,60 - 64세,1998,1133,534,599
'4113356000,  은행2동,'70,65 - 69세,1998,713,312,401
'4113356000,  은행2동,'75,70 - 74세,1998,455,168,287
'4113356000,  은행2동,'80,75 - 79세,1998,295,109,186
'4113356000,  은행2동,'85,80 - 84세,1998,177,47,130
'4113356000,  은행2동,'90,85+ ,1998,100,29,71
'4113357000,  상대원1동,'00,계,1998,35183,18240,16943
'4113357000,  상대원1동,'05,0 - 4세,1998,2590,1388,1202
'4113357000,  상대원1동,'10,5 - 9세,1998,2922,1543,1379
'4113357000,  상대원1동,'15,10 - 14세,1998,2805,1478,1327
'4113357000,  상대원1동,'20,15 - 19세,1998,3262,1678,1584
'4113357000,  상대원1동,'25,20 - 24세,1998,2734,1434,1300
'4113357000,  상대원1동,'30,25 - 29세,1998,3382,1781,1601
'4113357000,  상대원1동,'35,30 - 34세,1998,3642,1829,1813
'4113357000,  상대원1동,'40,35 - 39세,1998,4180,2223,1957
'4113357000,  상대원1동,'45,40 - 44세,1998,3074,1712,1362
'4113357000,  상대원1동,'50,45 - 49세,1998,1847,1009,838
'4113357000,  상대원1동,'55,50 - 54세,1998,1436,731,705
'4113357000,  상대원1동,'60,55 - 59세,1998,1222,631,591
'4113357000,  상대원1동,'65,60 - 64세,1998,811,361,450
'4113357000,  상대원1동,'70,65 - 69세,1998,542,191,351
'4113357000,  상대원1동,'75,70 - 74세,1998,338,121,217
'4113357000,  상대원1동,'80,75 - 79세,1998,228,81,147
'4113357000,  상대원1동,'85,80 - 84세,1998,116,38,78
'4113357000,  상대원1동,'90,85+ ,1998,52,11,41
'4113358000,  상대원2동,'00,계,1998,22938,11904,11034
'4113358000,  상대원2동,'05,0 - 4세,1998,1688,902,786
'4113358000,  상대원2동,'10,5 - 9세,1998,1787,951,836
'4113358000,  상대원2동,'15,10 - 14세,1998,1612,797,815
'4113358000,  상대원2동,'20,15 - 19세,1998,1975,1005,970
'4113358000,  상대원2동,'25,20 - 24세,1998,2098,1086,1012
'4113358000,  상대원2동,'30,25 - 29세,1998,2622,1396,1226
'4113358000,  상대원2동,'35,30 - 34세,1998,2522,1370,1152
'4113358000,  상대원2동,'40,35 - 39세,1998,2425,1329,1096
'4113358000,  상대원2동,'45,40 - 44세,1998,1788,964,824
'4113358000,  상대원2동,'50,45 - 49세,1998,1213,634,579
'4113358000,  상대원2동,'55,50 - 54세,1998,951,508,443
'4113358000,  상대원2동,'60,55 - 59세,1998,854,429,425
'4113358000,  상대원2동,'65,60 - 64세,1998,554,236,318
'4113358000,  상대원2동,'70,65 - 69세,1998,382,147,235
'4113358000,  상대원2동,'75,70 - 74세,1998,229,79,150
'4113358000,  상대원2동,'80,75 - 79세,1998,145,47,98
'4113358000,  상대원2동,'85,80 - 84세,1998,53,18,35
'4113358000,  상대원2동,'90,85+ ,1998,40,6,34
'4113359000,  상대원3동,'00,계,1998,20394,10503,9891
'4113359000,  상대원3동,'05,0 - 4세,1998,1575,809,766
'4113359000,  상대원3동,'10,5 - 9세,1998,1783,909,874
'4113359000,  상대원3동,'15,10 - 14세,1998,1565,812,753
'4113359000,  상대원3동,'20,15 - 19세,1998,1748,868,880
'4113359000,  상대원3동,'25,20 - 24세,1998,1700,901,799
'4113359000,  상대원3동,'30,25 - 29세,1998,2269,1218,1051
'4113359000,  상대원3동,'35,30 - 34세,1998,2345,1220,1125
'4113359000,  상대원3동,'40,35 - 39세,1998,2292,1249,1043
'4113359000,  상대원3동,'45,40 - 44세,1998,1612,845,767
'4113359000,  상대원3동,'50,45 - 49세,1998,968,522,446
'4113359000,  상대원3동,'55,50 - 54세,1998,753,410,343
'4113359000,  상대원3동,'60,55 - 59세,1998,632,310,322
'4113359000,  상대원3동,'65,60 - 64세,1998,433,192,241
'4113359000,  상대원3동,'70,65 - 69세,1998,301,108,193
'4113359000,  상대원3동,'75,70 - 74세,1998,195,64,131
'4113359000,  상대원3동,'80,75 - 79세,1998,133,41,92
'4113359000,  상대원3동,'85,80 - 84세,1998,63,20,43
'4113359000,  상대원3동,'90,85+ ,1998,27,5,22
'4113362000,  여수동,'00,계,1998,20658,10516,10142
'4113362000,  여수동,'05,0 - 4세,1998,1642,867,775
'4113362000,  여수동,'10,5 - 9세,1998,1925,1010,915
'4113362000,  여수동,'15,10 - 14세,1998,1713,893,820
'4113362000,  여수동,'20,15 - 19세,1998,1794,928,866
'4113362000,  여수동,'25,20 - 24세,1998,1399,710,689
'4113362000,  여수동,'30,25 - 29세,1998,1786,858,928
'4113362000,  여수동,'35,30 - 34세,1998,2247,1103,1144
'4113362000,  여수동,'40,35 - 39세,1998,2545,1299,1246
'4113362000,  여수동,'45,40 - 44세,1998,1908,1039,869
'4113362000,  여수동,'50,45 - 49세,1998,1087,616,471
'4113362000,  여수동,'55,50 - 54세,1998,756,412,344
'4113362000,  여수동,'60,55 - 59세,1998,553,284,269
'4113362000,  여수동,'65,60 - 64세,1998,466,220,246
'4113362000,  여수동,'70,65 - 69세,1998,328,125,203
'4113362000,  여수동,'75,70 - 74세,1998,241,74,167
'4113362000,  여수동,'80,75 - 79세,1998,150,42,108
'4113362000,  여수동,'85,80 - 84세,1998,73,25,48
'4113362000,  여수동,'90,85+ ,1998,45,11,34
'41135, 분당구,'00,계,1998,386599,191839,194760
'41135, 분당구,'05,0 - 4세,1998,26726,14092,12634
'41135, 분당구,'10,5 - 9세,1998,32964,17543,15421
'41135, 분당구,'15,10 - 14세,1998,33163,17230,15933
'41135, 분당구,'20,15 - 19세,1998,31737,16319,15418
'41135, 분당구,'25,20 - 24세,1998,24718,12596,12122
'41135, 분당구,'30,25 - 29세,1998,33528,15607,17921
'41135, 분당구,'35,30 - 34세,1998,34356,16055,18301
'41135, 분당구,'40,35 - 39세,1998,42539,19747,22792
'41135, 분당구,'45,40 - 44세,1998,39132,20282,18850
'41135, 분당구,'50,45 - 49세,1998,23314,12440,10874
'41135, 분당구,'55,50 - 54세,1998,18521,9274,9247
'41135, 분당구,'60,55 - 59세,1998,15181,8053,7128
'41135, 분당구,'65,60 - 64세,1998,10698,5218,5480
'41135, 분당구,'70,65 - 69세,1998,7668,3188,4480
'41135, 분당구,'75,70 - 74세,1998,5268,1965,3303
'41135, 분당구,'80,75 - 79세,1998,3734,1290,2444
'41135, 분당구,'85,80 - 84세,1998,2070,614,1456
'41135, 분당구,'90,85+ ,1998,1282,326,956
'4113551000,  분당동,'00,계,1998,28004,13810,14194
'4113551000,  분당동,'05,0 - 4세,1998,2182,1128,1054
'4113551000,  분당동,'10,5 - 9세,1998,2604,1362,1242
'4113551000,  분당동,'15,10 - 14세,1998,2456,1262,1194
'4113551000,  분당동,'20,15 - 19세,1998,2194,1074,1120
'4113551000,  분당동,'25,20 - 24세,1998,1520,811,709
'4113551000,  분당동,'30,25 - 29세,1998,2449,1122,1327
'4113551000,  분당동,'35,30 - 34세,1998,2625,1216,1409
'4113551000,  분당동,'40,35 - 39세,1998,3197,1492,1705
'4113551000,  분당동,'45,40 - 44세,1998,2919,1509,1410
'4113551000,  분당동,'50,45 - 49세,1998,1635,878,757
'4113551000,  분당동,'55,50 - 54세,1998,1189,599,590
'4113551000,  분당동,'60,55 - 59세,1998,979,532,447
'4113551000,  분당동,'65,60 - 64세,1998,698,330,368
'4113551000,  분당동,'70,65 - 69세,1998,521,201,320
'4113551000,  분당동,'75,70 - 74세,1998,350,131,219
'4113551000,  분당동,'80,75 - 79세,1998,255,89,166
'4113551000,  분당동,'85,80 - 84세,1998,136,49,87
'4113551000,  분당동,'90,85+ ,1998,95,25,70
'4113565000,  판교동,'00,계,1998,4598,2446,2152
'4113565000,  판교동,'05,0 - 4세,1998,268,130,138
'4113565000,  판교동,'10,5 - 9세,1998,254,132,122
'4113565000,  판교동,'15,10 - 14세,1998,258,128,130
'4113565000,  판교동,'20,15 - 19세,1998,403,216,187
'4113565000,  판교동,'25,20 - 24세,1998,394,235,159
'4113565000,  판교동,'30,25 - 29세,1998,429,252,177
'4113565000,  판교동,'35,30 - 34세,1998,385,237,148
'4113565000,  판교동,'40,35 - 39세,1998,414,227,187
'4113565000,  판교동,'45,40 - 44세,1998,388,204,184
'4113565000,  판교동,'50,45 - 49세,1998,296,151,145
'4113565000,  판교동,'55,50 - 54세,1998,292,148,144
'4113565000,  판교동,'60,55 - 59세,1998,239,128,111
'4113565000,  판교동,'65,60 - 64세,1998,219,115,104
'4113565000,  판교동,'70,65 - 69세,1998,144,61,83
'4113565000,  판교동,'75,70 - 74세,1998,100,42,58
'4113565000,  판교동,'80,75 - 79세,1998,66,26,40
'4113565000,  판교동,'85,80 - 84세,1998,32,10,22
'4113565000,  판교동,'90,85+ ,1998,17,4,13
'4113566000,  금곡동,'00,계,1998,42003,20811,21192
'4113566000,  금곡동,'05,0 - 4세,1998,3495,1775,1720
'4113566000,  금곡동,'10,5 - 9세,1998,3978,2173,1805
'4113566000,  금곡동,'15,10 - 14세,1998,3313,1692,1621
'4113566000,  금곡동,'20,15 - 19세,1998,3033,1540,1493
'4113566000,  금곡동,'25,20 - 24세,1998,2561,1310,1251
'4113566000,  금곡동,'30,25 - 29세,1998,3776,1672,2104
'4113566000,  금곡동,'35,30 - 34세,1998,4554,2138,2416
'4113566000,  금곡동,'40,35 - 39세,1998,4972,2457,2515
'4113566000,  금곡동,'45,40 - 44세,1998,3853,2094,1759
'4113566000,  금곡동,'50,45 - 49세,1998,2107,1103,1004
'4113566000,  금곡동,'55,50 - 54세,1998,1810,878,932
'4113566000,  금곡동,'60,55 - 59세,1998,1456,767,689
'4113566000,  금곡동,'65,60 - 64세,1998,1042,481,561
'4113566000,  금곡동,'70,65 - 69세,1998,822,333,489
'4113566000,  금곡동,'75,70 - 74세,1998,575,202,373
'4113566000,  금곡동,'80,75 - 79세,1998,347,122,225
'4113566000,  금곡동,'85,80 - 84세,1998,197,51,146
'4113566000,  금곡동,'90,85+ ,1998,112,23,89
'4113566100,  금곡1동,'00,계,1998,,,
'4113566100,  금곡1동,'05,0 - 4세,1998,,,
'4113566100,  금곡1동,'10,5 - 9세,1998,,,
'4113566100,  금곡1동,'15,10 - 14세,1998,,,
'4113566100,  금곡1동,'20,15 - 19세,1998,,,
'4113566100,  금곡1동,'25,20 - 24세,1998,,,
'4113566100,  금곡1동,'30,25 - 29세,1998,,,
'4113566100,  금곡1동,'35,30 - 34세,1998,,,
'4113566100,  금곡1동,'40,35 - 39세,1998,,,
'4113566100,  금곡1동,'45,40 - 44세,1998,,,
'4113566100,  금곡1동,'50,45 - 49세,1998,,,
'4113566100,  금곡1동,'55,50 - 54세,1998,,,
'4113566100,  금곡1동,'60,55 - 59세,1998,,,
'4113566100,  금곡1동,'65,60 - 64세,1998,,,
'4113566100,  금곡1동,'70,65 - 69세,1998,,,
'4113566100,  금곡1동,'75,70 - 74세,1998,,,
'4113566100,  금곡1동,'80,75 - 79세,1998,,,
'4113566100,  금곡1동,'85,80 - 84세,1998,,,
'4113566100,  금곡1동,'90,85+ ,1998,,,
'4113567000,  구미동,'00,계,1998,35254,17603,17651
'4113567000,  구미동,'05,0 - 4세,1998,3050,1633,1417
'4113567000,  구미동,'10,5 - 9세,1998,3556,1871,1685
'4113567000,  구미동,'15,10 - 14세,1998,2719,1413,1306
'4113567000,  구미동,'20,15 - 19세,1998,2052,1064,988
'4113567000,  구미동,'25,20 - 24세,1998,2088,1103,985
'4113567000,  구미동,'30,25 - 29세,1998,2938,1287,1651
'4113567000,  구미동,'35,30 - 34세,1998,3910,1779,2131
'4113567000,  구미동,'40,35 - 39세,1998,4443,2270,2173
'4113567000,  구미동,'45,40 - 44세,1998,3131,1708,1423
'4113567000,  구미동,'50,45 - 49세,1998,1728,892,836
'4113567000,  구미동,'55,50 - 54세,1998,1623,796,827
'4113567000,  구미동,'60,55 - 59세,1998,1364,682,682
'4113567000,  구미동,'65,60 - 64세,1998,1022,497,525
'4113567000,  구미동,'70,65 - 69세,1998,688,306,382
'4113567000,  구미동,'75,70 - 74세,1998,423,148,275
'4113567000,  구미동,'80,75 - 79세,1998,280,88,192
'4113567000,  구미동,'85,80 - 84세,1998,148,39,109
'4113567000,  구미동,'90,85+ ,1998,91,27,64
'4113568000,  운중동,'00,계,1998,2133,1152,981
'4113568000,  운중동,'05,0 - 4세,1998,110,56,54
'4113568000,  운중동,'10,5 - 9세,1998,120,72,48
'4113568000,  운중동,'15,10 - 14세,1998,138,67,71
'4113568000,  운중동,'20,15 - 19세,1998,198,115,83
'4113568000,  운중동,'25,20 - 24세,1998,153,88,65
'4113568000,  운중동,'30,25 - 29세,1998,181,111,70
'4113568000,  운중동,'35,30 - 34세,1998,174,100,74
'4113568000,  운중동,'40,35 - 39세,1998,183,108,75
'4113568000,  운중동,'45,40 - 44세,1998,194,106,88
'4113568000,  운중동,'50,45 - 49세,1998,115,57,58
'4113568000,  운중동,'55,50 - 54세,1998,126,64,62
'4113568000,  운중동,'60,55 - 59세,1998,113,64,49
'4113568000,  운중동,'65,60 - 64세,1998,106,57,49
'4113568000,  운중동,'70,65 - 69세,1998,84,35,49
'4113568000,  운중동,'75,70 - 74세,1998,62,20,42
'4113568000,  운중동,'80,75 - 79세,1998,36,16,20
'4113568000,  운중동,'85,80 - 84세,1998,21,8,13
'4113568000,  운중동,'90,85+ ,1998,19,8,11
'4113590000,  서현동,'00,계,1998,30075,14779,15296
'4113590000,  서현동,'05,0 - 4세,1998,1475,781,694
'4113590000,  서현동,'10,5 - 9세,1998,2295,1214,1081
'4113590000,  서현동,'15,10 - 14세,1998,2770,1424,1346
'4113590000,  서현동,'20,15 - 19세,1998,2741,1416,1325
'4113590000,  서현동,'25,20 - 24세,1998,2012,999,1013
'4113590000,  서현동,'30,25 - 29세,1998,2515,1278,1237
'4113590000,  서현동,'35,30 - 34세,1998,1964,888,1076
'4113590000,  서현동,'40,35 - 39세,1998,2927,1203,1724
'4113590000,  서현동,'45,40 - 44세,1998,3257,1613,1644
'4113590000,  서현동,'50,45 - 49세,1998,2023,1062,961
'4113590000,  서현동,'55,50 - 54세,1998,1683,838,845
'4113590000,  서현동,'60,55 - 59세,1998,1435,775,660
'4113590000,  서현동,'65,60 - 64세,1998,1074,537,537
'4113590000,  서현동,'70,65 - 69세,1998,721,315,406
'4113590000,  서현동,'75,70 - 74세,1998,517,211,306
'4113590000,  서현동,'80,75 - 79세,1998,319,111,208
'4113590000,  서현동,'85,80 - 84세,1998,208,72,136
'4113590000,  서현동,'90,85+ ,1998,139,42,97
'4113590100,  내정동,'00,계,1998,11969,5920,6049
'4113590100,  내정동,'05,0 - 4세,1998,562,309,253
'4113590100,  내정동,'10,5 - 9세,1998,892,481,411
'4113590100,  내정동,'15,10 - 14세,1998,1249,651,598
'4113590100,  내정동,'20,15 - 19세,1998,1210,651,559
'4113590100,  내정동,'25,20 - 24세,1998,786,377,409
'4113590100,  내정동,'30,25 - 29세,1998,854,412,442
'4113590100,  내정동,'35,30 - 34세,1998,657,280,377
'4113590100,  내정동,'40,35 - 39세,1998,1136,472,664
'4113590100,  내정동,'45,40 - 44세,1998,1413,681,732
'4113590100,  내정동,'50,45 - 49세,1998,929,506,423
'4113590100,  내정동,'55,50 - 54세,1998,646,332,314
'4113590100,  내정동,'60,55 - 59세,1998,579,319,260
'4113590100,  내정동,'65,60 - 64세,1998,367,184,183
'4113590100,  내정동,'70,65 - 69세,1998,275,127,148
'4113590100,  내정동,'75,70 - 74세,1998,161,69,92
'4113590100,  내정동,'80,75 - 79세,1998,139,40,99
'4113590100,  내정동,'85,80 - 84세,1998,75,22,53
'4113590100,  내정동,'90,85+ ,1998,39,7,32
'4113590200,  정자동,'00,계,1998,23418,11498,11920
'4113590200,  정자동,'05,0 - 4세,1998,2047,1104,943
'4113590200,  정자동,'10,5 - 9세,1998,2138,1099,1039
'4113590200,  정자동,'15,10 - 14세,1998,1797,917,880
'4113590200,  정자동,'20,15 - 19세,1998,1637,830,807
'4113590200,  정자동,'25,20 - 24세,1998,1223,597,626
'4113590200,  정자동,'30,25 - 29세,1998,2282,971,1311
'4113590200,  정자동,'35,30 - 34세,1998,2769,1341,1428
'4113590200,  정자동,'40,35 - 39세,1998,2791,1397,1394
'4113590200,  정자동,'45,40 - 44세,1998,2101,1151,950
'4113590200,  정자동,'50,45 - 49세,1998,1127,602,525
'4113590200,  정자동,'55,50 - 54세,1998,795,396,399
'4113590200,  정자동,'60,55 - 59세,1998,774,372,402
'4113590200,  정자동,'65,60 - 64세,1998,598,272,326
'4113590200,  정자동,'70,65 - 69세,1998,511,188,323
'4113590200,  정자동,'75,70 - 74세,1998,389,127,262
'4113590200,  정자동,'80,75 - 79세,1998,251,82,169
'4113590200,  정자동,'85,80 - 84세,1998,118,32,86
'4113590200,  정자동,'90,85+ ,1998,70,20,50
'4113590300,  초림동,'00,계,1998,15965,7879,8086
'4113590300,  초림동,'05,0 - 4세,1998,849,457,392
'4113590300,  초림동,'10,5 - 9세,1998,1086,578,508
'4113590300,  초림동,'15,10 - 14세,1998,1288,652,636
'4113590300,  초림동,'20,15 - 19세,1998,1368,715,653
'4113590300,  초림동,'25,20 - 24세,1998,1149,579,570
'4113590300,  초림동,'30,25 - 29세,1998,1536,754,782
'4113590300,  초림동,'35,30 - 34세,1998,1127,533,594
'4113590300,  초림동,'40,35 - 39세,1998,1439,647,792
'4113590300,  초림동,'45,40 - 44세,1998,1558,747,811
'4113590300,  초림동,'50,45 - 49세,1998,1083,566,517
'4113590300,  초림동,'55,50 - 54세,1998,992,485,507
'4113590300,  초림동,'60,55 - 59세,1998,855,431,424
'4113590300,  초림동,'65,60 - 64세,1998,606,307,299
'4113590300,  초림동,'70,65 - 69세,1998,404,181,223
'4113590300,  초림동,'75,70 - 74세,1998,262,119,143
'4113590300,  초림동,'80,75 - 79세,1998,187,75,112
'4113590300,  초림동,'85,80 - 84세,1998,112,39,73
'4113590300,  초림동,'90,85+ ,1998,64,14,50
'4113590400,  서당동,'00,계,1998,20810,10374,10436
'4113590400,  서당동,'05,0 - 4세,1998,1281,686,595
'4113590400,  서당동,'10,5 - 9세,1998,1786,946,840
'4113590400,  서당동,'15,10 - 14세,1998,2040,1081,959
'4113590400,  서당동,'20,15 - 19세,1998,1915,981,934
'4113590400,  서당동,'25,20 - 24세,1998,1236,628,608
'4113590400,  서당동,'30,25 - 29세,1998,1510,727,783
'4113590400,  서당동,'35,30 - 34세,1998,1644,729,915
'4113590400,  서당동,'40,35 - 39세,1998,2361,1053,1308
'4113590400,  서당동,'45,40 - 44세,1998,2427,1236,1191
'4113590400,  서당동,'50,45 - 49세,1998,1367,771,596
'4113590400,  서당동,'55,50 - 54세,1998,949,499,450
'4113590400,  서당동,'60,55 - 59세,1998,724,393,331
'4113590400,  서당동,'65,60 - 64세,1998,528,248,280
'4113590400,  서당동,'70,65 - 69세,1998,386,165,221
'4113590400,  서당동,'75,70 - 74세,1998,269,103,166
'4113590400,  서당동,'80,75 - 79세,1998,216,78,138
'4113590400,  서당동,'85,80 - 84세,1998,100,29,71
'4113590400,  서당동,'90,85+ ,1998,71,21,50
'4113590500,  수내동,'00,계,1998,15166,7519,7647
'4113590500,  수내동,'05,0 - 4세,1998,900,476,424
'4113590500,  수내동,'10,5 - 9세,1998,1284,683,601
'4113590500,  수내동,'15,10 - 14세,1998,1601,837,764
'4113590500,  수내동,'20,15 - 19세,1998,1436,730,706
'4113590500,  수내동,'25,20 - 24세,1998,854,453,401
'4113590500,  수내동,'30,25 - 29세,1998,1203,561,642
'4113590500,  수내동,'35,30 - 34세,1998,1117,534,583
'4113590500,  수내동,'40,35 - 39세,1998,1693,714,979
'4113590500,  수내동,'45,40 - 44세,1998,1821,921,900
'4113590500,  수내동,'50,45 - 49세,1998,968,527,441
'4113590500,  수내동,'55,50 - 54세,1998,672,367,305
'4113590500,  수내동,'60,55 - 59세,1998,491,248,243
'4113590500,  수내동,'65,60 - 64세,1998,362,188,174
'4113590500,  수내동,'70,65 - 69세,1998,254,112,142
'4113590500,  수내동,'75,70 - 74세,1998,193,69,124
'4113590500,  수내동,'80,75 - 79세,1998,148,56,92
'4113590500,  수내동,'85,80 - 84세,1998,104,22,82
'4113590500,  수내동,'90,85+ ,1998,65,21,44
'4113590600,  이매동,'00,계,1998,25636,12796,12840
'4113590600,  이매동,'05,0 - 4세,1998,1365,742,623
'4113590600,  이매동,'10,5 - 9세,1998,1985,1064,921
'4113590600,  이매동,'15,10 - 14세,1998,2358,1249,1109
'4113590600,  이매동,'20,15 - 19세,1998,2303,1180,1123
'4113590600,  이매동,'25,20 - 24세,1998,1776,920,856
'4113590600,  이매동,'30,25 - 29세,1998,2146,1027,1119
'4113590600,  이매동,'35,30 - 34세,1998,1894,885,1009
'4113590600,  이매동,'40,35 - 39세,1998,2601,1117,1484
'4113590600,  이매동,'45,40 - 44세,1998,2860,1425,1435
'4113590600,  이매동,'50,45 - 49세,1998,1805,1012,793
'4113590600,  이매동,'55,50 - 54세,1998,1405,704,701
'4113590600,  이매동,'60,55 - 59세,1998,1145,629,516
'4113590600,  이매동,'65,60 - 64세,1998,716,362,354
'4113590600,  이매동,'70,65 - 69세,1998,484,200,284
'4113590600,  이매동,'75,70 - 74세,1998,325,131,194
'4113590600,  이매동,'80,75 - 79세,1998,241,91,150
'4113590600,  이매동,'85,80 - 84세,1998,132,38,94
'4113590600,  이매동,'90,85+ ,1998,95,20,75
'4113590700,  야탑동,'00,계,1998,17921,8914,9007
'4113590700,  야탑동,'05,0 - 4세,1998,1208,618,590
'4113590700,  야탑동,'10,5 - 9세,1998,1443,766,677
'4113590700,  야탑동,'15,10 - 14세,1998,1522,815,707
'4113590700,  야탑동,'20,15 - 19세,1998,1557,839,718
'4113590700,  야탑동,'25,20 - 24세,1998,1241,635,606
'4113590700,  야탑동,'30,25 - 29세,1998,1564,718,846
'4113590700,  야탑동,'35,30 - 34세,1998,1571,722,849
'4113590700,  야탑동,'40,35 - 39세,1998,1902,836,1066
'4113590700,  야탑동,'45,40 - 44세,1998,1888,991,897
'4113590700,  야탑동,'50,45 - 49세,1998,1192,632,560
'4113590700,  야탑동,'55,50 - 54세,1998,883,456,427
'4113590700,  야탑동,'60,55 - 59세,1998,676,363,313
'4113590700,  야탑동,'65,60 - 64세,1998,475,215,260
'4113590700,  야탑동,'70,65 - 69세,1998,311,134,177
'4113590700,  야탑동,'75,70 - 74세,1998,208,78,130
'4113590700,  야탑동,'80,75 - 79세,1998,155,63,92
'4113590700,  야탑동,'85,80 - 84세,1998,81,25,56
'4113590700,  야탑동,'90,85+ ,1998,44,8,36
'4113590800,  중탑동,'00,계,1998,32095,16043,16052
'4113590800,  중탑동,'05,0 - 4세,1998,2858,1524,1334
'4113590800,  중탑동,'10,5 - 9세,1998,3097,1674,1423
'4113590800,  중탑동,'15,10 - 14세,1998,2628,1361,1267
'4113590800,  중탑동,'20,15 - 19세,1998,2556,1390,1166
'4113590800,  중탑동,'25,20 - 24세,1998,2148,1091,1057
'4113590800,  중탑동,'30,25 - 29세,1998,2896,1273,1623
'4113590800,  중탑동,'35,30 - 34세,1998,3540,1683,1857
'4113590800,  중탑동,'40,35 - 39세,1998,4017,2003,2014
'4113590800,  중탑동,'45,40 - 44세,1998,2866,1580,1286
'4113590800,  중탑동,'50,45 - 49세,1998,1519,798,721
'4113590800,  중탑동,'55,50 - 54세,1998,1097,544,553
'4113590800,  중탑동,'60,55 - 59세,1998,859,430,429
'4113590800,  중탑동,'65,60 - 64세,1998,602,244,358
'4113590800,  중탑동,'70,65 - 69세,1998,488,165,323
'4113590800,  중탑동,'75,70 - 74세,1998,366,109,257
'4113590800,  중탑동,'80,75 - 79세,1998,308,95,213
'4113590800,  중탑동,'85,80 - 84세,1998,172,60,112
'4113590800,  중탑동,'90,85+ ,1998,78,19,59
'4113590900,  하탑동,'00,계,1998,20454,10065,10389
'4113590900,  하탑동,'05,0 - 4세,1998,1056,584,472
'4113590900,  하탑동,'10,5 - 9세,1998,1432,757,675
'4113590900,  하탑동,'15,10 - 14세,1998,1739,912,827
'4113590900,  하탑동,'20,15 - 19세,1998,1889,938,951
'4113590900,  하탑동,'25,20 - 24세,1998,1668,801,867
'4113590900,  하탑동,'30,25 - 29세,1998,1745,847,898
'4113590900,  하탑동,'35,30 - 34세,1998,1321,611,710
'4113590900,  하탑동,'40,35 - 39세,1998,2011,880,1131
'4113590900,  하탑동,'45,40 - 44세,1998,2098,1049,1049
'4113590900,  하탑동,'50,45 - 49세,1998,1511,764,747
'4113590900,  하탑동,'55,50 - 54세,1998,1243,622,621
'4113590900,  하탑동,'60,55 - 59세,1998,968,556,412
'4113590900,  하탑동,'65,60 - 64세,1998,605,293,312
'4113590900,  하탑동,'70,65 - 69세,1998,442,190,252
'4113590900,  하탑동,'75,70 - 74세,1998,313,128,185
'4113590900,  하탑동,'80,75 - 79세,1998,212,74,138
'4113590900,  하탑동,'85,80 - 84세,1998,116,32,84
'4113590900,  하탑동,'90,85+ ,1998,85,27,58
'4113591000,  매송동,'00,계,1998,16278,8015,8263
'4113591000,  매송동,'05,0 - 4세,1998,586,324,262
'4113591000,  매송동,'10,5 - 9세,1998,1104,581,523
'4113591000,  매송동,'15,10 - 14세,1998,1566,807,759
'4113591000,  매송동,'20,15 - 19세,1998,1649,826,823
'4113591000,  매송동,'25,20 - 24세,1998,1268,634,634
'4113591000,  매송동,'30,25 - 29세,1998,1228,665,563
'4113591000,  매송동,'35,30 - 34세,1998,840,377,463
'4113591000,  매송동,'40,35 - 39세,1998,1456,565,891
'4113591000,  매송동,'45,40 - 44세,1998,1862,901,961
'4113591000,  매송동,'50,45 - 49세,1998,1250,660,590
'4113591000,  매송동,'55,50 - 54세,1998,1071,528,543
'4113591000,  매송동,'60,55 - 59세,1998,871,471,400
'4113591000,  매송동,'65,60 - 64세,1998,570,317,253
'4113591000,  매송동,'70,65 - 69세,1998,380,170,210
'4113591000,  매송동,'75,70 - 74세,1998,228,88,140
'4113591000,  매송동,'80,75 - 79세,1998,176,57,119
'4113591000,  매송동,'85,80 - 84세,1998,105,31,74
'4113591000,  매송동,'90,85+ ,1998,68,13,55
'4113591100,  신기동,'00,계,1998,26568,13171,13397
'4113591100,  신기동,'05,0 - 4세,1998,1951,1002,949
'4113591100,  신기동,'10,5 - 9세,1998,2121,1116,1005
'4113591100,  신기동,'15,10 - 14세,1998,2166,1135,1031
'4113591100,  신기동,'20,15 - 19세,1998,2309,1177,1132
'4113591100,  신기동,'25,20 - 24세,1998,1701,856,845
'4113591100,  신기동,'30,25 - 29세,1998,2614,1206,1408
'4113591100,  신기동,'35,30 - 34세,1998,2417,1168,1249
'4113591100,  신기동,'40,35 - 39세,1998,2760,1263,1497
'4113591100,  신기동,'45,40 - 44세,1998,2670,1371,1299
'4113591100,  신기동,'50,45 - 49세,1998,1660,898,762
'4113591100,  신기동,'55,50 - 54세,1998,1295,654,641
'4113591100,  신기동,'60,55 - 59세,1998,1006,556,450
'4113591100,  신기동,'65,60 - 64세,1998,684,353,331
'4113591100,  신기동,'70,65 - 69세,1998,448,183,265
'4113591100,  신기동,'75,70 - 74세,1998,297,105,192
'4113591100,  신기동,'80,75 - 79세,1998,245,72,173
'4113591100,  신기동,'85,80 - 84세,1998,132,36,96
'4113591100,  신기동,'90,85+ ,1998,92,20,72
'4113591200,  불정동,'00,계,1998,18252,9044,9208
'4113591200,  불정동,'05,0 - 4세,1998,1483,763,720
'4113591200,  불정동,'10,5 - 9세,1998,1789,974,815
'4113591200,  불정동,'15,10 - 14세,1998,1555,827,728
'4113591200,  불정동,'20,15 - 19세,1998,1287,637,650
'4113591200,  불정동,'25,20 - 24세,1998,940,479,461
'4113591200,  불정동,'30,25 - 29세,1998,1662,724,938
'4113591200,  불정동,'35,30 - 34세,1998,1847,834,1013
'4113591200,  불정동,'40,35 - 39세,1998,2236,1043,1193
'4113591200,  불정동,'45,40 - 44세,1998,1826,995,831
'4113591200,  불정동,'50,45 - 49세,1998,999,561,438
'4113591200,  불정동,'55,50 - 54세,1998,750,364,386
'4113591200,  불정동,'60,55 - 59세,1998,647,337,310
'4113591200,  불정동,'65,60 - 64세,1998,424,218,206
'4113591200,  불정동,'70,65 - 69세,1998,305,122,183
'4113591200,  불정동,'75,70 - 74세,1998,230,85,145
'4113591200,  불정동,'80,75 - 79세,1998,153,55,98
'4113591200,  불정동,'85,80 - 84세,1998,81,19,62
'4113591200,  불정동,'90,85+ ,1998,38,7,31
'41150, 의정부시,'00,계,1998,327965,163812,164153
'41150, 의정부시,'05,0 - 4세,1998,28354,14802,13552
'41150, 의정부시,'10,5 - 9세,1998,29010,14985,14025
'41150, 의정부시,'15,10 - 14세,1998,21624,11084,10540
'41150, 의정부시,'20,15 - 19세,1998,23385,12122,11263
'41150, 의정부시,'25,20 - 24세,1998,23192,11522,11670
'41150, 의정부시,'30,25 - 29세,1998,32926,15800,17126
'41150, 의정부시,'35,30 - 34세,1998,37161,18013,19148
'41150, 의정부시,'40,35 - 39세,1998,37592,20022,17570
'41150, 의정부시,'45,40 - 44세,1998,26478,14158,12320
'41150, 의정부시,'50,45 - 49세,1998,15663,7867,7796
'41150, 의정부시,'55,50 - 54세,1998,13587,6690,6897
'41150, 의정부시,'60,55 - 59세,1998,12793,5990,6803
'41150, 의정부시,'65,60 - 64세,1998,10146,4552,5594
'41150, 의정부시,'70,65 - 69세,1998,6737,2899,3838
'41150, 의정부시,'75,70 - 74세,1998,4298,1639,2659
'41150, 의정부시,'80,75 - 79세,1998,2758,1037,1721
'41150, 의정부시,'85,80 - 84세,1998,1422,416,1006
'41150, 의정부시,'90,85+ ,1998,839,214,625
'4115051000,  의정부1동,'00,계,1998,21862,10888,10974
'4115051000,  의정부1동,'05,0 - 4세,1998,1305,704,601
'4115051000,  의정부1동,'10,5 - 9세,1998,1519,787,732
'4115051000,  의정부1동,'15,10 - 14세,1998,1410,720,690
'4115051000,  의정부1동,'20,15 - 19세,1998,1808,897,911
'4115051000,  의정부1동,'25,20 - 24세,1998,1875,919,956
'4115051000,  의정부1동,'30,25 - 29세,1998,2314,1230,1084
'4115051000,  의정부1동,'35,30 - 34세,1998,2030,1018,1012
'4115051000,  의정부1동,'40,35 - 39세,1998,2175,1110,1065
'4115051000,  의정부1동,'45,40 - 44세,1998,1837,934,903
'4115051000,  의정부1동,'50,45 - 49세,1998,1193,553,640
'4115051000,  의정부1동,'55,50 - 54세,1998,1121,539,582
'4115051000,  의정부1동,'60,55 - 59세,1998,1097,496,601
'4115051000,  의정부1동,'65,60 - 64세,1998,897,417,480
'4115051000,  의정부1동,'70,65 - 69세,1998,538,263,275
'4115051000,  의정부1동,'75,70 - 74세,1998,357,149,208
'4115051000,  의정부1동,'80,75 - 79세,1998,224,101,123
'4115051000,  의정부1동,'85,80 - 84세,1998,109,39,70
'4115051000,  의정부1동,'90,85+ ,1998,53,12,41
'4115052000,  의정부2동,'00,계,1998,29310,14683,14627
'4115052000,  의정부2동,'05,0 - 4세,1998,2834,1472,1362
'4115052000,  의정부2동,'10,5 - 9세,1998,2373,1264,1109
'4115052000,  의정부2동,'15,10 - 14세,1998,1670,895,775
'4115052000,  의정부2동,'20,15 - 19세,1998,1837,981,856
'4115052000,  의정부2동,'25,20 - 24세,1998,2289,1072,1217
'4115052000,  의정부2동,'30,25 - 29세,1998,3801,1758,2043
'4115052000,  의정부2동,'35,30 - 34세,1998,3711,1926,1785
'4115052000,  의정부2동,'40,35 - 39세,1998,3123,1736,1387
'4115052000,  의정부2동,'45,40 - 44세,1998,2008,1054,954
'4115052000,  의정부2동,'50,45 - 49세,1998,1237,580,657
'4115052000,  의정부2동,'55,50 - 54세,1998,1237,588,649
'4115052000,  의정부2동,'60,55 - 59세,1998,1119,515,604
'4115052000,  의정부2동,'65,60 - 64세,1998,840,355,485
'4115052000,  의정부2동,'70,65 - 69세,1998,543,233,310
'4115052000,  의정부2동,'75,70 - 74세,1998,326,134,192
'4115052000,  의정부2동,'80,75 - 79세,1998,212,75,137
'4115052000,  의정부2동,'85,80 - 84세,1998,104,31,73
'4115052000,  의정부2동,'90,85+ ,1998,46,14,32
'4115053000,  의정부3동,'00,계,1998,15392,7665,7727
'4115053000,  의정부3동,'05,0 - 4세,1998,1039,539,500
'4115053000,  의정부3동,'10,5 - 9세,1998,1248,628,620
'4115053000,  의정부3동,'15,10 - 14세,1998,998,478,520
'4115053000,  의정부3동,'20,15 - 19세,1998,1148,605,543
'4115053000,  의정부3동,'25,20 - 24세,1998,1131,575,556
'4115053000,  의정부3동,'30,25 - 29세,1998,1584,800,784
'4115053000,  의정부3동,'35,30 - 34세,1998,1503,738,765
'4115053000,  의정부3동,'40,35 - 39세,1998,1654,886,768
'4115053000,  의정부3동,'45,40 - 44세,1998,1268,670,598
'4115053000,  의정부3동,'50,45 - 49세,1998,873,436,437
'4115053000,  의정부3동,'55,50 - 54세,1998,712,327,385
'4115053000,  의정부3동,'60,55 - 59세,1998,671,308,363
'4115053000,  의정부3동,'65,60 - 64세,1998,642,290,352
'4115053000,  의정부3동,'70,65 - 69세,1998,411,180,231
'4115053000,  의정부3동,'75,70 - 74세,1998,248,92,156
'4115053000,  의정부3동,'80,75 - 79세,1998,135,66,69
'4115053000,  의정부3동,'85,80 - 84세,1998,78,30,48
'4115053000,  의정부3동,'90,85+ ,1998,49,17,32
'4115055000,  호원동,'00,계,1998,57793,29105,28688
'4115055000,  호원동,'05,0 - 4세,1998,5261,2761,2500
'4115055000,  호원동,'10,5 - 9세,1998,4885,2499,2386
'4115055000,  호원동,'15,10 - 14세,1998,2928,1499,1429
'4115055000,  호원동,'20,15 - 19세,1998,3797,2028,1769
'4115055000,  호원동,'25,20 - 24세,1998,4504,2346,2158
'4115055000,  호원동,'30,25 - 29세,1998,5992,2859,3133
'4115055000,  호원동,'35,30 - 34세,1998,6664,3164,3500
'4115055000,  호원동,'40,35 - 39세,1998,6254,3517,2737
'4115055000,  호원동,'45,40 - 44세,1998,4266,2255,2011
'4115055000,  호원동,'50,45 - 49세,1998,3015,1466,1549
'4115055000,  호원동,'55,50 - 54세,1998,2909,1404,1505
'4115055000,  호원동,'60,55 - 59세,1998,2742,1375,1367
'4115055000,  호원동,'65,60 - 64세,1998,1860,876,984
'4115055000,  호원동,'70,65 - 69세,1998,1126,534,592
'4115055000,  호원동,'75,70 - 74세,1998,719,265,454
'4115055000,  호원동,'80,75 - 79세,1998,464,158,306
'4115055000,  호원동,'85,80 - 84세,1998,261,68,193
'4115055000,  호원동,'90,85+ ,1998,146,31,115
'4115056100,  장암동,'00,계,1998,18661,9214,9447
'4115056100,  장암동,'05,0 - 4세,1998,1461,757,704
'4115056100,  장암동,'10,5 - 9세,1998,1679,901,778
'4115056100,  장암동,'15,10 - 14세,1998,1324,686,638
'4115056100,  장암동,'20,15 - 19세,1998,1513,788,725
'4115056100,  장암동,'25,20 - 24세,1998,1352,710,642
'4115056100,  장암동,'30,25 - 29세,1998,1522,731,791
'4115056100,  장암동,'35,30 - 34세,1998,1837,840,997
'4115056100,  장암동,'40,35 - 39세,1998,2254,1149,1105
'4115056100,  장암동,'45,40 - 44세,1998,1620,875,745
'4115056100,  장암동,'50,45 - 49세,1998,914,449,465
'4115056100,  장암동,'55,50 - 54세,1998,781,384,397
'4115056100,  장암동,'60,55 - 59세,1998,717,331,386
'4115056100,  장암동,'65,60 - 64세,1998,576,237,339
'4115056100,  장암동,'70,65 - 69세,1998,443,164,279
'4115056100,  장암동,'75,70 - 74세,1998,280,90,190
'4115056100,  장암동,'80,75 - 79세,1998,213,74,139
'4115056100,  장암동,'85,80 - 84세,1998,102,27,75
'4115056100,  장암동,'90,85+ ,1998,73,21,52
'4115056700,  신곡1동,'00,계,1998,36779,18364,18415
'4115056700,  신곡1동,'05,0 - 4세,1998,3696,1907,1789
'4115056700,  신곡1동,'10,5 - 9세,1998,3624,1873,1751
'4115056700,  신곡1동,'15,10 - 14세,1998,2382,1240,1142
'4115056700,  신곡1동,'20,15 - 19세,1998,2460,1260,1200
'4115056700,  신곡1동,'25,20 - 24세,1998,2316,1139,1177
'4115056700,  신곡1동,'30,25 - 29세,1998,3455,1553,1902
'4115056700,  신곡1동,'35,30 - 34세,1998,4782,2258,2524
'4115056700,  신곡1동,'40,35 - 39세,1998,4464,2465,1999
'4115056700,  신곡1동,'45,40 - 44세,1998,2821,1530,1291
'4115056700,  신곡1동,'50,45 - 49세,1998,1680,872,808
'4115056700,  신곡1동,'55,50 - 54세,1998,1336,690,646
'4115056700,  신곡1동,'60,55 - 59세,1998,1235,576,659
'4115056700,  신곡1동,'65,60 - 64세,1998,975,433,542
'4115056700,  신곡1동,'70,65 - 69세,1998,698,285,413
'4115056700,  신곡1동,'75,70 - 74세,1998,400,150,250
'4115056700,  신곡1동,'80,75 - 79세,1998,257,87,170
'4115056700,  신곡1동,'85,80 - 84세,1998,122,30,92
'4115056700,  신곡1동,'90,85+ ,1998,76,16,60
'4115056800,  신곡2동,'00,계,1998,25163,12494,12669
'4115056800,  신곡2동,'05,0 - 4세,1998,2233,1188,1045
'4115056800,  신곡2동,'10,5 - 9세,1998,3084,1565,1519
'4115056800,  신곡2동,'15,10 - 14세,1998,2313,1203,1110
'4115056800,  신곡2동,'20,15 - 19세,1998,1588,830,758
'4115056800,  신곡2동,'25,20 - 24세,1998,1188,570,618
'4115056800,  신곡2동,'30,25 - 29세,1998,1744,770,974
'4115056800,  신곡2동,'35,30 - 34세,1998,2879,1201,1678
'4115056800,  신곡2동,'40,35 - 39세,1998,3773,1898,1875
'4115056800,  신곡2동,'45,40 - 44세,1998,2372,1372,1000
'4115056800,  신곡2동,'50,45 - 49세,1998,1029,571,458
'4115056800,  신곡2동,'55,50 - 54세,1998,725,406,319
'4115056800,  신곡2동,'60,55 - 59세,1998,666,310,356
'4115056800,  신곡2동,'65,60 - 64세,1998,559,247,312
'4115056800,  신곡2동,'70,65 - 69세,1998,376,159,217
'4115056800,  신곡2동,'75,70 - 74세,1998,277,93,184
'4115056800,  신곡2동,'80,75 - 79세,1998,187,62,125
'4115056800,  신곡2동,'85,80 - 84세,1998,107,29,78
'4115056800,  신곡2동,'90,85+ ,1998,63,20,43
'4115057000,  송산동,'00,계,1998,29016,14510,14506
'4115057000,  송산동,'05,0 - 4세,1998,2859,1503,1356
'4115057000,  송산동,'10,5 - 9세,1998,2907,1497,1410
'4115057000,  송산동,'15,10 - 14세,1998,2039,1041,998
'4115057000,  송산동,'20,15 - 19세,1998,1719,889,830
'4115057000,  송산동,'25,20 - 24세,1998,1511,776,735
'4115057000,  송산동,'30,25 - 29세,1998,2644,1203,1441
'4115057000,  송산동,'35,30 - 34세,1998,3583,1756,1827
'4115057000,  송산동,'40,35 - 39세,1998,3655,1911,1744
'4115057000,  송산동,'45,40 - 44세,1998,2374,1345,1029
'4115057000,  송산동,'50,45 - 49세,1998,1201,642,559
'4115057000,  송산동,'55,50 - 54세,1998,936,482,454
'4115057000,  송산동,'60,55 - 59세,1998,971,431,540
'4115057000,  송산동,'65,60 - 64세,1998,916,387,529
'4115057000,  송산동,'70,65 - 69세,1998,651,257,394
'4115057000,  송산동,'75,70 - 74세,1998,470,187,283
'4115057000,  송산동,'80,75 - 79세,1998,320,121,199
'4115057000,  송산동,'85,80 - 84세,1998,166,54,112
'4115057000,  송산동,'90,85+ ,1998,94,28,66
'4115058000,  자금동,'00,계,1998,23582,11769,11813
'4115058000,  자금동,'05,0 - 4세,1998,2049,1036,1013
'4115058000,  자금동,'10,5 - 9세,1998,1904,999,905
'4115058000,  자금동,'15,10 - 14세,1998,1605,780,825
'4115058000,  자금동,'20,15 - 19세,1998,1718,899,819
'4115058000,  자금동,'25,20 - 24세,1998,1690,835,855
'4115058000,  자금동,'30,25 - 29세,1998,2458,1181,1277
'4115058000,  자금동,'35,30 - 34세,1998,2724,1384,1340
'4115058000,  자금동,'40,35 - 39세,1998,2590,1385,1205
'4115058000,  자금동,'45,40 - 44세,1998,1944,1053,891
'4115058000,  자금동,'50,45 - 49세,1998,1092,566,526
'4115058000,  자금동,'55,50 - 54세,1998,924,443,481
'4115058000,  자금동,'60,55 - 59세,1998,909,404,505
'4115058000,  자금동,'65,60 - 64세,1998,766,337,429
'4115058000,  자금동,'70,65 - 69세,1998,521,220,301
'4115058000,  자금동,'75,70 - 74세,1998,348,136,212
'4115058000,  자금동,'80,75 - 79세,1998,198,68,130
'4115058000,  자금동,'85,80 - 84세,1998,95,31,64
'4115058000,  자금동,'90,85+ ,1998,47,12,35
'4115059000,  가능1동,'00,계,1998,29766,14757,15009
'4115059000,  가능1동,'05,0 - 4세,1998,2419,1242,1177
'4115059000,  가능1동,'10,5 - 9세,1998,2279,1187,1092
'4115059000,  가능1동,'15,10 - 14세,1998,1934,951,983
'4115059000,  가능1동,'20,15 - 19세,1998,2496,1248,1248
'4115059000,  가능1동,'25,20 - 24세,1998,2537,1228,1309
'4115059000,  가능1동,'30,25 - 29세,1998,3392,1679,1713
'4115059000,  가능1동,'35,30 - 34세,1998,3134,1617,1517
'4115059000,  가능1동,'40,35 - 39세,1998,3034,1543,1491
'4115059000,  가능1동,'45,40 - 44세,1998,2476,1246,1230
'4115059000,  가능1동,'50,45 - 49세,1998,1500,731,769
'4115059000,  가능1동,'55,50 - 54세,1998,1297,630,667
'4115059000,  가능1동,'60,55 - 59세,1998,1112,545,567
'4115059000,  가능1동,'65,60 - 64세,1998,876,409,467
'4115059000,  가능1동,'70,65 - 69세,1998,548,236,312
'4115059000,  가능1동,'75,70 - 74세,1998,345,142,203
'4115059000,  가능1동,'80,75 - 79세,1998,196,75,121
'4115059000,  가능1동,'85,80 - 84세,1998,109,34,75
'4115059000,  가능1동,'90,85+ ,1998,82,14,68
'4115060000,  가능2동,'00,계,1998,13086,6510,6576
'4115060000,  가능2동,'05,0 - 4세,1998,968,527,441
'4115060000,  가능2동,'10,5 - 9세,1998,1181,592,589
'4115060000,  가능2동,'15,10 - 14세,1998,1048,520,528
'4115060000,  가능2동,'20,15 - 19세,1998,1091,545,546
'4115060000,  가능2동,'25,20 - 24세,1998,900,430,470
'4115060000,  가능2동,'30,25 - 29세,1998,1369,697,672
'4115060000,  가능2동,'35,30 - 34세,1998,1384,678,706
'4115060000,  가능2동,'40,35 - 39세,1998,1489,768,721
'4115060000,  가능2동,'45,40 - 44세,1998,1102,564,538
'4115060000,  가능2동,'50,45 - 49세,1998,602,322,280
'4115060000,  가능2동,'55,50 - 54세,1998,511,254,257
'4115060000,  가능2동,'60,55 - 59세,1998,489,230,259
'4115060000,  가능2동,'65,60 - 64세,1998,365,173,192
'4115060000,  가능2동,'70,65 - 69세,1998,249,99,150
'4115060000,  가능2동,'75,70 - 74세,1998,152,43,109
'4115060000,  가능2동,'80,75 - 79세,1998,104,49,55
'4115060000,  가능2동,'85,80 - 84세,1998,49,13,36
'4115060000,  가능2동,'90,85+ ,1998,33,6,27
'4115061000,  가능3동,'00,계,1998,13029,6519,6510
'4115061000,  가능3동,'05,0 - 4세,1998,976,494,482
'4115061000,  가능3동,'10,5 - 9세,1998,928,502,426
'4115061000,  가능3동,'15,10 - 14세,1998,806,445,361
'4115061000,  가능3동,'20,15 - 19세,1998,1076,544,532
'4115061000,  가능3동,'25,20 - 24세,1998,1059,511,548
'4115061000,  가능3동,'30,25 - 29세,1998,1429,759,670
'4115061000,  가능3동,'35,30 - 34세,1998,1328,673,655
'4115061000,  가능3동,'40,35 - 39세,1998,1280,668,612
'4115061000,  가능3동,'45,40 - 44세,1998,1064,549,515
'4115061000,  가능3동,'50,45 - 49세,1998,650,315,335
'4115061000,  가능3동,'55,50 - 54세,1998,581,281,300
'4115061000,  가능3동,'60,55 - 59세,1998,596,250,346
'4115061000,  가능3동,'65,60 - 64세,1998,492,227,265
'4115061000,  가능3동,'70,65 - 69세,1998,336,139,197
'4115061000,  가능3동,'75,70 - 74세,1998,202,88,114
'4115061000,  가능3동,'80,75 - 79세,1998,121,47,74
'4115061000,  가능3동,'85,80 - 84세,1998,72,17,55
'4115061000,  가능3동,'90,85+ ,1998,33,10,23
'4115062000,  녹양동,'00,계,1998,14526,7334,7192
'4115062000,  녹양동,'05,0 - 4세,1998,1254,672,582
'4115062000,  녹양동,'10,5 - 9세,1998,1399,691,708
'4115062000,  녹양동,'15,10 - 14세,1998,1167,626,541
'4115062000,  녹양동,'20,15 - 19세,1998,1134,608,526
'4115062000,  녹양동,'25,20 - 24세,1998,840,411,429
'4115062000,  녹양동,'30,25 - 29세,1998,1222,580,642
'4115062000,  녹양동,'35,30 - 34세,1998,1602,760,842
'4115062000,  녹양동,'40,35 - 39세,1998,1847,986,861
'4115062000,  녹양동,'45,40 - 44세,1998,1326,711,615
'4115062000,  녹양동,'50,45 - 49세,1998,677,364,313
'4115062000,  녹양동,'55,50 - 54세,1998,517,262,255
'4115062000,  녹양동,'60,55 - 59세,1998,469,219,250
'4115062000,  녹양동,'65,60 - 64세,1998,382,164,218
'4115062000,  녹양동,'70,65 - 69세,1998,297,130,167
'4115062000,  녹양동,'75,70 - 74세,1998,174,70,104
'4115062000,  녹양동,'80,75 - 79세,1998,127,54,73
'4115062000,  녹양동,'85,80 - 84세,1998,48,13,35
'4115062000,  녹양동,'90,85+ ,1998,44,13,31
'41170, 안양시,'00,계,1998,586562,294048,292514
'41170, 안양시,'05,0 - 4세,1998,44159,23184,20975
'41170, 안양시,'10,5 - 9세,1998,48012,25340,22672
'41170, 안양시,'15,10 - 14세,1998,45764,23860,21904
'41170, 안양시,'20,15 - 19세,1998,50035,25546,24489
'41170, 안양시,'25,20 - 24세,1998,41965,20596,21369
'41170, 안양시,'30,25 - 29세,1998,57081,28175,28906
'41170, 안양시,'35,30 - 34세,1998,58985,29192,29793
'41170, 안양시,'40,35 - 39세,1998,65977,32663,33314
'41170, 안양시,'45,40 - 44세,1998,54888,28411,26477
'41170, 안양시,'50,45 - 49세,1998,32797,17775,15022
'41170, 안양시,'55,50 - 54세,1998,23808,12309,11499
'41170, 안양시,'60,55 - 59세,1998,20426,10069,10357
'41170, 안양시,'65,60 - 64세,1998,15659,6933,8726
'41170, 안양시,'70,65 - 69세,1998,10891,4430,6461
'41170, 안양시,'75,70 - 74세,1998,7350,2726,4624
'41170, 안양시,'80,75 - 79세,1998,4934,1767,3167
'41170, 안양시,'85,80 - 84세,1998,2453,733,1720
'41170, 안양시,'90,85+ ,1998,1378,339,1039
'41171, 만안구,'00,계,1998,252866,127449,125417
'41171, 만안구,'05,0 - 4세,1998,19029,10125,8904
'41171, 만안구,'10,5 - 9세,1998,19423,10180,9243
'41171, 만안구,'15,10 - 14세,1998,17356,9013,8343
'41171, 만안구,'20,15 - 19세,1998,21199,10837,10362
'41171, 만안구,'25,20 - 24세,1998,20864,10175,10689
'41171, 만안구,'30,25 - 29세,1998,27082,13857,13225
'41171, 만안구,'35,30 - 34세,1998,25845,13191,12654
'41171, 만안구,'40,35 - 39세,1998,26435,13637,12798
'41171, 만안구,'45,40 - 44세,1998,21249,10881,10368
'41171, 만안구,'50,45 - 49세,1998,13844,7209,6635
'41171, 만안구,'55,50 - 54세,1998,11088,5597,5491
'41171, 만안구,'60,55 - 59세,1998,10008,4879,5129
'41171, 만안구,'65,60 - 64세,1998,7498,3394,4104
'41171, 만안구,'70,65 - 69세,1998,4958,2051,2907
'41171, 만안구,'75,70 - 74세,1998,3130,1197,1933
'41171, 만안구,'80,75 - 79세,1998,2149,742,1407
'41171, 만안구,'85,80 - 84세,1998,1044,318,726
'41171, 만안구,'90,85+ ,1998,665,166,499
'4117151000,  안양1동,'00,계,1998,11733,5858,5875
'4117151000,  안양1동,'05,0 - 4세,1998,722,395,327
'4117151000,  안양1동,'10,5 - 9세,1998,886,488,398
'4117151000,  안양1동,'15,10 - 14세,1998,844,438,406
'4117151000,  안양1동,'20,15 - 19세,1998,1054,554,500
'4117151000,  안양1동,'25,20 - 24세,1998,938,460,478
'4117151000,  안양1동,'30,25 - 29세,1998,1035,504,531
'4117151000,  안양1동,'35,30 - 34세,1998,995,476,519
'4117151000,  안양1동,'40,35 - 39세,1998,1252,631,621
'4117151000,  안양1동,'45,40 - 44세,1998,1102,553,549
'4117151000,  안양1동,'50,45 - 49세,1998,766,404,362
'4117151000,  안양1동,'55,50 - 54세,1998,573,290,283
'4117151000,  안양1동,'60,55 - 59세,1998,491,246,245
'4117151000,  안양1동,'65,60 - 64세,1998,359,150,209
'4117151000,  안양1동,'70,65 - 69세,1998,278,116,162
'4117151000,  안양1동,'75,70 - 74세,1998,192,73,119
'4117151000,  안양1동,'80,75 - 79세,1998,142,54,88
'4117151000,  안양1동,'85,80 - 84세,1998,72,22,50
'4117151000,  안양1동,'90,85+ ,1998,32,4,28
'4117152000,  안양2동,'00,계,1998,28223,14177,14046
'4117152000,  안양2동,'05,0 - 4세,1998,1986,1065,921
'4117152000,  안양2동,'10,5 - 9세,1998,2273,1188,1085
'4117152000,  안양2동,'15,10 - 14세,1998,1990,1003,987
'4117152000,  안양2동,'20,15 - 19세,1998,2283,1140,1143
'4117152000,  안양2동,'25,20 - 24세,1998,2335,1142,1193
'4117152000,  안양2동,'30,25 - 29세,1998,3072,1612,1460
'4117152000,  안양2동,'35,30 - 34세,1998,2781,1372,1409
'4117152000,  안양2동,'40,35 - 39세,1998,2989,1539,1450
'4117152000,  안양2동,'45,40 - 44세,1998,2418,1256,1162
'4117152000,  안양2동,'50,45 - 49세,1998,1583,833,750
'4117152000,  안양2동,'55,50 - 54세,1998,1246,631,615
'4117152000,  안양2동,'60,55 - 59세,1998,1157,546,611
'4117152000,  안양2동,'65,60 - 64세,1998,855,391,464
'4117152000,  안양2동,'70,65 - 69세,1998,505,211,294
'4117152000,  안양2동,'75,70 - 74세,1998,329,111,218
'4117152000,  안양2동,'80,75 - 79세,1998,229,87,142
'4117152000,  안양2동,'85,80 - 84세,1998,124,33,91
'4117152000,  안양2동,'90,85+ ,1998,68,17,51
'4117153000,  안양3동,'00,계,1998,21091,10508,10583
'4117153000,  안양3동,'05,0 - 4세,1998,1464,787,677
'4117153000,  안양3동,'10,5 - 9세,1998,1647,875,772
'4117153000,  안양3동,'15,10 - 14세,1998,1589,787,802
'4117153000,  안양3동,'20,15 - 19세,1998,1912,977,935
'4117153000,  안양3동,'25,20 - 24세,1998,1752,857,895
'4117153000,  안양3동,'30,25 - 29세,1998,2134,1057,1077
'4117153000,  안양3동,'35,30 - 34세,1998,2036,959,1077
'4117153000,  안양3동,'40,35 - 39세,1998,2330,1165,1165
'4117153000,  안양3동,'45,40 - 44세,1998,1907,993,914
'4117153000,  안양3동,'50,45 - 49세,1998,1235,633,602
'4117153000,  안양3동,'55,50 - 54세,1998,928,494,434
'4117153000,  안양3동,'60,55 - 59세,1998,727,376,351
'4117153000,  안양3동,'65,60 - 64세,1998,565,252,313
'4117153000,  안양3동,'70,65 - 69세,1998,330,129,201
'4117153000,  안양3동,'75,70 - 74세,1998,213,79,134
'4117153000,  안양3동,'80,75 - 79세,1998,181,53,128
'4117153000,  안양3동,'85,80 - 84세,1998,93,26,67
'4117153000,  안양3동,'90,85+ ,1998,48,9,39
'4117154000,  안양4동,'00,계,1998,8867,4435,4432
'4117154000,  안양4동,'05,0 - 4세,1998,565,288,277
'4117154000,  안양4동,'10,5 - 9세,1998,566,276,290
'4117154000,  안양4동,'15,10 - 14세,1998,555,287,268
'4117154000,  안양4동,'20,15 - 19세,1998,806,430,376
'4117154000,  안양4동,'25,20 - 24세,1998,816,413,403
'4117154000,  안양4동,'30,25 - 29세,1998,944,506,438
'4117154000,  안양4동,'35,30 - 34세,1998,786,428,358
'4117154000,  안양4동,'40,35 - 39세,1998,814,405,409
'4117154000,  안양4동,'45,40 - 44세,1998,753,364,389
'4117154000,  안양4동,'50,45 - 49세,1998,533,265,268
'4117154000,  안양4동,'55,50 - 54세,1998,465,223,242
'4117154000,  안양4동,'60,55 - 59세,1998,462,223,239
'4117154000,  안양4동,'65,60 - 64세,1998,311,141,170
'4117154000,  안양4동,'70,65 - 69세,1998,198,75,123
'4117154000,  안양4동,'75,70 - 74세,1998,139,57,82
'4117154000,  안양4동,'80,75 - 79세,1998,72,29,43
'4117154000,  안양4동,'85,80 - 84세,1998,43,14,29
'4117154000,  안양4동,'90,85+ ,1998,39,11,28
'4117155000,  안양5동,'00,계,1998,16406,8205,8201
'4117155000,  안양5동,'05,0 - 4세,1998,1163,611,552
'4117155000,  안양5동,'10,5 - 9세,1998,1128,577,551
'4117155000,  안양5동,'15,10 - 14세,1998,1025,545,480
'4117155000,  안양5동,'20,15 - 19세,1998,1375,705,670
'4117155000,  안양5동,'25,20 - 24세,1998,1519,715,804
'4117155000,  안양5동,'30,25 - 29세,1998,1910,1003,907
'4117155000,  안양5동,'35,30 - 34세,1998,1616,833,783
'4117155000,  안양5동,'40,35 - 39세,1998,1568,817,751
'4117155000,  안양5동,'45,40 - 44세,1998,1323,665,658
'4117155000,  안양5동,'50,45 - 49세,1998,879,436,443
'4117155000,  안양5동,'55,50 - 54세,1998,852,421,431
'4117155000,  안양5동,'60,55 - 59세,1998,731,356,375
'4117155000,  안양5동,'65,60 - 64세,1998,515,238,277
'4117155000,  안양5동,'70,65 - 69세,1998,320,130,190
'4117155000,  안양5동,'75,70 - 74세,1998,204,69,135
'4117155000,  안양5동,'80,75 - 79세,1998,149,51,98
'4117155000,  안양5동,'85,80 - 84세,1998,72,16,56
'4117155000,  안양5동,'90,85+ ,1998,57,17,40
'4117156000,  안양6동,'00,계,1998,18778,9498,9280
'4117156000,  안양6동,'05,0 - 4세,1998,1415,730,685
'4117156000,  안양6동,'10,5 - 9세,1998,1144,607,537
'4117156000,  안양6동,'15,10 - 14세,1998,1050,565,485
'4117156000,  안양6동,'20,15 - 19세,1998,1560,812,748
'4117156000,  안양6동,'25,20 - 24세,1998,1775,853,922
'4117156000,  안양6동,'30,25 - 29세,1998,2408,1210,1198
'4117156000,  안양6동,'35,30 - 34세,1998,1944,1071,873
'4117156000,  안양6동,'40,35 - 39세,1998,1697,903,794
'4117156000,  안양6동,'45,40 - 44세,1998,1413,725,688
'4117156000,  안양6동,'50,45 - 49세,1998,1077,510,567
'4117156000,  안양6동,'55,50 - 54세,1998,912,461,451
'4117156000,  안양6동,'60,55 - 59세,1998,849,412,437
'4117156000,  안양6동,'65,60 - 64세,1998,629,284,345
'4117156000,  안양6동,'70,65 - 69세,1998,374,168,206
'4117156000,  안양6동,'75,70 - 74세,1998,234,99,135
'4117156000,  안양6동,'80,75 - 79세,1998,160,52,108
'4117156000,  안양6동,'85,80 - 84세,1998,84,24,60
'4117156000,  안양6동,'90,85+ ,1998,53,12,41
'4117157000,  안양7동,'00,계,1998,21038,10740,10298
'4117157000,  안양7동,'05,0 - 4세,1998,1455,775,680
'4117157000,  안양7동,'10,5 - 9세,1998,1516,788,728
'4117157000,  안양7동,'15,10 - 14세,1998,1427,751,676
'4117157000,  안양7동,'20,15 - 19세,1998,1990,1000,990
'4117157000,  안양7동,'25,20 - 24세,1998,2022,1033,989
'4117157000,  안양7동,'30,25 - 29세,1998,2207,1208,999
'4117157000,  안양7동,'35,30 - 34세,1998,1992,1030,962
'4117157000,  안양7동,'40,35 - 39세,1998,2137,1097,1040
'4117157000,  안양7동,'45,40 - 44세,1998,1714,853,861
'4117157000,  안양7동,'50,45 - 49세,1998,1279,679,600
'4117157000,  안양7동,'55,50 - 54세,1998,924,471,453
'4117157000,  안양7동,'60,55 - 59세,1998,860,424,436
'4117157000,  안양7동,'65,60 - 64세,1998,603,294,309
'4117157000,  안양7동,'70,65 - 69세,1998,378,156,222
'4117157000,  안양7동,'75,70 - 74세,1998,236,87,149
'4117157000,  안양7동,'80,75 - 79세,1998,171,60,111
'4117157000,  안양7동,'85,80 - 84세,1998,69,22,47
'4117157000,  안양7동,'90,85+ ,1998,58,12,46
'4117158000,  안양8동,'00,계,1998,15491,7724,7767
'4117158000,  안양8동,'05,0 - 4세,1998,1339,723,616
'4117158000,  안양8동,'10,5 - 9세,1998,1078,552,526
'4117158000,  안양8동,'15,10 - 14세,1998,1034,532,502
'4117158000,  안양8동,'20,15 - 19세,1998,1282,644,638
'4117158000,  안양8동,'25,20 - 24세,1998,1337,596,741
'4117158000,  안양8동,'30,25 - 29세,1998,1920,933,987
'4117158000,  안양8동,'35,30 - 34세,1998,1675,908,767
'4117158000,  안양8동,'40,35 - 39세,1998,1561,803,758
'4117158000,  안양8동,'45,40 - 44세,1998,1201,589,612
'4117158000,  안양8동,'50,45 - 49세,1998,792,404,388
'4117158000,  안양8동,'55,50 - 54세,1998,630,331,299
'4117158000,  안양8동,'60,55 - 59세,1998,539,260,279
'4117158000,  안양8동,'65,60 - 64세,1998,426,196,230
'4117158000,  안양8동,'70,65 - 69세,1998,281,112,169
'4117158000,  안양8동,'75,70 - 74세,1998,184,68,116
'4117158000,  안양8동,'80,75 - 79세,1998,105,40,65
'4117158000,  안양8동,'85,80 - 84세,1998,60,22,38
'4117158000,  안양8동,'90,85+ ,1998,47,11,36
'4117158100,  안양9동,'00,계,1998,16584,8403,8181
'4117158100,  안양9동,'05,0 - 4세,1998,1189,631,558
'4117158100,  안양9동,'10,5 - 9세,1998,1307,688,619
'4117158100,  안양9동,'15,10 - 14세,1998,1211,637,574
'4117158100,  안양9동,'20,15 - 19세,1998,1438,748,690
'4117158100,  안양9동,'25,20 - 24세,1998,1289,646,643
'4117158100,  안양9동,'30,25 - 29세,1998,1599,843,756
'4117158100,  안양9동,'35,30 - 34세,1998,1656,834,822
'4117158100,  안양9동,'40,35 - 39세,1998,1776,892,884
'4117158100,  안양9동,'45,40 - 44세,1998,1439,748,691
'4117158100,  안양9동,'50,45 - 49세,1998,915,480,435
'4117158100,  안양9동,'55,50 - 54세,1998,753,373,380
'4117158100,  안양9동,'60,55 - 59세,1998,661,331,330
'4117158100,  안양9동,'65,60 - 64세,1998,513,247,266
'4117158100,  안양9동,'70,65 - 69세,1998,369,145,224
'4117158100,  안양9동,'75,70 - 74세,1998,216,87,129
'4117158100,  안양9동,'80,75 - 79세,1998,130,36,94
'4117158100,  안양9동,'85,80 - 84세,1998,76,25,51
'4117158100,  안양9동,'90,85+ ,1998,47,12,35
'4117159000,  석수1동,'00,계,1998,11192,5602,5590
'4117159000,  석수1동,'05,0 - 4세,1998,868,457,411
'4117159000,  석수1동,'10,5 - 9세,1998,815,406,409
'4117159000,  석수1동,'15,10 - 14세,1998,684,347,337
'4117159000,  석수1동,'20,15 - 19세,1998,766,386,380
'4117159000,  석수1동,'25,20 - 24세,1998,886,460,426
'4117159000,  석수1동,'30,25 - 29세,1998,1268,637,631
'4117159000,  석수1동,'35,30 - 34세,1998,1193,609,584
'4117159000,  석수1동,'40,35 - 39세,1998,1144,628,516
'4117159000,  석수1동,'45,40 - 44세,1998,831,424,407
'4117159000,  석수1동,'50,45 - 49세,1998,569,276,293
'4117159000,  석수1동,'55,50 - 54세,1998,516,254,262
'4117159000,  석수1동,'60,55 - 59세,1998,545,252,293
'4117159000,  석수1동,'65,60 - 64세,1998,436,209,227
'4117159000,  석수1동,'70,65 - 69세,1998,285,116,169
'4117159000,  석수1동,'75,70 - 74세,1998,175,77,98
'4117159000,  석수1동,'80,75 - 79세,1998,107,41,66
'4117159000,  석수1동,'85,80 - 84세,1998,62,14,48
'4117159000,  석수1동,'90,85+ ,1998,42,9,33
'4117160000,  석수2동,'00,계,1998,26855,13630,13225
'4117160000,  석수2동,'05,0 - 4세,1998,2270,1188,1082
'4117160000,  석수2동,'10,5 - 9세,1998,2085,1079,1006
'4117160000,  석수2동,'15,10 - 14세,1998,1623,849,774
'4117160000,  석수2동,'20,15 - 19세,1998,1984,1012,972
'4117160000,  석수2동,'25,20 - 24세,1998,2063,997,1066
'4117160000,  석수2동,'30,25 - 29세,1998,3051,1573,1478
'4117160000,  석수2동,'35,30 - 34세,1998,3054,1615,1439
'4117160000,  석수2동,'40,35 - 39세,1998,2753,1489,1264
'4117160000,  석수2동,'45,40 - 44세,1998,2002,1019,983
'4117160000,  석수2동,'50,45 - 49세,1998,1399,729,670
'4117160000,  석수2동,'55,50 - 54세,1998,1186,578,608
'4117160000,  석수2동,'60,55 - 59세,1998,1136,538,598
'4117160000,  석수2동,'65,60 - 64세,1998,865,383,482
'4117160000,  석수2동,'70,65 - 69세,1998,610,281,329
'4117160000,  석수2동,'75,70 - 74세,1998,358,151,207
'4117160000,  석수2동,'80,75 - 79세,1998,254,91,163
'4117160000,  석수2동,'85,80 - 84세,1998,106,36,70
'4117160000,  석수2동,'90,85+ ,1998,56,22,34
'4117161000,  석수3동,'00,계,1998,17633,9003,8630
'4117161000,  석수3동,'05,0 - 4세,1998,1671,904,767
'4117161000,  석수3동,'10,5 - 9세,1998,1719,954,765
'4117161000,  석수3동,'15,10 - 14세,1998,1251,659,592
'4117161000,  석수3동,'20,15 - 19세,1998,1317,716,601
'4117161000,  석수3동,'25,20 - 24세,1998,1090,534,556
'4117161000,  석수3동,'30,25 - 29세,1998,1747,822,925
'4117161000,  석수3동,'35,30 - 34세,1998,2184,1110,1074
'4117161000,  석수3동,'40,35 - 39세,1998,2069,1093,976
'4117161000,  석수3동,'45,40 - 44세,1998,1542,805,737
'4117161000,  석수3동,'50,45 - 49세,1998,759,430,329
'4117161000,  석수3동,'55,50 - 54세,1998,559,282,277
'4117161000,  석수3동,'60,55 - 59세,1998,541,249,292
'4117161000,  석수3동,'65,60 - 64세,1998,421,173,248
'4117161000,  석수3동,'70,65 - 69세,1998,321,114,207
'4117161000,  석수3동,'75,70 - 74세,1998,206,80,126
'4117161000,  석수3동,'80,75 - 79세,1998,141,44,97
'4117161000,  석수3동,'85,80 - 84세,1998,53,22,31
'4117161000,  석수3동,'90,85+ ,1998,42,12,30
'4117162100,  박달1동,'00,계,1998,21263,10780,10483
'4117162100,  박달1동,'05,0 - 4세,1998,1668,897,771
'4117162100,  박달1동,'10,5 - 9세,1998,1585,829,756
'4117162100,  박달1동,'15,10 - 14세,1998,1362,725,637
'4117162100,  박달1동,'20,15 - 19세,1998,1781,894,887
'4117162100,  박달1동,'25,20 - 24세,1998,1993,942,1051
'4117162100,  박달1동,'30,25 - 29세,1998,2477,1271,1206
'4117162100,  박달1동,'35,30 - 34세,1998,2328,1210,1118
'4117162100,  박달1동,'40,35 - 39세,1998,2113,1119,994
'4117162100,  박달1동,'45,40 - 44세,1998,1686,858,828
'4117162100,  박달1동,'50,45 - 49세,1998,1087,558,529
'4117162100,  박달1동,'55,50 - 54세,1998,947,465,482
'4117162100,  박달1동,'60,55 - 59세,1998,817,420,397
'4117162100,  박달1동,'65,60 - 64세,1998,584,270,314
'4117162100,  박달1동,'70,65 - 69세,1998,351,162,189
'4117162100,  박달1동,'75,70 - 74세,1998,229,79,150
'4117162100,  박달1동,'80,75 - 79세,1998,163,49,114
'4117162100,  박달1동,'85,80 - 84세,1998,58,21,37
'4117162100,  박달1동,'90,85+ ,1998,34,11,23
'4117163000,  박달2동,'00,계,1998,17712,8886,8826
'4117163000,  박달2동,'05,0 - 4세,1998,1254,674,580
'4117163000,  박달2동,'10,5 - 9세,1998,1674,873,801
'4117163000,  박달2동,'15,10 - 14세,1998,1711,888,823
'4117163000,  박달2동,'20,15 - 19세,1998,1651,819,832
'4117163000,  박달2동,'25,20 - 24세,1998,1049,527,522
'4117163000,  박달2동,'30,25 - 29세,1998,1310,678,632
'4117163000,  박달2동,'35,30 - 34세,1998,1605,736,869
'4117163000,  박달2동,'40,35 - 39세,1998,2232,1056,1176
'4117163000,  박달2동,'45,40 - 44세,1998,1918,1029,889
'4117163000,  박달2동,'50,45 - 49세,1998,971,572,399
'4117163000,  박달2동,'55,50 - 54세,1998,597,323,274
'4117163000,  박달2동,'60,55 - 59세,1998,492,246,246
'4117163000,  박달2동,'65,60 - 64세,1998,416,166,250
'4117163000,  박달2동,'70,65 - 69세,1998,358,136,222
'4117163000,  박달2동,'75,70 - 74세,1998,215,80,135
'4117163000,  박달2동,'80,75 - 79세,1998,145,55,90
'4117163000,  박달2동,'85,80 - 84세,1998,72,21,51
'4117163000,  박달2동,'90,85+ ,1998,42,7,35
'41173, 동안구,'00,계,1998,333696,166599,167097
'41173, 동안구,'05,0 - 4세,1998,25130,13059,12071
'41173, 동안구,'10,5 - 9세,1998,28589,15160,13429
'41173, 동안구,'15,10 - 14세,1998,28408,14847,13561
'41173, 동안구,'20,15 - 19세,1998,28836,14709,14127
'41173, 동안구,'25,20 - 24세,1998,21101,10421,10680
'41173, 동안구,'30,25 - 29세,1998,29999,14318,15681
'41173, 동안구,'35,30 - 34세,1998,33140,16001,17139
'41173, 동안구,'40,35 - 39세,1998,39542,19026,20516
'41173, 동안구,'45,40 - 44세,1998,33639,17530,16109
'41173, 동안구,'50,45 - 49세,1998,18953,10566,8387
'41173, 동안구,'55,50 - 54세,1998,12720,6712,6008
'41173, 동안구,'60,55 - 59세,1998,10418,5190,5228
'41173, 동안구,'65,60 - 64세,1998,8161,3539,4622
'41173, 동안구,'70,65 - 69세,1998,5933,2379,3554
'41173, 동안구,'75,70 - 74세,1998,4220,1529,2691
'41173, 동안구,'80,75 - 79세,1998,2785,1025,1760
'41173, 동안구,'85,80 - 84세,1998,1409,415,994
'41173, 동안구,'90,85+ ,1998,713,173,540
'4117351000,  비산1동,'00,계,1998,17233,8651,8582
'4117351000,  비산1동,'05,0 - 4세,1998,1562,792,770
'4117351000,  비산1동,'10,5 - 9세,1998,1362,722,640
'4117351000,  비산1동,'15,10 - 14세,1998,1149,626,523
'4117351000,  비산1동,'20,15 - 19세,1998,1350,731,619
'4117351000,  비산1동,'25,20 - 24세,1998,1241,583,658
'4117351000,  비산1동,'30,25 - 29세,1998,1839,904,935
'4117351000,  비산1동,'35,30 - 34세,1998,1997,1032,965
'4117351000,  비산1동,'40,35 - 39세,1998,1899,988,911
'4117351000,  비산1동,'45,40 - 44세,1998,1460,745,715
'4117351000,  비산1동,'50,45 - 49세,1998,889,474,415
'4117351000,  비산1동,'55,50 - 54세,1998,630,320,310
'4117351000,  비산1동,'60,55 - 59세,1998,574,270,304
'4117351000,  비산1동,'65,60 - 64세,1998,446,185,261
'4117351000,  비산1동,'70,65 - 69세,1998,300,107,193
'4117351000,  비산1동,'75,70 - 74세,1998,252,79,173
'4117351000,  비산1동,'80,75 - 79세,1998,165,53,112
'4117351000,  비산1동,'85,80 - 84세,1998,84,30,54
'4117351000,  비산1동,'90,85+ ,1998,34,10,24
'4117352000,  비산2동,'00,계,1998,14332,7108,7224
'4117352000,  비산2동,'05,0 - 4세,1998,1043,503,540
'4117352000,  비산2동,'10,5 - 9세,1998,1198,649,549
'4117352000,  비산2동,'15,10 - 14세,1998,1091,573,518
'4117352000,  비산2동,'20,15 - 19세,1998,1311,661,650
'4117352000,  비산2동,'25,20 - 24세,1998,1003,513,490
'4117352000,  비산2동,'30,25 - 29세,1998,1212,593,619
'4117352000,  비산2동,'35,30 - 34세,1998,1353,662,691
'4117352000,  비산2동,'40,35 - 39세,1998,1581,763,818
'4117352000,  비산2동,'45,40 - 44세,1998,1386,679,707
'4117352000,  비산2동,'50,45 - 49세,1998,873,475,398
'4117352000,  비산2동,'55,50 - 54세,1998,657,341,316
'4117352000,  비산2동,'60,55 - 59세,1998,497,248,249
'4117352000,  비산2동,'65,60 - 64세,1998,396,160,236
'4117352000,  비산2동,'70,65 - 69세,1998,276,106,170
'4117352000,  비산2동,'75,70 - 74세,1998,223,90,133
'4117352000,  비산2동,'80,75 - 79세,1998,143,70,73
'4117352000,  비산2동,'85,80 - 84세,1998,56,16,40
'4117352000,  비산2동,'90,85+ ,1998,33,6,27
'4117353000,  비산3동,'00,계,1998,27345,13696,13649
'4117353000,  비산3동,'05,0 - 4세,1998,2382,1228,1154
'4117353000,  비산3동,'10,5 - 9세,1998,2593,1409,1184
'4117353000,  비산3동,'15,10 - 14세,1998,2136,1156,980
'4117353000,  비산3동,'20,15 - 19세,1998,1991,1013,978
'4117353000,  비산3동,'25,20 - 24세,1998,1556,760,796
'4117353000,  비산3동,'30,25 - 29세,1998,2450,1155,1295
'4117353000,  비산3동,'35,30 - 34세,1998,3102,1449,1653
'4117353000,  비산3동,'40,35 - 39세,1998,3401,1734,1667
'4117353000,  비산3동,'45,40 - 44세,1998,2452,1316,1136
'4117353000,  비산3동,'50,45 - 49세,1998,1333,732,601
'4117353000,  비산3동,'55,50 - 54세,1998,946,502,444
'4117353000,  비산3동,'60,55 - 59세,1998,794,370,424
'4117353000,  비산3동,'65,60 - 64세,1998,713,297,416
'4117353000,  비산3동,'70,65 - 69세,1998,569,226,343
'4117353000,  비산3동,'75,70 - 74세,1998,445,161,284
'4117353000,  비산3동,'80,75 - 79세,1998,266,117,149
'4117353000,  비산3동,'85,80 - 84세,1998,145,53,92
'4117353000,  비산3동,'90,85+ ,1998,71,18,53
'4117354000,  부흥동,'00,계,1998,22704,11128,11576
'4117354000,  부흥동,'05,0 - 4세,1998,1541,820,721
'4117354000,  부흥동,'10,5 - 9세,1998,1885,987,898
'4117354000,  부흥동,'15,10 - 14세,1998,2188,1118,1070
'4117354000,  부흥동,'20,15 - 19세,1998,2263,1109,1154
'4117354000,  부흥동,'25,20 - 24세,1998,1473,744,729
'4117354000,  부흥동,'30,25 - 29세,1998,1684,767,917
'4117354000,  부흥동,'35,30 - 34세,1998,1972,940,1032
'4117354000,  부흥동,'40,35 - 39세,1998,2676,1174,1502
'4117354000,  부흥동,'45,40 - 44세,1998,2639,1326,1313
'4117354000,  부흥동,'50,45 - 49세,1998,1520,876,644
'4117354000,  부흥동,'55,50 - 54세,1998,817,438,379
'4117354000,  부흥동,'60,55 - 59세,1998,609,317,292
'4117354000,  부흥동,'65,60 - 64세,1998,442,175,267
'4117354000,  부흥동,'70,65 - 69세,1998,382,152,230
'4117354000,  부흥동,'75,70 - 74세,1998,291,100,191
'4117354000,  부흥동,'80,75 - 79세,1998,177,50,127
'4117354000,  부흥동,'85,80 - 84세,1998,97,26,71
'4117354000,  부흥동,'90,85+ ,1998,48,9,39
'4117354600,  달안동,'00,계,1998,17090,8448,8642
'4117354600,  달안동,'05,0 - 4세,1998,1515,744,771
'4117354600,  달안동,'10,5 - 9세,1998,1355,724,631
'4117354600,  달안동,'15,10 - 14세,1998,1389,742,647
'4117354600,  달안동,'20,15 - 19세,1998,1207,611,596
'4117354600,  달안동,'25,20 - 24세,1998,832,392,440
'4117354600,  달안동,'30,25 - 29세,1998,1976,859,1117
'4117354600,  달안동,'35,30 - 34세,1998,2039,1037,1002
'4117354600,  달안동,'40,35 - 39세,1998,2186,1059,1127
'4117354600,  달안동,'45,40 - 44세,1998,1647,907,740
'4117354600,  달안동,'50,45 - 49세,1998,819,447,372
'4117354600,  달안동,'55,50 - 54세,1998,553,288,265
'4117354600,  달안동,'60,55 - 59세,1998,484,234,250
'4117354600,  달안동,'65,60 - 64세,1998,416,169,247
'4117354600,  달안동,'70,65 - 69세,1998,263,95,168
'4117354600,  달안동,'75,70 - 74세,1998,218,82,136
'4117354600,  달안동,'80,75 - 79세,1998,111,31,80
'4117354600,  달안동,'85,80 - 84세,1998,58,19,39
'4117354600,  달안동,'90,85+ ,1998,22,8,14
'4117355000,  관양1동,'00,계,1998,32919,16425,16494
'4117355000,  관양1동,'05,0 - 4세,1998,2620,1390,1230
'4117355000,  관양1동,'10,5 - 9세,1998,2840,1466,1374
'4117355000,  관양1동,'15,10 - 14세,1998,2405,1283,1122
'4117355000,  관양1동,'20,15 - 19세,1998,2639,1352,1287
'4117355000,  관양1동,'25,20 - 24세,1998,2209,1081,1128
'4117355000,  관양1동,'30,25 - 29세,1998,3378,1680,1698
'4117355000,  관양1동,'35,30 - 34세,1998,3444,1648,1796
'4117355000,  관양1동,'40,35 - 39세,1998,3605,1827,1778
'4117355000,  관양1동,'45,40 - 44세,1998,2916,1473,1443
'4117355000,  관양1동,'50,45 - 49세,1998,1714,923,791
'4117355000,  관양1동,'55,50 - 54세,1998,1265,643,622
'4117355000,  관양1동,'60,55 - 59세,1998,1164,544,620
'4117355000,  관양1동,'65,60 - 64세,1998,992,447,545
'4117355000,  관양1동,'70,65 - 69세,1998,698,296,402
'4117355000,  관양1동,'75,70 - 74세,1998,469,180,289
'4117355000,  관양1동,'80,75 - 79세,1998,320,129,191
'4117355000,  관양1동,'85,80 - 84세,1998,150,45,105
'4117355000,  관양1동,'90,85+ ,1998,91,18,73
'4117356000,  관양2동,'00,계,1998,17658,8916,8742
'4117356000,  관양2동,'05,0 - 4세,1998,1649,852,797
'4117356000,  관양2동,'10,5 - 9세,1998,1394,758,636
'4117356000,  관양2동,'15,10 - 14세,1998,961,476,485
'4117356000,  관양2동,'20,15 - 19세,1998,1255,609,646
'4117356000,  관양2동,'25,20 - 24세,1998,1393,687,706
'4117356000,  관양2동,'30,25 - 29세,1998,2268,1143,1125
'4117356000,  관양2동,'35,30 - 34세,1998,2263,1154,1109
'4117356000,  관양2동,'40,35 - 39세,1998,1918,1062,856
'4117356000,  관양2동,'45,40 - 44세,1998,1293,657,636
'4117356000,  관양2동,'50,45 - 49세,1998,818,407,411
'4117356000,  관양2동,'55,50 - 54세,1998,712,362,350
'4117356000,  관양2동,'60,55 - 59세,1998,617,296,321
'4117356000,  관양2동,'65,60 - 64세,1998,437,190,247
'4117356000,  관양2동,'70,65 - 69세,1998,288,125,163
'4117356000,  관양2동,'75,70 - 74세,1998,180,67,113
'4117356000,  관양2동,'80,75 - 79세,1998,123,48,75
'4117356000,  관양2동,'85,80 - 84세,1998,54,16,38
'4117356000,  관양2동,'90,85+ ,1998,35,7,28
'4117356600,  부림동,'00,계,1998,27129,13581,13548
'4117356600,  부림동,'05,0 - 4세,1998,2256,1138,1118
'4117356600,  부림동,'10,5 - 9세,1998,2670,1407,1263
'4117356600,  부림동,'15,10 - 14세,1998,2415,1244,1171
'4117356600,  부림동,'20,15 - 19세,1998,1929,1002,927
'4117356600,  부림동,'25,20 - 24세,1998,1309,698,611
'4117356600,  부림동,'30,25 - 29세,1998,2508,1082,1426
'4117356600,  부림동,'35,30 - 34세,1998,3104,1478,1626
'4117356600,  부림동,'40,35 - 39세,1998,3805,1883,1922
'4117356600,  부림동,'45,40 - 44세,1998,2720,1538,1182
'4117356600,  부림동,'50,45 - 49세,1998,1272,724,548
'4117356600,  부림동,'55,50 - 54세,1998,795,424,371
'4117356600,  부림동,'60,55 - 59세,1998,787,369,418
'4117356600,  부림동,'65,60 - 64세,1998,575,239,336
'4117356600,  부림동,'70,65 - 69세,1998,403,153,250
'4117356600,  부림동,'75,70 - 74세,1998,277,99,178
'4117356600,  부림동,'80,75 - 79세,1998,171,71,100
'4117356600,  부림동,'85,80 - 84세,1998,86,20,66
'4117356600,  부림동,'90,85+ ,1998,47,12,35
'4117357000,  평촌동,'00,계,1998,4291,2218,2073
'4117357000,  평촌동,'05,0 - 4세,1998,243,134,109
'4117357000,  평촌동,'10,5 - 9세,1998,300,162,138
'4117357000,  평촌동,'15,10 - 14세,1998,270,144,126
'4117357000,  평촌동,'20,15 - 19세,1998,432,220,212
'4117357000,  평촌동,'25,20 - 24세,1998,361,179,182
'4117357000,  평촌동,'30,25 - 29세,1998,415,211,204
'4117357000,  평촌동,'35,30 - 34세,1998,442,251,191
'4117357000,  평촌동,'40,35 - 39세,1998,406,225,181
'4117357000,  평촌동,'45,40 - 44세,1998,385,208,177
'4117357000,  평촌동,'50,45 - 49세,1998,236,112,124
'4117357000,  평촌동,'55,50 - 54세,1998,193,97,96
'4117357000,  평촌동,'60,55 - 59세,1998,190,94,96
'4117357000,  평촌동,'65,60 - 64세,1998,152,72,80
'4117357000,  평촌동,'70,65 - 69세,1998,105,47,58
'4117357000,  평촌동,'75,70 - 74세,1998,62,27,35
'4117357000,  평촌동,'80,75 - 79세,1998,54,19,35
'4117357000,  평촌동,'85,80 - 84세,1998,34,14,20
'4117357000,  평촌동,'90,85+ ,1998,11,2,9
'4117357600,  평안동,'00,계,1998,29480,14780,14700
'4117357600,  평안동,'05,0 - 4세,1998,2196,1184,1012
'4117357600,  평안동,'10,5 - 9세,1998,2823,1499,1324
'4117357600,  평안동,'15,10 - 14세,1998,2936,1539,1397
'4117357600,  평안동,'20,15 - 19세,1998,2506,1307,1199
'4117357600,  평안동,'25,20 - 24세,1998,1428,716,712
'4117357600,  평안동,'30,25 - 29세,1998,2127,948,1179
'4117357600,  평안동,'35,30 - 34세,1998,2859,1305,1554
'4117357600,  평안동,'40,35 - 39세,1998,3949,1850,2099
'4117357600,  평안동,'45,40 - 44세,1998,3520,1901,1619
'4117357600,  평안동,'50,45 - 49세,1998,1627,961,666
'4117357600,  평안동,'55,50 - 54세,1998,982,540,442
'4117357600,  평안동,'60,55 - 59세,1998,736,364,372
'4117357600,  평안동,'65,60 - 64세,1998,596,246,350
'4117357600,  평안동,'70,65 - 69세,1998,494,192,302
'4117357600,  평안동,'75,70 - 74세,1998,321,96,225
'4117357600,  평안동,'80,75 - 79세,1998,227,85,142
'4117357600,  평안동,'85,80 - 84세,1998,102,32,70
'4117357600,  평안동,'90,85+ ,1998,51,15,36
'4117357800,  귀인동,'00,계,1998,15627,7705,7922
'4117357800,  귀인동,'05,0 - 4세,1998,738,399,339
'4117357800,  귀인동,'10,5 - 9세,1998,1298,672,626
'4117357800,  귀인동,'15,10 - 14세,1998,1665,894,771
'4117357800,  귀인동,'20,15 - 19세,1998,1490,737,753
'4117357800,  귀인동,'25,20 - 24세,1998,1036,526,510
'4117357800,  귀인동,'30,25 - 29세,1998,1045,518,527
'4117357800,  귀인동,'35,30 - 34세,1998,883,366,517
'4117357800,  귀인동,'40,35 - 39세,1998,1712,697,1015
'4117357800,  귀인동,'45,40 - 44세,1998,1854,949,905
'4117357800,  귀인동,'50,45 - 49세,1998,1121,613,508
'4117357800,  귀인동,'55,50 - 54세,1998,795,401,394
'4117357800,  귀인동,'60,55 - 59세,1998,657,354,303
'4117357800,  귀인동,'65,60 - 64세,1998,457,236,221
'4117357800,  귀인동,'70,65 - 69세,1998,349,146,203
'4117357800,  귀인동,'75,70 - 74세,1998,229,87,142
'4117357800,  귀인동,'80,75 - 79세,1998,161,75,86
'4117357800,  귀인동,'85,80 - 84세,1998,92,23,69
'4117357800,  귀인동,'90,85+ ,1998,45,12,33
'4117358000,  호계1동,'00,계,1998,21005,10600,10405
'4117358000,  호계1동,'05,0 - 4세,1998,1563,823,740
'4117358000,  호계1동,'10,5 - 9세,1998,1671,892,779
'4117358000,  호계1동,'15,10 - 14세,1998,1711,894,817
'4117358000,  호계1동,'20,15 - 19세,1998,1971,996,975
'4117358000,  호계1동,'25,20 - 24세,1998,1634,800,834
'4117358000,  호계1동,'30,25 - 29세,1998,2052,1064,988
'4117358000,  호계1동,'35,30 - 34세,1998,2160,1106,1054
'4117358000,  호계1동,'40,35 - 39세,1998,2365,1155,1210
'4117358000,  호계1동,'45,40 - 44세,1998,1956,975,981
'4117358000,  호계1동,'50,45 - 49세,1998,1195,676,519
'4117358000,  호계1동,'55,50 - 54세,1998,817,438,379
'4117358000,  호계1동,'60,55 - 59세,1998,611,303,308
'4117358000,  호계1동,'65,60 - 64세,1998,472,197,275
'4117358000,  호계1동,'70,65 - 69세,1998,349,130,219
'4117358000,  호계1동,'75,70 - 74세,1998,222,82,140
'4117358000,  호계1동,'80,75 - 79세,1998,134,37,97
'4117358000,  호계1동,'85,80 - 84세,1998,77,22,55
'4117358000,  호계1동,'90,85+ ,1998,45,10,35
'4117359000,  호계2동,'00,계,1998,21564,10861,10703
'4117359000,  호계2동,'05,0 - 4세,1998,1505,775,730
'4117359000,  호계2동,'10,5 - 9세,1998,1705,887,818
'4117359000,  호계2동,'15,10 - 14세,1998,1776,908,868
'4117359000,  호계2동,'20,15 - 19세,1998,2330,1198,1132
'4117359000,  호계2동,'25,20 - 24세,1998,1608,790,818
'4117359000,  호계2동,'30,25 - 29세,1998,1844,926,918
'4117359000,  호계2동,'35,30 - 34세,1998,1996,999,997
'4117359000,  호계2동,'40,35 - 39세,1998,2452,1170,1282
'4117359000,  호계2동,'45,40 - 44세,1998,2212,1145,1067
'4117359000,  호계2동,'50,45 - 49세,1998,1435,824,611
'4117359000,  호계2동,'55,50 - 54세,1998,838,475,363
'4117359000,  호계2동,'60,55 - 59세,1998,550,289,261
'4117359000,  호계2동,'65,60 - 64세,1998,448,198,250
'4117359000,  호계2동,'70,65 - 69세,1998,316,105,211
'4117359000,  호계2동,'75,70 - 74세,1998,251,87,164
'4117359000,  호계2동,'80,75 - 79세,1998,187,58,129
'4117359000,  호계2동,'85,80 - 84세,1998,85,23,62
'4117359000,  호계2동,'90,85+ ,1998,26,4,22
'4117360000,  호계3동,'00,계,1998,18388,9219,9169
'4117360000,  호계3동,'05,0 - 4세,1998,1517,779,738
'4117360000,  호계3동,'10,5 - 9세,1998,1672,864,808
'4117360000,  호계3동,'15,10 - 14세,1998,1625,853,772
'4117360000,  호계3동,'20,15 - 19세,1998,1677,898,779
'4117360000,  호계3동,'25,20 - 24세,1998,1107,509,598
'4117360000,  호계3동,'30,25 - 29세,1998,1583,780,803
'4117360000,  호계3동,'35,30 - 34세,1998,2012,959,1053
'4117360000,  호계3동,'40,35 - 39세,1998,2327,1173,1154
'4117360000,  호계3동,'45,40 - 44세,1998,1742,888,854
'4117360000,  호계3동,'50,45 - 49세,1998,962,549,413
'4117360000,  호계3동,'55,50 - 54세,1998,602,342,260
'4117360000,  호계3동,'60,55 - 59세,1998,468,240,228
'4117360000,  호계3동,'65,60 - 64세,1998,375,151,224
'4117360000,  호계3동,'70,65 - 69세,1998,289,102,187
'4117360000,  호계3동,'75,70 - 74세,1998,178,63,115
'4117360000,  호계3동,'80,75 - 79세,1998,147,41,106
'4117360000,  호계3동,'85,80 - 84세,1998,72,19,53
'4117360000,  호계3동,'90,85+ ,1998,33,9,24
'4117361000,  범계동,'00,계,1998,19002,9408,9594
'4117361000,  범계동,'05,0 - 4세,1998,943,493,450
'4117361000,  범계동,'10,5 - 9세,1998,1415,760,655
'4117361000,  범계동,'15,10 - 14세,1998,1981,1051,930
'4117361000,  범계동,'20,15 - 19세,1998,1830,899,931
'4117361000,  범계동,'25,20 - 24세,1998,1238,600,638
'4117361000,  범계동,'30,25 - 29세,1998,1552,758,794
'4117361000,  범계동,'35,30 - 34세,1998,1256,567,689
'4117361000,  범계동,'40,35 - 39세,1998,2048,854,1194
'4117361000,  범계동,'45,40 - 44세,1998,2248,1162,1086
'4117361000,  범계동,'50,45 - 49세,1998,1309,724,585
'4117361000,  범계동,'55,50 - 54세,1998,924,486,438
'4117361000,  범계동,'60,55 - 59세,1998,755,410,345
'4117361000,  범계동,'65,60 - 64세,1998,574,256,318
'4117361000,  범계동,'70,65 - 69세,1998,368,171,197
'4117361000,  범계동,'75,70 - 74세,1998,254,108,146
'4117361000,  범계동,'80,75 - 79세,1998,178,74,104
'4117361000,  범계동,'85,80 - 84세,1998,84,24,60
'4117361000,  범계동,'90,85+ ,1998,45,11,34
'4117362000,  신촌동,'00,계,1998,15865,7944,7921
'4117362000,  신촌동,'05,0 - 4세,1998,1095,594,501
'4117362000,  신촌동,'10,5 - 9세,1998,1452,787,665
'4117362000,  신촌동,'15,10 - 14세,1998,1625,802,823
'4117362000,  신촌동,'20,15 - 19세,1998,1570,828,742
'4117362000,  신촌동,'25,20 - 24세,1998,846,442,404
'4117362000,  신촌동,'30,25 - 29세,1998,1068,486,582
'4117362000,  신촌동,'35,30 - 34세,1998,1378,639,739
'4117362000,  신촌동,'40,35 - 39세,1998,1953,841,1112
'4117362000,  신촌동,'45,40 - 44세,1998,1931,1026,905
'4117362000,  신촌동,'50,45 - 49세,1998,1048,610,438
'4117362000,  신촌동,'55,50 - 54세,1998,574,327,247
'4117362000,  신촌동,'60,55 - 59세,1998,428,224,204
'4117362000,  신촌동,'65,60 - 64세,1998,307,144,163
'4117362000,  신촌동,'70,65 - 69세,1998,212,85,127
'4117362000,  신촌동,'75,70 - 74세,1998,162,52,110
'4117362000,  신촌동,'80,75 - 79세,1998,118,32,86
'4117362000,  신촌동,'85,80 - 84세,1998,65,17,48
'4117362000,  신촌동,'90,85+ ,1998,33,8,25
'4117363000,  갈산동,'00,계,1998,12064,5911,6153
'4117363000,  갈산동,'05,0 - 4세,1998,762,411,351
'4117363000,  갈산동,'10,5 - 9세,1998,956,515,441
'4117363000,  갈산동,'15,10 - 14세,1998,1085,544,541
'4117363000,  갈산동,'20,15 - 19세,1998,1085,538,547
'4117363000,  갈산동,'25,20 - 24세,1998,827,401,426
'4117363000,  갈산동,'30,25 - 29세,1998,998,444,554
'4117363000,  갈산동,'35,30 - 34세,1998,880,409,471
'4117363000,  갈산동,'40,35 - 39세,1998,1259,571,688
'4117363000,  갈산동,'45,40 - 44세,1998,1278,635,643
'4117363000,  갈산동,'50,45 - 49세,1998,782,439,343
'4117363000,  갈산동,'55,50 - 54세,1998,620,288,332
'4117363000,  갈산동,'60,55 - 59세,1998,497,264,233
'4117363000,  갈산동,'65,60 - 64세,1998,363,177,186
'4117363000,  갈산동,'70,65 - 69세,1998,272,141,131
'4117363000,  갈산동,'75,70 - 74세,1998,186,69,117
'4117363000,  갈산동,'80,75 - 79세,1998,103,35,68
'4117363000,  갈산동,'85,80 - 84세,1998,68,16,52
'4117363000,  갈산동,'90,85+ ,1998,43,14,29
'41190, 부천시,'00,계,1998,778789,393855,384934
'41190, 부천시,'05,0 - 4세,1998,63397,33297,30100
'41190, 부천시,'10,5 - 9세,1998,69047,36203,32844
'41190, 부천시,'15,10 - 14세,1998,61099,31733,29366
'41190, 부천시,'20,15 - 19세,1998,63901,32765,31136
'41190, 부천시,'25,20 - 24세,1998,54371,26987,27384
'41190, 부천시,'30,25 - 29세,1998,76921,37968,38953
'41190, 부천시,'35,30 - 34세,1998,84338,42145,42193
'41190, 부천시,'40,35 - 39세,1998,92123,47442,44681
'41190, 부천시,'45,40 - 44세,1998,70139,37333,32806
'41190, 부천시,'50,45 - 49세,1998,39859,21783,18076
'41190, 부천시,'55,50 - 54세,1998,27865,14909,12956
'41190, 부천시,'60,55 - 59세,1998,23532,11172,12360
'41190, 부천시,'65,60 - 64세,1998,19095,8306,10789
'41190, 부천시,'70,65 - 69세,1998,13453,5235,8218
'41190, 부천시,'75,70 - 74세,1998,9129,3289,5840
'41190, 부천시,'80,75 - 79세,1998,5942,2056,3886
'41190, 부천시,'85,80 - 84세,1998,2929,843,2086
'41190, 부천시,'90,85+ ,1998,1649,389,1260
'41195, 원미구,'00,계,1998,389560,196745,192815
'41195, 원미구,'05,0 - 4세,1998,29141,15344,13797
'41195, 원미구,'10,5 - 9세,1998,34427,18026,16401
'41195, 원미구,'15,10 - 14세,1998,32879,17036,15843
'41195, 원미구,'20,15 - 19세,1998,34260,17480,16780
'41195, 원미구,'25,20 - 24세,1998,27323,13596,13727
'41195, 원미구,'30,25 - 29세,1998,36266,17939,18327
'41195, 원미구,'35,30 - 34세,1998,39965,19710,20255
'41195, 원미구,'40,35 - 39세,1998,47117,23820,23297
'41195, 원미구,'45,40 - 44세,1998,37519,19826,17693
'41195, 원미구,'50,45 - 49세,1998,21073,11597,9476
'41195, 원미구,'55,50 - 54세,1998,14050,7689,6361
'41195, 원미구,'60,55 - 59세,1998,10990,5363,5627
'41195, 원미구,'65,60 - 64세,1998,8689,3793,4896
'41195, 원미구,'70,65 - 69세,1998,6309,2423,3886
'41195, 원미구,'75,70 - 74세,1998,4390,1554,2836
'41195, 원미구,'80,75 - 79세,1998,2875,958,1917
'41195, 원미구,'85,80 - 84세,1998,1470,411,1059
'41195, 원미구,'90,85+ ,1998,817,180,637
'4119551000,  심곡1동,'00,계,1998,14275,7260,7015
'4119551000,  심곡1동,'05,0 - 4세,1998,1025,520,505
'4119551000,  심곡1동,'10,5 - 9세,1998,980,512,468
'4119551000,  심곡1동,'15,10 - 14세,1998,909,462,447
'4119551000,  심곡1동,'20,15 - 19세,1998,1310,672,638
'4119551000,  심곡1동,'25,20 - 24세,1998,1405,691,714
'4119551000,  심곡1동,'30,25 - 29세,1998,1726,910,816
'4119551000,  심곡1동,'35,30 - 34세,1998,1487,808,679
'4119551000,  심곡1동,'40,35 - 39세,1998,1341,694,647
'4119551000,  심곡1동,'45,40 - 44세,1998,1203,601,602
'4119551000,  심곡1동,'50,45 - 49세,1998,897,457,440
'4119551000,  심곡1동,'55,50 - 54세,1998,629,348,281
'4119551000,  심곡1동,'60,55 - 59세,1998,463,234,229
'4119551000,  심곡1동,'65,60 - 64세,1998,332,143,189
'4119551000,  심곡1동,'70,65 - 69세,1998,247,100,147
'4119551000,  심곡1동,'75,70 - 74세,1998,151,54,97
'4119551000,  심곡1동,'80,75 - 79세,1998,105,34,71
'4119551000,  심곡1동,'85,80 - 84세,1998,44,14,30
'4119551000,  심곡1동,'90,85+ ,1998,21,6,15
'4119552000,  심곡2동,'00,계,1998,13989,7003,6986
'4119552000,  심곡2동,'05,0 - 4세,1998,904,442,462
'4119552000,  심곡2동,'10,5 - 9세,1998,776,406,370
'4119552000,  심곡2동,'15,10 - 14세,1998,716,357,359
'4119552000,  심곡2동,'20,15 - 19세,1998,1134,550,584
'4119552000,  심곡2동,'25,20 - 24세,1998,1471,715,756
'4119552000,  심곡2동,'30,25 - 29세,1998,1839,977,862
'4119552000,  심곡2동,'35,30 - 34세,1998,1351,755,596
'4119552000,  심곡2동,'40,35 - 39세,1998,1270,648,622
'4119552000,  심곡2동,'45,40 - 44세,1998,1138,573,565
'4119552000,  심곡2동,'50,45 - 49세,1998,820,400,420
'4119552000,  심곡2동,'55,50 - 54세,1998,711,356,355
'4119552000,  심곡2동,'60,55 - 59세,1998,648,304,344
'4119552000,  심곡2동,'65,60 - 64세,1998,472,226,246
'4119552000,  심곡2동,'70,65 - 69세,1998,279,111,168
'4119552000,  심곡2동,'75,70 - 74세,1998,219,101,118
'4119552000,  심곡2동,'80,75 - 79세,1998,131,49,82
'4119552000,  심곡2동,'85,80 - 84세,1998,61,23,38
'4119552000,  심곡2동,'90,85+ ,1998,49,10,39
'4119553000,  심곡3동,'00,계,1998,15876,8079,7797
'4119553000,  심곡3동,'05,0 - 4세,1998,1240,650,590
'4119553000,  심곡3동,'10,5 - 9세,1998,1289,681,608
'4119553000,  심곡3동,'15,10 - 14세,1998,1150,595,555
'4119553000,  심곡3동,'20,15 - 19세,1998,1419,726,693
'4119553000,  심곡3동,'25,20 - 24세,1998,1325,634,691
'4119553000,  심곡3동,'30,25 - 29세,1998,1849,954,895
'4119553000,  심곡3동,'35,30 - 34세,1998,1752,940,812
'4119553000,  심곡3동,'40,35 - 39세,1998,1702,885,817
'4119553000,  심곡3동,'45,40 - 44세,1998,1340,675,665
'4119553000,  심곡3동,'50,45 - 49세,1998,827,432,395
'4119553000,  심곡3동,'55,50 - 54세,1998,581,324,257
'4119553000,  심곡3동,'60,55 - 59세,1998,471,233,238
'4119553000,  심곡3동,'65,60 - 64세,1998,330,154,176
'4119553000,  심곡3동,'70,65 - 69세,1998,248,88,160
'4119553000,  심곡3동,'75,70 - 74세,1998,176,61,115
'4119553000,  심곡3동,'80,75 - 79세,1998,85,29,56
'4119553000,  심곡3동,'85,80 - 84세,1998,69,13,56
'4119553000,  심곡3동,'90,85+ ,1998,23,5,18
'4119554000,  원미1동,'00,계,1998,20346,10533,9813
'4119554000,  원미1동,'05,0 - 4세,1998,1703,953,750
'4119554000,  원미1동,'10,5 - 9세,1998,1824,963,861
'4119554000,  원미1동,'15,10 - 14세,1998,1491,784,707
'4119554000,  원미1동,'20,15 - 19세,1998,1712,897,815
'4119554000,  원미1동,'25,20 - 24세,1998,1661,818,843
'4119554000,  원미1동,'30,25 - 29세,1998,2100,1071,1029
'4119554000,  원미1동,'35,30 - 34세,1998,2258,1184,1074
'4119554000,  원미1동,'40,35 - 39세,1998,2369,1274,1095
'4119554000,  원미1동,'45,40 - 44세,1998,1706,903,803
'4119554000,  원미1동,'50,45 - 49세,1998,1063,564,499
'4119554000,  원미1동,'55,50 - 54세,1998,722,382,340
'4119554000,  원미1동,'60,55 - 59세,1998,539,269,270
'4119554000,  원미1동,'65,60 - 64세,1998,470,210,260
'4119554000,  원미1동,'70,65 - 69세,1998,298,119,179
'4119554000,  원미1동,'75,70 - 74세,1998,197,68,129
'4119554000,  원미1동,'80,75 - 79세,1998,142,44,98
'4119554000,  원미1동,'85,80 - 84세,1998,60,21,39
'4119554000,  원미1동,'90,85+ ,1998,31,9,22
'4119555000,  원미2동,'00,계,1998,15343,7785,7558
'4119555000,  원미2동,'05,0 - 4세,1998,1164,634,530
'4119555000,  원미2동,'10,5 - 9세,1998,1269,674,595
'4119555000,  원미2동,'15,10 - 14세,1998,1118,553,565
'4119555000,  원미2동,'20,15 - 19세,1998,1329,661,668
'4119555000,  원미2동,'25,20 - 24세,1998,1287,627,660
'4119555000,  원미2동,'30,25 - 29세,1998,1704,884,820
'4119555000,  원미2동,'35,30 - 34세,1998,1633,872,761
'4119555000,  원미2동,'40,35 - 39세,1998,1646,864,782
'4119555000,  원미2동,'45,40 - 44세,1998,1285,642,643
'4119555000,  원미2동,'50,45 - 49세,1998,840,446,394
'4119555000,  원미2동,'55,50 - 54세,1998,604,321,283
'4119555000,  원미2동,'60,55 - 59세,1998,422,206,216
'4119555000,  원미2동,'65,60 - 64세,1998,364,152,212
'4119555000,  원미2동,'70,65 - 69세,1998,264,101,163
'4119555000,  원미2동,'75,70 - 74세,1998,195,80,115
'4119555000,  원미2동,'80,75 - 79세,1998,124,42,82
'4119555000,  원미2동,'85,80 - 84세,1998,56,17,39
'4119555000,  원미2동,'90,85+ ,1998,39,9,30
'4119556000,  소사동,'00,계,1998,11701,5850,5851
'4119556000,  소사동,'05,0 - 4세,1998,911,462,449
'4119556000,  소사동,'10,5 - 9세,1998,780,428,352
'4119556000,  소사동,'15,10 - 14세,1998,665,347,318
'4119556000,  소사동,'20,15 - 19세,1998,889,439,450
'4119556000,  소사동,'25,20 - 24세,1998,1078,522,556
'4119556000,  소사동,'30,25 - 29세,1998,1506,745,761
'4119556000,  소사동,'35,30 - 34세,1998,1261,711,550
'4119556000,  소사동,'40,35 - 39세,1998,1040,575,465
'4119556000,  소사동,'45,40 - 44세,1998,943,465,478
'4119556000,  소사동,'50,45 - 49세,1998,649,310,339
'4119556000,  소사동,'55,50 - 54세,1998,509,251,258
'4119556000,  소사동,'60,55 - 59세,1998,437,216,221
'4119556000,  소사동,'65,60 - 64세,1998,338,144,194
'4119556000,  소사동,'70,65 - 69세,1998,254,105,149
'4119556000,  소사동,'75,70 - 74세,1998,183,61,122
'4119556000,  소사동,'80,75 - 79세,1998,114,38,76
'4119556000,  소사동,'85,80 - 84세,1998,76,19,57
'4119556000,  소사동,'90,85+ ,1998,68,12,56
'4119557000,  역곡1동,'00,계,1998,16994,8593,8401
'4119557000,  역곡1동,'05,0 - 4세,1998,1376,760,616
'4119557000,  역곡1동,'10,5 - 9세,1998,1526,781,745
'4119557000,  역곡1동,'15,10 - 14세,1998,1238,650,588
'4119557000,  역곡1동,'20,15 - 19세,1998,1294,659,635
'4119557000,  역곡1동,'25,20 - 24세,1998,1082,517,565
'4119557000,  역곡1동,'30,25 - 29세,1998,1688,836,852
'4119557000,  역곡1동,'35,30 - 34세,1998,1826,915,911
'4119557000,  역곡1동,'40,35 - 39세,1998,2014,1076,938
'4119557000,  역곡1동,'45,40 - 44세,1998,1520,820,700
'4119557000,  역곡1동,'50,45 - 49세,1998,846,454,392
'4119557000,  역곡1동,'55,50 - 54세,1998,554,297,257
'4119557000,  역곡1동,'60,55 - 59세,1998,595,256,339
'4119557000,  역곡1동,'65,60 - 64세,1998,513,213,300
'4119557000,  역곡1동,'70,65 - 69세,1998,394,168,226
'4119557000,  역곡1동,'75,70 - 74세,1998,236,98,138
'4119557000,  역곡1동,'80,75 - 79세,1998,171,54,117
'4119557000,  역곡1동,'85,80 - 84세,1998,81,24,57
'4119557000,  역곡1동,'90,85+ ,1998,40,15,25
'4119558000,  역곡2동,'00,계,1998,17150,8616,8534
'4119558000,  역곡2동,'05,0 - 4세,1998,1530,820,710
'4119558000,  역곡2동,'10,5 - 9세,1998,1420,753,667
'4119558000,  역곡2동,'15,10 - 14세,1998,1159,552,607
'4119558000,  역곡2동,'20,15 - 19세,1998,1144,575,569
'4119558000,  역곡2동,'25,20 - 24세,1998,1143,542,601
'4119558000,  역곡2동,'30,25 - 29세,1998,1921,956,965
'4119558000,  역곡2동,'35,30 - 34세,1998,2066,1072,994
'4119558000,  역곡2동,'40,35 - 39세,1998,1935,1055,880
'4119558000,  역곡2동,'45,40 - 44세,1998,1303,663,640
'4119558000,  역곡2동,'50,45 - 49세,1998,838,448,390
'4119558000,  역곡2동,'55,50 - 54세,1998,618,321,297
'4119558000,  역곡2동,'60,55 - 59세,1998,565,257,308
'4119558000,  역곡2동,'65,60 - 64세,1998,581,237,344
'4119558000,  역곡2동,'70,65 - 69세,1998,399,156,243
'4119558000,  역곡2동,'75,70 - 74세,1998,269,126,143
'4119558000,  역곡2동,'80,75 - 79세,1998,150,56,94
'4119558000,  역곡2동,'85,80 - 84세,1998,66,17,49
'4119558000,  역곡2동,'90,85+ ,1998,43,10,33
'4119559000,  춘의동,'00,계,1998,17839,9067,8772
'4119559000,  춘의동,'05,0 - 4세,1998,1084,544,540
'4119559000,  춘의동,'10,5 - 9세,1998,1158,591,567
'4119559000,  춘의동,'15,10 - 14세,1998,1256,632,624
'4119559000,  춘의동,'20,15 - 19세,1998,2008,1032,976
'4119559000,  춘의동,'25,20 - 24세,1998,1914,1001,913
'4119559000,  춘의동,'30,25 - 29세,1998,1740,985,755
'4119559000,  춘의동,'35,30 - 34세,1998,1633,920,713
'4119559000,  춘의동,'40,35 - 39세,1998,1753,909,844
'4119559000,  춘의동,'45,40 - 44세,1998,1513,741,772
'4119559000,  춘의동,'50,45 - 49세,1998,1092,528,564
'4119559000,  춘의동,'55,50 - 54세,1998,793,428,365
'4119559000,  춘의동,'60,55 - 59세,1998,596,275,321
'4119559000,  춘의동,'65,60 - 64세,1998,456,186,270
'4119559000,  춘의동,'70,65 - 69세,1998,311,124,187
'4119559000,  춘의동,'75,70 - 74세,1998,236,70,166
'4119559000,  춘의동,'80,75 - 79세,1998,162,65,97
'4119559000,  춘의동,'85,80 - 84세,1998,93,25,68
'4119559000,  춘의동,'90,85+ ,1998,41,11,30
'4119560000,  도당동,'00,계,1998,26333,13727,12606
'4119560000,  도당동,'05,0 - 4세,1998,2134,1103,1031
'4119560000,  도당동,'10,5 - 9세,1998,2436,1282,1154
'4119560000,  도당동,'15,10 - 14세,1998,2083,1050,1033
'4119560000,  도당동,'20,15 - 19세,1998,2173,1126,1047
'4119560000,  도당동,'25,20 - 24세,1998,1951,1020,931
'4119560000,  도당동,'30,25 - 29세,1998,2799,1516,1283
'4119560000,  도당동,'35,30 - 34세,1998,3093,1657,1436
'4119560000,  도당동,'40,35 - 39세,1998,3283,1786,1497
'4119560000,  도당동,'45,40 - 44세,1998,2199,1200,999
'4119560000,  도당동,'50,45 - 49세,1998,1217,687,530
'4119560000,  도당동,'55,50 - 54세,1998,823,430,393
'4119560000,  도당동,'60,55 - 59세,1998,735,348,387
'4119560000,  도당동,'65,60 - 64세,1998,554,241,313
'4119560000,  도당동,'70,65 - 69세,1998,376,140,236
'4119560000,  도당동,'75,70 - 74세,1998,233,75,158
'4119560000,  도당동,'80,75 - 79세,1998,136,37,99
'4119560000,  도당동,'85,80 - 84세,1998,70,24,46
'4119560000,  도당동,'90,85+ ,1998,38,5,33
'4119561000,  약대동,'00,계,1998,17211,8945,8266
'4119561000,  약대동,'05,0 - 4세,1998,1284,658,626
'4119561000,  약대동,'10,5 - 9세,1998,1461,785,676
'4119561000,  약대동,'15,10 - 14세,1998,1412,761,651
'4119561000,  약대동,'20,15 - 19세,1998,1657,811,846
'4119561000,  약대동,'25,20 - 24세,1998,1322,686,636
'4119561000,  약대동,'30,25 - 29세,1998,1590,862,728
'4119561000,  약대동,'35,30 - 34세,1998,1878,954,924
'4119561000,  약대동,'40,35 - 39세,1998,2010,1101,909
'4119561000,  약대동,'45,40 - 44세,1998,1593,848,745
'4119561000,  약대동,'50,45 - 49세,1998,931,523,408
'4119561000,  약대동,'55,50 - 54세,1998,605,363,242
'4119561000,  약대동,'60,55 - 59세,1998,463,231,232
'4119561000,  약대동,'65,60 - 64세,1998,326,148,178
'4119561000,  약대동,'70,65 - 69세,1998,244,89,155
'4119561000,  약대동,'75,70 - 74세,1998,196,59,137
'4119561000,  약대동,'80,75 - 79세,1998,148,46,102
'4119561000,  약대동,'85,80 - 84세,1998,65,15,50
'4119561000,  약대동,'90,85+ ,1998,26,5,21
'4119562000,  중동,'00,계,1998,28261,14262,13999
'4119562000,  중동,'05,0 - 4세,1998,2600,1346,1254
'4119562000,  중동,'10,5 - 9세,1998,2571,1378,1193
'4119562000,  중동,'15,10 - 14세,1998,2156,1172,984
'4119562000,  중동,'20,15 - 19세,1998,2281,1194,1087
'4119562000,  중동,'25,20 - 24세,1998,1768,838,930
'4119562000,  중동,'30,25 - 29세,1998,3126,1421,1705
'4119562000,  중동,'35,30 - 34세,1998,3484,1741,1743
'4119562000,  중동,'40,35 - 39세,1998,3349,1750,1599
'4119562000,  중동,'45,40 - 44세,1998,2609,1399,1210
'4119562000,  중동,'50,45 - 49세,1998,1325,745,580
'4119562000,  중동,'55,50 - 54세,1998,798,440,358
'4119562000,  중동,'60,55 - 59세,1998,586,263,323
'4119562000,  중동,'65,60 - 64세,1998,575,221,354
'4119562000,  중동,'70,65 - 69세,1998,454,159,295
'4119562000,  중동,'75,70 - 74세,1998,287,104,183
'4119562000,  중동,'80,75 - 79세,1998,177,51,126
'4119562000,  중동,'85,80 - 84세,1998,73,25,48
'4119562000,  중동,'90,85+ ,1998,42,15,27
'4119563000,  중1동,'00,계,1998,35013,17508,17505
'4119563000,  중1동,'05,0 - 4세,1998,2246,1219,1027
'4119563000,  중1동,'10,5 - 9세,1998,3766,2009,1757
'4119563000,  중1동,'15,10 - 14세,1998,4011,2047,1964
'4119563000,  중1동,'20,15 - 19세,1998,3200,1621,1579
'4119563000,  중1동,'25,20 - 24세,1998,1628,858,770
'4119563000,  중1동,'30,25 - 29세,1998,1926,887,1039
'4119563000,  중1동,'35,30 - 34세,1998,2970,1148,1822
'4119563000,  중1동,'40,35 - 39세,1998,5385,2483,2902
'4119563000,  중1동,'45,40 - 44세,1998,4336,2405,1931
'4119563000,  중1동,'50,45 - 49세,1998,1939,1193,746
'4119563000,  중1동,'55,50 - 54세,1998,1051,606,445
'4119563000,  중1동,'60,55 - 59세,1998,740,361,379
'4119563000,  중1동,'65,60 - 64세,1998,639,286,353
'4119563000,  중1동,'70,65 - 69세,1998,431,155,276
'4119563000,  중1동,'75,70 - 74세,1998,341,105,236
'4119563000,  중1동,'80,75 - 79세,1998,238,86,152
'4119563000,  중1동,'85,80 - 84세,1998,112,26,86
'4119563000,  중1동,'90,85+ ,1998,54,13,41
'4119564000,  중2동,'00,계,1998,28563,14168,14395
'4119564000,  중2동,'05,0 - 4세,1998,1608,834,774
'4119564000,  중2동,'10,5 - 9세,1998,2346,1247,1099
'4119564000,  중2동,'15,10 - 14세,1998,3111,1633,1478
'4119564000,  중2동,'20,15 - 19세,1998,3209,1669,1540
'4119564000,  중2동,'25,20 - 24세,1998,1762,883,879
'4119564000,  중2동,'30,25 - 29세,1998,1783,839,944
'4119564000,  중2동,'35,30 - 34세,1998,2006,880,1126
'4119564000,  중2동,'40,35 - 39세,1998,3386,1447,1939
'4119564000,  중2동,'45,40 - 44세,1998,3584,1805,1779
'4119564000,  중2동,'50,45 - 49세,1998,1935,1128,807
'4119564000,  중2동,'55,50 - 54세,1998,1183,690,493
'4119564000,  중2동,'60,55 - 59세,1998,804,432,372
'4119564000,  중2동,'65,60 - 64세,1998,561,259,302
'4119564000,  중2동,'70,65 - 69세,1998,456,165,291
'4119564000,  중2동,'75,70 - 74세,1998,344,122,222
'4119564000,  중2동,'80,75 - 79세,1998,269,82,187
'4119564000,  중2동,'85,80 - 84세,1998,147,39,108
'4119564000,  중2동,'90,85+ ,1998,69,14,55
'4119565000,  중3동,'00,계,1998,28220,14071,14149
'4119565000,  중3동,'05,0 - 4세,1998,2258,1201,1057
'4119565000,  중3동,'10,5 - 9세,1998,2991,1529,1462
'4119565000,  중3동,'15,10 - 14세,1998,2570,1325,1245
'4119565000,  중3동,'20,15 - 19세,1998,2322,1167,1155
'4119565000,  중3동,'25,20 - 24세,1998,1623,806,817
'4119565000,  중3동,'30,25 - 29세,1998,2205,987,1218
'4119565000,  중3동,'35,30 - 34세,1998,3036,1314,1722
'4119565000,  중3동,'40,35 - 39세,1998,3884,2026,1858
'4119565000,  중3동,'45,40 - 44세,1998,2645,1454,1191
'4119565000,  중3동,'50,45 - 49세,1998,1385,761,624
'4119565000,  중3동,'55,50 - 54세,1998,981,541,440
'4119565000,  중3동,'60,55 - 59세,1998,718,365,353
'4119565000,  중3동,'65,60 - 64세,1998,531,236,295
'4119565000,  중3동,'70,65 - 69세,1998,417,152,265
'4119565000,  중3동,'75,70 - 74세,1998,303,112,191
'4119565000,  중3동,'80,75 - 79세,1998,185,55,130
'4119565000,  중3동,'85,80 - 84세,1998,101,29,72
'4119565000,  중3동,'90,85+ ,1998,65,11,54
'4119566000,  중4동,'00,계,1998,27222,13474,13748
'4119566000,  중4동,'05,0 - 4세,1998,2576,1310,1266
'4119566000,  중4동,'10,5 - 9세,1998,2952,1488,1464
'4119566000,  중4동,'15,10 - 14세,1998,2237,1161,1076
'4119566000,  중4동,'20,15 - 19세,1998,2127,1101,1026
'4119566000,  중4동,'25,20 - 24세,1998,1428,692,736
'4119566000,  중4동,'30,25 - 29세,1998,2354,993,1361
'4119566000,  중4동,'35,30 - 34세,1998,3463,1624,1839
'4119566000,  중4동,'40,35 - 39세,1998,3623,1945,1678
'4119566000,  중4동,'45,40 - 44세,1998,2343,1230,1113
'4119566000,  중4동,'50,45 - 49세,1998,1257,678,579
'4119566000,  중4동,'55,50 - 54세,1998,789,433,356
'4119566000,  중4동,'60,55 - 59세,1998,620,301,319
'4119566000,  중4동,'65,60 - 64세,1998,478,201,277
'4119566000,  중4동,'70,65 - 69세,1998,381,144,237
'4119566000,  중4동,'75,70 - 74세,1998,272,81,191
'4119566000,  중4동,'80,75 - 79세,1998,168,53,115
'4119566000,  중4동,'85,80 - 84세,1998,105,31,74
'4119566000,  중4동,'90,85+ ,1998,49,8,41
'4119567000,  상동,'00,계,1998,23158,11591,11567
'4119567000,  상동,'05,0 - 4세,1998,1519,822,697
'4119567000,  상동,'10,5 - 9세,1998,1950,1023,927
'4119567000,  상동,'15,10 - 14세,1998,2078,1085,993
'4119567000,  상동,'20,15 - 19세,1998,2106,1043,1063
'4119567000,  상동,'25,20 - 24세,1998,1698,823,875
'4119567000,  상동,'30,25 - 29세,1998,2251,1105,1146
'4119567000,  상동,'35,30 - 34세,1998,2076,1040,1036
'4119567000,  상동,'40,35 - 39세,1998,2551,1200,1351
'4119567000,  상동,'45,40 - 44세,1998,2374,1232,1142
'4119567000,  상동,'50,45 - 49세,1998,1374,741,633
'4119567000,  상동,'55,50 - 54세,1998,981,525,456
'4119567000,  상동,'60,55 - 59세,1998,722,375,347
'4119567000,  상동,'65,60 - 64세,1998,516,243,273
'4119567000,  상동,'70,65 - 69세,1998,377,151,226
'4119567000,  상동,'75,70 - 74세,1998,263,85,178
'4119567000,  상동,'80,75 - 79세,1998,164,58,106
'4119567000,  상동,'85,80 - 84세,1998,105,25,80
'4119567000,  상동,'90,85+ ,1998,53,15,38
'4119568000,  상1동,'00,계,1998,32066,16213,15853
'4119568000,  상1동,'05,0 - 4세,1998,1979,1066,913
'4119568000,  상1동,'10,5 - 9세,1998,2932,1496,1436
'4119568000,  상1동,'15,10 - 14세,1998,3519,1870,1649
'4119568000,  상1동,'20,15 - 19세,1998,2946,1537,1409
'4119568000,  상1동,'25,20 - 24세,1998,1777,923,854
'4119568000,  상1동,'30,25 - 29세,1998,2159,1011,1148
'4119568000,  상1동,'35,30 - 34세,1998,2692,1175,1517
'4119568000,  상1동,'40,35 - 39세,1998,4576,2102,2474
'4119568000,  상1동,'45,40 - 44세,1998,3885,2170,1715
'4119568000,  상1동,'50,45 - 49세,1998,1838,1102,736
'4119568000,  상1동,'55,50 - 54세,1998,1118,633,485
'4119568000,  상1동,'60,55 - 59세,1998,866,437,429
'4119568000,  상1동,'65,60 - 64세,1998,653,293,360
'4119568000,  상1동,'70,65 - 69세,1998,479,196,283
'4119568000,  상1동,'75,70 - 74세,1998,289,92,197
'4119568000,  상1동,'80,75 - 79세,1998,206,79,127
'4119568000,  상1동,'85,80 - 84세,1998,86,24,62
'4119568000,  상1동,'90,85+ ,1998,66,7,59
'41197, 소사구,'00,계,1998,204039,102937,101102
'41197, 소사구,'05,0 - 4세,1998,16253,8505,7748
'41197, 소사구,'10,5 - 9세,1998,16744,8828,7916
'41197, 소사구,'15,10 - 14세,1998,15085,7835,7250
'41197, 소사구,'20,15 - 19세,1998,17026,8897,8129
'41197, 소사구,'25,20 - 24세,1998,15407,7600,7807
'41197, 소사구,'30,25 - 29세,1998,20815,10330,10485
'41197, 소사구,'35,30 - 34세,1998,21167,10778,10389
'41197, 소사구,'40,35 - 39세,1998,22381,11343,11038
'41197, 소사구,'45,40 - 44세,1998,18101,9417,8684
'41197, 소사구,'50,45 - 49세,1998,11098,5974,5124
'41197, 소사구,'55,50 - 54세,1998,7963,4239,3724
'41197, 소사구,'60,55 - 59세,1998,6778,3239,3539
'41197, 소사구,'65,60 - 64세,1998,5581,2456,3125
'41197, 소사구,'70,65 - 69세,1998,3863,1533,2330
'41197, 소사구,'75,70 - 74세,1998,2628,961,1667
'41197, 소사구,'80,75 - 79세,1998,1779,618,1161
'41197, 소사구,'85,80 - 84세,1998,861,253,608
'41197, 소사구,'90,85+ ,1998,509,131,378
'4119751000,  심곡본1동,'00,계,1998,20757,10479,10278
'4119751000,  심곡본1동,'05,0 - 4세,1998,1814,917,897
'4119751000,  심곡본1동,'10,5 - 9세,1998,1577,806,771
'4119751000,  심곡본1동,'15,10 - 14세,1998,1276,681,595
'4119751000,  심곡본1동,'20,15 - 19세,1998,1622,875,747
'4119751000,  심곡본1동,'25,20 - 24세,1998,1857,872,985
'4119751000,  심곡본1동,'30,25 - 29세,1998,2587,1307,1280
'4119751000,  심곡본1동,'35,30 - 34세,1998,2336,1223,1113
'4119751000,  심곡본1동,'40,35 - 39세,1998,2092,1108,984
'4119751000,  심곡본1동,'45,40 - 44세,1998,1635,842,793
'4119751000,  심곡본1동,'50,45 - 49세,1998,1105,554,551
'4119751000,  심곡본1동,'55,50 - 54세,1998,806,418,388
'4119751000,  심곡본1동,'60,55 - 59세,1998,658,326,332
'4119751000,  심곡본1동,'65,60 - 64세,1998,538,243,295
'4119751000,  심곡본1동,'70,65 - 69세,1998,352,138,214
'4119751000,  심곡본1동,'75,70 - 74세,1998,234,89,145
'4119751000,  심곡본1동,'80,75 - 79세,1998,163,52,111
'4119751000,  심곡본1동,'85,80 - 84세,1998,65,19,46
'4119751000,  심곡본1동,'90,85+ ,1998,40,9,31
'4119752000,  심곡본동,'00,계,1998,20958,10437,10521
'4119752000,  심곡본동,'05,0 - 4세,1998,1708,937,771
'4119752000,  심곡본동,'10,5 - 9세,1998,1526,821,705
'4119752000,  심곡본동,'15,10 - 14세,1998,1282,668,614
'4119752000,  심곡본동,'20,15 - 19세,1998,1586,813,773
'4119752000,  심곡본동,'25,20 - 24세,1998,1876,885,991
'4119752000,  심곡본동,'30,25 - 29세,1998,2574,1250,1324
'4119752000,  심곡본동,'35,30 - 34세,1998,2203,1135,1068
'4119752000,  심곡본동,'40,35 - 39세,1998,2102,1102,1000
'4119752000,  심곡본동,'45,40 - 44세,1998,1585,750,835
'4119752000,  심곡본동,'50,45 - 49세,1998,1113,562,551
'4119752000,  심곡본동,'55,50 - 54세,1998,894,448,446
'4119752000,  심곡본동,'60,55 - 59세,1998,832,400,432
'4119752000,  심곡본동,'65,60 - 64세,1998,629,298,331
'4119752000,  심곡본동,'70,65 - 69세,1998,404,170,234
'4119752000,  심곡본동,'75,70 - 74세,1998,280,102,178
'4119752000,  심곡본동,'80,75 - 79세,1998,199,61,138
'4119752000,  심곡본동,'85,80 - 84세,1998,105,23,82
'4119752000,  심곡본동,'90,85+ ,1998,60,12,48
'4119753000,  소사본1동,'00,계,1998,17025,8719,8306
'4119753000,  소사본1동,'05,0 - 4세,1998,1352,704,648
'4119753000,  소사본1동,'10,5 - 9세,1998,1363,734,629
'4119753000,  소사본1동,'15,10 - 14세,1998,1254,659,595
'4119753000,  소사본1동,'20,15 - 19세,1998,1524,801,723
'4119753000,  소사본1동,'25,20 - 24세,1998,1399,709,690
'4119753000,  소사본1동,'30,25 - 29세,1998,1730,866,864
'4119753000,  소사본1동,'35,30 - 34세,1998,1740,908,832
'4119753000,  소사본1동,'40,35 - 39세,1998,1807,945,862
'4119753000,  소사본1동,'45,40 - 44세,1998,1522,775,747
'4119753000,  소사본1동,'50,45 - 49세,1998,955,512,443
'4119753000,  소사본1동,'55,50 - 54세,1998,672,369,303
'4119753000,  소사본1동,'60,55 - 59세,1998,544,278,266
'4119753000,  소사본1동,'65,60 - 64세,1998,417,193,224
'4119753000,  소사본1동,'70,65 - 69세,1998,297,105,192
'4119753000,  소사본1동,'75,70 - 74세,1998,201,73,128
'4119753000,  소사본1동,'80,75 - 79세,1998,131,49,82
'4119753000,  소사본1동,'85,80 - 84세,1998,79,27,52
'4119753000,  소사본1동,'90,85+ ,1998,38,12,26
'4119754000,  소사본2동,'00,계,1998,10312,5296,5016
'4119754000,  소사본2동,'05,0 - 4세,1998,694,357,337
'4119754000,  소사본2동,'10,5 - 9세,1998,678,359,319
'4119754000,  소사본2동,'15,10 - 14세,1998,636,341,295
'4119754000,  소사본2동,'20,15 - 19세,1998,846,431,415
'4119754000,  소사본2동,'25,20 - 24세,1998,964,500,464
'4119754000,  소사본2동,'30,25 - 29세,1998,1167,641,526
'4119754000,  소사본2동,'35,30 - 34세,1998,972,526,446
'4119754000,  소사본2동,'40,35 - 39세,1998,1021,525,496
'4119754000,  소사본2동,'45,40 - 44세,1998,836,436,400
'4119754000,  소사본2동,'50,45 - 49세,1998,635,313,322
'4119754000,  소사본2동,'55,50 - 54세,1998,538,276,262
'4119754000,  소사본2동,'60,55 - 59세,1998,479,230,249
'4119754000,  소사본2동,'65,60 - 64세,1998,319,150,169
'4119754000,  소사본2동,'70,65 - 69세,1998,236,103,133
'4119754000,  소사본2동,'75,70 - 74세,1998,120,53,67
'4119754000,  소사본2동,'80,75 - 79세,1998,104,39,65
'4119754000,  소사본2동,'85,80 - 84세,1998,39,12,27
'4119754000,  소사본2동,'90,85+ ,1998,28,4,24
'4119755000,  소사본3동,'00,계,1998,31217,15717,15500
'4119755000,  소사본3동,'05,0 - 4세,1998,2127,1140,987
'4119755000,  소사본3동,'10,5 - 9세,1998,3023,1596,1427
'4119755000,  소사본3동,'15,10 - 14세,1998,3185,1621,1564
'4119755000,  소사본3동,'20,15 - 19세,1998,2976,1542,1434
'4119755000,  소사본3동,'25,20 - 24세,1998,2008,1011,997
'4119755000,  소사본3동,'30,25 - 29세,1998,2186,1073,1113
'4119755000,  소사본3동,'35,30 - 34세,1998,2830,1289,1541
'4119755000,  소사본3동,'40,35 - 39세,1998,4082,1971,2111
'4119755000,  소사본3동,'45,40 - 44세,1998,3306,1801,1505
'4119755000,  소사본3동,'50,45 - 49세,1998,1791,1014,777
'4119755000,  소사본3동,'55,50 - 54세,1998,1071,645,426
'4119755000,  소사본3동,'60,55 - 59세,1998,740,358,382
'4119755000,  소사본3동,'65,60 - 64세,1998,610,250,360
'4119755000,  소사본3동,'70,65 - 69세,1998,488,166,322
'4119755000,  소사본3동,'75,70 - 74세,1998,351,110,241
'4119755000,  소사본3동,'80,75 - 79세,1998,245,77,168
'4119755000,  소사본3동,'85,80 - 84세,1998,123,36,87
'4119755000,  소사본3동,'90,85+ ,1998,75,17,58
'4119756000,  범박동,'00,계,1998,8395,4258,4137
'4119756000,  범박동,'05,0 - 4세,1998,395,198,197
'4119756000,  범박동,'10,5 - 9세,1998,468,263,205
'4119756000,  범박동,'15,10 - 14세,1998,458,228,230
'4119756000,  범박동,'20,15 - 19세,1998,785,416,369
'4119756000,  범박동,'25,20 - 24세,1998,787,440,347
'4119756000,  범박동,'30,25 - 29세,1998,710,403,307
'4119756000,  범박동,'35,30 - 34세,1998,581,333,248
'4119756000,  범박동,'40,35 - 39세,1998,692,361,331
'4119756000,  범박동,'45,40 - 44세,1998,724,389,335
'4119756000,  범박동,'50,45 - 49세,1998,558,284,274
'4119756000,  범박동,'55,50 - 54세,1998,510,256,254
'4119756000,  범박동,'60,55 - 59세,1998,512,253,259
'4119756000,  범박동,'65,60 - 64세,1998,415,174,241
'4119756000,  범박동,'70,65 - 69세,1998,222,82,140
'4119756000,  범박동,'75,70 - 74세,1998,221,62,159
'4119756000,  범박동,'80,75 - 79세,1998,178,59,119
'4119756000,  범박동,'85,80 - 84세,1998,105,29,76
'4119756000,  범박동,'90,85+ ,1998,74,28,46
'4119757000,  괴안동,'00,계,1998,25488,12664,12824
'4119757000,  괴안동,'05,0 - 4세,1998,2433,1262,1171
'4119757000,  괴안동,'10,5 - 9세,1998,2647,1372,1275
'4119757000,  괴안동,'15,10 - 14세,1998,2019,1019,1000
'4119757000,  괴안동,'20,15 - 19세,1998,1731,892,839
'4119757000,  괴안동,'25,20 - 24세,1998,1344,641,703
'4119757000,  괴안동,'30,25 - 29세,1998,2326,1011,1315
'4119757000,  괴안동,'35,30 - 34세,1998,3041,1481,1560
'4119757000,  괴안동,'40,35 - 39세,1998,3307,1681,1626
'4119757000,  괴안동,'45,40 - 44세,1998,2281,1259,1022
'4119757000,  괴안동,'50,45 - 49세,1998,1103,625,478
'4119757000,  괴안동,'55,50 - 54세,1998,726,377,349
'4119757000,  괴안동,'60,55 - 59세,1998,701,318,383
'4119757000,  괴안동,'65,60 - 64세,1998,710,296,414
'4119757000,  괴안동,'70,65 - 69세,1998,501,210,291
'4119757000,  괴안동,'75,70 - 74세,1998,291,106,185
'4119757000,  괴안동,'80,75 - 79세,1998,189,65,124
'4119757000,  괴안동,'85,80 - 84세,1998,85,35,50
'4119757000,  괴안동,'90,85+ ,1998,53,14,39
'4119758000,  역곡3동,'00,계,1998,23658,11983,11675
'4119758000,  역곡3동,'05,0 - 4세,1998,2211,1139,1072
'4119758000,  역곡3동,'10,5 - 9세,1998,1931,1036,895
'4119758000,  역곡3동,'15,10 - 14세,1998,1430,763,667
'4119758000,  역곡3동,'20,15 - 19세,1998,1659,877,782
'4119758000,  역곡3동,'25,20 - 24세,1998,1613,763,850
'4119758000,  역곡3동,'30,25 - 29세,1998,2885,1402,1483
'4119758000,  역곡3동,'35,30 - 34세,1998,2919,1551,1368
'4119758000,  역곡3동,'40,35 - 39세,1998,2453,1294,1159
'4119758000,  역곡3동,'45,40 - 44세,1998,1818,972,846
'4119758000,  역곡3동,'50,45 - 49세,1998,1099,584,515
'4119758000,  역곡3동,'55,50 - 54세,1998,845,422,423
'4119758000,  역곡3동,'60,55 - 59세,1998,811,357,454
'4119758000,  역곡3동,'65,60 - 64세,1998,710,301,409
'4119758000,  역곡3동,'70,65 - 69세,1998,554,236,318
'4119758000,  역곡3동,'75,70 - 74세,1998,367,152,215
'4119758000,  역곡3동,'80,75 - 79세,1998,205,86,119
'4119758000,  역곡3동,'85,80 - 84세,1998,98,33,65
'4119758000,  역곡3동,'90,85+ ,1998,50,15,35
'4119759000,  송내1동,'00,계,1998,23747,12005,11742
'4119759000,  송내1동,'05,0 - 4세,1998,1669,876,793
'4119759000,  송내1동,'10,5 - 9세,1998,1731,910,821
'4119759000,  송내1동,'15,10 - 14세,1998,1871,954,917
'4119759000,  송내1동,'20,15 - 19세,1998,2321,1226,1095
'4119759000,  송내1동,'25,20 - 24세,1998,1811,898,913
'4119759000,  송내1동,'30,25 - 29세,1998,2266,1174,1092
'4119759000,  송내1동,'35,30 - 34세,1998,2157,1105,1052
'4119759000,  송내1동,'40,35 - 39세,1998,2410,1132,1278
'4119759000,  송내1동,'45,40 - 44세,1998,2412,1211,1201
'4119759000,  송내1동,'50,45 - 49세,1998,1522,871,651
'4119759000,  송내1동,'55,50 - 54세,1998,1021,544,477
'4119759000,  송내1동,'60,55 - 59세,1998,800,382,418
'4119759000,  송내1동,'65,60 - 64세,1998,675,309,366
'4119759000,  송내1동,'70,65 - 69세,1998,459,190,269
'4119759000,  송내1동,'75,70 - 74세,1998,294,117,177
'4119759000,  송내1동,'80,75 - 79세,1998,187,72,115
'4119759000,  송내1동,'85,80 - 84세,1998,87,19,68
'4119759000,  송내1동,'90,85+ ,1998,54,15,39
'4119760000,  송내2동,'00,계,1998,22482,11379,11103
'4119760000,  송내2동,'05,0 - 4세,1998,1850,975,875
'4119760000,  송내2동,'10,5 - 9세,1998,1800,931,869
'4119760000,  송내2동,'15,10 - 14세,1998,1674,901,773
'4119760000,  송내2동,'20,15 - 19세,1998,1976,1024,952
'4119760000,  송내2동,'25,20 - 24세,1998,1748,881,867
'4119760000,  송내2동,'30,25 - 29세,1998,2384,1203,1181
'4119760000,  송내2동,'35,30 - 34세,1998,2388,1227,1161
'4119760000,  송내2동,'40,35 - 39세,1998,2415,1224,1191
'4119760000,  송내2동,'45,40 - 44세,1998,1982,982,1000
'4119760000,  송내2동,'50,45 - 49세,1998,1217,655,562
'4119760000,  송내2동,'55,50 - 54세,1998,880,484,396
'4119760000,  송내2동,'60,55 - 59세,1998,701,337,364
'4119760000,  송내2동,'65,60 - 64세,1998,558,242,316
'4119760000,  송내2동,'70,65 - 69세,1998,350,133,217
'4119760000,  송내2동,'75,70 - 74세,1998,269,97,172
'4119760000,  송내2동,'80,75 - 79세,1998,178,58,120
'4119760000,  송내2동,'85,80 - 84세,1998,75,20,55
'4119760000,  송내2동,'90,85+ ,1998,37,5,32
'41199, 오정구,'00,계,1998,185190,94173,91017
'41199, 오정구,'05,0 - 4세,1998,18003,9448,8555
'41199, 오정구,'10,5 - 9세,1998,17876,9349,8527
'41199, 오정구,'15,10 - 14세,1998,13135,6862,6273
'41199, 오정구,'20,15 - 19세,1998,12615,6388,6227
'41199, 오정구,'25,20 - 24세,1998,11641,5791,5850
'41199, 오정구,'30,25 - 29세,1998,19840,9699,10141
'41199, 오정구,'35,30 - 34세,1998,23206,11657,11549
'41199, 오정구,'40,35 - 39세,1998,22625,12279,10346
'41199, 오정구,'45,40 - 44세,1998,14519,8090,6429
'41199, 오정구,'50,45 - 49세,1998,7688,4212,3476
'41199, 오정구,'55,50 - 54세,1998,5852,2981,2871
'41199, 오정구,'60,55 - 59세,1998,5764,2570,3194
'41199, 오정구,'65,60 - 64세,1998,4825,2057,2768
'41199, 오정구,'70,65 - 69세,1998,3281,1279,2002
'41199, 오정구,'75,70 - 74세,1998,2111,774,1337
'41199, 오정구,'80,75 - 79세,1998,1288,480,808
'41199, 오정구,'85,80 - 84세,1998,598,179,419
'41199, 오정구,'90,85+ ,1998,323,78,245
'4119951000,  성곡동,'00,계,1998,37236,18851,18385
'4119951000,  성곡동,'05,0 - 4세,1998,3815,2012,1803
'4119951000,  성곡동,'10,5 - 9세,1998,3683,1923,1760
'4119951000,  성곡동,'15,10 - 14세,1998,2571,1329,1242
'4119951000,  성곡동,'20,15 - 19세,1998,2492,1311,1181
'4119951000,  성곡동,'25,20 - 24세,1998,2247,1071,1176
'4119951000,  성곡동,'30,25 - 29세,1998,3995,1922,2073
'4119951000,  성곡동,'35,30 - 34세,1998,4846,2374,2472
'4119951000,  성곡동,'40,35 - 39세,1998,4551,2471,2080
'4119951000,  성곡동,'45,40 - 44세,1998,2877,1594,1283
'4119951000,  성곡동,'50,45 - 49세,1998,1508,837,671
'4119951000,  성곡동,'55,50 - 54세,1998,1065,548,517
'4119951000,  성곡동,'60,55 - 59세,1998,1072,474,598
'4119951000,  성곡동,'65,60 - 64세,1998,940,398,542
'4119951000,  성곡동,'70,65 - 69세,1998,634,239,395
'4119951000,  성곡동,'75,70 - 74세,1998,470,166,304
'4119951000,  성곡동,'80,75 - 79세,1998,272,111,161
'4119951000,  성곡동,'85,80 - 84세,1998,127,52,75
'4119951000,  성곡동,'90,85+ ,1998,71,19,52
'4119952000,  원종1동,'00,계,1998,23914,12109,11805
'4119952000,  원종1동,'05,0 - 4세,1998,2148,1151,997
'4119952000,  원종1동,'10,5 - 9세,1998,2363,1258,1105
'4119952000,  원종1동,'15,10 - 14세,1998,1830,972,858
'4119952000,  원종1동,'20,15 - 19세,1998,1624,828,796
'4119952000,  원종1동,'25,20 - 24세,1998,1408,696,712
'4119952000,  원종1동,'30,25 - 29세,1998,2429,1167,1262
'4119952000,  원종1동,'35,30 - 34세,1998,2789,1372,1417
'4119952000,  원종1동,'40,35 - 39세,1998,2923,1549,1374
'4119952000,  원종1동,'45,40 - 44세,1998,1937,1082,855
'4119952000,  원종1동,'50,45 - 49세,1998,1044,558,486
'4119952000,  원종1동,'55,50 - 54세,1998,813,423,390
'4119952000,  원종1동,'60,55 - 59세,1998,788,356,432
'4119952000,  원종1동,'65,60 - 64세,1998,695,299,396
'4119952000,  원종1동,'70,65 - 69세,1998,469,171,298
'4119952000,  원종1동,'75,70 - 74세,1998,295,108,187
'4119952000,  원종1동,'80,75 - 79세,1998,205,74,131
'4119952000,  원종1동,'85,80 - 84세,1998,92,30,62
'4119952000,  원종1동,'90,85+ ,1998,62,15,47
'4119953000,  원종2동,'00,계,1998,28933,14422,14511
'4119953000,  원종2동,'05,0 - 4세,1998,3258,1670,1588
'4119953000,  원종2동,'10,5 - 9세,1998,3072,1563,1509
'4119953000,  원종2동,'15,10 - 14세,1998,2107,1086,1021
'4119953000,  원종2동,'20,15 - 19세,1998,1709,815,894
'4119953000,  원종2동,'25,20 - 24세,1998,1480,691,789
'4119953000,  원종2동,'30,25 - 29세,1998,3104,1394,1710
'4119953000,  원종2동,'35,30 - 34세,1998,3978,1999,1979
'4119953000,  원종2동,'40,35 - 39세,1998,3780,2041,1739
'4119953000,  원종2동,'45,40 - 44세,1998,2243,1276,967
'4119953000,  원종2동,'50,45 - 49세,1998,981,549,432
'4119953000,  원종2동,'55,50 - 54세,1998,772,396,376
'4119953000,  원종2동,'60,55 - 59세,1998,764,303,461
'4119953000,  원종2동,'65,60 - 64세,1998,669,262,407
'4119953000,  원종2동,'70,65 - 69세,1998,456,176,280
'4119953000,  원종2동,'75,70 - 74세,1998,283,108,175
'4119953000,  원종2동,'80,75 - 79세,1998,166,60,106
'4119953000,  원종2동,'85,80 - 84세,1998,82,27,55
'4119953000,  원종2동,'90,85+ ,1998,29,6,23
'4119954000,  고강본동,'00,계,1998,33478,16916,16562
'4119954000,  고강본동,'05,0 - 4세,1998,3547,1871,1676
'4119954000,  고강본동,'10,5 - 9세,1998,3363,1767,1596
'4119954000,  고강본동,'15,10 - 14세,1998,2214,1158,1056
'4119954000,  고강본동,'20,15 - 19세,1998,1865,937,928
'4119954000,  고강본동,'25,20 - 24세,1998,1928,973,955
'4119954000,  고강본동,'30,25 - 29세,1998,3809,1782,2027
'4119954000,  고강본동,'35,30 - 34세,1998,4445,2209,2236
'4119954000,  고강본동,'40,35 - 39세,1998,4146,2262,1884
'4119954000,  고강본동,'45,40 - 44세,1998,2411,1387,1024
'4119954000,  고강본동,'50,45 - 49세,1998,1280,692,588
'4119954000,  고강본동,'55,50 - 54세,1998,1032,480,552
'4119954000,  고강본동,'60,55 - 59세,1998,1139,480,659
'4119954000,  고강본동,'65,60 - 64세,1998,917,399,518
'4119954000,  고강본동,'70,65 - 69세,1998,631,249,382
'4119954000,  고강본동,'75,70 - 74세,1998,391,149,242
'4119954000,  고강본동,'80,75 - 79세,1998,220,81,139
'4119954000,  고강본동,'85,80 - 84세,1998,96,29,67
'4119954000,  고강본동,'90,85+ ,1998,44,11,33
'4119955000,  고강1동,'00,계,1998,17316,8683,8633
'4119955000,  고강1동,'05,0 - 4세,1998,1724,893,831
'4119955000,  고강1동,'10,5 - 9세,1998,1642,844,798
'4119955000,  고강1동,'15,10 - 14세,1998,1111,606,505
'4119955000,  고강1동,'20,15 - 19세,1998,1101,552,549
'4119955000,  고강1동,'25,20 - 24세,1998,1069,529,540
'4119955000,  고강1동,'30,25 - 29세,1998,1826,842,984
'4119955000,  고강1동,'35,30 - 34세,1998,2182,1065,1117
'4119955000,  고강1동,'40,35 - 39세,1998,2142,1195,947
'4119955000,  고강1동,'45,40 - 44세,1998,1318,703,615
'4119955000,  고강1동,'50,45 - 49세,1998,691,383,308
'4119955000,  고강1동,'55,50 - 54세,1998,583,276,307
'4119955000,  고강1동,'60,55 - 59세,1998,611,289,322
'4119955000,  고강1동,'65,60 - 64세,1998,504,201,303
'4119955000,  고강1동,'70,65 - 69세,1998,342,140,202
'4119955000,  고강1동,'75,70 - 74세,1998,228,86,142
'4119955000,  고강1동,'80,75 - 79세,1998,144,50,94
'4119955000,  고강1동,'85,80 - 84세,1998,61,17,44
'4119955000,  고강1동,'90,85+ ,1998,37,12,25
'4119956000,  오정동,'00,계,1998,20898,10766,10132
'4119956000,  오정동,'05,0 - 4세,1998,1592,831,761
'4119956000,  오정동,'10,5 - 9세,1998,1882,1011,871
'4119956000,  오정동,'15,10 - 14세,1998,1667,872,795
'4119956000,  오정동,'20,15 - 19세,1998,1851,940,911
'4119956000,  오정동,'25,20 - 24세,1998,1439,727,712
'4119956000,  오정동,'30,25 - 29세,1998,1879,984,895
'4119956000,  오정동,'35,30 - 34세,1998,2343,1190,1153
'4119956000,  오정동,'40,35 - 39세,1998,2495,1329,1166
'4119956000,  오정동,'45,40 - 44세,1998,1920,1056,864
'4119956000,  오정동,'50,45 - 49세,1998,1055,598,457
'4119956000,  오정동,'55,50 - 54세,1998,670,359,311
'4119956000,  오정동,'60,55 - 59세,1998,662,319,343
'4119956000,  오정동,'65,60 - 64세,1998,512,225,287
'4119956000,  오정동,'70,65 - 69세,1998,404,154,250
'4119956000,  오정동,'75,70 - 74세,1998,244,79,165
'4119956000,  오정동,'80,75 - 79세,1998,165,64,101
'4119956000,  오정동,'85,80 - 84세,1998,80,16,64
'4119956000,  오정동,'90,85+ ,1998,38,12,26
'4119957000,  신흥동,'00,계,1998,23415,12426,10989
'4119957000,  신흥동,'05,0 - 4세,1998,1919,1020,899
'4119957000,  신흥동,'10,5 - 9세,1998,1871,983,888
'4119957000,  신흥동,'15,10 - 14세,1998,1635,839,796
'4119957000,  신흥동,'20,15 - 19세,1998,1973,1005,968
'4119957000,  신흥동,'25,20 - 24세,1998,2070,1104,966
'4119957000,  신흥동,'30,25 - 29세,1998,2798,1608,1190
'4119957000,  신흥동,'35,30 - 34세,1998,2623,1448,1175
'4119957000,  신흥동,'40,35 - 39세,1998,2588,1432,1156
'4119957000,  신흥동,'45,40 - 44세,1998,1813,992,821
'4119957000,  신흥동,'50,45 - 49세,1998,1129,595,534
'4119957000,  신흥동,'55,50 - 54세,1998,917,499,418
'4119957000,  신흥동,'60,55 - 59세,1998,728,349,379
'4119957000,  신흥동,'65,60 - 64세,1998,588,273,315
'4119957000,  신흥동,'70,65 - 69세,1998,345,150,195
'4119957000,  신흥동,'75,70 - 74세,1998,200,78,122
'4119957000,  신흥동,'80,75 - 79세,1998,116,40,76
'4119957000,  신흥동,'85,80 - 84세,1998,60,8,52
'4119957000,  신흥동,'90,85+ ,1998,42,3,39
'41210, 광명시,'00,계,1998,343933,172461,171472
'41210, 광명시,'05,0 - 4세,1998,29833,15819,14014
'41210, 광명시,'10,5 - 9세,1998,29696,15792,13904
'41210, 광명시,'15,10 - 14세,1998,23534,12022,11512
'41210, 광명시,'20,15 - 19세,1998,25805,13192,12613
'41210, 광명시,'25,20 - 24세,1998,23963,11859,12104
'41210, 광명시,'30,25 - 29세,1998,35828,17153,18675
'41210, 광명시,'35,30 - 34세,1998,38692,19412,19280
'41210, 광명시,'40,35 - 39세,1998,38319,19875,18444
'41210, 광명시,'45,40 - 44세,1998,28949,15319,13630
'41210, 광명시,'50,45 - 49세,1998,17312,9091,8221
'41210, 광명시,'55,50 - 54세,1998,13370,6738,6632
'41210, 광명시,'60,55 - 59세,1998,12495,5889,6606
'41210, 광명시,'65,60 - 64세,1998,9790,4312,5478
'41210, 광명시,'70,65 - 69세,1998,6812,2693,4119
'41210, 광명시,'75,70 - 74세,1998,4410,1640,2770
'41210, 광명시,'80,75 - 79세,1998,2982,1071,1911
'41210, 광명시,'85,80 - 84세,1998,1343,393,950
'41210, 광명시,'90,85+ ,1998,800,191,609
'4121051000,  광명1동,'00,계,1998,16883,8508,8375
'4121051000,  광명1동,'05,0 - 4세,1998,1316,722,594
'4121051000,  광명1동,'10,5 - 9세,1998,1144,594,550
'4121051000,  광명1동,'15,10 - 14세,1998,955,474,481
'4121051000,  광명1동,'20,15 - 19세,1998,1182,597,585
'4121051000,  광명1동,'25,20 - 24세,1998,1414,702,712
'4121051000,  광명1동,'30,25 - 29세,1998,2102,1096,1006
'4121051000,  광명1동,'35,30 - 34세,1998,1803,973,830
'4121051000,  광명1동,'40,35 - 39세,1998,1623,853,770
'4121051000,  광명1동,'45,40 - 44세,1998,1254,640,614
'4121051000,  광명1동,'50,45 - 49세,1998,852,417,435
'4121051000,  광명1동,'55,50 - 54세,1998,752,343,409
'4121051000,  광명1동,'60,55 - 59세,1998,871,395,476
'4121051000,  광명1동,'65,60 - 64세,1998,693,319,374
'4121051000,  광명1동,'70,65 - 69세,1998,437,202,235
'4121051000,  광명1동,'75,70 - 74세,1998,238,95,143
'4121051000,  광명1동,'80,75 - 79세,1998,135,60,75
'4121051000,  광명1동,'85,80 - 84세,1998,65,16,49
'4121051000,  광명1동,'90,85+ ,1998,47,10,37
'4121052000,  광명2동,'00,계,1998,13533,6746,6787
'4121052000,  광명2동,'05,0 - 4세,1998,1011,528,483
'4121052000,  광명2동,'10,5 - 9세,1998,1030,558,472
'4121052000,  광명2동,'15,10 - 14세,1998,823,406,417
'4121052000,  광명2동,'20,15 - 19세,1998,1059,508,551
'4121052000,  광명2동,'25,20 - 24세,1998,1151,571,580
'4121052000,  광명2동,'30,25 - 29세,1998,1569,807,762
'4121052000,  광명2동,'35,30 - 34세,1998,1305,648,657
'4121052000,  광명2동,'40,35 - 39세,1998,1320,686,634
'4121052000,  광명2동,'45,40 - 44세,1998,1088,544,544
'4121052000,  광명2동,'50,45 - 49세,1998,716,351,365
'4121052000,  광명2동,'55,50 - 54세,1998,670,326,344
'4121052000,  광명2동,'60,55 - 59세,1998,632,301,331
'4121052000,  광명2동,'65,60 - 64세,1998,486,239,247
'4121052000,  광명2동,'70,65 - 69세,1998,304,129,175
'4121052000,  광명2동,'75,70 - 74세,1998,165,75,90
'4121052000,  광명2동,'80,75 - 79세,1998,116,47,69
'4121052000,  광명2동,'85,80 - 84세,1998,51,13,38
'4121052000,  광명2동,'90,85+ ,1998,37,9,28
'4121054000,  광명3동,'00,계,1998,13928,6959,6969
'4121054000,  광명3동,'05,0 - 4세,1998,1222,620,602
'4121054000,  광명3동,'10,5 - 9세,1998,1042,560,482
'4121054000,  광명3동,'15,10 - 14세,1998,767,388,379
'4121054000,  광명3동,'20,15 - 19세,1998,977,506,471
'4121054000,  광명3동,'25,20 - 24세,1998,1158,579,579
'4121054000,  광명3동,'30,25 - 29세,1998,1741,837,904
'4121054000,  광명3동,'35,30 - 34세,1998,1618,869,749
'4121054000,  광명3동,'40,35 - 39세,1998,1331,720,611
'4121054000,  광명3동,'45,40 - 44세,1998,1013,499,514
'4121054000,  광명3동,'50,45 - 49세,1998,730,337,393
'4121054000,  광명3동,'55,50 - 54세,1998,666,323,343
'4121054000,  광명3동,'60,55 - 59세,1998,585,277,308
'4121054000,  광명3동,'65,60 - 64세,1998,432,194,238
'4121054000,  광명3동,'70,65 - 69세,1998,246,91,155
'4121054000,  광명3동,'75,70 - 74세,1998,179,73,106
'4121054000,  광명3동,'80,75 - 79세,1998,136,58,78
'4121054000,  광명3동,'85,80 - 84세,1998,52,19,33
'4121054000,  광명3동,'90,85+ ,1998,33,9,24
'4121055000,  광명4동,'00,계,1998,18025,9076,8949
'4121055000,  광명4동,'05,0 - 4세,1998,1390,742,648
'4121055000,  광명4동,'10,5 - 9세,1998,1366,722,644
'4121055000,  광명4동,'15,10 - 14세,1998,1090,563,527
'4121055000,  광명4동,'20,15 - 19세,1998,1491,791,700
'4121055000,  광명4동,'25,20 - 24세,1998,1530,750,780
'4121055000,  광명4동,'30,25 - 29세,1998,2013,999,1014
'4121055000,  광명4동,'35,30 - 34세,1998,1779,922,857
'4121055000,  광명4동,'40,35 - 39세,1998,1787,894,893
'4121055000,  광명4동,'45,40 - 44세,1998,1517,799,718
'4121055000,  광명4동,'50,45 - 49세,1998,1060,500,560
'4121055000,  광명4동,'55,50 - 54세,1998,882,456,426
'4121055000,  광명4동,'60,55 - 59세,1998,799,395,404
'4121055000,  광명4동,'65,60 - 64세,1998,527,236,291
'4121055000,  광명4동,'70,65 - 69세,1998,331,149,182
'4121055000,  광명4동,'75,70 - 74세,1998,220,81,139
'4121055000,  광명4동,'80,75 - 79세,1998,140,47,93
'4121055000,  광명4동,'85,80 - 84세,1998,74,21,53
'4121055000,  광명4동,'90,85+ ,1998,29,9,20
'4121056000,  광명5동,'00,계,1998,16879,8581,8298
'4121056000,  광명5동,'05,0 - 4세,1998,1340,742,598
'4121056000,  광명5동,'10,5 - 9세,1998,1272,643,629
'4121056000,  광명5동,'15,10 - 14세,1998,1073,553,520
'4121056000,  광명5동,'20,15 - 19세,1998,1416,750,666
'4121056000,  광명5동,'25,20 - 24세,1998,1440,731,709
'4121056000,  광명5동,'30,25 - 29세,1998,1777,868,909
'4121056000,  광명5동,'35,30 - 34세,1998,1740,905,835
'4121056000,  광명5동,'40,35 - 39세,1998,1646,889,757
'4121056000,  광명5동,'45,40 - 44세,1998,1426,754,672
'4121056000,  광명5동,'50,45 - 49세,1998,913,448,465
'4121056000,  광명5동,'55,50 - 54세,1998,755,398,357
'4121056000,  광명5동,'60,55 - 59세,1998,694,341,353
'4121056000,  광명5동,'65,60 - 64세,1998,531,252,279
'4121056000,  광명5동,'70,65 - 69세,1998,393,160,233
'4121056000,  광명5동,'75,70 - 74세,1998,194,68,126
'4121056000,  광명5동,'80,75 - 79세,1998,168,50,118
'4121056000,  광명5동,'85,80 - 84세,1998,60,20,40
'4121056000,  광명5동,'90,85+ ,1998,41,9,32
'4121057000,  광명6동,'00,계,1998,16269,8242,8027
'4121057000,  광명6동,'05,0 - 4세,1998,1089,573,516
'4121057000,  광명6동,'10,5 - 9세,1998,1143,583,560
'4121057000,  광명6동,'15,10 - 14세,1998,1066,556,510
'4121057000,  광명6동,'20,15 - 19세,1998,1511,781,730
'4121057000,  광명6동,'25,20 - 24세,1998,1310,674,636
'4121057000,  광명6동,'30,25 - 29세,1998,1600,828,772
'4121057000,  광명6동,'35,30 - 34세,1998,1544,820,724
'4121057000,  광명6동,'40,35 - 39세,1998,1644,827,817
'4121057000,  광명6동,'45,40 - 44세,1998,1428,761,667
'4121057000,  광명6동,'50,45 - 49세,1998,929,481,448
'4121057000,  광명6동,'55,50 - 54세,1998,805,402,403
'4121057000,  광명6동,'60,55 - 59세,1998,703,351,352
'4121057000,  광명6동,'65,60 - 64세,1998,575,261,314
'4121057000,  광명6동,'70,65 - 69세,1998,402,164,238
'4121057000,  광명6동,'75,70 - 74세,1998,255,91,164
'4121057000,  광명6동,'80,75 - 79세,1998,169,60,109
'4121057000,  광명6동,'85,80 - 84세,1998,52,17,35
'4121057000,  광명6동,'90,85+ ,1998,44,12,32
'4121058000,  광명7동,'00,계,1998,29190,14862,14328
'4121058000,  광명7동,'05,0 - 4세,1998,2253,1225,1028
'4121058000,  광명7동,'10,5 - 9세,1998,2564,1358,1206
'4121058000,  광명7동,'15,10 - 14세,1998,2106,1116,990
'4121058000,  광명7동,'20,15 - 19세,1998,2445,1242,1203
'4121058000,  광명7동,'25,20 - 24세,1998,2208,1075,1133
'4121058000,  광명7동,'30,25 - 29세,1998,2940,1466,1474
'4121058000,  광명7동,'35,30 - 34세,1998,2972,1504,1468
'4121058000,  광명7동,'40,35 - 39세,1998,3227,1657,1570
'4121058000,  광명7동,'45,40 - 44세,1998,2524,1355,1169
'4121058000,  광명7동,'50,45 - 49세,1998,1567,844,723
'4121058000,  광명7동,'55,50 - 54세,1998,1278,665,613
'4121058000,  광명7동,'60,55 - 59세,1998,1060,520,540
'4121058000,  광명7동,'65,60 - 64세,1998,795,378,417
'4121058000,  광명7동,'70,65 - 69세,1998,547,237,310
'4121058000,  광명7동,'75,70 - 74세,1998,318,100,218
'4121058000,  광명7동,'80,75 - 79세,1998,227,82,145
'4121058000,  광명7동,'85,80 - 84세,1998,96,22,74
'4121058000,  광명7동,'90,85+ ,1998,63,16,47
'4121059000,  철산1동,'00,계,1998,12540,6232,6308
'4121059000,  철산1동,'05,0 - 4세,1998,1060,569,491
'4121059000,  철산1동,'10,5 - 9세,1998,1127,598,529
'4121059000,  철산1동,'15,10 - 14세,1998,1009,484,525
'4121059000,  철산1동,'20,15 - 19세,1998,901,486,415
'4121059000,  철산1동,'25,20 - 24세,1998,716,335,381
'4121059000,  철산1동,'30,25 - 29세,1998,1244,576,668
'4121059000,  철산1동,'35,30 - 34세,1998,1331,639,692
'4121059000,  철산1동,'40,35 - 39세,1998,1504,780,724
'4121059000,  철산1동,'45,40 - 44세,1998,1129,594,535
'4121059000,  철산1동,'50,45 - 49세,1998,630,345,285
'4121059000,  철산1동,'55,50 - 54세,1998,467,224,243
'4121059000,  철산1동,'60,55 - 59세,1998,468,213,255
'4121059000,  철산1동,'65,60 - 64세,1998,376,166,210
'4121059000,  철산1동,'70,65 - 69세,1998,226,90,136
'4121059000,  철산1동,'75,70 - 74세,1998,181,79,102
'4121059000,  철산1동,'80,75 - 79세,1998,98,34,64
'4121059000,  철산1동,'85,80 - 84세,1998,51,14,37
'4121059000,  철산1동,'90,85+ ,1998,22,6,16
'4121060000,  철산2동,'00,계,1998,22943,11596,11347
'4121060000,  철산2동,'05,0 - 4세,1998,2329,1232,1097
'4121060000,  철산2동,'10,5 - 9세,1998,2343,1238,1105
'4121060000,  철산2동,'15,10 - 14세,1998,1495,770,725
'4121060000,  철산2동,'20,15 - 19세,1998,1499,781,718
'4121060000,  철산2동,'25,20 - 24세,1998,1402,673,729
'4121060000,  철산2동,'30,25 - 29세,1998,2503,1229,1274
'4121060000,  철산2동,'35,30 - 34세,1998,3021,1444,1577
'4121060000,  철산2동,'40,35 - 39세,1998,2710,1521,1189
'4121060000,  철산2동,'45,40 - 44세,1998,1805,957,848
'4121060000,  철산2동,'50,45 - 49세,1998,1025,564,461
'4121060000,  철산2동,'55,50 - 54세,1998,643,321,322
'4121060000,  철산2동,'60,55 - 59세,1998,694,327,367
'4121060000,  철산2동,'65,60 - 64세,1998,496,202,294
'4121060000,  철산2동,'70,65 - 69세,1998,420,152,268
'4121060000,  철산2동,'75,70 - 74세,1998,256,95,161
'4121060000,  철산2동,'80,75 - 79세,1998,174,61,113
'4121060000,  철산2동,'85,80 - 84세,1998,78,22,56
'4121060000,  철산2동,'90,85+ ,1998,50,7,43
'4121061000,  철산3동,'00,계,1998,38801,19182,19619
'4121061000,  철산3동,'05,0 - 4세,1998,3127,1677,1450
'4121061000,  철산3동,'10,5 - 9세,1998,3810,2028,1782
'4121061000,  철산3동,'15,10 - 14세,1998,3383,1723,1660
'4121061000,  철산3동,'20,15 - 19세,1998,2894,1476,1418
'4121061000,  철산3동,'25,20 - 24세,1998,2043,1029,1014
'4121061000,  철산3동,'30,25 - 29세,1998,3121,1431,1690
'4121061000,  철산3동,'35,30 - 34세,1998,3947,1803,2144
'4121061000,  철산3동,'40,35 - 39세,1998,4882,2349,2533
'4121061000,  철산3동,'45,40 - 44세,1998,3896,2067,1829
'4121061000,  철산3동,'50,45 - 49세,1998,2104,1153,951
'4121061000,  철산3동,'55,50 - 54세,1998,1323,697,626
'4121061000,  철산3동,'60,55 - 59세,1998,1183,535,648
'4121061000,  철산3동,'65,60 - 64세,1998,1088,474,614
'4121061000,  철산3동,'70,65 - 69세,1998,815,295,520
'4121061000,  철산3동,'75,70 - 74세,1998,549,213,336
'4121061000,  철산3동,'80,75 - 79세,1998,373,155,218
'4121061000,  철산3동,'85,80 - 84세,1998,165,53,112
'4121061000,  철산3동,'90,85+ ,1998,98,24,74
'4121062000,  철산4동,'00,계,1998,10342,5259,5083
'4121062000,  철산4동,'05,0 - 4세,1998,703,379,324
'4121062000,  철산4동,'10,5 - 9세,1998,646,353,293
'4121062000,  철산4동,'15,10 - 14세,1998,590,298,292
'4121062000,  철산4동,'20,15 - 19세,1998,970,489,481
'4121062000,  철산4동,'25,20 - 24세,1998,1053,519,534
'4121062000,  철산4동,'30,25 - 29세,1998,1220,660,560
'4121062000,  철산4동,'35,30 - 34세,1998,1008,544,464
'4121062000,  철산4동,'40,35 - 39세,1998,863,464,399
'4121062000,  철산4동,'45,40 - 44세,1998,796,364,432
'4121062000,  철산4동,'50,45 - 49세,1998,644,331,313
'4121062000,  철산4동,'55,50 - 54세,1998,525,269,256
'4121062000,  철산4동,'60,55 - 59세,1998,500,252,248
'4121062000,  철산4동,'65,60 - 64세,1998,367,161,206
'4121062000,  철산4동,'70,65 - 69세,1998,188,84,104
'4121062000,  철산4동,'75,70 - 74세,1998,118,47,71
'4121062000,  철산4동,'80,75 - 79세,1998,82,22,60
'4121062000,  철산4동,'85,80 - 84세,1998,40,13,27
'4121062000,  철산4동,'90,85+ ,1998,29,10,19
'4121063100,  하안1동,'00,계,1998,27892,13694,14198
'4121063100,  하안1동,'05,0 - 4세,1998,2982,1549,1433
'4121063100,  하안1동,'10,5 - 9세,1998,2691,1447,1244
'4121063100,  하안1동,'15,10 - 14세,1998,1866,945,921
'4121063100,  하안1동,'20,15 - 19세,1998,1587,805,782
'4121063100,  하안1동,'25,20 - 24세,1998,1692,727,965
'4121063100,  하안1동,'30,25 - 29세,1998,3150,1316,1834
'4121063100,  하안1동,'35,30 - 34세,1998,3802,1863,1939
'4121063100,  하안1동,'40,35 - 39세,1998,3426,1808,1618
'4121063100,  하안1동,'45,40 - 44세,1998,2220,1232,988
'4121063100,  하안1동,'50,45 - 49세,1998,1118,625,493
'4121063100,  하안1동,'55,50 - 54세,1998,800,409,391
'4121063100,  하안1동,'60,55 - 59세,1998,720,323,397
'4121063100,  하안1동,'65,60 - 64세,1998,620,226,394
'4121063100,  하안1동,'70,65 - 69세,1998,527,190,337
'4121063100,  하안1동,'75,70 - 74세,1998,325,122,203
'4121063100,  하안1동,'80,75 - 79세,1998,221,75,146
'4121063100,  하안1동,'85,80 - 84세,1998,94,25,69
'4121063100,  하안1동,'90,85+ ,1998,51,7,44
'4121063200,  하안2동,'00,계,1998,21431,10552,10879
'4121063200,  하안2동,'05,0 - 4세,1998,2594,1342,1252
'4121063200,  하안2동,'10,5 - 9세,1998,1868,976,892
'4121063200,  하안2동,'15,10 - 14세,1998,1380,744,636
'4121063200,  하안2동,'20,15 - 19세,1998,1354,668,686
'4121063200,  하안2동,'25,20 - 24세,1998,999,485,514
'4121063200,  하안2동,'30,25 - 29세,1998,2602,1038,1564
'4121063200,  하안2동,'35,30 - 34세,1998,3212,1681,1531
'4121063200,  하안2동,'40,35 - 39세,1998,2565,1356,1209
'4121063200,  하안2동,'45,40 - 44세,1998,1766,923,843
'4121063200,  하안2동,'50,45 - 49세,1998,872,499,373
'4121063200,  하안2동,'55,50 - 54세,1998,533,285,248
'4121063200,  하안2동,'60,55 - 59세,1998,456,178,278
'4121063200,  하안2동,'65,60 - 64세,1998,393,134,259
'4121063200,  하안2동,'70,65 - 69세,1998,319,91,228
'4121063200,  하안2동,'75,70 - 74세,1998,243,68,175
'4121063200,  하안2동,'80,75 - 79세,1998,166,52,114
'4121063200,  하안2동,'85,80 - 84세,1998,74,24,50
'4121063200,  하안2동,'90,85+ ,1998,35,8,27
'4121063300,  하안3동,'00,계,1998,29433,14438,14995
'4121063300,  하안3동,'05,0 - 4세,1998,2659,1395,1264
'4121063300,  하안3동,'10,5 - 9세,1998,2637,1411,1226
'4121063300,  하안3동,'15,10 - 14세,1998,2074,1052,1022
'4121063300,  하안3동,'20,15 - 19세,1998,2395,1221,1174
'4121063300,  하안3동,'25,20 - 24세,1998,2125,1124,1001
'4121063300,  하안3동,'30,25 - 29세,1998,2774,1274,1500
'4121063300,  하안3동,'35,30 - 34세,1998,3256,1585,1671
'4121063300,  하안3동,'40,35 - 39세,1998,3405,1674,1731
'4121063300,  하안3동,'45,40 - 44세,1998,2469,1303,1166
'4121063300,  하안3동,'50,45 - 49세,1998,1418,680,738
'4121063300,  하안3동,'55,50 - 54세,1998,1037,472,565
'4121063300,  하안3동,'60,55 - 59세,1998,968,425,543
'4121063300,  하안3동,'65,60 - 64세,1998,730,309,421
'4121063300,  하안3동,'70,65 - 69세,1998,595,226,369
'4121063300,  하안3동,'75,70 - 74세,1998,400,130,270
'4121063300,  하안3동,'80,75 - 79세,1998,274,95,179
'4121063300,  하안3동,'85,80 - 84세,1998,152,44,108
'4121063300,  하안3동,'90,85+ ,1998,65,18,47
'4121063400,  하안4동,'00,계,1998,16892,8406,8486
'4121063400,  하안4동,'05,0 - 4세,1998,1963,1017,946
'4121063400,  하안4동,'10,5 - 9세,1998,1894,1019,875
'4121063400,  하안4동,'15,10 - 14세,1998,1421,720,701
'4121063400,  하안4동,'20,15 - 19세,1998,926,486,440
'4121063400,  하안4동,'25,20 - 24세,1998,577,269,308
'4121063400,  하안4동,'30,25 - 29세,1998,1668,670,998
'4121063400,  하안4동,'35,30 - 34세,1998,2374,1162,1212
'4121063400,  하안4동,'40,35 - 39세,1998,2333,1161,1172
'4121063400,  하안4동,'45,40 - 44세,1998,1545,865,680
'4121063400,  하안4동,'50,45 - 49세,1998,591,369,222
'4121063400,  하안4동,'55,50 - 54세,1998,370,203,167
'4121063400,  하안4동,'60,55 - 59세,1998,329,151,178
'4121063400,  하안4동,'65,60 - 64세,1998,303,113,190
'4121063400,  하안4동,'70,65 - 69세,1998,232,77,155
'4121063400,  하안4동,'75,70 - 74세,1998,189,66,123
'4121063400,  하안4동,'80,75 - 79세,1998,111,37,74
'4121063400,  하안4동,'85,80 - 84세,1998,42,15,27
'4121063400,  하안4동,'90,85+ ,1998,24,6,18
'4121064000,  소하1동,'00,계,1998,10855,5660,5195
'4121064000,  소하1동,'05,0 - 4세,1998,601,323,278
'4121064000,  소하1동,'10,5 - 9세,1998,665,369,296
'4121064000,  소하1동,'15,10 - 14세,1998,634,309,325
'4121064000,  소하1동,'20,15 - 19세,1998,1006,521,485
'4121064000,  소하1동,'25,20 - 24세,1998,962,512,450
'4121064000,  소하1동,'30,25 - 29세,1998,1012,583,429
'4121064000,  소하1동,'35,30 - 34세,1998,941,495,446
'4121064000,  소하1동,'40,35 - 39세,1998,1018,564,454
'4121064000,  소하1동,'45,40 - 44세,1998,926,497,429
'4121064000,  소하1동,'50,45 - 49세,1998,719,396,323
'4121064000,  소하1동,'55,50 - 54세,1998,602,306,296
'4121064000,  소하1동,'60,55 - 59세,1998,612,301,311
'4121064000,  소하1동,'65,60 - 64세,1998,448,209,239
'4121064000,  소하1동,'70,65 - 69세,1998,294,134,160
'4121064000,  소하1동,'75,70 - 74세,1998,195,77,118
'4121064000,  소하1동,'80,75 - 79세,1998,112,36,76
'4121064000,  소하1동,'85,80 - 84세,1998,67,20,47
'4121064000,  소하1동,'90,85+ ,1998,41,8,33
'4121065000,  소하2동,'00,계,1998,24149,12388,11761
'4121065000,  소하2동,'05,0 - 4세,1998,1976,1062,914
'4121065000,  소하2동,'10,5 - 9세,1998,2198,1187,1011
'4121065000,  소하2동,'15,10 - 14세,1998,1564,783,781
'4121065000,  소하2동,'20,15 - 19세,1998,1847,905,942
'4121065000,  소하2동,'25,20 - 24세,1998,1856,924,932
'4121065000,  소하2동,'30,25 - 29세,1998,2490,1316,1174
'4121065000,  소하2동,'35,30 - 34세,1998,2714,1374,1340
'4121065000,  소하2동,'40,35 - 39세,1998,2663,1458,1205
'4121065000,  소하2동,'45,40 - 44세,1998,1834,997,837
'4121065000,  소하2동,'50,45 - 49세,1998,1201,628,573
'4121065000,  소하2동,'55,50 - 54세,1998,1045,524,521
'4121065000,  소하2동,'60,55 - 59세,1998,991,497,494
'4121065000,  소하2동,'65,60 - 64세,1998,710,338,372
'4121065000,  소하2동,'70,65 - 69세,1998,400,161,239
'4121065000,  소하2동,'75,70 - 74세,1998,292,125,167
'4121065000,  소하2동,'80,75 - 79세,1998,212,71,141
'4121065000,  소하2동,'85,80 - 84세,1998,91,24,67
'4121065000,  소하2동,'90,85+ ,1998,65,14,51
'4121066000,  학온동,'00,계,1998,3948,2080,1868
'4121066000,  학온동,'05,0 - 4세,1998,218,122,96
'4121066000,  학온동,'10,5 - 9세,1998,256,148,108
'4121066000,  학온동,'15,10 - 14세,1998,238,138,100
'4121066000,  학온동,'20,15 - 19세,1998,345,179,166
'4121066000,  학온동,'25,20 - 24세,1998,327,180,147
'4121066000,  학온동,'30,25 - 29세,1998,302,159,143
'4121066000,  학온동,'35,30 - 34세,1998,325,181,144
'4121066000,  학온동,'40,35 - 39세,1998,372,214,158
'4121066000,  학온동,'45,40 - 44세,1998,313,168,145
'4121066000,  학온동,'50,45 - 49세,1998,223,123,100
'4121066000,  학온동,'55,50 - 54세,1998,217,115,102
'4121066000,  학온동,'60,55 - 59세,1998,230,107,123
'4121066000,  학온동,'65,60 - 64세,1998,220,101,119
'4121066000,  학온동,'70,65 - 69세,1998,136,61,75
'4121066000,  학온동,'75,70 - 74세,1998,93,35,58
'4121066000,  학온동,'80,75 - 79세,1998,68,29,39
'4121066000,  학온동,'85,80 - 84세,1998,39,11,28
'4121066000,  학온동,'90,85+ ,1998,26,9,17
'41220, 평택시,'00,계,1998,346694,174641,172053
'41220, 평택시,'05,0 - 4세,1998,30668,16044,14624
'41220, 평택시,'10,5 - 9세,1998,28887,14883,14004
'41220, 평택시,'15,10 - 14세,1998,22729,11701,11028
'41220, 평택시,'20,15 - 19세,1998,25126,12863,12263
'41220, 평택시,'25,20 - 24세,1998,25842,12905,12937
'41220, 평택시,'30,25 - 29세,1998,36386,18203,18183
'41220, 평택시,'35,30 - 34세,1998,37285,19345,17940
'41220, 평택시,'40,35 - 39세,1998,35256,19049,16207
'41220, 평택시,'45,40 - 44세,1998,24684,13193,11491
'41220, 평택시,'50,45 - 49세,1998,15927,8069,7858
'41220, 평택시,'55,50 - 54세,1998,14102,6946,7156
'41220, 평택시,'60,55 - 59세,1998,14817,6950,7867
'41220, 평택시,'65,60 - 64세,1998,13109,5910,7199
'41220, 평택시,'70,65 - 69세,1998,8721,3639,5082
'41220, 평택시,'75,70 - 74세,1998,5781,2252,3529
'41220, 평택시,'80,75 - 79세,1998,3973,1570,2403
'41220, 평택시,'85,80 - 84세,1998,2133,786,1347
'41220, 평택시,'90,85+ ,1998,1268,333,935
'4122025000,  팽성읍,'00,계,1998,28738,14490,14248
'4122025000,  팽성읍,'05,0 - 4세,1998,1895,999,896
'4122025000,  팽성읍,'10,5 - 9세,1998,1627,822,805
'4122025000,  팽성읍,'15,10 - 14세,1998,1320,664,656
'4122025000,  팽성읍,'20,15 - 19세,1998,2291,1175,1116
'4122025000,  팽성읍,'25,20 - 24세,1998,2569,1347,1222
'4122025000,  팽성읍,'30,25 - 29세,1998,3035,1617,1418
'4122025000,  팽성읍,'35,30 - 34세,1998,2396,1373,1023
'4122025000,  팽성읍,'40,35 - 39세,1998,2288,1244,1044
'4122025000,  팽성읍,'45,40 - 44세,1998,1940,1014,926
'4122025000,  팽성읍,'50,45 - 49세,1998,1510,716,794
'4122025000,  팽성읍,'55,50 - 54세,1998,1634,763,871
'4122025000,  팽성읍,'60,55 - 59세,1998,1887,859,1028
'4122025000,  팽성읍,'65,60 - 64세,1998,1725,811,914
'4122025000,  팽성읍,'70,65 - 69세,1998,1071,486,585
'4122025000,  팽성읍,'75,70 - 74세,1998,715,287,428
'4122025000,  팽성읍,'80,75 - 79세,1998,452,187,265
'4122025000,  팽성읍,'85,80 - 84세,1998,236,89,147
'4122025000,  팽성읍,'90,85+ ,1998,147,37,110
'4122031000,  진위면,'00,계,1998,14697,7271,7426
'4122031000,  진위면,'05,0 - 4세,1998,1387,727,660
'4122031000,  진위면,'10,5 - 9세,1998,1283,650,633
'4122031000,  진위면,'15,10 - 14세,1998,815,430,385
'4122031000,  진위면,'20,15 - 19세,1998,989,490,499
'4122031000,  진위면,'25,20 - 24세,1998,1596,525,1071
'4122031000,  진위면,'30,25 - 29세,1998,1594,815,779
'4122031000,  진위면,'35,30 - 34세,1998,1677,902,775
'4122031000,  진위면,'40,35 - 39세,1998,1371,802,569
'4122031000,  진위면,'45,40 - 44세,1998,895,500,395
'4122031000,  진위면,'50,45 - 49세,1998,655,332,323
'4122031000,  진위면,'55,50 - 54세,1998,534,276,258
'4122031000,  진위면,'60,55 - 59세,1998,530,263,267
'4122031000,  진위면,'65,60 - 64세,1998,485,213,272
'4122031000,  진위면,'70,65 - 69세,1998,355,149,206
'4122031000,  진위면,'75,70 - 74세,1998,211,75,136
'4122031000,  진위면,'80,75 - 79세,1998,173,75,98
'4122031000,  진위면,'85,80 - 84세,1998,93,33,60
'4122031000,  진위면,'90,85+ ,1998,54,14,40
'4122032000,  서탄면,'00,계,1998,4844,2496,2348
'4122032000,  서탄면,'05,0 - 4세,1998,235,117,118
'4122032000,  서탄면,'10,5 - 9세,1998,238,115,123
'4122032000,  서탄면,'15,10 - 14세,1998,229,118,111
'4122032000,  서탄면,'20,15 - 19세,1998,427,220,207
'4122032000,  서탄면,'25,20 - 24세,1998,457,251,206
'4122032000,  서탄면,'30,25 - 29세,1998,433,268,165
'4122032000,  서탄면,'35,30 - 34세,1998,316,194,122
'4122032000,  서탄면,'40,35 - 39세,1998,346,196,150
'4122032000,  서탄면,'45,40 - 44세,1998,335,180,155
'4122032000,  서탄면,'50,45 - 49세,1998,276,141,135
'4122032000,  서탄면,'55,50 - 54세,1998,265,137,128
'4122032000,  서탄면,'60,55 - 59세,1998,322,154,168
'4122032000,  서탄면,'65,60 - 64세,1998,342,158,184
'4122032000,  서탄면,'70,65 - 69세,1998,244,105,139
'4122032000,  서탄면,'75,70 - 74세,1998,181,66,115
'4122032000,  서탄면,'80,75 - 79세,1998,112,56,56
'4122032000,  서탄면,'85,80 - 84세,1998,47,12,35
'4122032000,  서탄면,'90,85+ ,1998,39,8,31
'4122033000,  고덕면,'00,계,1998,14960,7668,7292
'4122033000,  고덕면,'05,0 - 4세,1998,1656,862,794
'4122033000,  고덕면,'10,5 - 9세,1998,1242,661,581
'4122033000,  고덕면,'15,10 - 14세,1998,839,429,410
'4122033000,  고덕면,'20,15 - 19세,1998,969,506,463
'4122033000,  고덕면,'25,20 - 24세,1998,1054,524,530
'4122033000,  고덕면,'30,25 - 29세,1998,1742,836,906
'4122033000,  고덕면,'35,30 - 34세,1998,1870,1062,808
'4122033000,  고덕면,'40,35 - 39세,1998,1295,742,553
'4122033000,  고덕면,'45,40 - 44세,1998,890,509,381
'4122033000,  고덕면,'50,45 - 49세,1998,600,307,293
'4122033000,  고덕면,'55,50 - 54세,1998,555,291,264
'4122033000,  고덕면,'60,55 - 59세,1998,618,291,327
'4122033000,  고덕면,'65,60 - 64세,1998,561,249,312
'4122033000,  고덕면,'70,65 - 69세,1998,414,152,262
'4122033000,  고덕면,'75,70 - 74세,1998,293,118,175
'4122033000,  고덕면,'80,75 - 79세,1998,199,75,124
'4122033000,  고덕면,'85,80 - 84세,1998,105,37,68
'4122033000,  고덕면,'90,85+ ,1998,58,17,41
'4122034000,  오성면,'00,계,1998,6928,3524,3404
'4122034000,  오성면,'05,0 - 4세,1998,395,202,193
'4122034000,  오성면,'10,5 - 9세,1998,428,228,200
'4122034000,  오성면,'15,10 - 14세,1998,409,197,212
'4122034000,  오성면,'20,15 - 19세,1998,545,268,277
'4122034000,  오성면,'25,20 - 24세,1998,627,342,285
'4122034000,  오성면,'30,25 - 29세,1998,606,352,254
'4122034000,  오성면,'35,30 - 34세,1998,523,281,242
'4122034000,  오성면,'40,35 - 39세,1998,572,330,242
'4122034000,  오성면,'45,40 - 44세,1998,432,242,190
'4122034000,  오성면,'50,45 - 49세,1998,352,173,179
'4122034000,  오성면,'55,50 - 54세,1998,346,171,175
'4122034000,  오성면,'60,55 - 59세,1998,490,241,249
'4122034000,  오성면,'65,60 - 64세,1998,444,188,256
'4122034000,  오성면,'70,65 - 69세,1998,295,118,177
'4122034000,  오성면,'75,70 - 74세,1998,169,72,97
'4122034000,  오성면,'80,75 - 79세,1998,151,56,95
'4122034000,  오성면,'85,80 - 84세,1998,100,44,56
'4122034000,  오성면,'90,85+ ,1998,44,19,25
'4122035000,  청북면,'00,계,1998,7376,3756,3620
'4122035000,  청북면,'05,0 - 4세,1998,346,181,165
'4122035000,  청북면,'10,5 - 9세,1998,359,171,188
'4122035000,  청북면,'15,10 - 14세,1998,441,229,212
'4122035000,  청북면,'20,15 - 19세,1998,604,293,311
'4122035000,  청북면,'25,20 - 24세,1998,669,372,297
'4122035000,  청북면,'30,25 - 29세,1998,528,342,186
'4122035000,  청북면,'35,30 - 34세,1998,468,265,203
'4122035000,  청북면,'40,35 - 39세,1998,569,298,271
'4122035000,  청북면,'45,40 - 44세,1998,547,297,250
'4122035000,  청북면,'50,45 - 49세,1998,395,194,201
'4122035000,  청북면,'55,50 - 54세,1998,416,227,189
'4122035000,  청북면,'60,55 - 59세,1998,500,230,270
'4122035000,  청북면,'65,60 - 64세,1998,502,217,285
'4122035000,  청북면,'70,65 - 69세,1998,355,150,205
'4122035000,  청북면,'75,70 - 74세,1998,284,111,173
'4122035000,  청북면,'80,75 - 79세,1998,197,100,97
'4122035000,  청북면,'85,80 - 84세,1998,127,65,62
'4122035000,  청북면,'90,85+ ,1998,69,14,55
'4122036000,  포승면,'00,계,1998,13656,7085,6571
'4122036000,  포승면,'05,0 - 4세,1998,1257,649,608
'4122036000,  포승면,'10,5 - 9세,1998,985,530,455
'4122036000,  포승면,'15,10 - 14세,1998,847,445,402
'4122036000,  포승면,'20,15 - 19세,1998,906,468,438
'4122036000,  포승면,'25,20 - 24세,1998,960,504,456
'4122036000,  포승면,'30,25 - 29세,1998,1510,844,666
'4122036000,  포승면,'35,30 - 34세,1998,1379,782,597
'4122036000,  포승면,'40,35 - 39세,1998,1211,674,537
'4122036000,  포승면,'45,40 - 44세,1998,872,481,391
'4122036000,  포승면,'50,45 - 49세,1998,603,311,292
'4122036000,  포승면,'55,50 - 54세,1998,537,281,256
'4122036000,  포승면,'60,55 - 59세,1998,656,283,373
'4122036000,  포승면,'65,60 - 64세,1998,712,338,374
'4122036000,  포승면,'70,65 - 69세,1998,501,213,288
'4122036000,  포승면,'75,70 - 74세,1998,302,120,182
'4122036000,  포승면,'80,75 - 79세,1998,234,96,138
'4122036000,  포승면,'85,80 - 84세,1998,111,44,67
'4122036000,  포승면,'90,85+ ,1998,73,22,51
'4122037000,  현덕면,'00,계,1998,7822,3978,3844
'4122037000,  현덕면,'05,0 - 4세,1998,504,256,248
'4122037000,  현덕면,'10,5 - 9세,1998,490,253,237
'4122037000,  현덕면,'15,10 - 14세,1998,406,212,194
'4122037000,  현덕면,'20,15 - 19세,1998,635,321,314
'4122037000,  현덕면,'25,20 - 24세,1998,708,408,300
'4122037000,  현덕면,'30,25 - 29세,1998,686,381,305
'4122037000,  현덕면,'35,30 - 34세,1998,615,357,258
'4122037000,  현덕면,'40,35 - 39세,1998,607,342,265
'4122037000,  현덕면,'45,40 - 44세,1998,489,257,232
'4122037000,  현덕면,'50,45 - 49세,1998,441,211,230
'4122037000,  현덕면,'55,50 - 54세,1998,405,209,196
'4122037000,  현덕면,'60,55 - 59세,1998,452,199,253
'4122037000,  현덕면,'65,60 - 64세,1998,514,226,288
'4122037000,  현덕면,'70,65 - 69세,1998,350,144,206
'4122037000,  현덕면,'75,70 - 74세,1998,216,91,125
'4122037000,  현덕면,'80,75 - 79세,1998,148,62,86
'4122037000,  현덕면,'85,80 - 84세,1998,103,37,66
'4122037000,  현덕면,'90,85+ ,1998,53,12,41
'4122038000,  안중면,'00,계,1998,12953,6493,6460
'4122038000,  안중면,'05,0 - 4세,1998,938,512,426
'4122038000,  안중면,'10,5 - 9세,1998,961,479,482
'4122038000,  안중면,'15,10 - 14세,1998,841,444,397
'4122038000,  안중면,'20,15 - 19세,1998,1063,551,512
'4122038000,  안중면,'25,20 - 24세,1998,1111,552,559
'4122038000,  안중면,'30,25 - 29세,1998,1180,617,563
'4122038000,  안중면,'35,30 - 34세,1998,1161,609,552
'4122038000,  안중면,'40,35 - 39세,1998,1163,605,558
'4122038000,  안중면,'45,40 - 44세,1998,896,461,435
'4122038000,  안중면,'50,45 - 49세,1998,673,324,349
'4122038000,  안중면,'55,50 - 54세,1998,618,305,313
'4122038000,  안중면,'60,55 - 59세,1998,682,352,330
'4122038000,  안중면,'65,60 - 64세,1998,618,270,348
'4122038000,  안중면,'70,65 - 69세,1998,399,163,236
'4122038000,  안중면,'75,70 - 74세,1998,253,102,151
'4122038000,  안중면,'80,75 - 79세,1998,190,72,118
'4122038000,  안중면,'85,80 - 84세,1998,131,47,84
'4122038000,  안중면,'90,85+ ,1998,75,28,47
'4122051000,  중앙동,'00,계,1998,30558,15298,15260
'4122051000,  중앙동,'05,0 - 4세,1998,3201,1654,1547
'4122051000,  중앙동,'10,5 - 9세,1998,3085,1552,1533
'4122051000,  중앙동,'15,10 - 14세,1998,2231,1145,1086
'4122051000,  중앙동,'20,15 - 19세,1998,2011,1009,1002
'4122051000,  중앙동,'25,20 - 24세,1998,1716,833,883
'4122051000,  중앙동,'30,25 - 29세,1998,3340,1542,1798
'4122051000,  중앙동,'35,30 - 34세,1998,3819,1915,1904
'4122051000,  중앙동,'40,35 - 39세,1998,3644,2015,1629
'4122051000,  중앙동,'45,40 - 44세,1998,2199,1194,1005
'4122051000,  중앙동,'50,45 - 49세,1998,1245,684,561
'4122051000,  중앙동,'55,50 - 54세,1998,988,504,484
'4122051000,  중앙동,'60,55 - 59세,1998,904,414,490
'4122051000,  중앙동,'65,60 - 64세,1998,787,326,461
'4122051000,  중앙동,'70,65 - 69세,1998,546,219,327
'4122051000,  중앙동,'75,70 - 74세,1998,395,144,251
'4122051000,  중앙동,'80,75 - 79세,1998,256,92,164
'4122051000,  중앙동,'85,80 - 84세,1998,125,41,84
'4122051000,  중앙동,'90,85+ ,1998,66,15,51
'4122052000,  서정동,'00,계,1998,32993,16629,16364
'4122052000,  서정동,'05,0 - 4세,1998,3546,1875,1671
'4122052000,  서정동,'10,5 - 9세,1998,2982,1558,1424
'4122052000,  서정동,'15,10 - 14세,1998,2098,1070,1028
'4122052000,  서정동,'20,15 - 19세,1998,2032,1027,1005
'4122052000,  서정동,'25,20 - 24세,1998,2418,1146,1272
'4122052000,  서정동,'30,25 - 29세,1998,4278,2054,2224
'4122052000,  서정동,'35,30 - 34세,1998,4024,2121,1903
'4122052000,  서정동,'40,35 - 39세,1998,3504,1915,1589
'4122052000,  서정동,'45,40 - 44세,1998,2232,1202,1030
'4122052000,  서정동,'50,45 - 49세,1998,1281,658,623
'4122052000,  서정동,'55,50 - 54세,1998,1122,515,607
'4122052000,  서정동,'60,55 - 59세,1998,1074,522,552
'4122052000,  서정동,'65,60 - 64세,1998,935,403,532
'4122052000,  서정동,'70,65 - 69세,1998,639,260,379
'4122052000,  서정동,'75,70 - 74세,1998,375,144,231
'4122052000,  서정동,'80,75 - 79세,1998,252,100,152
'4122052000,  서정동,'85,80 - 84세,1998,111,34,77
'4122052000,  서정동,'90,85+ ,1998,90,25,65
'4122053500,  송탄동,'00,계,1998,4261,2358,1903
'4122053500,  송탄동,'05,0 - 4세,1998,194,99,95
'4122053500,  송탄동,'10,5 - 9세,1998,168,83,85
'4122053500,  송탄동,'15,10 - 14세,1998,251,137,114
'4122053500,  송탄동,'20,15 - 19세,1998,360,200,160
'4122053500,  송탄동,'25,20 - 24세,1998,406,255,151
'4122053500,  송탄동,'30,25 - 29세,1998,512,379,133
'4122053500,  송탄동,'35,30 - 34세,1998,310,198,112
'4122053500,  송탄동,'40,35 - 39세,1998,328,178,150
'4122053500,  송탄동,'45,40 - 44세,1998,265,149,116
'4122053500,  송탄동,'50,45 - 49세,1998,243,123,120
'4122053500,  송탄동,'55,50 - 54세,1998,229,116,113
'4122053500,  송탄동,'60,55 - 59세,1998,263,133,130
'4122053500,  송탄동,'65,60 - 64세,1998,236,114,122
'4122053500,  송탄동,'70,65 - 69세,1998,176,75,101
'4122053500,  송탄동,'75,70 - 74세,1998,133,48,85
'4122053500,  송탄동,'80,75 - 79세,1998,95,35,60
'4122053500,  송탄동,'85,80 - 84세,1998,61,26,35
'4122053500,  송탄동,'90,85+ ,1998,31,10,21
'4122055000,  지산동,'00,계,1998,12183,6027,6156
'4122055000,  지산동,'05,0 - 4세,1998,1211,622,589
'4122055000,  지산동,'10,5 - 9세,1998,1225,660,565
'4122055000,  지산동,'15,10 - 14세,1998,759,370,389
'4122055000,  지산동,'20,15 - 19세,1998,807,394,413
'4122055000,  지산동,'25,20 - 24세,1998,812,368,444
'4122055000,  지산동,'30,25 - 29세,1998,1310,599,711
'4122055000,  지산동,'35,30 - 34세,1998,1467,714,753
'4122055000,  지산동,'40,35 - 39세,1998,1427,804,623
'4122055000,  지산동,'45,40 - 44세,1998,832,455,377
'4122055000,  지산동,'50,45 - 49세,1998,491,250,241
'4122055000,  지산동,'55,50 - 54세,1998,451,214,237
'4122055000,  지산동,'60,55 - 59세,1998,437,194,243
'4122055000,  지산동,'65,60 - 64세,1998,363,166,197
'4122055000,  지산동,'70,65 - 69세,1998,260,101,159
'4122055000,  지산동,'75,70 - 74세,1998,167,57,110
'4122055000,  지산동,'80,75 - 79세,1998,88,32,56
'4122055000,  지산동,'85,80 - 84세,1998,53,20,33
'4122055000,  지산동,'90,85+ ,1998,23,7,16
'4122056000,  송북동,'00,계,1998,21989,10986,11003
'4122056000,  송북동,'05,0 - 4세,1998,2398,1268,1130
'4122056000,  송북동,'10,5 - 9세,1998,2412,1248,1164
'4122056000,  송북동,'15,10 - 14세,1998,1539,767,772
'4122056000,  송북동,'20,15 - 19세,1998,1267,616,651
'4122056000,  송북동,'25,20 - 24세,1998,1204,607,597
'4122056000,  송북동,'30,25 - 29세,1998,2176,967,1209
'4122056000,  송북동,'35,30 - 34세,1998,2927,1393,1534
'4122056000,  송북동,'40,35 - 39세,1998,2737,1541,1196
'4122056000,  송북동,'45,40 - 44세,1998,1499,838,661
'4122056000,  송북동,'50,45 - 49세,1998,846,462,384
'4122056000,  송북동,'55,50 - 54세,1998,686,333,353
'4122056000,  송북동,'60,55 - 59세,1998,645,274,371
'4122056000,  송북동,'65,60 - 64세,1998,603,254,349
'4122056000,  송북동,'70,65 - 69세,1998,433,174,259
'4122056000,  송북동,'75,70 - 74세,1998,294,113,181
'4122056000,  송북동,'80,75 - 79세,1998,188,87,101
'4122056000,  송북동,'85,80 - 84세,1998,93,36,57
'4122056000,  송북동,'90,85+ ,1998,42,8,34
'4122057000,  신장1동,'00,계,1998,6989,3347,3642
'4122057000,  신장1동,'05,0 - 4세,1998,462,248,214
'4122057000,  신장1동,'10,5 - 9세,1998,465,214,251
'4122057000,  신장1동,'15,10 - 14세,1998,373,176,197
'4122057000,  신장1동,'20,15 - 19세,1998,497,270,227
'4122057000,  신장1동,'25,20 - 24세,1998,597,287,310
'4122057000,  신장1동,'30,25 - 29세,1998,836,442,394
'4122057000,  신장1동,'35,30 - 34세,1998,705,348,357
'4122057000,  신장1동,'40,35 - 39세,1998,638,316,322
'4122057000,  신장1동,'45,40 - 44세,1998,505,240,265
'4122057000,  신장1동,'50,45 - 49세,1998,353,164,189
'4122057000,  신장1동,'55,50 - 54세,1998,348,148,200
'4122057000,  신장1동,'60,55 - 59세,1998,398,174,224
'4122057000,  신장1동,'65,60 - 64세,1998,337,138,199
'4122057000,  신장1동,'70,65 - 69세,1998,220,85,135
'4122057000,  신장1동,'75,70 - 74세,1998,114,48,66
'4122057000,  신장1동,'80,75 - 79세,1998,81,34,47
'4122057000,  신장1동,'85,80 - 84세,1998,31,11,20
'4122057000,  신장1동,'90,85+ ,1998,29,4,25
'4122058000,  신장2동,'00,계,1998,10399,5158,5241
'4122058000,  신장2동,'05,0 - 4세,1998,634,319,315
'4122058000,  신장2동,'10,5 - 9세,1998,691,347,344
'4122058000,  신장2동,'15,10 - 14세,1998,636,308,328
'4122058000,  신장2동,'20,15 - 19세,1998,853,422,431
'4122058000,  신장2동,'25,20 - 24세,1998,920,469,451
'4122058000,  신장2동,'30,25 - 29세,1998,1110,621,489
'4122058000,  신장2동,'35,30 - 34세,1998,917,471,446
'4122058000,  신장2동,'40,35 - 39세,1998,866,452,414
'4122058000,  신장2동,'45,40 - 44세,1998,783,407,376
'4122058000,  신장2동,'50,45 - 49세,1998,572,271,301
'4122058000,  신장2동,'55,50 - 54세,1998,544,228,316
'4122058000,  신장2동,'60,55 - 59세,1998,666,316,350
'4122058000,  신장2동,'65,60 - 64세,1998,480,210,270
'4122058000,  신장2동,'70,65 - 69세,1998,331,148,183
'4122058000,  신장2동,'75,70 - 74세,1998,182,89,93
'4122058000,  신장2동,'80,75 - 79세,1998,106,40,66
'4122058000,  신장2동,'85,80 - 84세,1998,62,26,36
'4122058000,  신장2동,'90,85+ ,1998,46,14,32
'4122059000,  신평동,'00,계,1998,20405,10249,10156
'4122059000,  신평동,'05,0 - 4세,1998,1403,755,648
'4122059000,  신평동,'10,5 - 9세,1998,1393,752,641
'4122059000,  신평동,'15,10 - 14세,1998,1513,799,714
'4122059000,  신평동,'20,15 - 19세,1998,1873,981,892
'4122059000,  신평동,'25,20 - 24세,1998,1734,942,792
'4122059000,  신평동,'30,25 - 29세,1998,2118,1076,1042
'4122059000,  신평동,'35,30 - 34세,1998,1816,946,870
'4122059000,  신평동,'40,35 - 39세,1998,1953,951,1002
'4122059000,  신평동,'45,40 - 44세,1998,1750,862,888
'4122059000,  신평동,'50,45 - 49세,1998,1125,528,597
'4122059000,  신평동,'55,50 - 54세,1998,1006,490,516
'4122059000,  신평동,'60,55 - 59세,1998,904,435,469
'4122059000,  신평동,'65,60 - 64세,1998,702,335,367
'4122059000,  신평동,'70,65 - 69세,1998,431,178,253
'4122059000,  신평동,'75,70 - 74세,1998,293,95,198
'4122059000,  신평동,'80,75 - 79세,1998,238,86,152
'4122059000,  신평동,'85,80 - 84세,1998,90,24,66
'4122059000,  신평동,'90,85+ ,1998,63,14,49
'4122060000,  원평동,'00,계,1998,10419,5239,5180
'4122060000,  원평동,'05,0 - 4세,1998,678,344,334
'4122060000,  원평동,'10,5 - 9세,1998,799,409,390
'4122060000,  원평동,'15,10 - 14세,1998,758,376,382
'4122060000,  원평동,'20,15 - 19세,1998,833,400,433
'4122060000,  원평동,'25,20 - 24세,1998,887,458,429
'4122060000,  원평동,'30,25 - 29세,1998,1011,566,445
'4122060000,  원평동,'35,30 - 34세,1998,869,449,420
'4122060000,  원평동,'40,35 - 39세,1998,1026,535,491
'4122060000,  원평동,'45,40 - 44세,1998,779,412,367
'4122060000,  원평동,'50,45 - 49세,1998,575,277,298
'4122060000,  원평동,'55,50 - 54세,1998,535,262,273
'4122060000,  원평동,'60,55 - 59세,1998,537,268,269
'4122060000,  원평동,'65,60 - 64세,1998,455,213,242
'4122060000,  원평동,'70,65 - 69세,1998,272,111,161
'4122060000,  원평동,'75,70 - 74세,1998,195,80,115
'4122060000,  원평동,'80,75 - 79세,1998,124,52,72
'4122060000,  원평동,'85,80 - 84세,1998,60,21,39
'4122060000,  원평동,'90,85+ ,1998,26,6,20
'4122061000,  통복동,'00,계,1998,6636,3373,3263
'4122061000,  통복동,'05,0 - 4세,1998,473,256,217
'4122061000,  통복동,'10,5 - 9세,1998,428,216,212
'4122061000,  통복동,'15,10 - 14세,1998,416,212,204
'4122061000,  통복동,'20,15 - 19세,1998,509,269,240
'4122061000,  통복동,'25,20 - 24세,1998,530,270,260
'4122061000,  통복동,'30,25 - 29세,1998,655,349,306
'4122061000,  통복동,'35,30 - 34세,1998,676,350,326
'4122061000,  통복동,'40,35 - 39세,1998,615,319,296
'4122061000,  통복동,'45,40 - 44세,1998,496,260,236
'4122061000,  통복동,'50,45 - 49세,1998,399,210,189
'4122061000,  통복동,'55,50 - 54세,1998,312,151,161
'4122061000,  통복동,'60,55 - 59세,1998,351,169,182
'4122061000,  통복동,'65,60 - 64세,1998,324,149,175
'4122061000,  통복동,'70,65 - 69세,1998,178,81,97
'4122061000,  통복동,'75,70 - 74세,1998,116,40,76
'4122061000,  통복동,'80,75 - 79세,1998,83,39,44
'4122061000,  통복동,'85,80 - 84세,1998,49,23,26
'4122061000,  통복동,'90,85+ ,1998,26,10,16
'4122062000,  비전1동,'00,계,1998,16236,8211,8025
'4122062000,  비전1동,'05,0 - 4세,1998,1266,651,615
'4122062000,  비전1동,'10,5 - 9세,1998,1367,721,646
'4122062000,  비전1동,'15,10 - 14세,1998,1248,655,593
'4122062000,  비전1동,'20,15 - 19세,1998,1359,714,645
'4122062000,  비전1동,'25,20 - 24세,1998,1207,625,582
'4122062000,  비전1동,'30,25 - 29세,1998,1545,771,774
'4122062000,  비전1동,'35,30 - 34세,1998,1567,789,778
'4122062000,  비전1동,'40,35 - 39세,1998,1820,905,915
'4122062000,  비전1동,'45,40 - 44세,1998,1309,714,595
'4122062000,  비전1동,'50,45 - 49세,1998,782,411,371
'4122062000,  비전1동,'55,50 - 54세,1998,664,333,331
'4122062000,  비전1동,'60,55 - 59세,1998,693,324,369
'4122062000,  비전1동,'65,60 - 64세,1998,544,274,270
'4122062000,  비전1동,'70,65 - 69세,1998,314,128,186
'4122062000,  비전1동,'75,70 - 74세,1998,233,98,135
'4122062000,  비전1동,'80,75 - 79세,1998,173,50,123
'4122062000,  비전1동,'85,80 - 84세,1998,96,37,59
'4122062000,  비전1동,'90,85+ ,1998,49,11,38
'4122063000,  비전2동,'00,계,1998,39700,19873,19827
'4122063000,  비전2동,'05,0 - 4세,1998,3766,1990,1776
'4122063000,  비전2동,'10,5 - 9세,1998,4107,2095,2012
'4122063000,  비전2동,'15,10 - 14세,1998,3312,1780,1532
'4122063000,  비전2동,'20,15 - 19세,1998,3061,1593,1468
'4122063000,  비전2동,'25,20 - 24세,1998,2410,1229,1181
'4122063000,  비전2동,'30,25 - 29세,1998,3465,1571,1894
'4122063000,  비전2동,'35,30 - 34세,1998,4549,2088,2461
'4122063000,  비전2동,'40,35 - 39세,1998,4804,2513,2291
'4122063000,  비전2동,'45,40 - 44세,1998,3397,1780,1617
'4122063000,  비전2동,'50,45 - 49세,1998,1817,950,867
'4122063000,  비전2동,'55,50 - 54세,1998,1318,717,601
'4122063000,  비전2동,'60,55 - 59세,1998,1173,570,603
'4122063000,  비전2동,'65,60 - 64세,1998,925,431,494
'4122063000,  비전2동,'70,65 - 69세,1998,585,243,342
'4122063000,  비전2동,'75,70 - 74세,1998,454,162,292
'4122063000,  비전2동,'80,75 - 79세,1998,287,86,201
'4122063000,  비전2동,'85,80 - 84세,1998,163,52,111
'4122063000,  비전2동,'90,85+ ,1998,107,23,84
'4122064000,  세교동,'00,계,1998,21952,11132,10820
'4122064000,  세교동,'05,0 - 4세,1998,2823,1458,1365
'4122064000,  세교동,'10,5 - 9세,1998,2152,1119,1033
'4122064000,  세교동,'15,10 - 14세,1998,1448,738,710
'4122064000,  세교동,'20,15 - 19세,1998,1235,676,559
'4122064000,  세교동,'25,20 - 24세,1998,1250,591,659
'4122064000,  세교동,'30,25 - 29세,1998,2716,1194,1522
'4122064000,  세교동,'35,30 - 34세,1998,3234,1738,1496
'4122064000,  세교동,'40,35 - 39세,1998,2472,1372,1100
'4122064000,  세교동,'45,40 - 44세,1998,1342,739,603
'4122064000,  세교동,'50,45 - 49세,1998,693,372,321
'4122064000,  세교동,'55,50 - 54세,1998,589,275,314
'4122064000,  세교동,'60,55 - 59세,1998,635,285,350
'4122064000,  세교동,'65,60 - 64세,1998,515,227,288
'4122064000,  세교동,'70,65 - 69세,1998,352,156,196
'4122064000,  세교동,'75,70 - 74세,1998,206,92,114
'4122064000,  세교동,'80,75 - 79세,1998,146,58,88
'4122064000,  세교동,'85,80 - 84세,1998,86,27,59
'4122064000,  세교동,'90,85+ ,1998,58,15,43
'41250, 동두천시,'00,계,1998,73625,37082,36543
'41250, 동두천시,'05,0 - 4세,1998,5354,2773,2581
'41250, 동두천시,'10,5 - 9세,1998,5472,2803,2669
'41250, 동두천시,'15,10 - 14세,1998,4574,2337,2237
'41250, 동두천시,'20,15 - 19세,1998,5578,2876,2702
'41250, 동두천시,'25,20 - 24세,1998,5540,2791,2749
'41250, 동두천시,'30,25 - 29세,1998,7268,3661,3607
'41250, 동두천시,'35,30 - 34세,1998,7327,3884,3443
'41250, 동두천시,'40,35 - 39세,1998,7402,3982,3420
'41250, 동두천시,'45,40 - 44세,1998,5755,3204,2551
'41250, 동두천시,'50,45 - 49세,1998,3610,1828,1782
'41250, 동두천시,'55,50 - 54세,1998,3429,1618,1811
'41250, 동두천시,'60,55 - 59세,1998,3800,1620,2180
'41250, 동두천시,'65,60 - 64세,1998,3264,1464,1800
'41250, 동두천시,'70,65 - 69세,1998,2297,1045,1252
'41250, 동두천시,'75,70 - 74세,1998,1365,576,789
'41250, 동두천시,'80,75 - 79세,1998,929,401,528
'41250, 동두천시,'85,80 - 84세,1998,409,142,267
'41250, 동두천시,'90,85+ ,1998,252,77,175
'4125051000,  생연1동,'00,계,1998,8517,4267,4250
'4125051000,  생연1동,'05,0 - 4세,1998,595,320,275
'4125051000,  생연1동,'10,5 - 9세,1998,712,388,324
'4125051000,  생연1동,'15,10 - 14세,1998,631,306,325
'4125051000,  생연1동,'20,15 - 19세,1998,719,362,357
'4125051000,  생연1동,'25,20 - 24세,1998,567,266,301
'4125051000,  생연1동,'30,25 - 29세,1998,775,393,382
'4125051000,  생연1동,'35,30 - 34세,1998,833,410,423
'4125051000,  생연1동,'40,35 - 39세,1998,969,504,465
'4125051000,  생연1동,'45,40 - 44세,1998,718,393,325
'4125051000,  생연1동,'50,45 - 49세,1998,404,214,190
'4125051000,  생연1동,'55,50 - 54세,1998,382,170,212
'4125051000,  생연1동,'60,55 - 59세,1998,401,169,232
'4125051000,  생연1동,'65,60 - 64세,1998,338,166,172
'4125051000,  생연1동,'70,65 - 69세,1998,207,99,108
'4125051000,  생연1동,'75,70 - 74세,1998,128,58,70
'4125051000,  생연1동,'80,75 - 79세,1998,84,31,53
'4125051000,  생연1동,'85,80 - 84세,1998,34,14,20
'4125051000,  생연1동,'90,85+ ,1998,20,4,16
'4125052000,  생연2동,'00,계,1998,8782,4437,4345
'4125052000,  생연2동,'05,0 - 4세,1998,562,282,280
'4125052000,  생연2동,'10,5 - 9세,1998,555,296,259
'4125052000,  생연2동,'15,10 - 14세,1998,517,286,231
'4125052000,  생연2동,'20,15 - 19세,1998,669,352,317
'4125052000,  생연2동,'25,20 - 24세,1998,764,389,375
'4125052000,  생연2동,'30,25 - 29세,1998,871,443,428
'4125052000,  생연2동,'35,30 - 34세,1998,790,441,349
'4125052000,  생연2동,'40,35 - 39세,1998,782,409,373
'4125052000,  생연2동,'45,40 - 44세,1998,664,368,296
'4125052000,  생연2동,'50,45 - 49세,1998,461,214,247
'4125052000,  생연2동,'55,50 - 54세,1998,473,206,267
'4125052000,  생연2동,'60,55 - 59세,1998,536,250,286
'4125052000,  생연2동,'65,60 - 64세,1998,435,201,234
'4125052000,  생연2동,'70,65 - 69세,1998,305,126,179
'4125052000,  생연2동,'75,70 - 74세,1998,171,75,96
'4125052000,  생연2동,'80,75 - 79세,1998,137,72,65
'4125052000,  생연2동,'85,80 - 84세,1998,56,17,39
'4125052000,  생연2동,'90,85+ ,1998,34,10,24
'4125053500,  중앙동,'00,계,1998,9523,4750,4773
'4125053500,  중앙동,'05,0 - 4세,1998,520,275,245
'4125053500,  중앙동,'10,5 - 9세,1998,635,320,315
'4125053500,  중앙동,'15,10 - 14세,1998,557,295,262
'4125053500,  중앙동,'20,15 - 19세,1998,751,378,373
'4125053500,  중앙동,'25,20 - 24세,1998,813,432,381
'4125053500,  중앙동,'30,25 - 29세,1998,869,452,417
'4125053500,  중앙동,'35,30 - 34세,1998,828,449,379
'4125053500,  중앙동,'40,35 - 39세,1998,890,480,410
'4125053500,  중앙동,'45,40 - 44세,1998,735,382,353
'4125053500,  중앙동,'50,45 - 49세,1998,522,251,271
'4125053500,  중앙동,'55,50 - 54세,1998,501,234,267
'4125053500,  중앙동,'60,55 - 59세,1998,577,238,339
'4125053500,  중앙동,'65,60 - 64세,1998,491,202,289
'4125053500,  중앙동,'70,65 - 69세,1998,367,164,203
'4125053500,  중앙동,'75,70 - 74세,1998,211,91,120
'4125053500,  중앙동,'80,75 - 79세,1998,160,73,87
'4125053500,  중앙동,'85,80 - 84세,1998,71,23,48
'4125053500,  중앙동,'90,85+ ,1998,25,11,14
'4125055000,  보산동,'00,계,1998,5157,2518,2639
'4125055000,  보산동,'05,0 - 4세,1998,353,176,177
'4125055000,  보산동,'10,5 - 9세,1998,341,196,145
'4125055000,  보산동,'15,10 - 14세,1998,311,160,151
'4125055000,  보산동,'20,15 - 19세,1998,379,194,185
'4125055000,  보산동,'25,20 - 24세,1998,393,175,218
'4125055000,  보산동,'30,25 - 29세,1998,550,286,264
'4125055000,  보산동,'35,30 - 34세,1998,485,243,242
'4125055000,  보산동,'40,35 - 39세,1998,559,278,281
'4125055000,  보산동,'45,40 - 44세,1998,409,214,195
'4125055000,  보산동,'50,45 - 49세,1998,258,126,132
'4125055000,  보산동,'55,50 - 54세,1998,242,108,134
'4125055000,  보산동,'60,55 - 59세,1998,290,128,162
'4125055000,  보산동,'65,60 - 64세,1998,227,94,133
'4125055000,  보산동,'70,65 - 69세,1998,156,62,94
'4125055000,  보산동,'75,70 - 74세,1998,101,34,67
'4125055000,  보산동,'80,75 - 79세,1998,61,28,33
'4125055000,  보산동,'85,80 - 84세,1998,25,10,15
'4125055000,  보산동,'90,85+ ,1998,17,6,11
'4125056500,  불현동,'00,계,1998,22274,11125,11149
'4125056500,  불현동,'05,0 - 4세,1998,1954,1012,942
'4125056500,  불현동,'10,5 - 9세,1998,1908,959,949
'4125056500,  불현동,'15,10 - 14세,1998,1418,699,719
'4125056500,  불현동,'20,15 - 19세,1998,1493,749,744
'4125056500,  불현동,'25,20 - 24세,1998,1504,733,771
'4125056500,  불현동,'30,25 - 29세,1998,2274,1083,1191
'4125056500,  불현동,'35,30 - 34세,1998,2437,1274,1163
'4125056500,  불현동,'40,35 - 39세,1998,2384,1266,1118
'4125056500,  불현동,'45,40 - 44세,1998,1764,1013,751
'4125056500,  불현동,'50,45 - 49세,1998,979,522,457
'4125056500,  불현동,'55,50 - 54세,1998,901,426,475
'4125056500,  불현동,'60,55 - 59세,1998,999,419,580
'4125056500,  불현동,'65,60 - 64세,1998,859,379,480
'4125056500,  불현동,'70,65 - 69세,1998,596,277,319
'4125056500,  불현동,'75,70 - 74세,1998,360,155,205
'4125056500,  불현동,'80,75 - 79세,1998,237,93,144
'4125056500,  불현동,'85,80 - 84세,1998,123,41,82
'4125056500,  불현동,'90,85+ ,1998,84,25,59
'4125058000,  소요동,'00,계,1998,10792,5573,5219
'4125058000,  소요동,'05,0 - 4세,1998,710,366,344
'4125058000,  소요동,'10,5 - 9세,1998,722,364,358
'4125058000,  소요동,'15,10 - 14세,1998,633,336,297
'4125058000,  소요동,'20,15 - 19세,1998,898,482,416
'4125058000,  소요동,'25,20 - 24세,1998,886,489,397
'4125058000,  소요동,'30,25 - 29세,1998,1068,561,507
'4125058000,  소요동,'35,30 - 34세,1998,1011,556,455
'4125058000,  소요동,'40,35 - 39세,1998,969,551,418
'4125058000,  소요동,'45,40 - 44세,1998,795,443,352
'4125058000,  소요동,'50,45 - 49세,1998,563,288,275
'4125058000,  소요동,'55,50 - 54세,1998,549,285,264
'4125058000,  소요동,'60,55 - 59세,1998,559,220,339
'4125058000,  소요동,'65,60 - 64세,1998,553,253,300
'4125058000,  소요동,'70,65 - 69세,1998,393,191,202
'4125058000,  소요동,'75,70 - 74세,1998,237,95,142
'4125058000,  소요동,'80,75 - 79세,1998,150,63,87
'4125058000,  소요동,'85,80 - 84세,1998,58,22,36
'4125058000,  소요동,'90,85+ ,1998,38,8,30
'4125060000,  상패동,'00,계,1998,8580,4412,4168
'4125060000,  상패동,'05,0 - 4세,1998,660,342,318
'4125060000,  상패동,'10,5 - 9세,1998,599,280,319
'4125060000,  상패동,'15,10 - 14세,1998,507,255,252
'4125060000,  상패동,'20,15 - 19세,1998,669,359,310
'4125060000,  상패동,'25,20 - 24세,1998,613,307,306
'4125060000,  상패동,'30,25 - 29세,1998,861,443,418
'4125060000,  상패동,'35,30 - 34세,1998,943,511,432
'4125060000,  상패동,'40,35 - 39세,1998,849,494,355
'4125060000,  상패동,'45,40 - 44세,1998,670,391,279
'4125060000,  상패동,'50,45 - 49세,1998,423,213,210
'4125060000,  상패동,'55,50 - 54세,1998,381,189,192
'4125060000,  상패동,'60,55 - 59세,1998,438,196,242
'4125060000,  상패동,'65,60 - 64세,1998,361,169,192
'4125060000,  상패동,'70,65 - 69세,1998,273,126,147
'4125060000,  상패동,'75,70 - 74세,1998,157,68,89
'4125060000,  상패동,'80,75 - 79세,1998,100,41,59
'4125060000,  상패동,'85,80 - 84세,1998,42,15,27
'4125060000,  상패동,'90,85+ ,1998,34,13,21
'41270, 안산시,'00,계,1998,546117,281579,264538
'41270, 안산시,'05,0 - 4세,1998,58791,30869,27922
'41270, 안산시,'10,5 - 9세,1998,56002,29220,26782
'41270, 안산시,'15,10 - 14세,1998,40496,20854,19642
'41270, 안산시,'20,15 - 19세,1998,34945,17718,17227
'41270, 안산시,'25,20 - 24세,1998,35704,17797,17907
'41270, 안산시,'30,25 - 29세,1998,63997,31418,32579
'41270, 안산시,'35,30 - 34세,1998,72304,37548,34756
'41270, 안산시,'40,35 - 39세,1998,66741,36789,29952
'41270, 안산시,'45,40 - 44세,1998,41432,23530,17902
'41270, 안산시,'50,45 - 49세,1998,20252,11442,8810
'41270, 안산시,'55,50 - 54세,1998,13743,7395,6348
'41270, 안산시,'60,55 - 59세,1998,12206,5731,6475
'41270, 안산시,'65,60 - 64세,1998,10601,4507,6094
'41270, 안산시,'70,65 - 69세,1998,7458,2887,4571
'41270, 안산시,'75,70 - 74세,1998,5305,1840,3465
'41270, 안산시,'80,75 - 79세,1998,3446,1272,2174
'41270, 안산시,'85,80 - 84세,1998,1692,509,1183
'41270, 안산시,'90,85+ ,1998,1002,253,749
'4127051100,  일동,'00,계,1998,37553,19376,18177
'4127051100,  일동,'05,0 - 4세,1998,5186,2684,2502
'4127051100,  일동,'10,5 - 9세,1998,3663,1868,1795
'4127051100,  일동,'15,10 - 14세,1998,1870,934,936
'4127051100,  일동,'20,15 - 19세,1998,1566,784,782
'4127051100,  일동,'25,20 - 24세,1998,2613,1222,1391
'4127051100,  일동,'30,25 - 29세,1998,6112,2942,3170
'4127051100,  일동,'35,30 - 34세,1998,5969,3360,2609
'4127051100,  일동,'40,35 - 39세,1998,3834,2325,1509
'4127051100,  일동,'45,40 - 44세,1998,1972,1120,852
'4127051100,  일동,'50,45 - 49세,1998,1072,548,524
'4127051100,  일동,'55,50 - 54세,1998,874,428,446
'4127051100,  일동,'60,55 - 59세,1998,912,412,500
'4127051100,  일동,'65,60 - 64세,1998,751,329,422
'4127051100,  일동,'70,65 - 69세,1998,459,190,269
'4127051100,  일동,'75,70 - 74세,1998,335,107,228
'4127051100,  일동,'80,75 - 79세,1998,202,75,127
'4127051100,  일동,'85,80 - 84세,1998,110,29,81
'4127051100,  일동,'90,85+ ,1998,53,19,34
'4127051300,  사1동,'00,계,1998,17634,9132,8502
'4127051300,  사1동,'05,0 - 4세,1998,2302,1203,1099
'4127051300,  사1동,'10,5 - 9세,1998,1591,824,767
'4127051300,  사1동,'15,10 - 14세,1998,954,472,482
'4127051300,  사1동,'20,15 - 19세,1998,890,445,445
'4127051300,  사1동,'25,20 - 24세,1998,1232,575,657
'4127051300,  사1동,'30,25 - 29세,1998,2710,1373,1337
'4127051300,  사1동,'35,30 - 34세,1998,2532,1441,1091
'4127051300,  사1동,'40,35 - 39세,1998,1927,1094,833
'4127051300,  사1동,'45,40 - 44세,1998,1094,613,481
'4127051300,  사1동,'50,45 - 49세,1998,560,305,255
'4127051300,  사1동,'55,50 - 54세,1998,425,217,208
'4127051300,  사1동,'60,55 - 59세,1998,414,193,221
'4127051300,  사1동,'65,60 - 64세,1998,364,160,204
'4127051300,  사1동,'70,65 - 69세,1998,268,97,171
'4127051300,  사1동,'75,70 - 74세,1998,155,46,109
'4127051300,  사1동,'80,75 - 79세,1998,122,49,73
'4127051300,  사1동,'85,80 - 84세,1998,58,17,41
'4127051300,  사1동,'90,85+ ,1998,36,8,28
'4127051500,  사2동,'00,계,1998,32236,16313,15923
'4127051500,  사2동,'05,0 - 4세,1998,3227,1689,1538
'4127051500,  사2동,'10,5 - 9세,1998,4158,2184,1974
'4127051500,  사2동,'15,10 - 14세,1998,2869,1427,1442
'4127051500,  사2동,'20,15 - 19세,1998,2099,1097,1002
'4127051500,  사2동,'25,20 - 24세,1998,1535,694,841
'4127051500,  사2동,'30,25 - 29세,1998,2862,1314,1548
'4127051500,  사2동,'35,30 - 34세,1998,4028,1846,2182
'4127051500,  사2동,'40,35 - 39세,1998,4553,2418,2135
'4127051500,  사2동,'45,40 - 44세,1998,2854,1617,1237
'4127051500,  사2동,'50,45 - 49세,1998,1245,767,478
'4127051500,  사2동,'55,50 - 54세,1998,736,415,321
'4127051500,  사2동,'60,55 - 59세,1998,613,305,308
'4127051500,  사2동,'65,60 - 64세,1998,494,217,277
'4127051500,  사2동,'70,65 - 69세,1998,384,143,241
'4127051500,  사2동,'75,70 - 74세,1998,267,96,171
'4127051500,  사2동,'80,75 - 79세,1998,178,60,118
'4127051500,  사2동,'85,80 - 84세,1998,85,14,71
'4127051500,  사2동,'90,85+ ,1998,49,10,39
'4127051700,  본오1동,'00,계,1998,34679,17716,16963
'4127051700,  본오1동,'05,0 - 4세,1998,4690,2414,2276
'4127051700,  본오1동,'10,5 - 9세,1998,3620,1891,1729
'4127051700,  본오1동,'15,10 - 14세,1998,2167,1147,1020
'4127051700,  본오1동,'20,15 - 19세,1998,1817,886,931
'4127051700,  본오1동,'25,20 - 24세,1998,1940,846,1094
'4127051700,  본오1동,'30,25 - 29세,1998,4937,2258,2679
'4127051700,  본오1동,'35,30 - 34세,1998,5391,2880,2511
'4127051700,  본오1동,'40,35 - 39세,1998,3865,2205,1660
'4127051700,  본오1동,'45,40 - 44세,1998,2270,1300,970
'4127051700,  본오1동,'50,45 - 49세,1998,987,578,409
'4127051700,  본오1동,'55,50 - 54세,1998,709,362,347
'4127051700,  본오1동,'60,55 - 59세,1998,697,315,382
'4127051700,  본오1동,'65,60 - 64세,1998,573,253,320
'4127051700,  본오1동,'70,65 - 69세,1998,398,153,245
'4127051700,  본오1동,'75,70 - 74세,1998,310,116,194
'4127051700,  본오1동,'80,75 - 79세,1998,167,63,104
'4127051700,  본오1동,'85,80 - 84세,1998,95,34,61
'4127051700,  본오1동,'90,85+ ,1998,46,15,31
'4127051800,  본오2동,'00,계,1998,29808,14882,14926
'4127051800,  본오2동,'05,0 - 4세,1998,3329,1744,1585
'4127051800,  본오2동,'10,5 - 9세,1998,3166,1631,1535
'4127051800,  본오2동,'15,10 - 14세,1998,2329,1195,1134
'4127051800,  본오2동,'20,15 - 19세,1998,1721,832,889
'4127051800,  본오2동,'25,20 - 24세,1998,1589,742,847
'4127051800,  본오2동,'30,25 - 29세,1998,3395,1503,1892
'4127051800,  본오2동,'35,30 - 34세,1998,3930,1922,2008
'4127051800,  본오2동,'40,35 - 39세,1998,3907,2062,1845
'4127051800,  본오2동,'45,40 - 44세,1998,2265,1331,934
'4127051800,  본오2동,'50,45 - 49세,1998,1033,585,448
'4127051800,  본오2동,'55,50 - 54세,1998,733,367,366
'4127051800,  본오2동,'60,55 - 59세,1998,683,301,382
'4127051800,  본오2동,'65,60 - 64세,1998,597,244,353
'4127051800,  본오2동,'70,65 - 69세,1998,458,179,279
'4127051800,  본오2동,'75,70 - 74세,1998,298,111,187
'4127051800,  본오2동,'80,75 - 79세,1998,216,86,130
'4127051800,  본오2동,'85,80 - 84세,1998,107,29,78
'4127051800,  본오2동,'90,85+ ,1998,52,18,34
'4127051900,  부곡동,'00,계,1998,20010,10417,9593
'4127051900,  부곡동,'05,0 - 4세,1998,2584,1388,1196
'4127051900,  부곡동,'10,5 - 9세,1998,2304,1220,1084
'4127051900,  부곡동,'15,10 - 14세,1998,1258,643,615
'4127051900,  부곡동,'20,15 - 19세,1998,991,504,487
'4127051900,  부곡동,'25,20 - 24세,1998,1112,570,542
'4127051900,  부곡동,'30,25 - 29세,1998,2600,1168,1432
'4127051900,  부곡동,'35,30 - 34세,1998,3184,1697,1487
'4127051900,  부곡동,'40,35 - 39세,1998,2410,1420,990
'4127051900,  부곡동,'45,40 - 44세,1998,1214,707,507
'4127051900,  부곡동,'50,45 - 49세,1998,568,326,242
'4127051900,  부곡동,'55,50 - 54세,1998,391,213,178
'4127051900,  부곡동,'60,55 - 59세,1998,424,197,227
'4127051900,  부곡동,'65,60 - 64세,1998,375,148,227
'4127051900,  부곡동,'70,65 - 69세,1998,254,115,139
'4127051900,  부곡동,'75,70 - 74세,1998,146,48,98
'4127051900,  부곡동,'80,75 - 79세,1998,110,32,78
'4127051900,  부곡동,'85,80 - 84세,1998,43,11,32
'4127051900,  부곡동,'90,85+ ,1998,42,10,32
'4127052100,  월피동,'00,계,1998,41623,21130,20493
'4127052100,  월피동,'05,0 - 4세,1998,4917,2647,2270
'4127052100,  월피동,'10,5 - 9세,1998,4895,2552,2343
'4127052100,  월피동,'15,10 - 14세,1998,3298,1681,1617
'4127052100,  월피동,'20,15 - 19세,1998,2408,1208,1200
'4127052100,  월피동,'25,20 - 24세,1998,2076,921,1155
'4127052100,  월피동,'30,25 - 29세,1998,4698,2084,2614
'4127052100,  월피동,'35,30 - 34세,1998,5923,2921,3002
'4127052100,  월피동,'40,35 - 39세,1998,5610,3132,2478
'4127052100,  월피동,'45,40 - 44세,1998,3078,1807,1271
'4127052100,  월피동,'50,45 - 49세,1998,1291,740,551
'4127052100,  월피동,'55,50 - 54세,1998,830,450,380
'4127052100,  월피동,'60,55 - 59세,1998,716,317,399
'4127052100,  월피동,'65,60 - 64세,1998,664,245,419
'4127052100,  월피동,'70,65 - 69세,1998,480,175,305
'4127052100,  월피동,'75,70 - 74세,1998,373,123,250
'4127052100,  월피동,'80,75 - 79세,1998,218,87,131
'4127052100,  월피동,'85,80 - 84세,1998,91,24,67
'4127052100,  월피동,'90,85+ ,1998,57,16,41
'4127052600,  와동,'00,계,1998,42743,22280,20463
'4127052600,  와동,'05,0 - 4세,1998,6095,3186,2909
'4127052600,  와동,'10,5 - 9세,1998,4191,2179,2012
'4127052600,  와동,'15,10 - 14세,1998,2335,1205,1130
'4127052600,  와동,'20,15 - 19세,1998,2117,1050,1067
'4127052600,  와동,'25,20 - 24세,1998,3294,1549,1745
'4127052600,  와동,'30,25 - 29세,1998,6731,3300,3431
'4127052600,  와동,'35,30 - 34세,1998,6769,3858,2911
'4127052600,  와동,'40,35 - 39세,1998,4542,2669,1873
'4127052600,  와동,'45,40 - 44세,1998,2406,1369,1037
'4127052600,  와동,'50,45 - 49세,1998,1098,589,509
'4127052600,  와동,'55,50 - 54세,1998,786,402,384
'4127052600,  와동,'60,55 - 59세,1998,709,319,390
'4127052600,  와동,'65,60 - 64세,1998,658,265,393
'4127052600,  와동,'70,65 - 69세,1998,416,149,267
'4127052600,  와동,'75,70 - 74세,1998,266,74,192
'4127052600,  와동,'80,75 - 79세,1998,183,80,103
'4127052600,  와동,'85,80 - 84세,1998,93,31,62
'4127052600,  와동,'90,85+ ,1998,54,6,48
'4127053100,  고잔1동,'00,계,1998,28630,14683,13947
'4127053100,  고잔1동,'05,0 - 4세,1998,2670,1414,1256
'4127053100,  고잔1동,'10,5 - 9세,1998,2903,1512,1391
'4127053100,  고잔1동,'15,10 - 14세,1998,2375,1246,1129
'4127053100,  고잔1동,'20,15 - 19세,1998,2143,1091,1052
'4127053100,  고잔1동,'25,20 - 24세,1998,1836,943,893
'4127053100,  고잔1동,'30,25 - 29세,1998,2821,1362,1459
'4127053100,  고잔1동,'35,30 - 34세,1998,3509,1775,1734
'4127053100,  고잔1동,'40,35 - 39세,1998,3606,1937,1669
'4127053100,  고잔1동,'45,40 - 44세,1998,2316,1342,974
'4127053100,  고잔1동,'50,45 - 49세,1998,1203,684,519
'4127053100,  고잔1동,'55,50 - 54세,1998,769,387,382
'4127053100,  고잔1동,'60,55 - 59세,1998,769,341,428
'4127053100,  고잔1동,'65,60 - 64세,1998,672,298,374
'4127053100,  고잔1동,'70,65 - 69세,1998,408,151,257
'4127053100,  고잔1동,'75,70 - 74세,1998,275,92,183
'4127053100,  고잔1동,'80,75 - 79세,1998,183,56,127
'4127053100,  고잔1동,'85,80 - 84세,1998,104,36,68
'4127053100,  고잔1동,'90,85+ ,1998,68,16,52
'4127053200,  고잔2동,'00,계,1998,26590,13446,13144
'4127053200,  고잔2동,'05,0 - 4세,1998,2304,1168,1136
'4127053200,  고잔2동,'10,5 - 9세,1998,2748,1455,1293
'4127053200,  고잔2동,'15,10 - 14세,1998,2604,1366,1238
'4127053200,  고잔2동,'20,15 - 19세,1998,2200,1145,1055
'4127053200,  고잔2동,'25,20 - 24세,1998,1467,743,724
'4127053200,  고잔2동,'30,25 - 29세,1998,2084,1000,1084
'4127053200,  고잔2동,'35,30 - 34세,1998,2920,1355,1565
'4127053200,  고잔2동,'40,35 - 39세,1998,3558,1743,1815
'4127053200,  고잔2동,'45,40 - 44세,1998,2774,1523,1251
'4127053200,  고잔2동,'50,45 - 49세,1998,1310,782,528
'4127053200,  고잔2동,'55,50 - 54세,1998,653,401,252
'4127053200,  고잔2동,'60,55 - 59세,1998,444,211,233
'4127053200,  고잔2동,'65,60 - 64세,1998,461,187,274
'4127053200,  고잔2동,'70,65 - 69세,1998,404,138,266
'4127053200,  고잔2동,'75,70 - 74세,1998,298,100,198
'4127053200,  고잔2동,'80,75 - 79세,1998,225,87,138
'4127053200,  고잔2동,'85,80 - 84세,1998,90,30,60
'4127053200,  고잔2동,'90,85+ ,1998,46,12,34
'4127053600,  성포동,'00,계,1998,33079,16567,16512
'4127053600,  성포동,'05,0 - 4세,1998,2806,1563,1243
'4127053600,  성포동,'10,5 - 9세,1998,3888,2031,1857
'4127053600,  성포동,'15,10 - 14세,1998,3205,1634,1571
'4127053600,  성포동,'20,15 - 19세,1998,2597,1304,1293
'4127053600,  성포동,'25,20 - 24세,1998,1502,745,757
'4127053600,  성포동,'30,25 - 29세,1998,2292,996,1296
'4127053600,  성포동,'35,30 - 34세,1998,3571,1496,2075
'4127053600,  성포동,'40,35 - 39세,1998,4772,2462,2310
'4127053600,  성포동,'45,40 - 44세,1998,3363,1862,1501
'4127053600,  성포동,'50,45 - 49세,1998,1530,883,647
'4127053600,  성포동,'55,50 - 54세,1998,844,487,357
'4127053600,  성포동,'60,55 - 59세,1998,701,349,352
'4127053600,  성포동,'65,60 - 64세,1998,610,227,383
'4127053600,  성포동,'70,65 - 69세,1998,545,212,333
'4127053600,  성포동,'75,70 - 74세,1998,408,156,252
'4127053600,  성포동,'80,75 - 79세,1998,250,99,151
'4127053600,  성포동,'85,80 - 84세,1998,121,40,81
'4127053600,  성포동,'90,85+ ,1998,74,21,53
'4127054100,  원곡본동,'00,계,1998,19989,11272,8717
'4127054100,  원곡본동,'05,0 - 4세,1998,1499,782,717
'4127054100,  원곡본동,'10,5 - 9세,1998,1434,740,694
'4127054100,  원곡본동,'15,10 - 14세,1998,1194,639,555
'4127054100,  원곡본동,'20,15 - 19세,1998,1378,705,673
'4127054100,  원곡본동,'25,20 - 24세,1998,2132,1282,850
'4127054100,  원곡본동,'30,25 - 29세,1998,2684,1759,925
'4127054100,  원곡본동,'35,30 - 34세,1998,2431,1448,983
'4127054100,  원곡본동,'40,35 - 39세,1998,2286,1338,948
'4127054100,  원곡본동,'45,40 - 44세,1998,1520,883,637
'4127054100,  원곡본동,'50,45 - 49세,1998,879,475,404
'4127054100,  원곡본동,'55,50 - 54세,1998,665,383,282
'4127054100,  원곡본동,'60,55 - 59세,1998,591,296,295
'4127054100,  원곡본동,'65,60 - 64세,1998,483,226,257
'4127054100,  원곡본동,'70,65 - 69세,1998,324,147,177
'4127054100,  원곡본동,'75,70 - 74세,1998,209,75,134
'4127054100,  원곡본동,'80,75 - 79세,1998,146,58,88
'4127054100,  원곡본동,'85,80 - 84세,1998,85,28,57
'4127054100,  원곡본동,'90,85+ ,1998,49,8,41
'4127055100,  원곡1동,'00,계,1998,15490,8304,7186
'4127055100,  원곡1동,'05,0 - 4세,1998,898,461,437
'4127055100,  원곡1동,'10,5 - 9세,1998,967,534,433
'4127055100,  원곡1동,'15,10 - 14세,1998,1168,602,566
'4127055100,  원곡1동,'20,15 - 19세,1998,1536,766,770
'4127055100,  원곡1동,'25,20 - 24세,1998,1713,1012,701
'4127055100,  원곡1동,'30,25 - 29세,1998,1564,962,602
'4127055100,  원곡1동,'35,30 - 34세,1998,1422,815,607
'4127055100,  원곡1동,'40,35 - 39세,1998,1587,863,724
'4127055100,  원곡1동,'45,40 - 44세,1998,1332,666,666
'4127055100,  원곡1동,'50,45 - 49세,1998,937,488,449
'4127055100,  원곡1동,'55,50 - 54세,1998,714,398,316
'4127055100,  원곡1동,'60,55 - 59세,1998,567,288,279
'4127055100,  원곡1동,'65,60 - 64세,1998,421,215,206
'4127055100,  원곡1동,'70,65 - 69세,1998,251,105,146
'4127055100,  원곡1동,'75,70 - 74세,1998,198,65,133
'4127055100,  원곡1동,'80,75 - 79세,1998,117,43,74
'4127055100,  원곡1동,'85,80 - 84세,1998,66,16,50
'4127055100,  원곡1동,'90,85+ ,1998,32,5,27
'4127055200,  원곡2동,'00,계,1998,9065,4750,4315
'4127055200,  원곡2동,'05,0 - 4세,1998,800,403,397
'4127055200,  원곡2동,'10,5 - 9세,1998,793,415,378
'4127055200,  원곡2동,'15,10 - 14세,1998,594,306,288
'4127055200,  원곡2동,'20,15 - 19세,1998,651,345,306
'4127055200,  원곡2동,'25,20 - 24세,1998,821,490,331
'4127055200,  원곡2동,'30,25 - 29세,1998,1154,653,501
'4127055200,  원곡2동,'35,30 - 34세,1998,1117,598,519
'4127055200,  원곡2동,'40,35 - 39세,1998,1018,561,457
'4127055200,  원곡2동,'45,40 - 44세,1998,699,373,326
'4127055200,  원곡2동,'50,45 - 49세,1998,378,203,175
'4127055200,  원곡2동,'55,50 - 54세,1998,271,134,137
'4127055200,  원곡2동,'60,55 - 59세,1998,211,93,118
'4127055200,  원곡2동,'65,60 - 64세,1998,204,64,140
'4127055200,  원곡2동,'70,65 - 69세,1998,163,52,111
'4127055200,  원곡2동,'75,70 - 74세,1998,85,28,57
'4127055200,  원곡2동,'80,75 - 79세,1998,50,17,33
'4127055200,  원곡2동,'85,80 - 84세,1998,35,8,27
'4127055200,  원곡2동,'90,85+ ,1998,21,7,14
'4127056100,  초지동,'00,계,1998,12593,6836,5757
'4127056100,  초지동,'05,0 - 4세,1998,717,367,350
'4127056100,  초지동,'10,5 - 9세,1998,895,473,422
'4127056100,  초지동,'15,10 - 14세,1998,942,495,447
'4127056100,  초지동,'20,15 - 19세,1998,1237,661,576
'4127056100,  초지동,'25,20 - 24세,1998,1381,826,555
'4127056100,  초지동,'30,25 - 29세,1998,1273,803,470
'4127056100,  초지동,'35,30 - 34세,1998,1149,653,496
'4127056100,  초지동,'40,35 - 39세,1998,1284,669,615
'4127056100,  초지동,'45,40 - 44세,1998,1117,602,515
'4127056100,  초지동,'50,45 - 49세,1998,722,402,320
'4127056100,  초지동,'55,50 - 54세,1998,580,319,261
'4127056100,  초지동,'60,55 - 59세,1998,443,222,221
'4127056100,  초지동,'65,60 - 64세,1998,352,166,186
'4127056100,  초지동,'70,65 - 69세,1998,187,81,106
'4127056100,  초지동,'75,70 - 74세,1998,136,49,87
'4127056100,  초지동,'80,75 - 79세,1998,108,33,75
'4127056100,  초지동,'85,80 - 84세,1998,44,9,35
'4127056100,  초지동,'90,85+ ,1998,26,6,20
'4127057100,  선부1동,'00,계,1998,24059,12307,11752
'4127057100,  선부1동,'05,0 - 4세,1998,2222,1168,1054
'4127057100,  선부1동,'10,5 - 9세,1998,2483,1310,1173
'4127057100,  선부1동,'15,10 - 14세,1998,2238,1149,1089
'4127057100,  선부1동,'20,15 - 19세,1998,2103,1096,1007
'4127057100,  선부1동,'25,20 - 24세,1998,1612,814,798
'4127057100,  선부1동,'30,25 - 29세,1998,2107,984,1123
'4127057100,  선부1동,'35,30 - 34세,1998,2915,1422,1493
'4127057100,  선부1동,'40,35 - 39세,1998,3179,1663,1516
'4127057100,  선부1동,'45,40 - 44세,1998,2084,1197,887
'4127057100,  선부1동,'50,45 - 49세,1998,1066,612,454
'4127057100,  선부1동,'55,50 - 54세,1998,617,350,267
'4127057100,  선부1동,'60,55 - 59세,1998,416,212,204
'4127057100,  선부1동,'65,60 - 64세,1998,348,127,221
'4127057100,  선부1동,'70,65 - 69세,1998,242,73,169
'4127057100,  선부1동,'75,70 - 74세,1998,210,67,143
'4127057100,  선부1동,'80,75 - 79세,1998,118,34,84
'4127057100,  선부1동,'85,80 - 84세,1998,69,24,45
'4127057100,  선부1동,'90,85+ ,1998,30,5,25
'4127057200,  선부2동,'00,계,1998,27295,14633,12662
'4127057200,  선부2동,'05,0 - 4세,1998,3278,1719,1559
'4127057200,  선부2동,'10,5 - 9세,1998,2733,1423,1310
'4127057200,  선부2동,'15,10 - 14세,1998,1853,947,906
'4127057200,  선부2동,'20,15 - 19세,1998,1532,772,760
'4127057200,  선부2동,'25,20 - 24세,1998,2140,1061,1079
'4127057200,  선부2동,'30,25 - 29세,1998,4079,2232,1847
'4127057200,  선부2동,'35,30 - 34세,1998,3978,2277,1701
'4127057200,  선부2동,'40,35 - 39세,1998,3217,1896,1321
'4127057200,  선부2동,'45,40 - 44세,1998,1773,1021,752
'4127057200,  선부2동,'50,45 - 49세,1998,797,462,335
'4127057200,  선부2동,'55,50 - 54세,1998,512,282,230
'4127057200,  선부2동,'60,55 - 59세,1998,393,177,216
'4127057200,  선부2동,'65,60 - 64세,1998,363,148,215
'4127057200,  선부2동,'70,65 - 69세,1998,267,96,171
'4127057200,  선부2동,'75,70 - 74세,1998,177,62,115
'4127057200,  선부2동,'80,75 - 79세,1998,129,34,95
'4127057200,  선부2동,'85,80 - 84세,1998,42,20,22
'4127057200,  선부2동,'90,85+ ,1998,32,4,28
'4127057300,  선부3동,'00,계,1998,40899,21077,19822
'4127057300,  선부3동,'05,0 - 4세,1998,4384,2309,2075
'4127057300,  선부3동,'10,5 - 9세,1998,4730,2481,2249
'4127057300,  선부3동,'15,10 - 14세,1998,3704,1910,1794
'4127057300,  선부3동,'20,15 - 19세,1998,2594,1348,1246
'4127057300,  선부3동,'25,20 - 24세,1998,2373,1157,1216
'4127057300,  선부3동,'30,25 - 29세,1998,4232,1989,2243
'4127057300,  선부3동,'35,30 - 34세,1998,5381,2632,2749
'4127057300,  선부3동,'40,35 - 39세,1998,5644,3099,2545
'4127057300,  선부3동,'45,40 - 44세,1998,3390,1997,1393
'4127057300,  선부3동,'50,45 - 49세,1998,1341,797,544
'4127057300,  선부3동,'55,50 - 54세,1998,772,435,337
'4127057300,  선부3동,'60,55 - 59세,1998,656,307,349
'4127057300,  선부3동,'65,60 - 64세,1998,562,246,316
'4127057300,  선부3동,'70,65 - 69세,1998,425,150,275
'4127057300,  선부3동,'75,70 - 74세,1998,335,110,225
'4127057300,  선부3동,'80,75 - 79세,1998,210,65,145
'4127057300,  선부3동,'85,80 - 84세,1998,98,24,74
'4127057300,  선부3동,'90,85+ ,1998,68,21,47
'4127058000,  반월동,'00,계,1998,14010,7118,6892
'4127058000,  반월동,'05,0 - 4세,1998,1165,601,564
'4127058000,  반월동,'10,5 - 9세,1998,1234,624,610
'4127058000,  반월동,'15,10 - 14세,1998,972,491,481
'4127058000,  반월동,'20,15 - 19세,1998,1144,578,566
'4127058000,  반월동,'25,20 - 24세,1998,1078,545,533
'4127058000,  반월동,'30,25 - 29세,1998,1285,646,639
'4127058000,  반월동,'35,30 - 34세,1998,1551,770,781
'4127058000,  반월동,'40,35 - 39세,1998,1507,828,679
'4127058000,  반월동,'45,40 - 44세,1998,1163,596,567
'4127058000,  반월동,'50,45 - 49세,1998,710,375,335
'4127058000,  반월동,'55,50 - 54세,1998,575,320,255
'4127058000,  반월동,'60,55 - 59세,1998,534,270,264
'4127058000,  반월동,'65,60 - 64세,1998,418,208,210
'4127058000,  반월동,'70,65 - 69세,1998,269,107,162
'4127058000,  반월동,'75,70 - 74세,1998,197,81,116
'4127058000,  반월동,'80,75 - 79세,1998,111,48,63
'4127058000,  반월동,'85,80 - 84세,1998,70,24,46
'4127058000,  반월동,'90,85+ ,1998,27,6,21
'4127059000,  대부동,'00,계,1998,6227,3234,2993
'4127059000,  대부동,'05,0 - 4세,1998,350,180,170
'4127059000,  대부동,'10,5 - 9세,1998,383,197,186
'4127059000,  대부동,'15,10 - 14세,1998,327,181,146
'4127059000,  대부동,'20,15 - 19세,1998,436,228,208
'4127059000,  대부동,'25,20 - 24세,1998,394,228,166
'4127059000,  대부동,'30,25 - 29세,1998,408,224,184
'4127059000,  대부동,'35,30 - 34세,1998,465,264,201
'4127059000,  대부동,'40,35 - 39세,1998,477,271,206
'4127059000,  대부동,'45,40 - 44세,1998,493,281,212
'4127059000,  대부동,'50,45 - 49세,1998,407,231,176
'4127059000,  대부동,'55,50 - 54세,1998,397,216,181
'4127059000,  대부동,'60,55 - 59세,1998,428,200,228
'4127059000,  대부동,'65,60 - 64세,1998,422,192,230
'4127059000,  대부동,'70,65 - 69세,1998,295,134,161
'4127059000,  대부동,'75,70 - 74세,1998,237,87,150
'4127059000,  대부동,'80,75 - 79세,1998,171,73,98
'4127059000,  대부동,'85,80 - 84세,1998,76,32,44
'4127059000,  대부동,'90,85+ ,1998,61,15,46
'4127060000,  안산동,'00,계,1998,6918,3501,3417
'4127060000,  안산동,'05,0 - 4세,1998,507,257,250
'4127060000,  안산동,'10,5 - 9세,1998,660,333,327
'4127060000,  안산동,'15,10 - 14세,1998,544,290,254
'4127060000,  안산동,'20,15 - 19세,1998,607,290,317
'4127060000,  안산동,'25,20 - 24세,1998,472,240,232
'4127060000,  안산동,'30,25 - 29세,1998,577,294,283
'4127060000,  안산동,'35,30 - 34세,1998,669,325,344
'4127060000,  안산동,'40,35 - 39세,1998,796,446,350
'4127060000,  안산동,'45,40 - 44세,1998,591,330,261
'4127060000,  안산동,'50,45 - 49세,1998,360,207,153
'4127060000,  안산동,'55,50 - 54세,1998,253,120,133
'4127060000,  안산동,'60,55 - 59세,1998,275,142,133
'4127060000,  안산동,'65,60 - 64세,1998,221,97,124
'4127060000,  안산동,'70,65 - 69세,1998,146,49,97
'4127060000,  안산동,'75,70 - 74세,1998,126,42,84
'4127060000,  안산동,'80,75 - 79세,1998,65,28,37
'4127060000,  안산동,'85,80 - 84세,1998,25,3,22
'4127060000,  안산동,'90,85+ ,1998,24,8,16
'4127061000,  본오3동,'00,계,1998,24987,12605,12382
'4127061000,  본오3동,'05,0 - 4세,1998,2861,1522,1339
'4127061000,  본오3동,'10,5 - 9세,1998,2563,1343,1220
'4127061000,  본오3동,'15,10 - 14세,1998,1696,894,802
'4127061000,  본오3동,'20,15 - 19세,1998,1178,583,595
'4127061000,  본오3동,'25,20 - 24세,1998,1392,592,800
'4127061000,  본오3동,'30,25 - 29세,1998,3392,1572,1820
'4127061000,  본오3동,'35,30 - 34세,1998,3500,1793,1707
'4127061000,  본오3동,'40,35 - 39세,1998,3162,1688,1474
'4127061000,  본오3동,'45,40 - 44세,1998,1664,993,671
'4127061000,  본오3동,'50,45 - 49세,1998,758,403,355
'4127061000,  본오3동,'55,50 - 54세,1998,637,309,328
'4127061000,  본오3동,'60,55 - 59세,1998,610,264,346
'4127061000,  본오3동,'65,60 - 64세,1998,588,245,343
'4127061000,  본오3동,'70,65 - 69세,1998,415,191,224
'4127061000,  본오3동,'75,70 - 74세,1998,264,105,159
'4127061000,  본오3동,'80,75 - 79세,1998,167,65,102
'4127061000,  본오3동,'85,80 - 84세,1998,85,26,59
'4127061000,  본오3동,'90,85+ ,1998,55,17,38
'41280, 고양시,'00,계,1998,750418,374360,376058
'41280, 고양시,'05,0 - 4세,1998,69334,36308,33026
'41280, 고양시,'10,5 - 9세,1998,74418,38763,35655
'41280, 고양시,'15,10 - 14세,1998,53413,27501,25912
'41280, 고양시,'20,15 - 19세,1998,44265,22472,21793
'41280, 고양시,'25,20 - 24세,1998,41001,20434,20567
'41280, 고양시,'30,25 - 29세,1998,70694,31988,38706
'41280, 고양시,'35,30 - 34세,1998,88108,41669,46439
'41280, 고양시,'40,35 - 39세,1998,94041,49252,44789
'41280, 고양시,'45,40 - 44세,1998,64170,36114,28056
'41280, 고양시,'50,45 - 49세,1998,33445,17855,15590
'41280, 고양시,'55,50 - 54세,1998,28113,13659,14454
'41280, 고양시,'60,55 - 59세,1998,27458,12944,14514
'41280, 고양시,'65,60 - 64세,1998,22970,10520,12450
'41280, 고양시,'70,65 - 69세,1998,15892,6710,9182
'41280, 고양시,'75,70 - 74세,1998,10321,3859,6462
'41280, 고양시,'80,75 - 79세,1998,6962,2621,4341
'41280, 고양시,'85,80 - 84세,1998,3577,1132,2445
'41280, 고양시,'90,85+ ,1998,2236,559,1677
'41281, 덕양구,'00,계,1998,357085,179260,177825
'41281, 덕양구,'05,0 - 4세,1998,35678,18527,17151
'41281, 덕양구,'10,5 - 9세,1998,34488,17802,16686
'41281, 덕양구,'15,10 - 14세,1998,20840,10674,10166
'41281, 덕양구,'20,15 - 19세,1998,18969,9795,9174
'41281, 덕양구,'25,20 - 24세,1998,20782,10452,10330
'41281, 덕양구,'30,25 - 29세,1998,37577,17101,20476
'41281, 덕양구,'35,30 - 34세,1998,46229,22640,23589
'41281, 덕양구,'40,35 - 39세,1998,43218,23981,19237
'41281, 덕양구,'45,40 - 44세,1998,26701,15238,11463
'41281, 덕양구,'50,45 - 49세,1998,14895,7736,7159
'41281, 덕양구,'55,50 - 54세,1998,13535,6422,7113
'41281, 덕양구,'60,55 - 59세,1998,13856,6375,7481
'41281, 덕양구,'65,60 - 64세,1998,11500,5300,6200
'41281, 덕양구,'70,65 - 69세,1998,7755,3291,4464
'41281, 덕양구,'75,70 - 74세,1998,4987,1836,3151
'41281, 덕양구,'80,75 - 79세,1998,3338,1278,2060
'41281, 덕양구,'85,80 - 84세,1998,1739,560,1179
'41281, 덕양구,'90,85+ ,1998,998,252,746
'4128151000,  주교동,'00,계,1998,16701,8334,8367
'4128151000,  주교동,'05,0 - 4세,1998,1539,789,750
'4128151000,  주교동,'10,5 - 9세,1998,1699,860,839
'4128151000,  주교동,'15,10 - 14세,1998,1019,488,531
'4128151000,  주교동,'20,15 - 19세,1998,904,455,449
'4128151000,  주교동,'25,20 - 24세,1998,954,469,485
'4128151000,  주교동,'30,25 - 29세,1998,1806,889,917
'4128151000,  주교동,'35,30 - 34세,1998,2166,1078,1088
'4128151000,  주교동,'40,35 - 39세,1998,1986,1107,879
'4128151000,  주교동,'45,40 - 44세,1998,1200,663,537
'4128151000,  주교동,'50,45 - 49세,1998,635,349,286
'4128151000,  주교동,'55,50 - 54세,1998,586,254,332
'4128151000,  주교동,'60,55 - 59세,1998,672,305,367
'4128151000,  주교동,'65,60 - 64세,1998,589,253,336
'4128151000,  주교동,'70,65 - 69세,1998,407,171,236
'4128151000,  주교동,'75,70 - 74세,1998,270,117,153
'4128151000,  주교동,'80,75 - 79세,1998,155,53,102
'4128151000,  주교동,'85,80 - 84세,1998,74,25,49
'4128151000,  주교동,'90,85+ ,1998,40,9,31
'4128152000,  원신동,'00,계,1998,4341,2338,2003
'4128152000,  원신동,'05,0 - 4세,1998,282,157,125
'4128152000,  원신동,'10,5 - 9세,1998,258,131,127
'4128152000,  원신동,'15,10 - 14세,1998,214,124,90
'4128152000,  원신동,'20,15 - 19세,1998,317,176,141
'4128152000,  원신동,'25,20 - 24세,1998,365,198,167
'4128152000,  원신동,'30,25 - 29세,1998,430,248,182
'4128152000,  원신동,'35,30 - 34세,1998,402,241,161
'4128152000,  원신동,'40,35 - 39세,1998,415,226,189
'4128152000,  원신동,'45,40 - 44세,1998,356,203,153
'4128152000,  원신동,'50,45 - 49세,1998,261,138,123
'4128152000,  원신동,'55,50 - 54세,1998,252,134,118
'4128152000,  원신동,'60,55 - 59세,1998,236,121,115
'4128152000,  원신동,'65,60 - 64세,1998,212,101,111
'4128152000,  원신동,'70,65 - 69세,1998,141,67,74
'4128152000,  원신동,'75,70 - 74세,1998,81,29,52
'4128152000,  원신동,'80,75 - 79세,1998,73,33,40
'4128152000,  원신동,'85,80 - 84세,1998,30,8,22
'4128152000,  원신동,'90,85+ ,1998,16,3,13
'4128153000,  흥도동,'00,계,1998,5643,2973,2670
'4128153000,  흥도동,'05,0 - 4세,1998,371,180,191
'4128153000,  흥도동,'10,5 - 9세,1998,318,165,153
'4128153000,  흥도동,'15,10 - 14세,1998,255,147,108
'4128153000,  흥도동,'20,15 - 19세,1998,385,193,192
'4128153000,  흥도동,'25,20 - 24세,1998,454,251,203
'4128153000,  흥도동,'30,25 - 29세,1998,585,334,251
'4128153000,  흥도동,'35,30 - 34세,1998,495,287,208
'4128153000,  흥도동,'40,35 - 39세,1998,472,284,188
'4128153000,  흥도동,'45,40 - 44세,1998,465,248,217
'4128153000,  흥도동,'50,45 - 49세,1998,339,186,153
'4128153000,  흥도동,'55,50 - 54세,1998,326,157,169
'4128153000,  흥도동,'60,55 - 59세,1998,366,182,184
'4128153000,  흥도동,'65,60 - 64세,1998,320,172,148
'4128153000,  흥도동,'70,65 - 69세,1998,200,93,107
'4128153000,  흥도동,'75,70 - 74세,1998,119,38,81
'4128153000,  흥도동,'80,75 - 79세,1998,89,35,54
'4128153000,  흥도동,'85,80 - 84세,1998,58,17,41
'4128153000,  흥도동,'90,85+ ,1998,26,4,22
'4128154000,  성사1동,'00,계,1998,21566,10748,10818
'4128154000,  성사1동,'05,0 - 4세,1998,2629,1354,1275
'4128154000,  성사1동,'10,5 - 9세,1998,2120,1123,997
'4128154000,  성사1동,'15,10 - 14세,1998,917,483,434
'4128154000,  성사1동,'20,15 - 19세,1998,853,437,416
'4128154000,  성사1동,'25,20 - 24세,1998,1105,504,601
'4128154000,  성사1동,'30,25 - 29세,1998,2780,1283,1497
'4128154000,  성사1동,'35,30 - 34세,1998,3342,1695,1647
'4128154000,  성사1동,'40,35 - 39세,1998,2523,1439,1084
'4128154000,  성사1동,'45,40 - 44세,1998,1383,792,591
'4128154000,  성사1동,'50,45 - 49세,1998,703,345,358
'4128154000,  성사1동,'55,50 - 54세,1998,615,270,345
'4128154000,  성사1동,'60,55 - 59세,1998,747,306,441
'4128154000,  성사1동,'65,60 - 64세,1998,666,282,384
'4128154000,  성사1동,'70,65 - 69세,1998,486,179,307
'4128154000,  성사1동,'75,70 - 74세,1998,311,114,197
'4128154000,  성사1동,'80,75 - 79세,1998,230,92,138
'4128154000,  성사1동,'85,80 - 84세,1998,107,43,64
'4128154000,  성사1동,'90,85+ ,1998,49,7,42
'4128155000,  성사2동,'00,계,1998,14676,7244,7432
'4128155000,  성사2동,'05,0 - 4세,1998,1237,656,581
'4128155000,  성사2동,'10,5 - 9세,1998,1465,756,709
'4128155000,  성사2동,'15,10 - 14세,1998,1201,615,586
'4128155000,  성사2동,'20,15 - 19세,1998,886,438,448
'4128155000,  성사2동,'25,20 - 24세,1998,763,378,385
'4128155000,  성사2동,'30,25 - 29세,1998,1331,547,784
'4128155000,  성사2동,'35,30 - 34세,1998,1684,792,892
'4128155000,  성사2동,'40,35 - 39세,1998,2001,1001,1000
'4128155000,  성사2동,'45,40 - 44세,1998,1366,794,572
'4128155000,  성사2동,'50,45 - 49세,1998,614,332,282
'4128155000,  성사2동,'55,50 - 54세,1998,502,238,264
'4128155000,  성사2동,'60,55 - 59세,1998,483,234,249
'4128155000,  성사2동,'65,60 - 64세,1998,426,179,247
'4128155000,  성사2동,'70,65 - 69세,1998,332,144,188
'4128155000,  성사2동,'75,70 - 74세,1998,188,78,110
'4128155000,  성사2동,'80,75 - 79세,1998,101,37,64
'4128155000,  성사2동,'85,80 - 84세,1998,64,18,46
'4128155000,  성사2동,'90,85+ ,1998,32,7,25
'4128156000,  효자동,'00,계,1998,7709,4098,3611
'4128156000,  효자동,'05,0 - 4세,1998,436,214,222
'4128156000,  효자동,'10,5 - 9세,1998,422,213,209
'4128156000,  효자동,'15,10 - 14세,1998,270,136,134
'4128156000,  효자동,'20,15 - 19세,1998,547,305,242
'4128156000,  효자동,'25,20 - 24세,1998,757,390,367
'4128156000,  효자동,'30,25 - 29세,1998,800,472,328
'4128156000,  효자동,'35,30 - 34세,1998,651,387,264
'4128156000,  효자동,'40,35 - 39세,1998,681,397,284
'4128156000,  효자동,'45,40 - 44세,1998,608,366,242
'4128156000,  효자동,'50,45 - 49세,1998,490,252,238
'4128156000,  효자동,'55,50 - 54세,1998,500,233,267
'4128156000,  효자동,'60,55 - 59세,1998,535,269,266
'4128156000,  효자동,'65,60 - 64세,1998,367,193,174
'4128156000,  효자동,'70,65 - 69세,1998,239,104,135
'4128156000,  효자동,'75,70 - 74세,1998,158,66,92
'4128156000,  효자동,'80,75 - 79세,1998,150,58,92
'4128156000,  효자동,'85,80 - 84세,1998,57,24,33
'4128156000,  효자동,'90,85+ ,1998,41,19,22
'4128157000,  신도동,'00,계,1998,10068,5233,4835
'4128157000,  신도동,'05,0 - 4세,1998,599,296,303
'4128157000,  신도동,'10,5 - 9세,1998,680,365,315
'4128157000,  신도동,'15,10 - 14세,1998,457,217,240
'4128157000,  신도동,'20,15 - 19세,1998,672,337,335
'4128157000,  신도동,'25,20 - 24세,1998,808,446,362
'4128157000,  신도동,'30,25 - 29세,1998,1020,554,466
'4128157000,  신도동,'35,30 - 34세,1998,965,540,425
'4128157000,  신도동,'40,35 - 39세,1998,965,543,422
'4128157000,  신도동,'45,40 - 44세,1998,833,479,354
'4128157000,  신도동,'50,45 - 49세,1998,589,311,278
'4128157000,  신도동,'55,50 - 54세,1998,572,290,282
'4128157000,  신도동,'60,55 - 59세,1998,642,302,340
'4128157000,  신도동,'65,60 - 64세,1998,465,224,241
'4128157000,  신도동,'70,65 - 69세,1998,319,143,176
'4128157000,  신도동,'75,70 - 74세,1998,216,90,126
'4128157000,  신도동,'80,75 - 79세,1998,131,48,83
'4128157000,  신도동,'85,80 - 84세,1998,83,31,52
'4128157000,  신도동,'90,85+ ,1998,52,17,35
'4128158000,  창릉동,'00,계,1998,6879,3695,3184
'4128158000,  창릉동,'05,0 - 4세,1998,420,213,207
'4128158000,  창릉동,'10,5 - 9세,1998,298,161,137
'4128158000,  창릉동,'15,10 - 14세,1998,227,111,116
'4128158000,  창릉동,'20,15 - 19세,1998,548,308,240
'4128158000,  창릉동,'25,20 - 24세,1998,614,338,276
'4128158000,  창릉동,'30,25 - 29세,1998,785,443,342
'4128158000,  창릉동,'35,30 - 34세,1998,545,344,201
'4128158000,  창릉동,'40,35 - 39세,1998,544,328,216
'4128158000,  창릉동,'45,40 - 44세,1998,529,306,223
'4128158000,  창릉동,'50,45 - 49세,1998,424,208,216
'4128158000,  창릉동,'55,50 - 54세,1998,471,238,233
'4128158000,  창릉동,'60,55 - 59세,1998,471,239,232
'4128158000,  창릉동,'65,60 - 64세,1998,408,211,197
'4128158000,  창릉동,'70,65 - 69세,1998,242,112,130
'4128158000,  창릉동,'75,70 - 74세,1998,158,67,91
'4128158000,  창릉동,'80,75 - 79세,1998,89,41,48
'4128158000,  창릉동,'85,80 - 84세,1998,68,20,48
'4128158000,  창릉동,'90,85+ ,1998,38,7,31
'4128159000,  고양동,'00,계,1998,19570,9972,9598
'4128159000,  고양동,'05,0 - 4세,1998,2111,1115,996
'4128159000,  고양동,'10,5 - 9세,1998,1704,864,840
'4128159000,  고양동,'15,10 - 14세,1998,813,427,386
'4128159000,  고양동,'20,15 - 19세,1998,1078,560,518
'4128159000,  고양동,'25,20 - 24세,1998,1330,696,634
'4128159000,  고양동,'30,25 - 29세,1998,2231,1043,1188
'4128159000,  고양동,'35,30 - 34세,1998,2601,1320,1281
'4128159000,  고양동,'40,35 - 39세,1998,2147,1283,864
'4128159000,  고양동,'45,40 - 44세,1998,1305,717,588
'4128159000,  고양동,'50,45 - 49세,1998,847,419,428
'4128159000,  고양동,'55,50 - 54세,1998,833,408,425
'4128159000,  고양동,'60,55 - 59세,1998,847,382,465
'4128159000,  고양동,'65,60 - 64세,1998,651,311,340
'4128159000,  고양동,'70,65 - 69세,1998,437,206,231
'4128159000,  고양동,'75,70 - 74세,1998,286,102,184
'4128159000,  고양동,'80,75 - 79세,1998,193,61,132
'4128159000,  고양동,'85,80 - 84세,1998,103,42,61
'4128159000,  고양동,'90,85+ ,1998,53,16,37
'4128160000,  관산동,'00,계,1998,17437,8825,8612
'4128160000,  관산동,'05,0 - 4세,1998,1703,896,807
'4128160000,  관산동,'10,5 - 9세,1998,1337,709,628
'4128160000,  관산동,'15,10 - 14세,1998,738,375,363
'4128160000,  관산동,'20,15 - 19세,1998,1029,508,521
'4128160000,  관산동,'25,20 - 24세,1998,1180,600,580
'4128160000,  관산동,'30,25 - 29세,1998,2051,991,1060
'4128160000,  관산동,'35,30 - 34세,1998,2138,1134,1004
'4128160000,  관산동,'40,35 - 39세,1998,1831,1044,787
'4128160000,  관산동,'45,40 - 44세,1998,1227,672,555
'4128160000,  관산동,'50,45 - 49세,1998,774,398,376
'4128160000,  관산동,'55,50 - 54세,1998,761,360,401
'4128160000,  관산동,'60,55 - 59세,1998,836,356,480
'4128160000,  관산동,'65,60 - 64세,1998,716,343,373
'4128160000,  관산동,'70,65 - 69세,1998,442,204,238
'4128160000,  관산동,'75,70 - 74세,1998,312,109,203
'4128160000,  관산동,'80,75 - 79세,1998,173,72,101
'4128160000,  관산동,'85,80 - 84세,1998,115,38,77
'4128160000,  관산동,'90,85+ ,1998,74,16,58
'4128161000,  능곡동,'00,계,1998,13155,6599,6556
'4128161000,  능곡동,'05,0 - 4세,1998,1177,642,535
'4128161000,  능곡동,'10,5 - 9세,1998,1178,579,599
'4128161000,  능곡동,'15,10 - 14세,1998,739,374,365
'4128161000,  능곡동,'20,15 - 19세,1998,805,402,403
'4128161000,  능곡동,'25,20 - 24세,1998,822,392,430
'4128161000,  능곡동,'30,25 - 29세,1998,1357,692,665
'4128161000,  능곡동,'35,30 - 34세,1998,1547,771,776
'4128161000,  능곡동,'40,35 - 39세,1998,1446,824,622
'4128161000,  능곡동,'45,40 - 44세,1998,942,512,430
'4128161000,  능곡동,'50,45 - 49세,1998,619,306,313
'4128161000,  능곡동,'55,50 - 54세,1998,559,269,290
'4128161000,  능곡동,'60,55 - 59세,1998,563,259,304
'4128161000,  능곡동,'65,60 - 64세,1998,499,241,258
'4128161000,  능곡동,'70,65 - 69세,1998,349,141,208
'4128161000,  능곡동,'75,70 - 74세,1998,235,79,156
'4128161000,  능곡동,'80,75 - 79세,1998,183,73,110
'4128161000,  능곡동,'85,80 - 84세,1998,93,32,61
'4128161000,  능곡동,'90,85+ ,1998,42,11,31
'4128162100,  화정1동,'00,계,1998,45051,22124,22927
'4128162100,  화정1동,'05,0 - 4세,1998,4220,2193,2027
'4128162100,  화정1동,'10,5 - 9세,1998,4377,2267,2110
'4128162100,  화정1동,'15,10 - 14세,1998,3079,1553,1526
'4128162100,  화정1동,'20,15 - 19세,1998,2221,1138,1083
'4128162100,  화정1동,'25,20 - 24세,1998,2831,1344,1487
'4128162100,  화정1동,'30,25 - 29세,1998,5057,2167,2890
'4128162100,  화정1동,'35,30 - 34세,1998,5584,2640,2944
'4128162100,  화정1동,'40,35 - 39세,1998,5441,2825,2616
'4128162100,  화정1동,'45,40 - 44세,1998,3413,1943,1470
'4128162100,  화정1동,'50,45 - 49세,1998,1910,952,958
'4128162100,  화정1동,'55,50 - 54세,1998,1831,829,1002
'4128162100,  화정1동,'60,55 - 59세,1998,1756,876,880
'4128162100,  화정1동,'65,60 - 64세,1998,1287,638,649
'4128162100,  화정1동,'70,65 - 69세,1998,812,345,467
'4128162100,  화정1동,'75,70 - 74세,1998,503,184,319
'4128162100,  화정1동,'80,75 - 79세,1998,369,138,231
'4128162100,  화정1동,'85,80 - 84세,1998,227,59,168
'4128162100,  화정1동,'90,85+ ,1998,133,33,100
'4128162200,  화정2동,'00,계,1998,37704,18679,19025
'4128162200,  화정2동,'05,0 - 4세,1998,4638,2440,2198
'4128162200,  화정2동,'10,5 - 9세,1998,4672,2381,2291
'4128162200,  화정2동,'15,10 - 14세,1998,2631,1394,1237
'4128162200,  화정2동,'20,15 - 19세,1998,1594,838,756
'4128162200,  화정2동,'25,20 - 24세,1998,1349,632,717
'4128162200,  화정2동,'30,25 - 29세,1998,3546,1337,2209
'4128162200,  화정2동,'35,30 - 34세,1998,5807,2619,3188
'4128162200,  화정2동,'40,35 - 39세,1998,5458,3018,2440
'4128162200,  화정2동,'45,40 - 44세,1998,2913,1736,1177
'4128162200,  화정2동,'50,45 - 49세,1998,1178,658,520
'4128162200,  화정2동,'55,50 - 54세,1998,956,460,496
'4128162200,  화정2동,'60,55 - 59세,1998,863,368,495
'4128162200,  화정2동,'65,60 - 64세,1998,755,307,448
'4128162200,  화정2동,'70,65 - 69세,1998,605,246,359
'4128162200,  화정2동,'75,70 - 74세,1998,346,118,228
'4128162200,  화정2동,'80,75 - 79세,1998,230,91,139
'4128162200,  화정2동,'85,80 - 84세,1998,94,23,71
'4128162200,  화정2동,'90,85+ ,1998,69,13,56
'4128163000,  행주동,'00,계,1998,18838,9456,9382
'4128163000,  행주동,'05,0 - 4세,1998,1738,877,861
'4128163000,  행주동,'10,5 - 9세,1998,1459,747,712
'4128163000,  행주동,'15,10 - 14세,1998,1043,534,509
'4128163000,  행주동,'20,15 - 19세,1998,1246,639,607
'4128163000,  행주동,'25,20 - 24세,1998,1280,665,615
'4128163000,  행주동,'30,25 - 29세,1998,2101,1003,1098
'4128163000,  행주동,'35,30 - 34세,1998,2279,1184,1095
'4128163000,  행주동,'40,35 - 39세,1998,2059,1154,905
'4128163000,  행주동,'45,40 - 44세,1998,1385,747,638
'4128163000,  행주동,'50,45 - 49세,1998,858,430,428
'4128163000,  행주동,'55,50 - 54세,1998,812,402,410
'4128163000,  행주동,'60,55 - 59세,1998,791,355,436
'4128163000,  행주동,'65,60 - 64세,1998,691,307,384
'4128163000,  행주동,'70,65 - 69세,1998,421,185,236
'4128163000,  행주동,'75,70 - 74세,1998,313,94,219
'4128163000,  행주동,'80,75 - 79세,1998,207,84,123
'4128163000,  행주동,'85,80 - 84세,1998,99,29,70
'4128163000,  행주동,'90,85+ ,1998,56,20,36
'4128164000,  행신1동,'00,계,1998,62140,30849,31291
'4128164000,  행신1동,'05,0 - 4세,1998,7206,3717,3489
'4128164000,  행신1동,'10,5 - 9세,1998,6623,3461,3162
'4128164000,  행신1동,'15,10 - 14세,1998,3573,1830,1743
'4128164000,  행신1동,'20,15 - 19세,1998,2887,1484,1403
'4128164000,  행신1동,'25,20 - 24세,1998,3235,1618,1617
'4128164000,  행신1동,'30,25 - 29세,1998,6421,2661,3760
'4128164000,  행신1동,'35,30 - 34세,1998,9045,4273,4772
'4128164000,  행신1동,'40,35 - 39세,1998,8063,4592,3471
'4128164000,  행신1동,'45,40 - 44세,1998,4292,2399,1893
'4128164000,  행신1동,'50,45 - 49세,1998,2353,1188,1165
'4128164000,  행신1동,'55,50 - 54세,1998,2049,963,1086
'4128164000,  행신1동,'60,55 - 59세,1998,2054,915,1139
'4128164000,  행신1동,'65,60 - 64세,1998,1745,769,976
'4128164000,  행신1동,'70,65 - 69세,1998,1122,466,656
'4128164000,  행신1동,'75,70 - 74세,1998,696,255,441
'4128164000,  행신1동,'80,75 - 79세,1998,443,176,267
'4128164000,  행신1동,'85,80 - 84세,1998,204,51,153
'4128164000,  행신1동,'90,85+ ,1998,129,31,98
'4128165000,  행신2동,'00,계,1998,39990,19806,20184
'4128165000,  행신2동,'05,0 - 4세,1998,4236,2206,2030
'4128165000,  행신2동,'10,5 - 9세,1998,4826,2474,2352
'4128165000,  행신2동,'15,10 - 14세,1998,3040,1557,1483
'4128165000,  행신2동,'20,15 - 19세,1998,1932,998,934
'4128165000,  행신2동,'25,20 - 24세,1998,1711,820,891
'4128165000,  행신2동,'30,25 - 29세,1998,3636,1496,2140
'4128165000,  행신2동,'35,30 - 34세,1998,5359,2412,2947
'4128165000,  행신2동,'40,35 - 39세,1998,5804,3083,2721
'4128165000,  행신2동,'45,40 - 44세,1998,3287,1976,1311
'4128165000,  행신2동,'50,45 - 49세,1998,1427,795,632
'4128165000,  행신2동,'55,50 - 54세,1998,1090,516,574
'4128165000,  행신2동,'60,55 - 59세,1998,1097,505,592
'4128165000,  행신2동,'65,60 - 64세,1998,961,402,559
'4128165000,  행신2동,'70,65 - 69세,1998,661,247,414
'4128165000,  행신2동,'75,70 - 74세,1998,440,150,290
'4128165000,  행신2동,'80,75 - 79세,1998,274,101,173
'4128165000,  행신2동,'85,80 - 84세,1998,139,51,88
'4128165000,  행신2동,'90,85+ ,1998,70,17,53
'4128166000,  화전동,'00,계,1998,10505,5599,4906
'4128166000,  화전동,'05,0 - 4세,1998,725,374,351
'4128166000,  화전동,'10,5 - 9세,1998,635,335,300
'4128166000,  화전동,'15,10 - 14세,1998,369,179,190
'4128166000,  화전동,'20,15 - 19세,1998,694,380,314
'4128166000,  화전동,'25,20 - 24세,1998,863,485,378
'4128166000,  화전동,'30,25 - 29세,1998,1135,666,469
'4128166000,  화전동,'35,30 - 34세,1998,1007,582,425
'4128166000,  화전동,'40,35 - 39세,1998,965,602,363
'4128166000,  화전동,'45,40 - 44세,1998,811,470,341
'4128166000,  화전동,'50,45 - 49세,1998,592,313,279
'4128166000,  화전동,'55,50 - 54세,1998,584,280,304
'4128166000,  화전동,'60,55 - 59세,1998,635,277,358
'4128166000,  화전동,'65,60 - 64세,1998,537,265,272
'4128166000,  화전동,'70,65 - 69세,1998,397,181,216
'4128166000,  화전동,'75,70 - 74세,1998,250,107,143
'4128166000,  화전동,'80,75 - 79세,1998,166,57,109
'4128166000,  화전동,'85,80 - 84세,1998,82,31,51
'4128166000,  화전동,'90,85+ ,1998,58,15,43
'4128167000,  대덕동,'00,계,1998,5112,2688,2424
'4128167000,  대덕동,'05,0 - 4세,1998,411,208,203
'4128167000,  대덕동,'10,5 - 9세,1998,417,211,206
'4128167000,  대덕동,'15,10 - 14세,1998,255,130,125
'4128167000,  대덕동,'20,15 - 19세,1998,371,199,172
'4128167000,  대덕동,'25,20 - 24세,1998,361,226,135
'4128167000,  대덕동,'30,25 - 29세,1998,505,275,230
'4128167000,  대덕동,'35,30 - 34세,1998,612,341,271
'4128167000,  대덕동,'40,35 - 39세,1998,417,231,186
'4128167000,  대덕동,'45,40 - 44세,1998,386,215,171
'4128167000,  대덕동,'50,45 - 49세,1998,282,156,126
'4128167000,  대덕동,'55,50 - 54세,1998,236,121,115
'4128167000,  대덕동,'60,55 - 59세,1998,262,124,138
'4128167000,  대덕동,'65,60 - 64세,1998,205,102,103
'4128167000,  대덕동,'70,65 - 69세,1998,143,57,86
'4128167000,  대덕동,'75,70 - 74세,1998,105,39,66
'4128167000,  대덕동,'80,75 - 79세,1998,82,28,54
'4128167000,  대덕동,'85,80 - 84세,1998,42,18,24
'4128167000,  대덕동,'90,85+ ,1998,20,7,13
'41283, 일산구,'00,계,1998,393333,195100,198233
'41283, 일산구,'05,0 - 4세,1998,33656,17781,15875
'41283, 일산구,'10,5 - 9세,1998,39930,20961,18969
'41283, 일산구,'15,10 - 14세,1998,32573,16827,15746
'41283, 일산구,'20,15 - 19세,1998,25296,12677,12619
'41283, 일산구,'25,20 - 24세,1998,20219,9982,10237
'41283, 일산구,'30,25 - 29세,1998,33117,14887,18230
'41283, 일산구,'35,30 - 34세,1998,41879,19029,22850
'41283, 일산구,'40,35 - 39세,1998,50823,25271,25552
'41283, 일산구,'45,40 - 44세,1998,37469,20876,16593
'41283, 일산구,'50,45 - 49세,1998,18550,10119,8431
'41283, 일산구,'55,50 - 54세,1998,14578,7237,7341
'41283, 일산구,'60,55 - 59세,1998,13602,6569,7033
'41283, 일산구,'65,60 - 64세,1998,11470,5220,6250
'41283, 일산구,'70,65 - 69세,1998,8137,3419,4718
'41283, 일산구,'75,70 - 74세,1998,5334,2023,3311
'41283, 일산구,'80,75 - 79세,1998,3624,1343,2281
'41283, 일산구,'85,80 - 84세,1998,1838,572,1266
'41283, 일산구,'90,85+ ,1998,1238,307,931
'4128351000,  식사동,'00,계,1998,5016,2660,2356
'4128351000,  식사동,'05,0 - 4세,1998,384,208,176
'4128351000,  식사동,'10,5 - 9세,1998,376,186,190
'4128351000,  식사동,'15,10 - 14세,1998,290,144,146
'4128351000,  식사동,'20,15 - 19세,1998,375,177,198
'4128351000,  식사동,'25,20 - 24세,1998,385,204,181
'4128351000,  식사동,'30,25 - 29세,1998,535,310,225
'4128351000,  식사동,'35,30 - 34세,1998,539,321,218
'4128351000,  식사동,'40,35 - 39세,1998,516,280,236
'4128351000,  식사동,'45,40 - 44세,1998,396,229,167
'4128351000,  식사동,'50,45 - 49세,1998,269,154,115
'4128351000,  식사동,'55,50 - 54세,1998,233,108,125
'4128351000,  식사동,'60,55 - 59세,1998,257,139,118
'4128351000,  식사동,'65,60 - 64세,1998,170,94,76
'4128351000,  식사동,'70,65 - 69세,1998,120,53,67
'4128351000,  식사동,'75,70 - 74세,1998,73,19,54
'4128351000,  식사동,'80,75 - 79세,1998,49,22,27
'4128351000,  식사동,'85,80 - 84세,1998,28,7,21
'4128351000,  식사동,'90,85+ ,1998,21,5,16
'4128352000,  일산1동,'00,계,1998,40002,19914,20088
'4128352000,  일산1동,'05,0 - 4세,1998,4211,2227,1984
'4128352000,  일산1동,'10,5 - 9세,1998,4557,2348,2209
'4128352000,  일산1동,'15,10 - 14세,1998,2772,1434,1338
'4128352000,  일산1동,'20,15 - 19세,1998,2213,1116,1097
'4128352000,  일산1동,'25,20 - 24세,1998,1869,919,950
'4128352000,  일산1동,'30,25 - 29세,1998,3505,1543,1962
'4128352000,  일산1동,'35,30 - 34세,1998,5126,2321,2805
'4128352000,  일산1동,'40,35 - 39세,1998,5651,3095,2556
'4128352000,  일산1동,'45,40 - 44세,1998,3154,1779,1375
'4128352000,  일산1동,'50,45 - 49세,1998,1533,809,724
'4128352000,  일산1동,'55,50 - 54세,1998,1188,564,624
'4128352000,  일산1동,'60,55 - 59세,1998,1298,579,719
'4128352000,  일산1동,'65,60 - 64세,1998,1083,486,597
'4128352000,  일산1동,'70,65 - 69세,1998,773,303,470
'4128352000,  일산1동,'75,70 - 74세,1998,496,188,308
'4128352000,  일산1동,'80,75 - 79세,1998,314,127,187
'4128352000,  일산1동,'85,80 - 84세,1998,161,53,108
'4128352000,  일산1동,'90,85+ ,1998,98,23,75
'4128353000,  일산2동,'00,계,1998,38169,18864,19305
'4128353000,  일산2동,'05,0 - 4세,1998,3936,2075,1861
'4128353000,  일산2동,'10,5 - 9세,1998,4256,2212,2044
'4128353000,  일산2동,'15,10 - 14세,1998,2479,1269,1210
'4128353000,  일산2동,'20,15 - 19세,1998,1932,943,989
'4128353000,  일산2동,'25,20 - 24세,1998,1939,913,1026
'4128353000,  일산2동,'30,25 - 29세,1998,3643,1601,2042
'4128353000,  일산2동,'35,30 - 34세,1998,5003,2337,2666
'4128353000,  일산2동,'40,35 - 39세,1998,5047,2739,2308
'4128353000,  일산2동,'45,40 - 44세,1998,3006,1691,1315
'4128353000,  일산2동,'50,45 - 49세,1998,1391,699,692
'4128353000,  일산2동,'55,50 - 54세,1998,1315,612,703
'4128353000,  일산2동,'60,55 - 59세,1998,1247,565,682
'4128353000,  일산2동,'65,60 - 64세,1998,1114,502,612
'4128353000,  일산2동,'70,65 - 69세,1998,782,310,472
'4128353000,  일산2동,'75,70 - 74세,1998,491,191,300
'4128353000,  일산2동,'80,75 - 79세,1998,317,130,187
'4128353000,  일산2동,'85,80 - 84세,1998,142,42,100
'4128353000,  일산2동,'90,85+ ,1998,129,33,96
'4128354000,  일산3동,'00,계,1998,43824,21504,22320
'4128354000,  일산3동,'05,0 - 4세,1998,3379,1736,1643
'4128354000,  일산3동,'10,5 - 9세,1998,5101,2696,2405
'4128354000,  일산3동,'15,10 - 14세,1998,4536,2337,2199
'4128354000,  일산3동,'20,15 - 19세,1998,2809,1422,1387
'4128354000,  일산3동,'25,20 - 24세,1998,1801,885,916
'4128354000,  일산3동,'30,25 - 29세,1998,2713,1150,1563
'4128354000,  일산3동,'35,30 - 34세,1998,4211,1647,2564
'4128354000,  일산3동,'40,35 - 39세,1998,6528,3045,3483
'4128354000,  일산3동,'45,40 - 44세,1998,4894,2862,2032
'4128354000,  일산3동,'50,45 - 49세,1998,2059,1147,912
'4128354000,  일산3동,'55,50 - 54세,1998,1494,783,711
'4128354000,  일산3동,'60,55 - 59세,1998,1189,564,625
'4128354000,  일산3동,'65,60 - 64세,1998,1047,470,577
'4128354000,  일산3동,'70,65 - 69세,1998,816,329,487
'4128354000,  일산3동,'75,70 - 74세,1998,542,209,333
'4128354000,  일산3동,'80,75 - 79세,1998,417,143,274
'4128354000,  일산3동,'85,80 - 84세,1998,175,51,124
'4128354000,  일산3동,'90,85+ ,1998,113,28,85
'4128355000,  일산4동,'00,계,1998,24857,12303,12554
'4128355000,  일산4동,'05,0 - 4세,1998,2562,1348,1214
'4128355000,  일산4동,'10,5 - 9세,1998,2417,1258,1159
'4128355000,  일산4동,'15,10 - 14세,1998,1881,1010,871
'4128355000,  일산4동,'20,15 - 19세,1998,1529,747,782
'4128355000,  일산4동,'25,20 - 24세,1998,1328,647,681
'4128355000,  일산4동,'30,25 - 29세,1998,2770,1196,1574
'4128355000,  일산4동,'35,30 - 34세,1998,2960,1430,1530
'4128355000,  일산4동,'40,35 - 39세,1998,2979,1500,1479
'4128355000,  일산4동,'45,40 - 44세,1998,2133,1152,981
'4128355000,  일산4동,'50,45 - 49세,1998,1095,579,516
'4128355000,  일산4동,'55,50 - 54세,1998,853,434,419
'4128355000,  일산4동,'60,55 - 59세,1998,735,368,367
'4128355000,  일산4동,'65,60 - 64세,1998,579,276,303
'4128355000,  일산4동,'70,65 - 69세,1998,401,154,247
'4128355000,  일산4동,'75,70 - 74세,1998,285,96,189
'4128355000,  일산4동,'80,75 - 79세,1998,185,61,124
'4128355000,  일산4동,'85,80 - 84세,1998,94,30,64
'4128355000,  일산4동,'90,85+ ,1998,71,17,54
'4128356000,  풍산동,'00,계,1998,9670,4939,4731
'4128356000,  풍산동,'05,0 - 4세,1998,964,518,446
'4128356000,  풍산동,'10,5 - 9세,1998,795,430,365
'4128356000,  풍산동,'15,10 - 14세,1998,609,322,287
'4128356000,  풍산동,'20,15 - 19세,1998,648,335,313
'4128356000,  풍산동,'25,20 - 24세,1998,612,319,293
'4128356000,  풍산동,'30,25 - 29세,1998,953,472,481
'4128356000,  풍산동,'35,30 - 34세,1998,1168,572,596
'4128356000,  풍산동,'40,35 - 39세,1998,1087,603,484
'4128356000,  풍산동,'45,40 - 44세,1998,771,428,343
'4128356000,  풍산동,'50,45 - 49세,1998,452,227,225
'4128356000,  풍산동,'55,50 - 54세,1998,392,195,197
'4128356000,  풍산동,'60,55 - 59세,1998,389,188,201
'4128356000,  풍산동,'65,60 - 64세,1998,302,134,168
'4128356000,  풍산동,'70,65 - 69세,1998,200,84,116
'4128356000,  풍산동,'75,70 - 74세,1998,139,50,89
'4128356000,  풍산동,'80,75 - 79세,1998,104,35,69
'4128356000,  풍산동,'85,80 - 84세,1998,51,21,30
'4128356000,  풍산동,'90,85+ ,1998,34,6,28
'4128357000,  백석동,'00,계,1998,40411,20024,20387
'4128357000,  백석동,'05,0 - 4세,1998,3271,1724,1547
'4128357000,  백석동,'10,5 - 9세,1998,3877,2067,1810
'4128357000,  백석동,'15,10 - 14세,1998,3847,2031,1816
'4128357000,  백석동,'20,15 - 19세,1998,2891,1429,1462
'4128357000,  백석동,'25,20 - 24세,1998,1922,935,987
'4128357000,  백석동,'30,25 - 29세,1998,3507,1545,1962
'4128357000,  백석동,'35,30 - 34세,1998,4254,2011,2243
'4128357000,  백석동,'40,35 - 39세,1998,5508,2639,2869
'4128357000,  백석동,'45,40 - 44세,1998,4203,2320,1883
'4128357000,  백석동,'50,45 - 49세,1998,1911,1103,808
'4128357000,  백석동,'55,50 - 54세,1998,1263,642,621
'4128357000,  백석동,'60,55 - 59세,1998,1130,517,613
'4128357000,  백석동,'65,60 - 64세,1998,955,394,561
'4128357000,  백석동,'70,65 - 69세,1998,756,285,471
'4128357000,  백석동,'75,70 - 74세,1998,494,181,313
'4128357000,  백석동,'80,75 - 79세,1998,366,125,241
'4128357000,  백석동,'85,80 - 84세,1998,155,44,111
'4128357000,  백석동,'90,85+ ,1998,101,32,69
'4128358000,  마두1동,'00,계,1998,28510,13928,14582
'4128358000,  마두1동,'05,0 - 4세,1998,1965,1031,934
'4128358000,  마두1동,'10,5 - 9세,1998,2901,1531,1370
'4128358000,  마두1동,'15,10 - 14세,1998,2831,1423,1408
'4128358000,  마두1동,'20,15 - 19세,1998,2079,1025,1054
'4128358000,  마두1동,'25,20 - 24세,1998,1505,735,770
'4128358000,  마두1동,'30,25 - 29세,1998,2056,962,1094
'4128358000,  마두1동,'35,30 - 34세,1998,2400,1024,1376
'4128358000,  마두1동,'40,35 - 39세,1998,3530,1550,1980
'4128358000,  마두1동,'45,40 - 44세,1998,3226,1753,1473
'4128358000,  마두1동,'50,45 - 49세,1998,1585,892,693
'4128358000,  마두1동,'55,50 - 54세,1998,1168,594,574
'4128358000,  마두1동,'60,55 - 59세,1998,991,510,481
'4128358000,  마두1동,'65,60 - 64세,1998,813,368,445
'4128358000,  마두1동,'70,65 - 69세,1998,593,251,342
'4128358000,  마두1동,'75,70 - 74세,1998,393,132,261
'4128358000,  마두1동,'80,75 - 79세,1998,258,88,170
'4128358000,  마두1동,'85,80 - 84세,1998,124,37,87
'4128358000,  마두1동,'90,85+ ,1998,92,22,70
'4128359000,  마두2동,'00,계,1998,20270,9899,10371
'4128359000,  마두2동,'05,0 - 4세,1998,1082,539,543
'4128359000,  마두2동,'10,5 - 9세,1998,1749,907,842
'4128359000,  마두2동,'15,10 - 14세,1998,1925,1016,909
'4128359000,  마두2동,'20,15 - 19세,1998,1587,812,775
'4128359000,  마두2동,'25,20 - 24세,1998,1254,601,653
'4128359000,  마두2동,'30,25 - 29세,1998,1376,647,729
'4128359000,  마두2동,'35,30 - 34세,1998,1377,543,834
'4128359000,  마두2동,'40,35 - 39세,1998,2284,995,1289
'4128359000,  마두2동,'45,40 - 44세,1998,2267,1212,1055
'4128359000,  마두2동,'50,45 - 49세,1998,1254,678,576
'4128359000,  마두2동,'55,50 - 54세,1998,1017,474,543
'4128359000,  마두2동,'60,55 - 59세,1998,942,474,468
'4128359000,  마두2동,'65,60 - 64세,1998,802,400,402
'4128359000,  마두2동,'70,65 - 69세,1998,544,272,272
'4128359000,  마두2동,'75,70 - 74세,1998,350,155,195
'4128359000,  마두2동,'80,75 - 79세,1998,233,101,132
'4128359000,  마두2동,'85,80 - 84세,1998,154,53,101
'4128359000,  마두2동,'90,85+ ,1998,73,20,53
'4128360000,  주엽1동,'00,계,1998,37277,18397,18880
'4128360000,  주엽1동,'05,0 - 4세,1998,2880,1560,1320
'4128360000,  주엽1동,'10,5 - 9세,1998,3602,1904,1698
'4128360000,  주엽1동,'15,10 - 14세,1998,3374,1740,1634
'4128360000,  주엽1동,'20,15 - 19세,1998,2621,1319,1302
'4128360000,  주엽1동,'25,20 - 24세,1998,1818,889,929
'4128360000,  주엽1동,'30,25 - 29세,1998,2742,1192,1550
'4128360000,  주엽1동,'35,30 - 34세,1998,3631,1597,2034
'4128360000,  주엽1동,'40,35 - 39세,1998,4763,2219,2544
'4128360000,  주엽1동,'45,40 - 44세,1998,3896,2120,1776
'4128360000,  주엽1동,'50,45 - 49세,1998,1982,1134,848
'4128360000,  주엽1동,'55,50 - 54세,1998,1433,720,713
'4128360000,  주엽1동,'60,55 - 59세,1998,1369,677,692
'4128360000,  주엽1동,'65,60 - 64세,1998,1192,533,659
'4128360000,  주엽1동,'70,65 - 69세,1998,801,369,432
'4128360000,  주엽1동,'75,70 - 74세,1998,533,206,327
'4128360000,  주엽1동,'80,75 - 79세,1998,327,129,198
'4128360000,  주엽1동,'85,80 - 84세,1998,195,61,134
'4128360000,  주엽1동,'90,85+ ,1998,118,28,90
'4128361000,  주엽2동,'00,계,1998,37348,18478,18870
'4128361000,  주엽2동,'05,0 - 4세,1998,3135,1649,1486
'4128361000,  주엽2동,'10,5 - 9세,1998,3656,1939,1717
'4128361000,  주엽2동,'15,10 - 14세,1998,3102,1630,1472
'4128361000,  주엽2동,'20,15 - 19세,1998,2325,1185,1140
'4128361000,  주엽2동,'25,20 - 24세,1998,1882,950,932
'4128361000,  주엽2동,'30,25 - 29세,1998,3162,1408,1754
'4128361000,  주엽2동,'35,30 - 34세,1998,3950,1792,2158
'4128361000,  주엽2동,'40,35 - 39세,1998,4723,2311,2412
'4128361000,  주엽2동,'45,40 - 44세,1998,3547,1956,1591
'4128361000,  주엽2동,'50,45 - 49세,1998,1791,959,832
'4128361000,  주엽2동,'55,50 - 54세,1998,1473,692,781
'4128361000,  주엽2동,'60,55 - 59세,1998,1418,698,720
'4128361000,  주엽2동,'65,60 - 64세,1998,1194,539,655
'4128361000,  주엽2동,'70,65 - 69세,1998,819,362,457
'4128361000,  주엽2동,'75,70 - 74세,1998,525,199,326
'4128361000,  주엽2동,'80,75 - 79세,1998,343,133,210
'4128361000,  주엽2동,'85,80 - 84세,1998,166,45,121
'4128361000,  주엽2동,'90,85+ ,1998,137,31,106
'4128362000,  장항1동,'00,계,1998,3816,2011,1805
'4128362000,  장항1동,'05,0 - 4세,1998,348,202,146
'4128362000,  장항1동,'10,5 - 9세,1998,268,123,145
'4128362000,  장항1동,'15,10 - 14세,1998,233,113,120
'4128362000,  장항1동,'20,15 - 19세,1998,259,136,123
'4128362000,  장항1동,'25,20 - 24세,1998,257,141,116
'4128362000,  장항1동,'30,25 - 29세,1998,397,222,175
'4128362000,  장항1동,'35,30 - 34세,1998,394,215,179
'4128362000,  장항1동,'40,35 - 39세,1998,413,233,180
'4128362000,  장항1동,'45,40 - 44세,1998,307,176,131
'4128362000,  장항1동,'50,45 - 49세,1998,203,113,90
'4128362000,  장항1동,'55,50 - 54세,1998,159,92,67
'4128362000,  장항1동,'60,55 - 59세,1998,180,86,94
'4128362000,  장항1동,'65,60 - 64세,1998,143,65,78
'4128362000,  장항1동,'70,65 - 69세,1998,77,26,51
'4128362000,  장항1동,'75,70 - 74세,1998,74,25,49
'4128362000,  장항1동,'80,75 - 79세,1998,55,22,33
'4128362000,  장항1동,'85,80 - 84세,1998,30,12,18
'4128362000,  장항1동,'90,85+ ,1998,19,9,10
'4128363000,  장항2동,'00,계,1998,13138,6416,6722
'4128363000,  장항2동,'05,0 - 4세,1998,946,522,424
'4128363000,  장항2동,'10,5 - 9세,1998,1267,664,603
'4128363000,  장항2동,'15,10 - 14세,1998,1126,553,573
'4128363000,  장항2동,'20,15 - 19세,1998,923,461,462
'4128363000,  장항2동,'25,20 - 24세,1998,703,328,375
'4128363000,  장항2동,'30,25 - 29세,1998,1052,446,606
'4128363000,  장항2동,'35,30 - 34세,1998,1123,471,652
'4128363000,  장항2동,'40,35 - 39세,1998,1608,762,846
'4128363000,  장항2동,'45,40 - 44세,1998,1355,746,609
'4128363000,  장항2동,'50,45 - 49세,1998,710,376,334
'4128363000,  장항2동,'55,50 - 54세,1998,605,293,312
'4128363000,  장항2동,'60,55 - 59세,1998,543,287,256
'4128363000,  장항2동,'65,60 - 64세,1998,427,200,227
'4128363000,  장항2동,'70,65 - 69세,1998,303,135,168
'4128363000,  장항2동,'75,70 - 74세,1998,202,88,114
'4128363000,  장항2동,'80,75 - 79세,1998,122,49,73
'4128363000,  장항2동,'85,80 - 84세,1998,79,24,55
'4128363000,  장항2동,'90,85+ ,1998,44,11,33
'4128364000,  대화동,'00,계,1998,29913,14789,15124
'4128364000,  대화동,'05,0 - 4세,1998,2850,1535,1315
'4128364000,  대화동,'10,5 - 9세,1998,3408,1800,1608
'4128364000,  대화동,'15,10 - 14세,1998,2447,1237,1210
'4128364000,  대화동,'20,15 - 19세,1998,1664,851,813
'4128364000,  대화동,'25,20 - 24세,1998,1457,720,737
'4128364000,  대화동,'30,25 - 29세,1998,2742,1161,1581
'4128364000,  대화동,'35,30 - 34세,1998,3560,1584,1976
'4128364000,  대화동,'40,35 - 39세,1998,3990,2014,1976
'4128364000,  대화동,'45,40 - 44세,1998,2665,1501,1164
'4128364000,  대화동,'50,45 - 49세,1998,1273,670,603
'4128364000,  대화동,'55,50 - 54세,1998,1008,515,493
'4128364000,  대화동,'60,55 - 59세,1998,841,416,425
'4128364000,  대화동,'65,60 - 64세,1998,711,307,404
'4128364000,  대화동,'70,65 - 69세,1998,518,206,312
'4128364000,  대화동,'75,70 - 74세,1998,357,153,204
'4128364000,  대화동,'80,75 - 79세,1998,231,66,165
'4128364000,  대화동,'85,80 - 84세,1998,113,36,77
'4128364000,  대화동,'90,85+ ,1998,78,17,61
'4128365000,  고봉동,'00,계,1998,9267,4842,4425
'4128365000,  고봉동,'05,0 - 4세,1998,731,377,354
'4128365000,  고봉동,'10,5 - 9세,1998,739,408,331
'4128365000,  고봉동,'15,10 - 14세,1998,525,270,255
'4128365000,  고봉동,'20,15 - 19세,1998,628,315,313
'4128365000,  고봉동,'25,20 - 24세,1998,663,354,309
'4128365000,  고봉동,'30,25 - 29세,1998,797,429,368
'4128365000,  고봉동,'35,30 - 34세,1998,934,483,451
'4128365000,  고봉동,'40,35 - 39세,1998,969,564,405
'4128365000,  고봉동,'45,40 - 44세,1998,748,433,315
'4128365000,  고봉동,'50,45 - 49세,1998,502,280,222
'4128365000,  고봉동,'55,50 - 54세,1998,426,240,186
'4128365000,  고봉동,'60,55 - 59세,1998,468,214,254
'4128365000,  고봉동,'65,60 - 64세,1998,413,199,214
'4128365000,  고봉동,'70,65 - 69세,1998,300,131,169
'4128365000,  고봉동,'75,70 - 74세,1998,168,65,103
'4128365000,  고봉동,'80,75 - 79세,1998,132,47,85
'4128365000,  고봉동,'85,80 - 84세,1998,68,21,47
'4128365000,  고봉동,'90,85+ ,1998,56,12,44
'4128366000,  송포동,'00,계,1998,2901,1475,1426
'4128366000,  송포동,'05,0 - 4세,1998,227,112,115
'4128366000,  송포동,'10,5 - 9세,1998,207,111,96
'4128366000,  송포동,'15,10 - 14세,1998,168,99,69
'4128366000,  송포동,'20,15 - 19세,1998,244,121,123
'4128366000,  송포동,'25,20 - 24세,1998,221,113,108
'4128366000,  송포동,'30,25 - 29세,1998,257,128,129
'4128366000,  송포동,'35,30 - 34세,1998,265,149,116
'4128366000,  송포동,'40,35 - 39세,1998,282,147,135
'4128366000,  송포동,'45,40 - 44세,1998,244,125,119
'4128366000,  송포동,'50,45 - 49세,1998,138,80,58
'4128366000,  송포동,'55,50 - 54세,1998,147,72,75
'4128366000,  송포동,'60,55 - 59세,1998,155,84,71
'4128366000,  송포동,'65,60 - 64세,1998,122,56,66
'4128366000,  송포동,'70,65 - 69세,1998,81,30,51
'4128366000,  송포동,'75,70 - 74세,1998,57,20,37
'4128366000,  송포동,'80,75 - 79세,1998,40,15,25
'4128366000,  송포동,'85,80 - 84세,1998,31,11,20
'4128366000,  송포동,'90,85+ ,1998,15,2,13
'4128367000,  송산동,'00,계,1998,8944,4657,4287
'4128367000,  송산동,'05,0 - 4세,1998,785,418,367
'4128367000,  송산동,'10,5 - 9세,1998,754,377,377
'4128367000,  송산동,'15,10 - 14세,1998,428,199,229
'4128367000,  송산동,'20,15 - 19세,1998,569,283,286
'4128367000,  송산동,'25,20 - 24세,1998,603,329,274
'4128367000,  송산동,'30,25 - 29세,1998,910,475,435
'4128367000,  송산동,'35,30 - 34세,1998,984,532,452
'4128367000,  송산동,'40,35 - 39세,1998,945,575,370
'4128367000,  송산동,'45,40 - 44세,1998,657,393,264
'4128367000,  송산동,'50,45 - 49세,1998,402,219,183
'4128367000,  송산동,'55,50 - 54세,1998,404,207,197
'4128367000,  송산동,'60,55 - 59세,1998,450,203,247
'4128367000,  송산동,'65,60 - 64세,1998,403,197,206
'4128367000,  송산동,'70,65 - 69세,1998,253,119,134
'4128367000,  송산동,'75,70 - 74세,1998,155,46,109
'4128367000,  송산동,'80,75 - 79세,1998,131,50,81
'4128367000,  송산동,'85,80 - 84세,1998,72,24,48
'4128367000,  송산동,'90,85+ ,1998,39,11,28
'41290, 과천시,'00,계,1998,71322,35165,36157
'41290, 과천시,'05,0 - 4세,1998,6494,3304,3190
'41290, 과천시,'10,5 - 9세,1998,6385,3421,2964
'41290, 과천시,'15,10 - 14세,1998,5187,2802,2385
'41290, 과천시,'20,15 - 19세,1998,4398,2300,2098
'41290, 과천시,'25,20 - 24세,1998,3654,1784,1870
'41290, 과천시,'30,25 - 29세,1998,7004,3256,3748
'41290, 과천시,'35,30 - 34세,1998,8496,4108,4388
'41290, 과천시,'40,35 - 39세,1998,8596,4253,4343
'41290, 과천시,'45,40 - 44세,1998,6400,3354,3046
'41290, 과천시,'50,45 - 49세,1998,3562,1838,1724
'41290, 과천시,'55,50 - 54세,1998,2588,1296,1292
'41290, 과천시,'60,55 - 59세,1998,2266,1072,1194
'41290, 과천시,'65,60 - 64세,1998,1996,857,1139
'41290, 과천시,'70,65 - 69세,1998,1579,566,1013
'41290, 과천시,'75,70 - 74세,1998,1159,404,755
'41290, 과천시,'80,75 - 79세,1998,861,324,537
'41290, 과천시,'85,80 - 84세,1998,422,143,279
'41290, 과천시,'90,85+ ,1998,275,83,192
'4129051000,  중앙동,'00,계,1998,10736,5236,5500
'4129051000,  중앙동,'05,0 - 4세,1998,889,457,432
'4129051000,  중앙동,'10,5 - 9세,1998,985,544,441
'4129051000,  중앙동,'15,10 - 14세,1998,837,452,385
'4129051000,  중앙동,'20,15 - 19세,1998,692,330,362
'4129051000,  중앙동,'25,20 - 24세,1998,476,218,258
'4129051000,  중앙동,'30,25 - 29세,1998,987,447,540
'4129051000,  중앙동,'35,30 - 34세,1998,1118,513,605
'4129051000,  중앙동,'40,35 - 39세,1998,1256,603,653
'4129051000,  중앙동,'45,40 - 44세,1998,1020,527,493
'4129051000,  중앙동,'50,45 - 49세,1998,559,290,269
'4129051000,  중앙동,'55,50 - 54세,1998,428,213,215
'4129051000,  중앙동,'60,55 - 59세,1998,375,186,189
'4129051000,  중앙동,'65,60 - 64세,1998,354,163,191
'4129051000,  중앙동,'70,65 - 69세,1998,259,107,152
'4129051000,  중앙동,'75,70 - 74세,1998,209,79,130
'4129051000,  중앙동,'80,75 - 79세,1998,130,59,71
'4129051000,  중앙동,'85,80 - 84세,1998,97,32,65
'4129051000,  중앙동,'90,85+ ,1998,65,16,49
'4129052000,  갈현동,'00,계,1998,13283,6460,6823
'4129052000,  갈현동,'05,0 - 4세,1998,1570,814,756
'4129052000,  갈현동,'10,5 - 9세,1998,1216,668,548
'4129052000,  갈현동,'15,10 - 14세,1998,762,396,366
'4129052000,  갈현동,'20,15 - 19세,1998,582,303,279
'4129052000,  갈현동,'25,20 - 24세,1998,585,276,309
'4129052000,  갈현동,'30,25 - 29세,1998,1635,693,942
'4129052000,  갈현동,'35,30 - 34세,1998,2103,1041,1062
'4129052000,  갈현동,'40,35 - 39세,1998,1738,915,823
'4129052000,  갈현동,'45,40 - 44세,1998,959,507,452
'4129052000,  갈현동,'50,45 - 49세,1998,491,235,256
'4129052000,  갈현동,'55,50 - 54세,1998,365,166,199
'4129052000,  갈현동,'60,55 - 59세,1998,321,139,182
'4129052000,  갈현동,'65,60 - 64세,1998,288,107,181
'4129052000,  갈현동,'70,65 - 69세,1998,227,66,161
'4129052000,  갈현동,'75,70 - 74세,1998,185,55,130
'4129052000,  갈현동,'80,75 - 79세,1998,148,47,101
'4129052000,  갈현동,'85,80 - 84세,1998,73,23,50
'4129052000,  갈현동,'90,85+ ,1998,35,9,26
'4129053000,  별양동,'00,계,1998,17234,8498,8736
'4129053000,  별양동,'05,0 - 4세,1998,1442,729,713
'4129053000,  별양동,'10,5 - 9세,1998,1741,901,840
'4129053000,  별양동,'15,10 - 14세,1998,1507,838,669
'4129053000,  별양동,'20,15 - 19세,1998,1169,605,564
'4129053000,  별양동,'25,20 - 24세,1998,797,396,401
'4129053000,  별양동,'30,25 - 29세,1998,1304,605,699
'4129053000,  별양동,'35,30 - 34세,1998,1859,834,1025
'4129053000,  별양동,'40,35 - 39세,1998,2247,1085,1162
'4129053000,  별양동,'45,40 - 44세,1998,1765,909,856
'4129053000,  별양동,'50,45 - 49세,1998,938,517,421
'4129053000,  별양동,'55,50 - 54세,1998,556,294,262
'4129053000,  별양동,'60,55 - 59세,1998,439,203,236
'4129053000,  별양동,'65,60 - 64세,1998,469,201,268
'4129053000,  별양동,'70,65 - 69세,1998,375,140,235
'4129053000,  별양동,'75,70 - 74세,1998,262,96,166
'4129053000,  별양동,'80,75 - 79세,1998,211,89,122
'4129053000,  별양동,'85,80 - 84세,1998,88,34,54
'4129053000,  별양동,'90,85+ ,1998,65,22,43
'4129054000,  부림동,'00,계,1998,15294,7531,7763
'4129054000,  부림동,'05,0 - 4세,1998,1498,754,744
'4129054000,  부림동,'10,5 - 9세,1998,1559,838,721
'4129054000,  부림동,'15,10 - 14세,1998,1208,670,538
'4129054000,  부림동,'20,15 - 19세,1998,863,471,392
'4129054000,  부림동,'25,20 - 24세,1998,671,312,359
'4129054000,  부림동,'30,25 - 29세,1998,1363,616,747
'4129054000,  부림동,'35,30 - 34세,1998,1850,857,993
'4129054000,  부림동,'40,35 - 39세,1998,2011,985,1026
'4129054000,  부림동,'45,40 - 44세,1998,1476,798,678
'4129054000,  부림동,'50,45 - 49세,1998,694,373,321
'4129054000,  부림동,'55,50 - 54세,1998,473,239,234
'4129054000,  부림동,'60,55 - 59세,1998,417,185,232
'4129054000,  부림동,'65,60 - 64세,1998,386,144,242
'4129054000,  부림동,'70,65 - 69세,1998,325,110,215
'4129054000,  부림동,'75,70 - 74세,1998,203,72,131
'4129054000,  부림동,'80,75 - 79세,1998,165,62,103
'4129054000,  부림동,'85,80 - 84세,1998,74,28,46
'4129054000,  부림동,'90,85+ ,1998,58,17,41
'4129055000,  과천동,'00,계,1998,8510,4383,4127
'4129055000,  과천동,'05,0 - 4세,1998,660,332,328
'4129055000,  과천동,'10,5 - 9세,1998,470,245,225
'4129055000,  과천동,'15,10 - 14세,1998,457,238,219
'4129055000,  과천동,'20,15 - 19세,1998,628,344,284
'4129055000,  과천동,'25,20 - 24세,1998,670,354,316
'4129055000,  과천동,'30,25 - 29세,1998,1136,590,546
'4129055000,  과천동,'35,30 - 34세,1998,965,551,414
'4129055000,  과천동,'40,35 - 39세,1998,706,369,337
'4129055000,  과천동,'45,40 - 44세,1998,641,343,298
'4129055000,  과천동,'50,45 - 49세,1998,473,234,239
'4129055000,  과천동,'55,50 - 54세,1998,468,236,232
'4129055000,  과천동,'60,55 - 59세,1998,421,210,211
'4129055000,  과천동,'65,60 - 64세,1998,289,145,144
'4129055000,  과천동,'70,65 - 69세,1998,207,81,126
'4129055000,  과천동,'75,70 - 74세,1998,157,58,99
'4129055000,  과천동,'80,75 - 79세,1998,102,33,69
'4129055000,  과천동,'85,80 - 84세,1998,36,10,26
'4129055000,  과천동,'90,85+ ,1998,24,10,14
'4129056000,  문원동,'00,계,1998,6265,3057,3208
'4129056000,  문원동,'05,0 - 4세,1998,435,218,217
'4129056000,  문원동,'10,5 - 9세,1998,414,225,189
'4129056000,  문원동,'15,10 - 14세,1998,416,208,208
'4129056000,  문원동,'20,15 - 19세,1998,464,247,217
'4129056000,  문원동,'25,20 - 24세,1998,455,228,227
'4129056000,  문원동,'30,25 - 29세,1998,579,305,274
'4129056000,  문원동,'35,30 - 34세,1998,601,312,289
'4129056000,  문원동,'40,35 - 39세,1998,638,296,342
'4129056000,  문원동,'45,40 - 44세,1998,539,270,269
'4129056000,  문원동,'50,45 - 49세,1998,407,189,218
'4129056000,  문원동,'55,50 - 54세,1998,298,148,150
'4129056000,  문원동,'60,55 - 59세,1998,293,149,144
'4129056000,  문원동,'65,60 - 64세,1998,210,97,113
'4129056000,  문원동,'70,65 - 69세,1998,186,62,124
'4129056000,  문원동,'75,70 - 74세,1998,143,44,99
'4129056000,  문원동,'80,75 - 79세,1998,105,34,71
'4129056000,  문원동,'85,80 - 84세,1998,54,16,38
'4129056000,  문원동,'90,85+ ,1998,28,9,19
'41310, 구리시,'00,계,1998,163758,82446,81312
'41310, 구리시,'05,0 - 4세,1998,13743,7278,6465
'41310, 구리시,'10,5 - 9세,1998,14484,7522,6962
'41310, 구리시,'15,10 - 14세,1998,11844,6100,5744
'41310, 구리시,'20,15 - 19세,1998,12355,6249,6106
'41310, 구리시,'25,20 - 24세,1998,11374,5644,5730
'41310, 구리시,'30,25 - 29세,1998,15416,7488,7928
'41310, 구리시,'35,30 - 34세,1998,18049,8787,9262
'41310, 구리시,'40,35 - 39세,1998,19344,10303,9041
'41310, 구리시,'45,40 - 44세,1998,14161,7783,6378
'41310, 구리시,'50,45 - 49세,1998,8098,4293,3805
'41310, 구리시,'55,50 - 54세,1998,6512,3243,3269
'41310, 구리시,'60,55 - 59세,1998,6139,2956,3183
'41310, 구리시,'65,60 - 64세,1998,4610,2049,2561
'41310, 구리시,'70,65 - 69세,1998,3087,1250,1837
'41310, 구리시,'75,70 - 74세,1998,1984,713,1271
'41310, 구리시,'80,75 - 79세,1998,1408,470,938
'41310, 구리시,'85,80 - 84세,1998,741,211,530
'41310, 구리시,'90,85+ ,1998,409,107,302
'4131051000,  갈매동,'00,계,1998,3851,2020,1831
'4131051000,  갈매동,'05,0 - 4세,1998,204,118,86
'4131051000,  갈매동,'10,5 - 9세,1998,217,121,96
'4131051000,  갈매동,'15,10 - 14세,1998,209,108,101
'4131051000,  갈매동,'20,15 - 19세,1998,347,171,176
'4131051000,  갈매동,'25,20 - 24세,1998,343,196,147
'4131051000,  갈매동,'30,25 - 29세,1998,341,195,146
'4131051000,  갈매동,'35,30 - 34세,1998,302,156,146
'4131051000,  갈매동,'40,35 - 39세,1998,321,188,133
'4131051000,  갈매동,'45,40 - 44세,1998,324,178,146
'4131051000,  갈매동,'50,45 - 49세,1998,265,135,130
'4131051000,  갈매동,'55,50 - 54세,1998,207,113,94
'4131051000,  갈매동,'60,55 - 59세,1998,242,122,120
'4131051000,  갈매동,'65,60 - 64세,1998,206,103,103
'4131051000,  갈매동,'70,65 - 69세,1998,134,60,74
'4131051000,  갈매동,'75,70 - 74세,1998,80,23,57
'4131051000,  갈매동,'80,75 - 79세,1998,59,19,40
'4131051000,  갈매동,'85,80 - 84세,1998,30,8,22
'4131051000,  갈매동,'90,85+ ,1998,20,6,14
'4131052000,  동구동,'00,계,1998,34530,17397,17133
'4131052000,  동구동,'05,0 - 4세,1998,3241,1690,1551
'4131052000,  동구동,'10,5 - 9세,1998,3589,1885,1704
'4131052000,  동구동,'15,10 - 14세,1998,2602,1328,1274
'4131052000,  동구동,'20,15 - 19세,1998,2250,1142,1108
'4131052000,  동구동,'25,20 - 24세,1998,2067,1059,1008
'4131052000,  동구동,'30,25 - 29세,1998,2903,1324,1579
'4131052000,  동구동,'35,30 - 34세,1998,4156,1883,2273
'4131052000,  동구동,'40,35 - 39세,1998,4562,2533,2029
'4131052000,  동구동,'45,40 - 44세,1998,2840,1616,1224
'4131052000,  동구동,'50,45 - 49세,1998,1508,786,722
'4131052000,  동구동,'55,50 - 54세,1998,1248,623,625
'4131052000,  동구동,'60,55 - 59세,1998,1205,603,602
'4131052000,  동구동,'65,60 - 64세,1998,902,389,513
'4131052000,  동구동,'70,65 - 69세,1998,588,236,352
'4131052000,  동구동,'75,70 - 74세,1998,389,147,242
'4131052000,  동구동,'80,75 - 79세,1998,259,84,175
'4131052000,  동구동,'85,80 - 84세,1998,139,42,97
'4131052000,  동구동,'90,85+ ,1998,82,27,55
'4131053000,  인창동,'00,계,1998,18405,9194,9211
'4131053000,  인창동,'05,0 - 4세,1998,1575,818,757
'4131053000,  인창동,'10,5 - 9세,1998,1479,725,754
'4131053000,  인창동,'15,10 - 14세,1998,1180,609,571
'4131053000,  인창동,'20,15 - 19세,1998,1416,694,722
'4131053000,  인창동,'25,20 - 24세,1998,1414,684,730
'4131053000,  인창동,'30,25 - 29세,1998,1889,928,961
'4131053000,  인창동,'35,30 - 34세,1998,2034,1021,1013
'4131053000,  인창동,'40,35 - 39세,1998,2016,1122,894
'4131053000,  인창동,'45,40 - 44세,1998,1431,773,658
'4131053000,  인창동,'50,45 - 49세,1998,941,480,461
'4131053000,  인창동,'55,50 - 54세,1998,720,344,376
'4131053000,  인창동,'60,55 - 59세,1998,807,384,423
'4131053000,  인창동,'65,60 - 64세,1998,614,287,327
'4131053000,  인창동,'70,65 - 69세,1998,365,144,221
'4131053000,  인창동,'75,70 - 74세,1998,232,85,147
'4131053000,  인창동,'80,75 - 79세,1998,159,55,104
'4131053000,  인창동,'85,80 - 84세,1998,90,28,62
'4131053000,  인창동,'90,85+ ,1998,43,13,30
'4131054100,  교문1동,'00,계,1998,18471,9329,9142
'4131054100,  교문1동,'05,0 - 4세,1998,1554,825,729
'4131054100,  교문1동,'10,5 - 9세,1998,1452,778,674
'4131054100,  교문1동,'15,10 - 14세,1998,1179,590,589
'4131054100,  교문1동,'20,15 - 19세,1998,1249,624,625
'4131054100,  교문1동,'25,20 - 24세,1998,1386,656,730
'4131054100,  교문1동,'30,25 - 29세,1998,2127,1062,1065
'4131054100,  교문1동,'35,30 - 34세,1998,2075,1093,982
'4131054100,  교문1동,'40,35 - 39세,1998,1954,1077,877
'4131054100,  교문1동,'45,40 - 44세,1998,1386,733,653
'4131054100,  교문1동,'50,45 - 49세,1998,885,448,437
'4131054100,  교문1동,'55,50 - 54세,1998,870,421,449
'4131054100,  교문1동,'60,55 - 59세,1998,809,379,430
'4131054100,  교문1동,'65,60 - 64세,1998,571,270,301
'4131054100,  교문1동,'70,65 - 69세,1998,361,156,205
'4131054100,  교문1동,'75,70 - 74세,1998,261,107,154
'4131054100,  교문1동,'80,75 - 79세,1998,195,67,128
'4131054100,  교문1동,'85,80 - 84세,1998,99,28,71
'4131054100,  교문1동,'90,85+ ,1998,58,15,43
'4131054200,  교문2동,'00,계,1998,23937,11925,12012
'4131054200,  교문2동,'05,0 - 4세,1998,1857,1022,835
'4131054200,  교문2동,'10,5 - 9세,1998,2349,1219,1130
'4131054200,  교문2동,'15,10 - 14세,1998,2081,1059,1022
'4131054200,  교문2동,'20,15 - 19세,1998,1865,961,904
'4131054200,  교문2동,'25,20 - 24세,1998,1410,696,714
'4131054200,  교문2동,'30,25 - 29세,1998,1810,837,973
'4131054200,  교문2동,'35,30 - 34세,1998,2312,1034,1278
'4131054200,  교문2동,'40,35 - 39세,1998,3151,1482,1669
'4131054200,  교문2동,'45,40 - 44세,1998,2440,1395,1045
'4131054200,  교문2동,'50,45 - 49세,1998,1275,721,554
'4131054200,  교문2동,'55,50 - 54세,1998,955,488,467
'4131054200,  교문2동,'60,55 - 59세,1998,738,365,373
'4131054200,  교문2동,'65,60 - 64세,1998,574,252,322
'4131054200,  교문2동,'70,65 - 69세,1998,443,177,266
'4131054200,  교문2동,'75,70 - 74세,1998,287,89,198
'4131054200,  교문2동,'80,75 - 79세,1998,215,75,140
'4131054200,  교문2동,'85,80 - 84세,1998,109,35,74
'4131054200,  교문2동,'90,85+ ,1998,66,18,48
'4131057000,  수택1동,'00,계,1998,23579,11828,11751
'4131057000,  수택1동,'05,0 - 4세,1998,1867,984,883
'4131057000,  수택1동,'10,5 - 9세,1998,1874,946,928
'4131057000,  수택1동,'15,10 - 14세,1998,1479,769,710
'4131057000,  수택1동,'20,15 - 19세,1998,1863,936,927
'4131057000,  수택1동,'25,20 - 24세,1998,1941,956,985
'4131057000,  수택1동,'30,25 - 29세,1998,2445,1236,1209
'4131057000,  수택1동,'35,30 - 34세,1998,2582,1313,1269
'4131057000,  수택1동,'40,35 - 39세,1998,2589,1391,1198
'4131057000,  수택1동,'45,40 - 44세,1998,1995,1050,945
'4131057000,  수택1동,'50,45 - 49세,1998,1217,608,609
'4131057000,  수택1동,'55,50 - 54세,1998,1010,499,511
'4131057000,  수택1동,'60,55 - 59세,1998,903,426,477
'4131057000,  수택1동,'65,60 - 64세,1998,714,330,384
'4131057000,  수택1동,'70,65 - 69세,1998,463,185,278
'4131057000,  수택1동,'75,70 - 74세,1998,279,102,177
'4131057000,  수택1동,'80,75 - 79세,1998,203,63,140
'4131057000,  수택1동,'85,80 - 84세,1998,98,24,74
'4131057000,  수택1동,'90,85+ ,1998,57,10,47
'4131058000,  수택2동,'00,계,1998,22571,11349,11222
'4131058000,  수택2동,'05,0 - 4세,1998,1953,1010,943
'4131058000,  수택2동,'10,5 - 9세,1998,1887,983,904
'4131058000,  수택2동,'15,10 - 14세,1998,1600,858,742
'4131058000,  수택2동,'20,15 - 19세,1998,1835,908,927
'4131058000,  수택2동,'25,20 - 24세,1998,1640,792,848
'4131058000,  수택2동,'30,25 - 29세,1998,2311,1137,1174
'4131058000,  수택2동,'35,30 - 34세,1998,2617,1325,1292
'4131058000,  수택2동,'40,35 - 39세,1998,2503,1353,1150
'4131058000,  수택2동,'45,40 - 44세,1998,1942,1020,922
'4131058000,  수택2동,'50,45 - 49세,1998,1087,581,506
'4131058000,  수택2동,'55,50 - 54세,1998,857,433,424
'4131058000,  수택2동,'60,55 - 59세,1998,802,375,427
'4131058000,  수택2동,'65,60 - 64세,1998,568,236,332
'4131058000,  수택2동,'70,65 - 69세,1998,403,161,242
'4131058000,  수택2동,'75,70 - 74세,1998,263,89,174
'4131058000,  수택2동,'80,75 - 79세,1998,166,56,110
'4131058000,  수택2동,'85,80 - 84세,1998,95,21,74
'4131058000,  수택2동,'90,85+ ,1998,42,11,31
'4131059000,  수택3동,'00,계,1998,18414,9404,9010
'4131059000,  수택3동,'05,0 - 4세,1998,1492,811,681
'4131059000,  수택3동,'10,5 - 9세,1998,1637,865,772
'4131059000,  수택3동,'15,10 - 14세,1998,1514,779,735
'4131059000,  수택3동,'20,15 - 19세,1998,1530,813,717
'4131059000,  수택3동,'25,20 - 24세,1998,1173,605,568
'4131059000,  수택3동,'30,25 - 29세,1998,1590,769,821
'4131059000,  수택3동,'35,30 - 34세,1998,1971,962,1009
'4131059000,  수택3동,'40,35 - 39세,1998,2248,1157,1091
'4131059000,  수택3동,'45,40 - 44세,1998,1803,1018,785
'4131059000,  수택3동,'50,45 - 49세,1998,920,534,386
'4131059000,  수택3동,'55,50 - 54세,1998,645,322,323
'4131059000,  수택3동,'60,55 - 59세,1998,633,302,331
'4131059000,  수택3동,'65,60 - 64세,1998,461,182,279
'4131059000,  수택3동,'70,65 - 69세,1998,330,131,199
'4131059000,  수택3동,'75,70 - 74세,1998,193,71,122
'4131059000,  수택3동,'80,75 - 79세,1998,152,51,101
'4131059000,  수택3동,'85,80 - 84세,1998,81,25,56
'4131059000,  수택3동,'90,85+ ,1998,41,7,34
'41360, 남양주시,'00,계,1998,306553,155283,151270
'41360, 남양주시,'05,0 - 4세,1998,28758,15095,13663
'41360, 남양주시,'10,5 - 9세,1998,27836,14371,13465
'41360, 남양주시,'15,10 - 14세,1998,20188,10275,9913
'41360, 남양주시,'20,15 - 19세,1998,20557,10532,10025
'41360, 남양주시,'25,20 - 24세,1998,19667,10033,9634
'41360, 남양주시,'30,25 - 29세,1998,29308,14054,15254
'41360, 남양주시,'35,30 - 34세,1998,36259,18060,18199
'41360, 남양주시,'40,35 - 39세,1998,34985,19342,15643
'41360, 남양주시,'45,40 - 44세,1998,23843,13271,10572
'41360, 남양주시,'50,45 - 49세,1998,13785,7308,6477
'41360, 남양주시,'55,50 - 54세,1998,12054,6040,6014
'41360, 남양주시,'60,55 - 59세,1998,12024,5681,6343
'41360, 남양주시,'65,60 - 64세,1998,10006,4567,5439
'41360, 남양주시,'70,65 - 69세,1998,6841,2794,4047
'41360, 남양주시,'75,70 - 74세,1998,4588,1735,2853
'41360, 남양주시,'80,75 - 79세,1998,3174,1248,1926
'41360, 남양주시,'85,80 - 84세,1998,1702,577,1125
'41360, 남양주시,'90,85+ ,1998,978,300,678
'4136025000,  와부읍,'00,계,1998,44097,22335,21762
'4136025000,  와부읍,'05,0 - 4세,1998,4797,2546,2251
'4136025000,  와부읍,'10,5 - 9세,1998,4164,2180,1984
'4136025000,  와부읍,'15,10 - 14세,1998,2465,1236,1229
'4136025000,  와부읍,'20,15 - 19세,1998,2665,1413,1252
'4136025000,  와부읍,'25,20 - 24세,1998,2728,1426,1302
'4136025000,  와부읍,'30,25 - 29세,1998,4361,1984,2377
'4136025000,  와부읍,'35,30 - 34세,1998,5872,2853,3019
'4136025000,  와부읍,'40,35 - 39세,1998,5115,2932,2183
'4136025000,  와부읍,'45,40 - 44세,1998,3113,1739,1374
'4136025000,  와부읍,'50,45 - 49세,1998,1861,975,886
'4136025000,  와부읍,'55,50 - 54세,1998,1611,791,820
'4136025000,  와부읍,'60,55 - 59세,1998,1682,815,867
'4136025000,  와부읍,'65,60 - 64세,1998,1237,564,673
'4136025000,  와부읍,'70,65 - 69세,1998,892,369,523
'4136025000,  와부읍,'75,70 - 74세,1998,630,231,399
'4136025000,  와부읍,'80,75 - 79세,1998,476,155,321
'4136025000,  와부읍,'85,80 - 84세,1998,267,79,188
'4136025000,  와부읍,'90,85+ ,1998,161,47,114
'4136025300,  진접읍,'00,계,1998,35444,18092,17352
'4136025300,  진접읍,'05,0 - 4세,1998,3209,1683,1526
'4136025300,  진접읍,'10,5 - 9세,1998,3284,1678,1606
'4136025300,  진접읍,'15,10 - 14세,1998,2444,1266,1178
'4136025300,  진접읍,'20,15 - 19세,1998,2394,1159,1235
'4136025300,  진접읍,'25,20 - 24세,1998,2293,1221,1072
'4136025300,  진접읍,'30,25 - 29세,1998,3278,1596,1682
'4136025300,  진접읍,'35,30 - 34세,1998,4076,2053,2023
'4136025300,  진접읍,'40,35 - 39세,1998,4009,2215,1794
'4136025300,  진접읍,'45,40 - 44세,1998,2731,1570,1161
'4136025300,  진접읍,'50,45 - 49세,1998,1586,859,727
'4136025300,  진접읍,'55,50 - 54세,1998,1414,724,690
'4136025300,  진접읍,'60,55 - 59세,1998,1444,676,768
'4136025300,  진접읍,'65,60 - 64세,1998,1248,590,658
'4136025300,  진접읍,'70,65 - 69세,1998,819,326,493
'4136025300,  진접읍,'75,70 - 74세,1998,508,199,309
'4136025300,  진접읍,'80,75 - 79세,1998,371,159,212
'4136025300,  진접읍,'85,80 - 84세,1998,216,88,128
'4136025300,  진접읍,'90,85+ ,1998,120,30,90
'4136025600,  화도읍,'00,계,1998,53735,27223,26512
'4136025600,  화도읍,'05,0 - 4세,1998,5772,3066,2706
'4136025600,  화도읍,'10,5 - 9세,1998,4937,2515,2422
'4136025600,  화도읍,'15,10 - 14세,1998,3281,1702,1579
'4136025600,  화도읍,'20,15 - 19세,1998,3166,1618,1548
'4136025600,  화도읍,'25,20 - 24세,1998,3439,1710,1729
'4136025600,  화도읍,'30,25 - 29세,1998,5807,2650,3157
'4136025600,  화도읍,'35,30 - 34세,1998,7002,3577,3425
'4136025600,  화도읍,'40,35 - 39세,1998,6160,3470,2690
'4136025600,  화도읍,'45,40 - 44세,1998,3857,2166,1691
'4136025600,  화도읍,'50,45 - 49세,1998,2206,1130,1076
'4136025600,  화도읍,'55,50 - 54세,1998,1982,963,1019
'4136025600,  화도읍,'60,55 - 59세,1998,1893,892,1001
'4136025600,  화도읍,'65,60 - 64세,1998,1637,734,903
'4136025600,  화도읍,'70,65 - 69세,1998,1038,426,612
'4136025600,  화도읍,'75,70 - 74세,1998,685,278,407
'4136025600,  화도읍,'80,75 - 79세,1998,477,198,279
'4136025600,  화도읍,'85,80 - 84세,1998,260,85,175
'4136025600,  화도읍,'90,85+ ,1998,136,43,93
'4136031000,  별내면,'00,계,1998,13460,6955,6505
'4136031000,  별내면,'05,0 - 4세,1998,943,516,427
'4136031000,  별내면,'10,5 - 9세,1998,938,494,444
'4136031000,  별내면,'15,10 - 14세,1998,657,297,360
'4136031000,  별내면,'20,15 - 19세,1998,975,525,450
'4136031000,  별내면,'25,20 - 24세,1998,1101,591,510
'4136031000,  별내면,'30,25 - 29세,1998,1238,676,562
'4136031000,  별내면,'35,30 - 34세,1998,1294,682,612
'4136031000,  별내면,'40,35 - 39세,1998,1210,703,507
'4136031000,  별내면,'45,40 - 44세,1998,1032,545,487
'4136031000,  별내면,'50,45 - 49세,1998,793,402,391
'4136031000,  별내면,'55,50 - 54세,1998,798,420,378
'4136031000,  별내면,'60,55 - 59세,1998,798,382,416
'4136031000,  별내면,'65,60 - 64세,1998,620,303,317
'4136031000,  별내면,'70,65 - 69세,1998,408,162,246
'4136031000,  별내면,'75,70 - 74세,1998,287,128,159
'4136031000,  별내면,'80,75 - 79세,1998,188,66,122
'4136031000,  별내면,'85,80 - 84세,1998,114,43,71
'4136031000,  별내면,'90,85+ ,1998,66,20,46
'4136033000,  진건면,'00,계,1998,27495,13813,13682
'4136033000,  진건면,'05,0 - 4세,1998,2582,1370,1212
'4136033000,  진건면,'10,5 - 9세,1998,2763,1411,1352
'4136033000,  진건면,'15,10 - 14세,1998,1991,997,994
'4136033000,  진건면,'20,15 - 19세,1998,1716,888,828
'4136033000,  진건면,'25,20 - 24세,1998,1565,780,785
'4136033000,  진건면,'30,25 - 29세,1998,2334,1124,1210
'4136033000,  진건면,'35,30 - 34세,1998,3210,1488,1722
'4136033000,  진건면,'40,35 - 39세,1998,3427,1896,1531
'4136033000,  진건면,'45,40 - 44세,1998,2139,1221,918
'4136033000,  진건면,'50,45 - 49세,1998,1166,619,547
'4136033000,  진건면,'55,50 - 54세,1998,1018,507,511
'4136033000,  진건면,'60,55 - 59세,1998,1038,482,556
'4136033000,  진건면,'65,60 - 64세,1998,931,419,512
'4136033000,  진건면,'70,65 - 69세,1998,647,261,386
'4136033000,  진건면,'75,70 - 74세,1998,410,143,267
'4136033000,  진건면,'80,75 - 79세,1998,306,129,177
'4136033000,  진건면,'85,80 - 84세,1998,164,49,115
'4136033000,  진건면,'90,85+ ,1998,88,29,59
'4136034000,  수동면,'00,계,1998,6235,3280,2955
'4136034000,  수동면,'05,0 - 4세,1998,380,190,190
'4136034000,  수동면,'10,5 - 9세,1998,413,221,192
'4136034000,  수동면,'15,10 - 14세,1998,378,194,184
'4136034000,  수동면,'20,15 - 19세,1998,419,222,197
'4136034000,  수동면,'25,20 - 24세,1998,476,249,227
'4136034000,  수동면,'30,25 - 29세,1998,514,288,226
'4136034000,  수동면,'35,30 - 34세,1998,546,319,227
'4136034000,  수동면,'40,35 - 39세,1998,555,330,225
'4136034000,  수동면,'45,40 - 44세,1998,504,294,210
'4136034000,  수동면,'50,45 - 49세,1998,329,176,153
'4136034000,  수동면,'55,50 - 54세,1998,363,178,185
'4136034000,  수동면,'60,55 - 59세,1998,368,185,183
'4136034000,  수동면,'65,60 - 64세,1998,307,140,167
'4136034000,  수동면,'70,65 - 69세,1998,248,113,135
'4136034000,  수동면,'75,70 - 74세,1998,180,78,102
'4136034000,  수동면,'80,75 - 79세,1998,139,62,77
'4136034000,  수동면,'85,80 - 84세,1998,71,25,46
'4136034000,  수동면,'90,85+ ,1998,45,16,29
'4136036000,  조안면,'00,계,1998,3609,1805,1804
'4136036000,  조안면,'05,0 - 4세,1998,188,87,101
'4136036000,  조안면,'10,5 - 9세,1998,190,87,103
'4136036000,  조안면,'15,10 - 14세,1998,194,101,93
'4136036000,  조안면,'20,15 - 19세,1998,281,140,141
'4136036000,  조안면,'25,20 - 24세,1998,290,152,138
'4136036000,  조안면,'30,25 - 29세,1998,267,148,119
'4136036000,  조안면,'35,30 - 34세,1998,261,145,116
'4136036000,  조안면,'40,35 - 39세,1998,270,150,120
'4136036000,  조안면,'45,40 - 44세,1998,256,136,120
'4136036000,  조안면,'50,45 - 49세,1998,198,101,97
'4136036000,  조안면,'55,50 - 54세,1998,241,115,126
'4136036000,  조안면,'60,55 - 59세,1998,253,128,125
'4136036000,  조안면,'65,60 - 64세,1998,245,122,123
'4136036000,  조안면,'70,65 - 69세,1998,166,69,97
'4136036000,  조안면,'75,70 - 74세,1998,124,43,81
'4136036000,  조안면,'80,75 - 79세,1998,101,50,51
'4136036000,  조안면,'85,80 - 84세,1998,53,23,30
'4136036000,  조안면,'90,85+ ,1998,31,8,23
'4136037000,  퇴계원면,'00,계,1998,19530,9862,9668
'4136037000,  퇴계원면,'05,0 - 4세,1998,1589,837,752
'4136037000,  퇴계원면,'10,5 - 9세,1998,1778,929,849
'4136037000,  퇴계원면,'15,10 - 14세,1998,1512,760,752
'4136037000,  퇴계원면,'20,15 - 19세,1998,1481,750,731
'4136037000,  퇴계원면,'25,20 - 24세,1998,1288,669,619
'4136037000,  퇴계원면,'30,25 - 29세,1998,1780,873,907
'4136037000,  퇴계원면,'35,30 - 34세,1998,2118,1049,1069
'4136037000,  퇴계원면,'40,35 - 39세,1998,2345,1233,1112
'4136037000,  퇴계원면,'45,40 - 44세,1998,1612,885,727
'4136037000,  퇴계원면,'50,45 - 49세,1998,934,497,437
'4136037000,  퇴계원면,'55,50 - 54세,1998,771,398,373
'4136037000,  퇴계원면,'60,55 - 59세,1998,765,334,431
'4136037000,  퇴계원면,'65,60 - 64세,1998,586,270,316
'4136037000,  퇴계원면,'70,65 - 69세,1998,396,159,237
'4136037000,  퇴계원면,'75,70 - 74세,1998,269,99,170
'4136037000,  퇴계원면,'80,75 - 79세,1998,176,79,97
'4136037000,  퇴계원면,'85,80 - 84세,1998,84,29,55
'4136037000,  퇴계원면,'90,85+ ,1998,46,12,34
'4136038000,  오남면,'00,계,1998,25673,12905,12768
'4136038000,  오남면,'05,0 - 4세,1998,3167,1642,1525
'4136038000,  오남면,'10,5 - 9세,1998,2918,1468,1450
'4136038000,  오남면,'15,10 - 14세,1998,1669,820,849
'4136038000,  오남면,'20,15 - 19세,1998,1173,605,568
'4136038000,  오남면,'25,20 - 24세,1998,1134,573,561
'4136038000,  오남면,'30,25 - 29세,1998,2567,1113,1454
'4136038000,  오남면,'35,30 - 34세,1998,3799,1850,1949
'4136038000,  오남면,'40,35 - 39세,1998,3306,1887,1419
'4136038000,  오남면,'45,40 - 44세,1998,1832,1106,726
'4136038000,  오남면,'50,45 - 49세,1998,810,437,373
'4136038000,  오남면,'55,50 - 54세,1998,739,349,390
'4136038000,  오남면,'60,55 - 59세,1998,786,348,438
'4136038000,  오남면,'65,60 - 64세,1998,681,293,388
'4136038000,  오남면,'70,65 - 69세,1998,435,172,263
'4136038000,  오남면,'75,70 - 74세,1998,312,118,194
'4136038000,  오남면,'80,75 - 79세,1998,197,80,117
'4136038000,  오남면,'85,80 - 84세,1998,97,28,69
'4136038000,  오남면,'90,85+ ,1998,51,16,35
'4136051000,  호평동,'00,계,1998,4994,2558,2436
'4136051000,  호평동,'05,0 - 4세,1998,328,162,166
'4136051000,  호평동,'10,5 - 9세,1998,378,188,190
'4136051000,  호평동,'15,10 - 14세,1998,325,176,149
'4136051000,  호평동,'20,15 - 19세,1998,427,232,195
'4136051000,  호평동,'25,20 - 24세,1998,368,182,186
'4136051000,  호평동,'30,25 - 29세,1998,443,227,216
'4136051000,  호평동,'35,30 - 34세,1998,479,238,241
'4136051000,  호평동,'40,35 - 39세,1998,533,311,222
'4136051000,  호평동,'45,40 - 44세,1998,450,236,214
'4136051000,  호평동,'50,45 - 49세,1998,269,144,125
'4136051000,  호평동,'55,50 - 54세,1998,233,116,117
'4136051000,  호평동,'60,55 - 59세,1998,247,129,118
'4136051000,  호평동,'65,60 - 64세,1998,209,103,106
'4136051000,  호평동,'70,65 - 69세,1998,116,47,69
'4136051000,  호평동,'75,70 - 74세,1998,91,34,57
'4136051000,  호평동,'80,75 - 79세,1998,51,19,32
'4136051000,  호평동,'85,80 - 84세,1998,34,9,25
'4136051000,  호평동,'90,85+ ,1998,13,5,8
'4136052000,  평내동,'00,계,1998,11927,6029,5898
'4136052000,  평내동,'05,0 - 4세,1998,1030,523,507
'4136052000,  평내동,'10,5 - 9세,1998,1233,656,577
'4136052000,  평내동,'15,10 - 14세,1998,835,451,384
'4136052000,  평내동,'20,15 - 19세,1998,794,424,370
'4136052000,  평내동,'25,20 - 24세,1998,665,318,347
'4136052000,  평내동,'30,25 - 29세,1998,1058,476,582
'4136052000,  평내동,'35,30 - 34세,1998,1421,697,724
'4136052000,  평내동,'40,35 - 39세,1998,1472,776,696
'4136052000,  평내동,'45,40 - 44세,1998,1056,609,447
'4136052000,  평내동,'50,45 - 49세,1998,485,270,215
'4136052000,  평내동,'55,50 - 54세,1998,387,207,180
'4136052000,  평내동,'60,55 - 59세,1998,422,169,253
'4136052000,  평내동,'65,60 - 64세,1998,406,185,221
'4136052000,  평내동,'70,65 - 69세,1998,307,131,176
'4136052000,  평내동,'75,70 - 74세,1998,158,53,105
'4136052000,  평내동,'80,75 - 79세,1998,98,39,59
'4136052000,  평내동,'85,80 - 84세,1998,60,31,29
'4136052000,  평내동,'90,85+ ,1998,40,14,26
'4136053000,  금곡동,'00,계,1998,24088,12132,11956
'4136053000,  금곡동,'05,0 - 4세,1998,2276,1199,1077
'4136053000,  금곡동,'10,5 - 9세,1998,2322,1232,1090
'4136053000,  금곡동,'15,10 - 14세,1998,1549,773,776
'4136053000,  금곡동,'20,15 - 19세,1998,1644,848,796
'4136053000,  금곡동,'25,20 - 24세,1998,1450,701,749
'4136053000,  금곡동,'30,25 - 29세,1998,2343,1135,1208
'4136053000,  금곡동,'35,30 - 34세,1998,2858,1384,1474
'4136053000,  금곡동,'40,35 - 39세,1998,2912,1599,1313
'4136053000,  금곡동,'45,40 - 44세,1998,1948,1043,905
'4136053000,  금곡동,'50,45 - 49세,1998,1082,589,493
'4136053000,  금곡동,'55,50 - 54세,1998,867,436,431
'4136053000,  금곡동,'60,55 - 59세,1998,853,400,453
'4136053000,  금곡동,'65,60 - 64세,1998,730,318,412
'4136053000,  금곡동,'70,65 - 69세,1998,514,203,311
'4136053000,  금곡동,'75,70 - 74세,1998,349,131,218
'4136053000,  금곡동,'80,75 - 79세,1998,226,89,137
'4136053000,  금곡동,'85,80 - 84세,1998,107,35,72
'4136053000,  금곡동,'90,85+ ,1998,58,17,41
'4136054000,  양정동,'00,계,1998,6399,3265,3134
'4136054000,  양정동,'05,0 - 4세,1998,443,214,229
'4136054000,  양정동,'10,5 - 9세,1998,407,191,216
'4136054000,  양정동,'15,10 - 14세,1998,394,190,204
'4136054000,  양정동,'20,15 - 19세,1998,561,284,277
'4136054000,  양정동,'25,20 - 24세,1998,522,266,256
'4136054000,  양정동,'30,25 - 29세,1998,616,360,256
'4136054000,  양정동,'35,30 - 34세,1998,584,322,262
'4136054000,  양정동,'40,35 - 39세,1998,552,295,257
'4136054000,  양정동,'45,40 - 44세,1998,537,281,256
'4136054000,  양정동,'50,45 - 49세,1998,362,199,163
'4136054000,  양정동,'55,50 - 54세,1998,308,153,155
'4136054000,  양정동,'60,55 - 59세,1998,358,182,176
'4136054000,  양정동,'65,60 - 64세,1998,278,136,142
'4136054000,  양정동,'70,65 - 69세,1998,191,89,102
'4136054000,  양정동,'75,70 - 74세,1998,132,48,84
'4136054000,  양정동,'80,75 - 79세,1998,82,27,55
'4136054000,  양정동,'85,80 - 84세,1998,43,18,25
'4136054000,  양정동,'90,85+ ,1998,29,10,19
'4136055000,  지금동,'00,계,1998,13954,6965,6989
'4136055000,  지금동,'05,0 - 4세,1998,842,438,404
'4136055000,  지금동,'10,5 - 9세,1998,973,492,481
'4136055000,  지금동,'15,10 - 14세,1998,1254,652,602
'4136055000,  지금동,'20,15 - 19세,1998,1385,678,707
'4136055000,  지금동,'25,20 - 24세,1998,1086,557,529
'4136055000,  지금동,'30,25 - 29세,1998,1180,643,537
'4136055000,  지금동,'35,30 - 34세,1998,1188,599,589
'4136055000,  지금동,'40,35 - 39세,1998,1413,657,756
'4136055000,  지금동,'45,40 - 44세,1998,1297,675,622
'4136055000,  지금동,'50,45 - 49세,1998,838,444,394
'4136055000,  지금동,'55,50 - 54세,1998,657,340,317
'4136055000,  지금동,'60,55 - 59세,1998,561,283,278
'4136055000,  지금동,'65,60 - 64세,1998,423,190,233
'4136055000,  지금동,'70,65 - 69세,1998,347,151,196
'4136055000,  지금동,'75,70 - 74세,1998,226,71,155
'4136055000,  지금동,'80,75 - 79세,1998,156,47,109
'4136055000,  지금동,'85,80 - 84세,1998,64,26,38
'4136055000,  지금동,'90,85+ ,1998,64,22,42
'4136056000,  도농동,'00,계,1998,15913,8064,7849
'4136056000,  도농동,'05,0 - 4세,1998,1212,622,590
'4136056000,  도농동,'10,5 - 9세,1998,1138,629,509
'4136056000,  도농동,'15,10 - 14세,1998,1240,660,580
'4136056000,  도농동,'20,15 - 19세,1998,1476,746,730
'4136056000,  도농동,'25,20 - 24세,1998,1262,638,624
'4136056000,  도농동,'30,25 - 29세,1998,1522,761,761
'4136056000,  도농동,'35,30 - 34세,1998,1551,804,747
'4136056000,  도농동,'40,35 - 39세,1998,1706,888,818
'4136056000,  도농동,'45,40 - 44세,1998,1479,765,714
'4136056000,  도농동,'50,45 - 49세,1998,866,466,400
'4136056000,  도농동,'55,50 - 54세,1998,665,343,322
'4136056000,  도농동,'60,55 - 59세,1998,556,276,280
'4136056000,  도농동,'65,60 - 64세,1998,468,200,268
'4136056000,  도농동,'70,65 - 69세,1998,317,116,201
'4136056000,  도농동,'75,70 - 74세,1998,227,81,146
'4136056000,  도농동,'80,75 - 79세,1998,130,49,81
'4136056000,  도농동,'85,80 - 84세,1998,68,9,59
'4136056000,  도농동,'90,85+ ,1998,30,11,19
'41370, 오산시,'00,계,1998,76638,38947,37691
'41370, 오산시,'05,0 - 4세,1998,6822,3539,3283
'41370, 오산시,'10,5 - 9세,1998,6784,3494,3290
'41370, 오산시,'15,10 - 14세,1998,5427,2720,2707
'41370, 오산시,'20,15 - 19세,1998,6076,3118,2958
'41370, 오산시,'25,20 - 24세,1998,6015,3083,2932
'41370, 오산시,'30,25 - 29세,1998,8177,4084,4093
'41370, 오산시,'35,30 - 34세,1998,8496,4311,4185
'41370, 오산시,'40,35 - 39세,1998,8417,4564,3853
'41370, 오산시,'45,40 - 44세,1998,5942,3248,2694
'41370, 오산시,'50,45 - 49세,1998,3531,1843,1688
'41370, 오산시,'55,50 - 54세,1998,2918,1491,1427
'41370, 오산시,'60,55 - 59세,1998,2601,1299,1302
'41370, 오산시,'65,60 - 64세,1998,2156,993,1163
'41370, 오산시,'70,65 - 69세,1998,1257,490,767
'41370, 오산시,'75,70 - 74세,1998,871,307,564
'41370, 오산시,'80,75 - 79세,1998,612,208,404
'41370, 오산시,'85,80 - 84세,1998,335,111,224
'41370, 오산시,'90,85+ ,1998,201,44,157
'4137051000,  중앙동,'00,계,1998,9701,4916,4785
'4137051000,  중앙동,'05,0 - 4세,1998,645,346,299
'4137051000,  중앙동,'10,5 - 9세,1998,790,425,365
'4137051000,  중앙동,'15,10 - 14세,1998,621,342,279
'4137051000,  중앙동,'20,15 - 19세,1998,850,415,435
'4137051000,  중앙동,'25,20 - 24세,1998,868,452,416
'4137051000,  중앙동,'30,25 - 29세,1998,974,504,470
'4137051000,  중앙동,'35,30 - 34세,1998,939,489,450
'4137051000,  중앙동,'40,35 - 39세,1998,916,459,457
'4137051000,  중앙동,'45,40 - 44세,1998,771,393,378
'4137051000,  중앙동,'50,45 - 49세,1998,541,273,268
'4137051000,  중앙동,'55,50 - 54세,1998,479,235,244
'4137051000,  중앙동,'60,55 - 59세,1998,433,226,207
'4137051000,  중앙동,'65,60 - 64세,1998,360,162,198
'4137051000,  중앙동,'70,65 - 69세,1998,195,76,119
'4137051000,  중앙동,'75,70 - 74세,1998,137,57,80
'4137051000,  중앙동,'80,75 - 79세,1998,97,31,66
'4137051000,  중앙동,'85,80 - 84세,1998,54,21,33
'4137051000,  중앙동,'90,85+ ,1998,31,10,21
'4137053000,  남촌동,'00,계,1998,8041,4164,3877
'4137053000,  남촌동,'05,0 - 4세,1998,545,292,253
'4137053000,  남촌동,'10,5 - 9세,1998,645,333,312
'4137053000,  남촌동,'15,10 - 14세,1998,574,282,292
'4137053000,  남촌동,'20,15 - 19세,1998,709,374,335
'4137053000,  남촌동,'25,20 - 24세,1998,796,434,362
'4137053000,  남촌동,'30,25 - 29세,1998,836,475,361
'4137053000,  남촌동,'35,30 - 34세,1998,776,403,373
'4137053000,  남촌동,'40,35 - 39세,1998,799,424,375
'4137053000,  남촌동,'45,40 - 44세,1998,624,333,291
'4137053000,  남촌동,'50,45 - 49세,1998,440,222,218
'4137053000,  남촌동,'55,50 - 54세,1998,328,177,151
'4137053000,  남촌동,'60,55 - 59세,1998,323,156,167
'4137053000,  남촌동,'65,60 - 64세,1998,252,113,139
'4137053000,  남촌동,'70,65 - 69세,1998,141,62,79
'4137053000,  남촌동,'75,70 - 74세,1998,119,43,76
'4137053000,  남촌동,'80,75 - 79세,1998,72,23,49
'4137053000,  남촌동,'85,80 - 84세,1998,39,14,25
'4137053000,  남촌동,'90,85+ ,1998,23,4,19
'4137054000,  신장동,'00,계,1998,21903,11039,10864
'4137054000,  신장동,'05,0 - 4세,1998,2027,1055,972
'4137054000,  신장동,'10,5 - 9세,1998,2009,1049,960
'4137054000,  신장동,'15,10 - 14세,1998,1740,863,877
'4137054000,  신장동,'20,15 - 19세,1998,1815,911,904
'4137054000,  신장동,'25,20 - 24세,1998,1540,762,778
'4137054000,  신장동,'30,25 - 29세,1998,2262,1076,1186
'4137054000,  신장동,'35,30 - 34세,1998,2438,1199,1239
'4137054000,  신장동,'40,35 - 39세,1998,2517,1344,1173
'4137054000,  신장동,'45,40 - 44세,1998,1893,1056,837
'4137054000,  신장동,'50,45 - 49세,1998,957,507,450
'4137054000,  신장동,'55,50 - 54세,1998,768,398,370
'4137054000,  신장동,'60,55 - 59세,1998,616,324,292
'4137054000,  신장동,'65,60 - 64세,1998,509,222,287
'4137054000,  신장동,'70,65 - 69세,1998,308,108,200
'4137054000,  신장동,'75,70 - 74세,1998,216,71,145
'4137054000,  신장동,'80,75 - 79세,1998,160,52,108
'4137054000,  신장동,'85,80 - 84세,1998,79,31,48
'4137054000,  신장동,'90,85+ ,1998,49,11,38
'4137055000,  세마동,'00,계,1998,2903,1506,1397
'4137055000,  세마동,'05,0 - 4세,1998,146,72,74
'4137055000,  세마동,'10,5 - 9세,1998,130,63,67
'4137055000,  세마동,'15,10 - 14세,1998,152,73,79
'4137055000,  세마동,'20,15 - 19세,1998,261,134,127
'4137055000,  세마동,'25,20 - 24세,1998,307,176,131
'4137055000,  세마동,'30,25 - 29세,1998,300,192,108
'4137055000,  세마동,'35,30 - 34세,1998,207,121,86
'4137055000,  세마동,'40,35 - 39세,1998,226,114,112
'4137055000,  세마동,'45,40 - 44세,1998,200,111,89
'4137055000,  세마동,'50,45 - 49세,1998,170,83,87
'4137055000,  세마동,'55,50 - 54세,1998,174,85,89
'4137055000,  세마동,'60,55 - 59세,1998,184,89,95
'4137055000,  세마동,'65,60 - 64세,1998,164,80,84
'4137055000,  세마동,'70,65 - 69세,1998,112,49,63
'4137055000,  세마동,'75,70 - 74세,1998,67,21,46
'4137055000,  세마동,'80,75 - 79세,1998,51,25,26
'4137055000,  세마동,'85,80 - 84세,1998,30,13,17
'4137055000,  세마동,'90,85+ ,1998,22,5,17
'4137056000,  초평동,'00,계,1998,8316,4242,4074
'4137056000,  초평동,'05,0 - 4세,1998,811,400,411
'4137056000,  초평동,'10,5 - 9세,1998,773,383,390
'4137056000,  초평동,'15,10 - 14세,1998,616,306,310
'4137056000,  초평동,'20,15 - 19세,1998,599,335,264
'4137056000,  초평동,'25,20 - 24세,1998,604,302,302
'4137056000,  초평동,'30,25 - 29세,1998,876,421,455
'4137056000,  초평동,'35,30 - 34세,1998,972,489,483
'4137056000,  초평동,'40,35 - 39세,1998,985,562,423
'4137056000,  초평동,'45,40 - 44세,1998,605,351,254
'4137056000,  초평동,'50,45 - 49세,1998,333,173,160
'4137056000,  초평동,'55,50 - 54세,1998,273,138,135
'4137056000,  초평동,'60,55 - 59세,1998,257,131,126
'4137056000,  초평동,'65,60 - 64세,1998,253,126,127
'4137056000,  초평동,'70,65 - 69세,1998,137,51,86
'4137056000,  초평동,'75,70 - 74세,1998,80,28,52
'4137056000,  초평동,'80,75 - 79세,1998,76,26,50
'4137056000,  초평동,'85,80 - 84세,1998,39,13,26
'4137056000,  초평동,'90,85+ ,1998,27,7,20
'4137057000,  대원동,'00,계,1998,25774,13080,12694
'4137057000,  대원동,'05,0 - 4세,1998,2648,1374,1274
'4137057000,  대원동,'10,5 - 9세,1998,2437,1241,1196
'4137057000,  대원동,'15,10 - 14세,1998,1724,854,870
'4137057000,  대원동,'20,15 - 19세,1998,1842,949,893
'4137057000,  대원동,'25,20 - 24세,1998,1900,957,943
'4137057000,  대원동,'30,25 - 29세,1998,2929,1416,1513
'4137057000,  대원동,'35,30 - 34세,1998,3164,1610,1554
'4137057000,  대원동,'40,35 - 39세,1998,2974,1661,1313
'4137057000,  대원동,'45,40 - 44세,1998,1849,1004,845
'4137057000,  대원동,'50,45 - 49세,1998,1090,585,505
'4137057000,  대원동,'55,50 - 54세,1998,896,458,438
'4137057000,  대원동,'60,55 - 59세,1998,788,373,415
'4137057000,  대원동,'65,60 - 64세,1998,618,290,328
'4137057000,  대원동,'70,65 - 69세,1998,364,144,220
'4137057000,  대원동,'75,70 - 74세,1998,252,87,165
'4137057000,  대원동,'80,75 - 79세,1998,156,51,105
'4137057000,  대원동,'85,80 - 84세,1998,94,19,75
'4137057000,  대원동,'90,85+ ,1998,49,7,42
'41390, 시흥시,'00,계,1998,253329,129034,124295
'41390, 시흥시,'05,0 - 4세,1998,29094,15282,13812
'41390, 시흥시,'10,5 - 9세,1998,29343,15249,14094
'41390, 시흥시,'15,10 - 14세,1998,17572,8916,8656
'41390, 시흥시,'20,15 - 19세,1998,13396,6761,6635
'41390, 시흥시,'25,20 - 24세,1998,13077,6643,6434
'41390, 시흥시,'30,25 - 29세,1998,26243,11846,14397
'41390, 시흥시,'35,30 - 34세,1998,36435,17859,18576
'41390, 시흥시,'40,35 - 39세,1998,33219,18912,14307
'41390, 시흥시,'45,40 - 44세,1998,17579,10375,7204
'41390, 시흥시,'50,45 - 49세,1998,8611,4766,3845
'41390, 시흥시,'55,50 - 54세,1998,6533,3347,3186
'41390, 시흥시,'60,55 - 59세,1998,6534,2980,3554
'41390, 시흥시,'65,60 - 64세,1998,5644,2440,3204
'41390, 시흥시,'70,65 - 69세,1998,4088,1586,2502
'41390, 시흥시,'75,70 - 74세,1998,2715,978,1737
'41390, 시흥시,'80,75 - 79세,1998,1800,647,1153
'41390, 시흥시,'85,80 - 84세,1998,895,278,617
'41390, 시흥시,'90,85+ ,1998,551,169,382
'4139051000,  대야동,'00,계,1998,36253,18429,17824
'4139051000,  대야동,'05,0 - 4세,1998,3747,1978,1769
'4139051000,  대야동,'10,5 - 9세,1998,4052,2142,1910
'4139051000,  대야동,'15,10 - 14세,1998,2774,1421,1353
'4139051000,  대야동,'20,15 - 19세,1998,2097,1076,1021
'4139051000,  대야동,'25,20 - 24세,1998,1821,910,911
'4139051000,  대야동,'30,25 - 29세,1998,3545,1634,1911
'4139051000,  대야동,'35,30 - 34세,1998,4805,2309,2496
'4139051000,  대야동,'40,35 - 39세,1998,4870,2663,2207
'4139051000,  대야동,'45,40 - 44세,1998,2899,1689,1210
'4139051000,  대야동,'50,45 - 49세,1998,1350,747,603
'4139051000,  대야동,'55,50 - 54세,1998,994,533,461
'4139051000,  대야동,'60,55 - 59세,1998,976,446,530
'4139051000,  대야동,'65,60 - 64세,1998,786,325,461
'4139051000,  대야동,'70,65 - 69세,1998,624,234,390
'4139051000,  대야동,'75,70 - 74세,1998,398,148,250
'4139051000,  대야동,'80,75 - 79세,1998,290,114,176
'4139051000,  대야동,'85,80 - 84세,1998,150,45,105
'4139051000,  대야동,'90,85+ ,1998,75,15,60
'4139052000,  신천동,'00,계,1998,41189,21026,20163
'4139052000,  신천동,'05,0 - 4세,1998,4344,2283,2061
'4139052000,  신천동,'10,5 - 9세,1998,4416,2336,2080
'4139052000,  신천동,'15,10 - 14세,1998,3048,1542,1506
'4139052000,  신천동,'20,15 - 19세,1998,2537,1277,1260
'4139052000,  신천동,'25,20 - 24세,1998,2337,1151,1186
'4139052000,  신천동,'30,25 - 29세,1998,4400,2055,2345
'4139052000,  신천동,'35,30 - 34세,1998,5544,2817,2727
'4139052000,  신천동,'40,35 - 39세,1998,5199,2885,2314
'4139052000,  신천동,'45,40 - 44세,1998,3068,1747,1321
'4139052000,  신천동,'50,45 - 49세,1998,1675,958,717
'4139052000,  신천동,'55,50 - 54세,1998,1116,576,540
'4139052000,  신천동,'60,55 - 59세,1998,1082,496,586
'4139052000,  신천동,'65,60 - 64세,1998,861,375,486
'4139052000,  신천동,'70,65 - 69세,1998,641,226,415
'4139052000,  신천동,'75,70 - 74세,1998,413,143,270
'4139052000,  신천동,'80,75 - 79세,1998,297,100,197
'4139052000,  신천동,'85,80 - 84세,1998,130,33,97
'4139052000,  신천동,'90,85+ ,1998,81,26,55
'4139053100,  신현동,'00,계,1998,13165,6730,6435
'4139053100,  신현동,'05,0 - 4세,1998,1437,732,705
'4139053100,  신현동,'10,5 - 9세,1998,1411,723,688
'4139053100,  신현동,'15,10 - 14세,1998,891,486,405
'4139053100,  신현동,'20,15 - 19세,1998,761,391,370
'4139053100,  신현동,'25,20 - 24세,1998,644,338,306
'4139053100,  신현동,'30,25 - 29세,1998,1197,537,660
'4139053100,  신현동,'35,30 - 34세,1998,1770,873,897
'4139053100,  신현동,'40,35 - 39세,1998,1757,1006,751
'4139053100,  신현동,'45,40 - 44세,1998,945,559,386
'4139053100,  신현동,'50,45 - 49세,1998,486,261,225
'4139053100,  신현동,'55,50 - 54세,1998,388,195,193
'4139053100,  신현동,'60,55 - 59세,1998,388,188,200
'4139053100,  신현동,'65,60 - 64세,1998,389,164,225
'4139053100,  신현동,'70,65 - 69세,1998,288,122,166
'4139053100,  신현동,'75,70 - 74세,1998,173,65,108
'4139053100,  신현동,'80,75 - 79세,1998,139,58,81
'4139053100,  신현동,'85,80 - 84세,1998,59,18,41
'4139053100,  신현동,'90,85+ ,1998,42,14,28
'4139054000,  은행동,'00,계,1998,26413,13412,13001
'4139054000,  은행동,'05,0 - 4세,1998,3012,1589,1423
'4139054000,  은행동,'10,5 - 9세,1998,3344,1743,1601
'4139054000,  은행동,'15,10 - 14세,1998,1969,988,981
'4139054000,  은행동,'20,15 - 19세,1998,1496,765,731
'4139054000,  은행동,'25,20 - 24세,1998,1168,596,572
'4139054000,  은행동,'30,25 - 29세,1998,2411,1029,1382
'4139054000,  은행동,'35,30 - 34세,1998,3842,1776,2066
'4139054000,  은행동,'40,35 - 39세,1998,3820,2176,1644
'4139054000,  은행동,'45,40 - 44세,1998,1932,1169,763
'4139054000,  은행동,'50,45 - 49세,1998,826,471,355
'4139054000,  은행동,'55,50 - 54세,1998,602,325,277
'4139054000,  은행동,'60,55 - 59세,1998,565,256,309
'4139054000,  은행동,'65,60 - 64세,1998,512,209,303
'4139054000,  은행동,'70,65 - 69세,1998,395,138,257
'4139054000,  은행동,'75,70 - 74세,1998,254,94,160
'4139054000,  은행동,'80,75 - 79세,1998,144,49,95
'4139054000,  은행동,'85,80 - 84세,1998,81,25,56
'4139054000,  은행동,'90,85+ ,1998,40,14,26
'4139055000,  매화동,'00,계,1998,13047,6561,6486
'4139055000,  매화동,'05,0 - 4세,1998,1511,755,756
'4139055000,  매화동,'10,5 - 9세,1998,1538,804,734
'4139055000,  매화동,'15,10 - 14세,1998,769,369,400
'4139055000,  매화동,'20,15 - 19세,1998,621,313,308
'4139055000,  매화동,'25,20 - 24세,1998,648,346,302
'4139055000,  매화동,'30,25 - 29세,1998,1350,614,736
'4139055000,  매화동,'35,30 - 34세,1998,1821,888,933
'4139055000,  매화동,'40,35 - 39세,1998,1647,964,683
'4139055000,  매화동,'45,40 - 44세,1998,812,464,348
'4139055000,  매화동,'50,45 - 49세,1998,460,242,218
'4139055000,  매화동,'55,50 - 54세,1998,393,192,201
'4139055000,  매화동,'60,55 - 59세,1998,396,188,208
'4139055000,  매화동,'65,60 - 64세,1998,392,170,222
'4139055000,  매화동,'70,65 - 69세,1998,268,110,158
'4139055000,  매화동,'75,70 - 74세,1998,185,75,110
'4139055000,  매화동,'80,75 - 79세,1998,142,45,97
'4139055000,  매화동,'85,80 - 84세,1998,57,15,42
'4139055000,  매화동,'90,85+ ,1998,37,7,30
'4139057000,  목감동,'00,계,1998,12036,6096,5940
'4139057000,  목감동,'05,0 - 4세,1998,1083,574,509
'4139057000,  목감동,'10,5 - 9세,1998,1206,608,598
'4139057000,  목감동,'15,10 - 14세,1998,814,414,400
'4139057000,  목감동,'20,15 - 19세,1998,778,376,402
'4139057000,  목감동,'25,20 - 24세,1998,712,367,345
'4139057000,  목감동,'30,25 - 29세,1998,1015,500,515
'4139057000,  목감동,'35,30 - 34세,1998,1445,716,729
'4139057000,  목감동,'40,35 - 39세,1998,1454,802,652
'4139057000,  목감동,'45,40 - 44세,1998,934,538,396
'4139057000,  목감동,'50,45 - 49세,1998,520,290,230
'4139057000,  목감동,'55,50 - 54세,1998,439,225,214
'4139057000,  목감동,'60,55 - 59세,1998,474,207,267
'4139057000,  목감동,'65,60 - 64세,1998,443,200,243
'4139057000,  목감동,'70,65 - 69세,1998,307,131,176
'4139057000,  목감동,'75,70 - 74세,1998,197,78,119
'4139057000,  목감동,'80,75 - 79세,1998,97,37,60
'4139057000,  목감동,'85,80 - 84세,1998,69,20,49
'4139057000,  목감동,'90,85+ ,1998,49,13,36
'4139058100,  군자동,'00,계,1998,16377,8451,7926
'4139058100,  군자동,'05,0 - 4세,1998,1537,815,722
'4139058100,  군자동,'10,5 - 9세,1998,1583,834,749
'4139058100,  군자동,'15,10 - 14세,1998,1140,611,529
'4139058100,  군자동,'20,15 - 19세,1998,1252,647,605
'4139058100,  군자동,'25,20 - 24세,1998,1029,514,515
'4139058100,  군자동,'30,25 - 29세,1998,1573,771,802
'4139058100,  군자동,'35,30 - 34세,1998,1955,977,978
'4139058100,  군자동,'40,35 - 39세,1998,1901,1101,800
'4139058100,  군자동,'45,40 - 44세,1998,1236,690,546
'4139058100,  군자동,'50,45 - 49세,1998,726,401,325
'4139058100,  군자동,'55,50 - 54세,1998,572,300,272
'4139058100,  군자동,'60,55 - 59세,1998,540,247,293
'4139058100,  군자동,'65,60 - 64세,1998,458,207,251
'4139058100,  군자동,'70,65 - 69세,1998,339,145,194
'4139058100,  군자동,'75,70 - 74세,1998,248,84,164
'4139058100,  군자동,'80,75 - 79세,1998,151,58,93
'4139058100,  군자동,'85,80 - 84세,1998,84,32,52
'4139058100,  군자동,'90,85+ ,1998,53,17,36
'4139059000,  정왕동,'00,계,1998,90017,45757,44260
'4139059000,  정왕동,'05,0 - 4세,1998,12136,6407,5729
'4139059000,  정왕동,'10,5 - 9세,1998,11551,5936,5615
'4139059000,  정왕동,'15,10 - 14세,1998,5958,2967,2991
'4139059000,  정왕동,'20,15 - 19세,1998,3512,1724,1788
'4139059000,  정왕동,'25,20 - 24세,1998,4270,2175,2095
'4139059000,  정왕동,'30,25 - 29세,1998,10347,4472,5875
'4139059000,  정왕동,'35,30 - 34세,1998,14872,7281,7591
'4139059000,  정왕동,'40,35 - 39세,1998,12186,7092,5094
'4139059000,  정왕동,'45,40 - 44세,1998,5373,3288,2085
'4139059000,  정왕동,'50,45 - 49세,1998,2273,1247,1026
'4139059000,  정왕동,'55,50 - 54세,1998,1725,837,888
'4139059000,  정왕동,'60,55 - 59세,1998,1800,800,1000
'4139059000,  정왕동,'65,60 - 64세,1998,1531,652,879
'4139059000,  정왕동,'70,65 - 69세,1998,1025,391,634
'4139059000,  정왕동,'75,70 - 74세,1998,688,225,463
'4139059000,  정왕동,'80,75 - 79세,1998,423,141,282
'4139059000,  정왕동,'85,80 - 84세,1998,212,74,138
'4139059000,  정왕동,'90,85+ ,1998,135,48,87
'4139062100,  과림동,'00,계,1998,2585,1415,1170
'4139062100,  과림동,'05,0 - 4세,1998,159,78,81
'4139062100,  과림동,'10,5 - 9세,1998,127,66,61
'4139062100,  과림동,'15,10 - 14세,1998,111,57,54
'4139062100,  과림동,'20,15 - 19세,1998,176,104,72
'4139062100,  과림동,'25,20 - 24세,1998,256,150,106
'4139062100,  과림동,'30,25 - 29세,1998,226,133,93
'4139062100,  과림동,'35,30 - 34세,1998,219,123,96
'4139062100,  과림동,'40,35 - 39세,1998,202,122,80
'4139062100,  과림동,'45,40 - 44세,1998,234,148,86
'4139062100,  과림동,'50,45 - 49세,1998,164,81,83
'4139062100,  과림동,'55,50 - 54세,1998,161,88,73
'4139062100,  과림동,'60,55 - 59세,1998,153,80,73
'4139062100,  과림동,'65,60 - 64세,1998,127,70,57
'4139062100,  과림동,'70,65 - 69세,1998,88,40,48
'4139062100,  과림동,'75,70 - 74세,1998,78,34,44
'4139062100,  과림동,'80,75 - 79세,1998,60,26,34
'4139062100,  과림동,'85,80 - 84세,1998,23,6,17
'4139062100,  과림동,'90,85+ ,1998,21,9,12
'4139063000,  연성동,'00,계,1998,2247,1157,1090
'4139063000,  연성동,'05,0 - 4세,1998,128,71,57
'4139063000,  연성동,'10,5 - 9세,1998,115,57,58
'4139063000,  연성동,'15,10 - 14세,1998,98,61,37
'4139063000,  연성동,'20,15 - 19세,1998,166,88,78
'4139063000,  연성동,'25,20 - 24세,1998,192,96,96
'4139063000,  연성동,'30,25 - 29세,1998,179,101,78
'4139063000,  연성동,'35,30 - 34세,1998,162,99,63
'4139063000,  연성동,'40,35 - 39세,1998,183,101,82
'4139063000,  연성동,'45,40 - 44세,1998,146,83,63
'4139063000,  연성동,'50,45 - 49세,1998,131,68,63
'4139063000,  연성동,'55,50 - 54세,1998,143,76,67
'4139063000,  연성동,'60,55 - 59세,1998,160,72,88
'4139063000,  연성동,'65,60 - 64세,1998,145,68,77
'4139063000,  연성동,'70,65 - 69세,1998,113,49,64
'4139063000,  연성동,'75,70 - 74세,1998,81,32,49
'4139063000,  연성동,'80,75 - 79세,1998,57,19,38
'4139063000,  연성동,'85,80 - 84세,1998,30,10,20
'4139063000,  연성동,'90,85+ ,1998,18,6,12
'41410, 군포시,'00,계,1998,270138,135737,134401
'41410, 군포시,'05,0 - 4세,1998,24798,13056,11742
'41410, 군포시,'10,5 - 9세,1998,24542,12850,11692
'41410, 군포시,'15,10 - 14세,1998,20719,10798,9921
'41410, 군포시,'20,15 - 19세,1998,19967,10287,9680
'41410, 군포시,'25,20 - 24세,1998,16725,8104,8621
'41410, 군포시,'30,25 - 29세,1998,27929,12931,14998
'41410, 군포시,'35,30 - 34세,1998,31794,15777,16017
'41410, 군포시,'40,35 - 39세,1998,32387,16800,15587
'41410, 군포시,'45,40 - 44세,1998,23377,12560,10817
'41410, 군포시,'50,45 - 49세,1998,12595,6903,5692
'41410, 군포시,'55,50 - 54세,1998,9312,4817,4495
'41410, 군포시,'60,55 - 59세,1998,8057,3988,4069
'41410, 군포시,'65,60 - 64세,1998,6393,2762,3631
'41410, 군포시,'70,65 - 69세,1998,4641,1821,2820
'41410, 군포시,'75,70 - 74세,1998,3187,1159,2028
'41410, 군포시,'80,75 - 79세,1998,2046,706,1340
'41410, 군포시,'85,80 - 84세,1998,1030,288,742
'41410, 군포시,'90,85+ ,1998,639,130,509
'4141051000,  군포1동,'00,계,1998,26781,14044,12737
'4141051000,  군포1동,'05,0 - 4세,1998,2515,1339,1176
'4141051000,  군포1동,'10,5 - 9세,1998,1918,959,959
'4141051000,  군포1동,'15,10 - 14세,1998,1599,863,736
'4141051000,  군포1동,'20,15 - 19세,1998,2082,1120,962
'4141051000,  군포1동,'25,20 - 24세,1998,2382,1200,1182
'4141051000,  군포1동,'30,25 - 29세,1998,3470,1877,1593
'4141051000,  군포1동,'35,30 - 34세,1998,3062,1738,1324
'4141051000,  군포1동,'40,35 - 39세,1998,2619,1434,1185
'4141051000,  군포1동,'45,40 - 44세,1998,2129,1126,1003
'4141051000,  군포1동,'50,45 - 49세,1998,1271,682,589
'4141051000,  군포1동,'55,50 - 54세,1998,1083,542,541
'4141051000,  군포1동,'60,55 - 59세,1998,938,469,469
'4141051000,  군포1동,'65,60 - 64세,1998,657,298,359
'4141051000,  군포1동,'70,65 - 69세,1998,424,179,245
'4141051000,  군포1동,'75,70 - 74세,1998,278,101,177
'4141051000,  군포1동,'80,75 - 79세,1998,203,75,128
'4141051000,  군포1동,'85,80 - 84세,1998,100,31,69
'4141051000,  군포1동,'90,85+ ,1998,51,11,40
'4141052000,  군포2동,'00,계,1998,25320,12816,12504
'4141052000,  군포2동,'05,0 - 4세,1998,2465,1341,1124
'4141052000,  군포2동,'10,5 - 9세,1998,2743,1427,1316
'4141052000,  군포2동,'15,10 - 14세,1998,2026,1037,989
'4141052000,  군포2동,'20,15 - 19세,1998,1823,969,854
'4141052000,  군포2동,'25,20 - 24세,1998,1448,662,786
'4141052000,  군포2동,'30,25 - 29세,1998,2166,991,1175
'4141052000,  군포2동,'35,30 - 34세,1998,3106,1412,1694
'4141052000,  군포2동,'40,35 - 39세,1998,3408,1898,1510
'4141052000,  군포2동,'45,40 - 44세,1998,2038,1145,893
'4141052000,  군포2동,'50,45 - 49세,1998,1084,593,491
'4141052000,  군포2동,'55,50 - 54세,1998,856,447,409
'4141052000,  군포2동,'60,55 - 59세,1998,654,341,313
'4141052000,  군포2동,'65,60 - 64세,1998,550,228,322
'4141052000,  군포2동,'70,65 - 69세,1998,397,154,243
'4141052000,  군포2동,'75,70 - 74세,1998,252,85,167
'4141052000,  군포2동,'80,75 - 79세,1998,161,52,109
'4141052000,  군포2동,'85,80 - 84세,1998,93,24,69
'4141052000,  군포2동,'90,85+ ,1998,50,10,40
'4141054000,  산본1동,'00,계,1998,25301,12675,12626
'4141054000,  산본1동,'05,0 - 4세,1998,2600,1346,1254
'4141054000,  산본1동,'10,5 - 9세,1998,2200,1176,1024
'4141054000,  산본1동,'15,10 - 14세,1998,1422,754,668
'4141054000,  산본1동,'20,15 - 19세,1998,1691,861,830
'4141054000,  산본1동,'25,20 - 24세,1998,1973,916,1057
'4141054000,  산본1동,'30,25 - 29세,1998,3398,1586,1812
'4141054000,  산본1동,'35,30 - 34세,1998,3359,1717,1642
'4141054000,  산본1동,'40,35 - 39세,1998,2730,1529,1201
'4141054000,  산본1동,'45,40 - 44세,1998,1775,942,833
'4141054000,  산본1동,'50,45 - 49세,1998,1066,523,543
'4141054000,  산본1동,'55,50 - 54세,1998,837,425,412
'4141054000,  산본1동,'60,55 - 59세,1998,738,344,394
'4141054000,  산본1동,'65,60 - 64세,1998,527,223,304
'4141054000,  산본1동,'70,65 - 69세,1998,423,160,263
'4141054000,  산본1동,'75,70 - 74세,1998,276,84,192
'4141054000,  산본1동,'80,75 - 79세,1998,159,48,111
'4141054000,  산본1동,'85,80 - 84세,1998,80,29,51
'4141054000,  산본1동,'90,85+ ,1998,47,12,35
'4141055000,  산본2동,'00,계,1998,30296,15161,15135
'4141055000,  산본2동,'05,0 - 4세,1998,2604,1347,1257
'4141055000,  산본2동,'10,5 - 9세,1998,3075,1635,1440
'4141055000,  산본2동,'15,10 - 14세,1998,2751,1434,1317
'4141055000,  산본2동,'20,15 - 19세,1998,2399,1185,1214
'4141055000,  산본2동,'25,20 - 24세,1998,1602,798,804
'4141055000,  산본2동,'30,25 - 29세,1998,2493,1135,1358
'4141055000,  산본2동,'35,30 - 34세,1998,3199,1482,1717
'4141055000,  산본2동,'40,35 - 39세,1998,4173,2069,2104
'4141055000,  산본2동,'45,40 - 44세,1998,3072,1666,1406
'4141055000,  산본2동,'50,45 - 49세,1998,1492,860,632
'4141055000,  산본2동,'55,50 - 54세,1998,966,534,432
'4141055000,  산본2동,'60,55 - 59세,1998,733,382,351
'4141055000,  산본2동,'65,60 - 64세,1998,589,252,337
'4141055000,  산본2동,'70,65 - 69세,1998,468,173,295
'4141055000,  산본2동,'75,70 - 74세,1998,330,109,221
'4141055000,  산본2동,'80,75 - 79세,1998,193,67,126
'4141055000,  산본2동,'85,80 - 84세,1998,95,23,72
'4141055000,  산본2동,'90,85+ ,1998,62,10,52
'4141056000,  금정동,'00,계,1998,19733,10180,9553
'4141056000,  금정동,'05,0 - 4세,1998,1641,870,771
'4141056000,  금정동,'10,5 - 9세,1998,1578,818,760
'4141056000,  금정동,'15,10 - 14세,1998,1308,683,625
'4141056000,  금정동,'20,15 - 19세,1998,1618,839,779
'4141056000,  금정동,'25,20 - 24세,1998,1685,856,829
'4141056000,  금정동,'30,25 - 29세,1998,2565,1319,1246
'4141056000,  금정동,'35,30 - 34세,1998,2336,1284,1052
'4141056000,  금정동,'40,35 - 39세,1998,2075,1118,957
'4141056000,  금정동,'45,40 - 44세,1998,1522,748,774
'4141056000,  금정동,'50,45 - 49세,1998,986,537,449
'4141056000,  금정동,'55,50 - 54세,1998,717,395,322
'4141056000,  금정동,'60,55 - 59세,1998,589,299,290
'4141056000,  금정동,'65,60 - 64세,1998,404,167,237
'4141056000,  금정동,'70,65 - 69세,1998,290,110,180
'4141056000,  금정동,'75,70 - 74세,1998,200,78,122
'4141056000,  금정동,'80,75 - 79세,1998,128,37,91
'4141056000,  금정동,'85,80 - 84세,1998,50,14,36
'4141056000,  금정동,'90,85+ ,1998,41,8,33
'4141057000,  재궁동,'00,계,1998,27913,13852,14061
'4141057000,  재궁동,'05,0 - 4세,1998,2420,1272,1148
'4141057000,  재궁동,'10,5 - 9세,1998,2200,1119,1081
'4141057000,  재궁동,'15,10 - 14세,1998,2265,1194,1071
'4141057000,  재궁동,'20,15 - 19세,1998,2166,1078,1088
'4141057000,  재궁동,'25,20 - 24세,1998,1698,802,896
'4141057000,  재궁동,'30,25 - 29세,1998,3231,1495,1736
'4141057000,  재궁동,'35,30 - 34세,1998,3277,1634,1643
'4141057000,  재궁동,'40,35 - 39세,1998,3184,1607,1577
'4141057000,  재궁동,'45,40 - 44세,1998,2441,1314,1127
'4141057000,  재궁동,'50,45 - 49세,1998,1339,731,608
'4141057000,  재궁동,'55,50 - 54세,1998,931,467,464
'4141057000,  재궁동,'60,55 - 59세,1998,850,415,435
'4141057000,  재궁동,'65,60 - 64세,1998,722,292,430
'4141057000,  재궁동,'70,65 - 69세,1998,502,203,299
'4141057000,  재궁동,'75,70 - 74세,1998,301,113,188
'4141057000,  재궁동,'80,75 - 79세,1998,220,74,146
'4141057000,  재궁동,'85,80 - 84세,1998,101,31,70
'4141057000,  재궁동,'90,85+ ,1998,65,11,54
'4141058000,  오금동,'00,계,1998,29939,14956,14983
'4141058000,  오금동,'05,0 - 4세,1998,3064,1633,1431
'4141058000,  오금동,'10,5 - 9세,1998,2652,1427,1225
'4141058000,  오금동,'15,10 - 14세,1998,2391,1238,1153
'4141058000,  오금동,'20,15 - 19세,1998,2082,1062,1020
'4141058000,  오금동,'25,20 - 24세,1998,1420,651,769
'4141058000,  오금동,'30,25 - 29세,1998,3123,1287,1836
'4141058000,  오금동,'35,30 - 34세,1998,3933,1964,1969
'4141058000,  오금동,'40,35 - 39세,1998,3686,1887,1799
'4141058000,  오금동,'45,40 - 44세,1998,2608,1409,1199
'4141058000,  오금동,'50,45 - 49세,1998,1341,762,579
'4141058000,  오금동,'55,50 - 54세,1998,937,496,441
'4141058000,  오금동,'60,55 - 59세,1998,834,425,409
'4141058000,  오금동,'65,60 - 64세,1998,709,318,391
'4141058000,  오금동,'70,65 - 69세,1998,448,173,275
'4141058000,  오금동,'75,70 - 74세,1998,319,102,217
'4141058000,  오금동,'80,75 - 79세,1998,205,67,138
'4141058000,  오금동,'85,80 - 84세,1998,104,33,71
'4141058000,  오금동,'90,85+ ,1998,83,22,61
'4141059000,  수리동,'00,계,1998,24768,12308,12460
'4141059000,  수리동,'05,0 - 4세,1998,2387,1261,1126
'4141059000,  수리동,'10,5 - 9세,1998,2502,1321,1181
'4141059000,  수리동,'15,10 - 14세,1998,1914,989,925
'4141059000,  수리동,'20,15 - 19세,1998,1631,847,784
'4141059000,  수리동,'25,20 - 24세,1998,1252,596,656
'4141059000,  수리동,'30,25 - 29세,1998,2318,978,1340
'4141059000,  수리동,'35,30 - 34세,1998,3060,1430,1630
'4141059000,  수리동,'40,35 - 39세,1998,3191,1726,1465
'4141059000,  수리동,'45,40 - 44세,1998,2015,1109,906
'4141059000,  수리동,'50,45 - 49세,1998,1052,577,475
'4141059000,  수리동,'55,50 - 54세,1998,807,390,417
'4141059000,  수리동,'60,55 - 59세,1998,785,370,415
'4141059000,  수리동,'65,60 - 64세,1998,651,276,375
'4141059000,  수리동,'70,65 - 69세,1998,486,183,303
'4141059000,  수리동,'75,70 - 74세,1998,357,143,214
'4141059000,  수리동,'80,75 - 79세,1998,205,74,131
'4141059000,  수리동,'85,80 - 84세,1998,94,24,70
'4141059000,  수리동,'90,85+ ,1998,61,14,47
'4141060000,  궁내동,'00,계,1998,25455,12688,12767
'4141060000,  궁내동,'05,0 - 4세,1998,1906,1000,906
'4141060000,  궁내동,'10,5 - 9세,1998,2644,1403,1241
'4141060000,  궁내동,'15,10 - 14세,1998,2408,1212,1196
'4141060000,  궁내동,'20,15 - 19세,1998,1902,991,911
'4141060000,  궁내동,'25,20 - 24세,1998,1280,670,610
'4141060000,  궁내동,'30,25 - 29세,1998,1802,799,1003
'4141060000,  궁내동,'35,30 - 34세,1998,2506,1120,1386
'4141060000,  궁내동,'40,35 - 39세,1998,3358,1590,1768
'4141060000,  궁내동,'45,40 - 44세,1998,2660,1472,1188
'4141060000,  궁내동,'50,45 - 49세,1998,1357,757,600
'4141060000,  궁내동,'55,50 - 54세,1998,914,481,433
'4141060000,  궁내동,'60,55 - 59세,1998,808,396,412
'4141060000,  궁내동,'65,60 - 64세,1998,679,327,352
'4141060000,  궁내동,'70,65 - 69세,1998,473,195,278
'4141060000,  궁내동,'75,70 - 74세,1998,342,141,201
'4141060000,  궁내동,'80,75 - 79세,1998,219,88,131
'4141060000,  궁내동,'85,80 - 84세,1998,135,37,98
'4141060000,  궁내동,'90,85+ ,1998,62,9,53
'4141061000,  대야동,'00,계,1998,5702,2930,2772
'4141061000,  대야동,'05,0 - 4세,1998,494,264,230
'4141061000,  대야동,'10,5 - 9세,1998,489,241,248
'4141061000,  대야동,'15,10 - 14세,1998,322,176,146
'4141061000,  대야동,'20,15 - 19세,1998,422,221,201
'4141061000,  대야동,'25,20 - 24세,1998,431,230,201
'4141061000,  대야동,'30,25 - 29세,1998,522,262,260
'4141061000,  대야동,'35,30 - 34세,1998,665,341,324
'4141061000,  대야동,'40,35 - 39세,1998,596,323,273
'4141061000,  대야동,'45,40 - 44세,1998,428,233,195
'4141061000,  대야동,'50,45 - 49세,1998,289,153,136
'4141061000,  대야동,'55,50 - 54세,1998,253,138,115
'4141061000,  대야동,'60,55 - 59세,1998,262,124,138
'4141061000,  대야동,'65,60 - 64세,1998,159,73,86
'4141061000,  대야동,'70,65 - 69세,1998,149,64,85
'4141061000,  대야동,'75,70 - 74세,1998,97,43,54
'4141061000,  대야동,'80,75 - 79세,1998,79,29,50
'4141061000,  대야동,'85,80 - 84세,1998,28,9,19
'4141061000,  대야동,'90,85+ ,1998,17,6,11
'4141062000,  광정동,'00,계,1998,28930,14127,14803
'4141062000,  광정동,'05,0 - 4세,1998,2702,1383,1319
'4141062000,  광정동,'10,5 - 9세,1998,2541,1324,1217
'4141062000,  광정동,'15,10 - 14세,1998,2313,1218,1095
'4141062000,  광정동,'20,15 - 19세,1998,2151,1114,1037
'4141062000,  광정동,'25,20 - 24세,1998,1554,723,831
'4141062000,  광정동,'30,25 - 29세,1998,2841,1202,1639
'4141062000,  광정동,'35,30 - 34세,1998,3291,1655,1636
'4141062000,  광정동,'40,35 - 39세,1998,3367,1619,1748
'4141062000,  광정동,'45,40 - 44세,1998,2689,1396,1293
'4141062000,  광정동,'50,45 - 49세,1998,1318,728,590
'4141062000,  광정동,'55,50 - 54세,1998,1011,502,509
'4141062000,  광정동,'60,55 - 59세,1998,866,423,443
'4141062000,  광정동,'65,60 - 64세,1998,746,308,438
'4141062000,  광정동,'70,65 - 69세,1998,581,227,354
'4141062000,  광정동,'75,70 - 74세,1998,435,160,275
'4141062000,  광정동,'80,75 - 79세,1998,274,95,179
'4141062000,  광정동,'85,80 - 84세,1998,150,33,117
'4141062000,  광정동,'90,85+ ,1998,100,17,83
'41430, 의왕시,'00,계,1998,115505,58592,56913
'41430, 의왕시,'05,0 - 4세,1998,10049,5286,4763
'41430, 의왕시,'10,5 - 9세,1998,11133,5851,5282
'41430, 의왕시,'15,10 - 14세,1998,8754,4563,4191
'41430, 의왕시,'20,15 - 19세,1998,8734,4590,4144
'41430, 의왕시,'25,20 - 24세,1998,6843,3458,3385
'41430, 의왕시,'30,25 - 29세,1998,10362,4948,5414
'41430, 의왕시,'35,30 - 34세,1998,12978,6357,6621
'41430, 의왕시,'40,35 - 39세,1998,14410,7506,6904
'41430, 의왕시,'45,40 - 44세,1998,10325,5668,4657
'41430, 의왕시,'50,45 - 49세,1998,5571,3112,2459
'41430, 의왕시,'55,50 - 54세,1998,4162,2242,1920
'41430, 의왕시,'60,55 - 59세,1998,3490,1661,1829
'41430, 의왕시,'65,60 - 64세,1998,3022,1316,1706
'41430, 의왕시,'70,65 - 69세,1998,2284,873,1411
'41430, 의왕시,'75,70 - 74세,1998,1548,516,1032
'41430, 의왕시,'80,75 - 79세,1998,1079,402,677
'41430, 의왕시,'85,80 - 84세,1998,474,167,307
'41430, 의왕시,'90,85+ ,1998,287,76,211
'4143051000,  고천동,'00,계,1998,14142,7206,6936
'4143051000,  고천동,'05,0 - 4세,1998,852,449,403
'4143051000,  고천동,'10,5 - 9세,1998,1249,630,619
'4143051000,  고천동,'15,10 - 14세,1998,1159,608,551
'4143051000,  고천동,'20,15 - 19세,1998,1327,687,640
'4143051000,  고천동,'25,20 - 24세,1998,1102,591,511
'4143051000,  고천동,'30,25 - 29세,1998,1064,568,496
'4143051000,  고천동,'35,30 - 34세,1998,1178,556,622
'4143051000,  고천동,'40,35 - 39세,1998,1726,825,901
'4143051000,  고천동,'45,40 - 44세,1998,1360,746,614
'4143051000,  고천동,'50,45 - 49세,1998,895,480,415
'4143051000,  고천동,'55,50 - 54세,1998,683,382,301
'4143051000,  고천동,'60,55 - 59세,1998,485,253,232
'4143051000,  고천동,'65,60 - 64세,1998,367,177,190
'4143051000,  고천동,'70,65 - 69세,1998,271,100,171
'4143051000,  고천동,'75,70 - 74세,1998,188,64,124
'4143051000,  고천동,'80,75 - 79세,1998,144,62,82
'4143051000,  고천동,'85,80 - 84세,1998,57,18,39
'4143051000,  고천동,'90,85+ ,1998,35,10,25
'4143052000,  부곡동,'00,계,1998,25450,12994,12456
'4143052000,  부곡동,'05,0 - 4세,1998,2404,1273,1131
'4143052000,  부곡동,'10,5 - 9세,1998,2461,1268,1193
'4143052000,  부곡동,'15,10 - 14세,1998,1712,886,826
'4143052000,  부곡동,'20,15 - 19세,1998,1669,872,797
'4143052000,  부곡동,'25,20 - 24세,1998,1524,760,764
'4143052000,  부곡동,'30,25 - 29세,1998,2606,1273,1333
'4143052000,  부곡동,'35,30 - 34세,1998,3135,1573,1562
'4143052000,  부곡동,'40,35 - 39세,1998,3118,1725,1393
'4143052000,  부곡동,'45,40 - 44세,1998,1798,1011,787
'4143052000,  부곡동,'50,45 - 49세,1998,1021,556,465
'4143052000,  부곡동,'55,50 - 54세,1998,915,466,449
'4143052000,  부곡동,'60,55 - 59세,1998,888,416,472
'4143052000,  부곡동,'65,60 - 64세,1998,854,391,463
'4143052000,  부곡동,'70,65 - 69세,1998,570,227,343
'4143052000,  부곡동,'75,70 - 74세,1998,376,144,232
'4143052000,  부곡동,'80,75 - 79세,1998,231,94,137
'4143052000,  부곡동,'85,80 - 84세,1998,97,39,58
'4143052000,  부곡동,'90,85+ ,1998,71,20,51
'4143053000,  오전동,'00,계,1998,29454,15043,14411
'4143053000,  오전동,'05,0 - 4세,1998,2442,1279,1163
'4143053000,  오전동,'10,5 - 9세,1998,2705,1433,1272
'4143053000,  오전동,'15,10 - 14세,1998,2315,1171,1144
'4143053000,  오전동,'20,15 - 19세,1998,2501,1323,1178
'4143053000,  오전동,'25,20 - 24세,1998,1922,988,934
'4143053000,  오전동,'30,25 - 29세,1998,2551,1233,1318
'4143053000,  오전동,'35,30 - 34세,1998,3134,1521,1613
'4143053000,  오전동,'40,35 - 39세,1998,3689,1896,1793
'4143053000,  오전동,'45,40 - 44세,1998,2912,1614,1298
'4143053000,  오전동,'50,45 - 49세,1998,1571,896,675
'4143053000,  오전동,'55,50 - 54세,1998,1082,592,490
'4143053000,  오전동,'60,55 - 59세,1998,834,433,401
'4143053000,  오전동,'65,60 - 64세,1998,608,268,340
'4143053000,  오전동,'70,65 - 69세,1998,453,172,281
'4143053000,  오전동,'75,70 - 74세,1998,309,99,210
'4143053000,  오전동,'80,75 - 79세,1998,244,76,168
'4143053000,  오전동,'85,80 - 84세,1998,118,35,83
'4143053000,  오전동,'90,85+ ,1998,64,14,50
'4143054000,  내손1동,'00,계,1998,13792,6879,6913
'4143054000,  내손1동,'05,0 - 4세,1998,1509,814,695
'4143054000,  내손1동,'10,5 - 9세,1998,1518,795,723
'4143054000,  내손1동,'15,10 - 14세,1998,909,505,404
'4143054000,  내손1동,'20,15 - 19세,1998,804,418,386
'4143054000,  내손1동,'25,20 - 24세,1998,604,293,311
'4143054000,  내손1동,'30,25 - 29세,1998,1307,533,774
'4143054000,  내손1동,'35,30 - 34세,1998,1951,946,1005
'4143054000,  내손1동,'40,35 - 39세,1998,1846,995,851
'4143054000,  내손1동,'45,40 - 44세,1998,1116,596,520
'4143054000,  내손1동,'50,45 - 49세,1998,567,322,245
'4143054000,  내손1동,'55,50 - 54세,1998,387,201,186
'4143054000,  내손1동,'60,55 - 59세,1998,318,139,179
'4143054000,  내손1동,'65,60 - 64세,1998,292,109,183
'4143054000,  내손1동,'70,65 - 69세,1998,276,88,188
'4143054000,  내손1동,'75,70 - 74세,1998,179,49,130
'4143054000,  내손1동,'80,75 - 79세,1998,140,55,85
'4143054000,  내손1동,'85,80 - 84세,1998,43,12,31
'4143054000,  내손1동,'90,85+ ,1998,26,9,17
'4143055000,  내손2동,'00,계,1998,26209,13100,13109
'4143055000,  내손2동,'05,0 - 4세,1998,2511,1291,1220
'4143055000,  내손2동,'10,5 - 9세,1998,2684,1430,1254
'4143055000,  내손2동,'15,10 - 14세,1998,2121,1102,1019
'4143055000,  내손2동,'20,15 - 19세,1998,1868,985,883
'4143055000,  내손2동,'25,20 - 24세,1998,1267,608,659
'4143055000,  내손2동,'30,25 - 29세,1998,2359,1066,1293
'4143055000,  내손2동,'35,30 - 34세,1998,3110,1513,1597
'4143055000,  내손2동,'40,35 - 39세,1998,3367,1745,1622
'4143055000,  내손2동,'45,40 - 44세,1998,2437,1320,1117
'4143055000,  내손2동,'50,45 - 49세,1998,1142,643,499
'4143055000,  내손2동,'55,50 - 54세,1998,722,406,316
'4143055000,  내손2동,'60,55 - 59세,1998,677,286,391
'4143055000,  내손2동,'65,60 - 64세,1998,652,235,417
'4143055000,  내손2동,'70,65 - 69세,1998,551,220,331
'4143055000,  내손2동,'75,70 - 74세,1998,352,114,238
'4143055000,  내손2동,'80,75 - 79세,1998,229,80,149
'4143055000,  내손2동,'85,80 - 84세,1998,100,39,61
'4143055000,  내손2동,'90,85+ ,1998,60,17,43
'4143056000,  청계동,'00,계,1998,6458,3370,3088
'4143056000,  청계동,'05,0 - 4세,1998,331,180,151
'4143056000,  청계동,'10,5 - 9세,1998,516,295,221
'4143056000,  청계동,'15,10 - 14세,1998,538,291,247
'4143056000,  청계동,'20,15 - 19세,1998,565,305,260
'4143056000,  청계동,'25,20 - 24세,1998,424,218,206
'4143056000,  청계동,'30,25 - 29세,1998,475,275,200
'4143056000,  청계동,'35,30 - 34세,1998,470,248,222
'4143056000,  청계동,'40,35 - 39세,1998,664,320,344
'4143056000,  청계동,'45,40 - 44세,1998,702,381,321
'4143056000,  청계동,'50,45 - 49세,1998,375,215,160
'4143056000,  청계동,'55,50 - 54세,1998,373,195,178
'4143056000,  청계동,'60,55 - 59세,1998,288,134,154
'4143056000,  청계동,'65,60 - 64세,1998,249,136,113
'4143056000,  청계동,'70,65 - 69세,1998,163,66,97
'4143056000,  청계동,'75,70 - 74세,1998,144,46,98
'4143056000,  청계동,'80,75 - 79세,1998,91,35,56
'4143056000,  청계동,'85,80 - 84세,1998,59,24,35
'4143056000,  청계동,'90,85+ ,1998,31,6,25
'41450, 하남시,'00,계,1998,123836,63420,60416
'41450, 하남시,'05,0 - 4세,1998,9292,4927,4365
'41450, 하남시,'10,5 - 9세,1998,10295,5415,4880
'41450, 하남시,'15,10 - 14세,1998,8374,4337,4037
'41450, 하남시,'20,15 - 19세,1998,10222,5340,4882
'41450, 하남시,'25,20 - 24세,1998,9238,4780,4458
'41450, 하남시,'30,25 - 29세,1998,11557,5888,5669
'41450, 하남시,'35,30 - 34세,1998,12371,6138,6233
'41450, 하남시,'40,35 - 39세,1998,13923,7437,6486
'41450, 하남시,'45,40 - 44세,1998,10684,5858,4826
'41450, 하남시,'50,45 - 49세,1998,6846,3640,3206
'41450, 하남시,'55,50 - 54세,1998,5811,3015,2796
'41450, 하남시,'60,55 - 59세,1998,4988,2567,2421
'41450, 하남시,'65,60 - 64세,1998,3663,1715,1948
'41450, 하남시,'70,65 - 69세,1998,2462,983,1479
'41450, 하남시,'75,70 - 74세,1998,1699,651,1048
'41450, 하남시,'80,75 - 79세,1998,1297,454,843
'41450, 하남시,'85,80 - 84세,1998,681,178,503
'41450, 하남시,'90,85+ ,1998,433,97,336
'4145051000,  천현동,'00,계,1998,8472,4441,4031
'4145051000,  천현동,'05,0 - 4세,1998,655,336,319
'4145051000,  천현동,'10,5 - 9세,1998,534,307,227
'4145051000,  천현동,'15,10 - 14세,1998,431,219,212
'4145051000,  천현동,'20,15 - 19세,1998,669,338,331
'4145051000,  천현동,'25,20 - 24세,1998,656,349,307
'4145051000,  천현동,'30,25 - 29세,1998,898,469,429
'4145051000,  천현동,'35,30 - 34세,1998,846,467,379
'4145051000,  천현동,'40,35 - 39세,1998,822,493,329
'4145051000,  천현동,'45,40 - 44세,1998,665,369,296
'4145051000,  천현동,'50,45 - 49세,1998,473,235,238
'4145051000,  천현동,'55,50 - 54세,1998,443,226,217
'4145051000,  천현동,'60,55 - 59세,1998,434,207,227
'4145051000,  천현동,'65,60 - 64세,1998,346,184,162
'4145051000,  천현동,'70,65 - 69세,1998,220,91,129
'4145051000,  천현동,'75,70 - 74세,1998,148,63,85
'4145051000,  천현동,'80,75 - 79세,1998,128,52,76
'4145051000,  천현동,'85,80 - 84세,1998,75,29,46
'4145051000,  천현동,'90,85+ ,1998,29,7,22
'4145052000,  신장1동,'00,계,1998,6984,3494,3490
'4145052000,  신장1동,'05,0 - 4세,1998,482,214,268
'4145052000,  신장1동,'10,5 - 9세,1998,521,286,235
'4145052000,  신장1동,'15,10 - 14세,1998,494,252,242
'4145052000,  신장1동,'20,15 - 19세,1998,669,339,330
'4145052000,  신장1동,'25,20 - 24세,1998,534,278,256
'4145052000,  신장1동,'30,25 - 29세,1998,694,349,345
'4145052000,  신장1동,'35,30 - 34세,1998,660,335,325
'4145052000,  신장1동,'40,35 - 39세,1998,749,392,357
'4145052000,  신장1동,'45,40 - 44세,1998,633,318,315
'4145052000,  신장1동,'50,45 - 49세,1998,416,208,208
'4145052000,  신장1동,'55,50 - 54세,1998,330,176,154
'4145052000,  신장1동,'60,55 - 59세,1998,273,145,128
'4145052000,  신장1동,'65,60 - 64세,1998,196,97,99
'4145052000,  신장1동,'70,65 - 69세,1998,115,36,79
'4145052000,  신장1동,'75,70 - 74세,1998,95,32,63
'4145052000,  신장1동,'80,75 - 79세,1998,69,25,44
'4145052000,  신장1동,'85,80 - 84세,1998,33,7,26
'4145052000,  신장1동,'90,85+ ,1998,21,5,16
'4145053000,  신장2동,'00,계,1998,38468,19390,19078
'4145053000,  신장2동,'05,0 - 4세,1998,2920,1553,1367
'4145053000,  신장2동,'10,5 - 9세,1998,3815,2013,1802
'4145053000,  신장2동,'15,10 - 14세,1998,2895,1487,1408
'4145053000,  신장2동,'20,15 - 19세,1998,3015,1524,1491
'4145053000,  신장2동,'25,20 - 24세,1998,2620,1335,1285
'4145053000,  신장2동,'30,25 - 29세,1998,3141,1497,1644
'4145053000,  신장2동,'35,30 - 34세,1998,3866,1721,2145
'4145053000,  신장2동,'40,35 - 39세,1998,4947,2546,2401
'4145053000,  신장2동,'45,40 - 44세,1998,3539,1987,1552
'4145053000,  신장2동,'50,45 - 49세,1998,2108,1136,972
'4145053000,  신장2동,'55,50 - 54세,1998,1687,903,784
'4145053000,  신장2동,'60,55 - 59세,1998,1318,695,623
'4145053000,  신장2동,'65,60 - 64세,1998,900,394,506
'4145053000,  신장2동,'70,65 - 69세,1998,636,252,384
'4145053000,  신장2동,'75,70 - 74세,1998,453,172,281
'4145053000,  신장2동,'80,75 - 79세,1998,338,112,226
'4145053000,  신장2동,'85,80 - 84세,1998,180,39,141
'4145053000,  신장2동,'90,85+ ,1998,90,24,66
'4145054000,  덕풍1동,'00,계,1998,15088,7683,7405
'4145054000,  덕풍1동,'05,0 - 4세,1998,1364,735,629
'4145054000,  덕풍1동,'10,5 - 9세,1998,1431,720,711
'4145054000,  덕풍1동,'15,10 - 14세,1998,1044,546,498
'4145054000,  덕풍1동,'20,15 - 19세,1998,1231,649,582
'4145054000,  덕풍1동,'25,20 - 24세,1998,1030,523,507
'4145054000,  덕풍1동,'30,25 - 29세,1998,1459,707,752
'4145054000,  덕풍1동,'35,30 - 34세,1998,1721,833,888
'4145054000,  덕풍1동,'40,35 - 39세,1998,1743,926,817
'4145054000,  덕풍1동,'45,40 - 44세,1998,1261,694,567
'4145054000,  덕풍1동,'50,45 - 49세,1998,751,408,343
'4145054000,  덕풍1동,'55,50 - 54세,1998,597,303,294
'4145054000,  덕풍1동,'60,55 - 59세,1998,490,257,233
'4145054000,  덕풍1동,'65,60 - 64세,1998,349,155,194
'4145054000,  덕풍1동,'70,65 - 69세,1998,256,100,156
'4145054000,  덕풍1동,'75,70 - 74세,1998,143,50,93
'4145054000,  덕풍1동,'80,75 - 79세,1998,130,48,82
'4145054000,  덕풍1동,'85,80 - 84세,1998,60,18,42
'4145054000,  덕풍1동,'90,85+ ,1998,28,11,17
'4145055000,  덕풍2동,'00,계,1998,19883,10121,9762
'4145055000,  덕풍2동,'05,0 - 4세,1998,1710,936,774
'4145055000,  덕풍2동,'10,5 - 9세,1998,1719,893,826
'4145055000,  덕풍2동,'15,10 - 14세,1998,1338,693,645
'4145055000,  덕풍2동,'20,15 - 19세,1998,1519,801,718
'4145055000,  덕풍2동,'25,20 - 24세,1998,1455,712,743
'4145055000,  덕풍2동,'30,25 - 29세,1998,2074,1010,1064
'4145055000,  덕풍2동,'35,30 - 34세,1998,2217,1115,1102
'4145055000,  덕풍2동,'40,35 - 39세,1998,2300,1230,1070
'4145055000,  덕풍2동,'45,40 - 44세,1998,1596,907,689
'4145055000,  덕풍2동,'50,45 - 49세,1998,998,521,477
'4145055000,  덕풍2동,'55,50 - 54세,1998,816,403,413
'4145055000,  덕풍2동,'60,55 - 59세,1998,703,358,345
'4145055000,  덕풍2동,'65,60 - 64세,1998,527,221,306
'4145055000,  덕풍2동,'70,65 - 69세,1998,367,129,238
'4145055000,  덕풍2동,'75,70 - 74세,1998,239,92,147
'4145055000,  덕풍2동,'80,75 - 79세,1998,174,65,109
'4145055000,  덕풍2동,'85,80 - 84세,1998,80,25,55
'4145055000,  덕풍2동,'90,85+ ,1998,51,10,41
'4145056000,  덕풍3동,'00,계,1998,10550,5388,5162
'4145056000,  덕풍3동,'05,0 - 4세,1998,835,462,373
'4145056000,  덕풍3동,'10,5 - 9세,1998,882,444,438
'4145056000,  덕풍3동,'15,10 - 14세,1998,739,384,355
'4145056000,  덕풍3동,'20,15 - 19세,1998,908,463,445
'4145056000,  덕풍3동,'25,20 - 24세,1998,784,394,390
'4145056000,  덕풍3동,'30,25 - 29세,1998,1004,510,494
'4145056000,  덕풍3동,'35,30 - 34세,1998,1154,604,550
'4145056000,  덕풍3동,'40,35 - 39세,1998,1138,619,519
'4145056000,  덕풍3동,'45,40 - 44세,1998,930,486,444
'4145056000,  덕풍3동,'50,45 - 49세,1998,562,294,268
'4145056000,  덕풍3동,'55,50 - 54세,1998,452,242,210
'4145056000,  덕풍3동,'60,55 - 59세,1998,348,169,179
'4145056000,  덕풍3동,'65,60 - 64세,1998,298,135,163
'4145056000,  덕풍3동,'70,65 - 69세,1998,212,83,129
'4145056000,  덕풍3동,'75,70 - 74세,1998,140,48,92
'4145056000,  덕풍3동,'80,75 - 79세,1998,90,34,56
'4145056000,  덕풍3동,'85,80 - 84세,1998,40,10,30
'4145056000,  덕풍3동,'90,85+ ,1998,34,7,27
'4145057000,  풍산동,'00,계,1998,8405,4473,3932
'4145057000,  풍산동,'05,0 - 4세,1998,409,215,194
'4145057000,  풍산동,'10,5 - 9세,1998,499,272,227
'4145057000,  풍산동,'15,10 - 14세,1998,447,235,212
'4145057000,  풍산동,'20,15 - 19세,1998,761,424,337
'4145057000,  풍산동,'25,20 - 24세,1998,737,422,315
'4145057000,  풍산동,'30,25 - 29세,1998,771,462,309
'4145057000,  풍산동,'35,30 - 34세,1998,644,357,287
'4145057000,  풍산동,'40,35 - 39세,1998,788,448,340
'4145057000,  풍산동,'45,40 - 44세,1998,669,381,288
'4145057000,  풍산동,'50,45 - 49세,1998,522,288,234
'4145057000,  풍산동,'55,50 - 54세,1998,533,264,269
'4145057000,  풍산동,'60,55 - 59세,1998,513,256,257
'4145057000,  풍산동,'65,60 - 64세,1998,380,205,175
'4145057000,  풍산동,'70,65 - 69세,1998,240,103,137
'4145057000,  풍산동,'75,70 - 74세,1998,171,62,109
'4145057000,  풍산동,'80,75 - 79세,1998,144,46,98
'4145057000,  풍산동,'85,80 - 84세,1998,87,19,68
'4145057000,  풍산동,'90,85+ ,1998,90,14,76
'4145058000,  감북동,'00,계,1998,6854,3624,3230
'4145058000,  감북동,'05,0 - 4세,1998,372,192,180
'4145058000,  감북동,'10,5 - 9세,1998,339,188,151
'4145058000,  감북동,'15,10 - 14세,1998,446,240,206
'4145058000,  감북동,'20,15 - 19세,1998,652,372,280
'4145058000,  감북동,'25,20 - 24세,1998,637,347,290
'4145058000,  감북동,'30,25 - 29세,1998,608,359,249
'4145058000,  감북동,'35,30 - 34세,1998,523,291,232
'4145058000,  감북동,'40,35 - 39세,1998,630,340,290
'4145058000,  감북동,'45,40 - 44세,1998,637,324,313
'4145058000,  감북동,'50,45 - 49세,1998,451,234,217
'4145058000,  감북동,'55,50 - 54세,1998,393,208,185
'4145058000,  감북동,'60,55 - 59세,1998,397,212,185
'4145058000,  감북동,'65,60 - 64세,1998,274,136,138
'4145058000,  감북동,'70,65 - 69세,1998,178,71,107
'4145058000,  감북동,'75,70 - 74세,1998,135,56,79
'4145058000,  감북동,'80,75 - 79세,1998,96,35,61
'4145058000,  감북동,'85,80 - 84세,1998,45,12,33
'4145058000,  감북동,'90,85+ ,1998,41,7,34
'4145059000,  춘궁동,'00,계,1998,4025,2119,1906
'4145059000,  춘궁동,'05,0 - 4세,1998,257,136,121
'4145059000,  춘궁동,'10,5 - 9세,1998,215,102,113
'4145059000,  춘궁동,'15,10 - 14세,1998,222,120,102
'4145059000,  춘궁동,'20,15 - 19세,1998,324,169,155
'4145059000,  춘궁동,'25,20 - 24세,1998,312,177,135
'4145059000,  춘궁동,'30,25 - 29세,1998,381,211,170
'4145059000,  춘궁동,'35,30 - 34세,1998,335,196,139
'4145059000,  춘궁동,'40,35 - 39세,1998,361,206,155
'4145059000,  춘궁동,'45,40 - 44세,1998,337,185,152
'4145059000,  춘궁동,'50,45 - 49세,1998,231,137,94
'4145059000,  춘궁동,'55,50 - 54세,1998,241,116,125
'4145059000,  춘궁동,'60,55 - 59세,1998,245,127,118
'4145059000,  춘궁동,'65,60 - 64세,1998,206,99,107
'4145059000,  춘궁동,'70,65 - 69세,1998,126,63,63
'4145059000,  춘궁동,'75,70 - 74세,1998,89,41,48
'4145059000,  춘궁동,'80,75 - 79세,1998,70,20,50
'4145059000,  춘궁동,'85,80 - 84세,1998,43,8,35
'4145059000,  춘궁동,'90,85+ ,1998,30,6,24
'4145060000,  초이동,'00,계,1998,5107,2687,2420
'4145060000,  초이동,'05,0 - 4세,1998,288,148,140
'4145060000,  초이동,'10,5 - 9세,1998,340,190,150
'4145060000,  초이동,'15,10 - 14세,1998,318,161,157
'4145060000,  초이동,'20,15 - 19세,1998,474,261,213
'4145060000,  초이동,'25,20 - 24세,1998,473,243,230
'4145060000,  초이동,'30,25 - 29세,1998,527,314,213
'4145060000,  초이동,'35,30 - 34세,1998,405,219,186
'4145060000,  초이동,'40,35 - 39세,1998,445,237,208
'4145060000,  초이동,'45,40 - 44세,1998,417,207,210
'4145060000,  초이동,'50,45 - 49세,1998,334,179,155
'4145060000,  초이동,'55,50 - 54세,1998,319,174,145
'4145060000,  초이동,'60,55 - 59세,1998,267,141,126
'4145060000,  초이동,'65,60 - 64세,1998,187,89,98
'4145060000,  초이동,'70,65 - 69세,1998,112,55,57
'4145060000,  초이동,'75,70 - 74세,1998,86,35,51
'4145060000,  초이동,'80,75 - 79세,1998,58,17,41
'4145060000,  초이동,'85,80 - 84세,1998,38,11,27
'4145060000,  초이동,'90,85+ ,1998,19,6,13
'41460, 용인시,'00,계,1998,318393,162291,156102
'41460, 용인시,'05,0 - 4세,1998,31804,16466,15338
'41460, 용인시,'10,5 - 9세,1998,29745,15404,14341
'41460, 용인시,'15,10 - 14세,1998,20265,10493,9772
'41460, 용인시,'20,15 - 19세,1998,20852,10758,10094
'41460, 용인시,'25,20 - 24세,1998,21925,11450,10475
'41460, 용인시,'30,25 - 29세,1998,33319,16426,16893
'41460, 용인시,'35,30 - 34세,1998,39454,19610,19844
'41460, 용인시,'40,35 - 39세,1998,35928,20174,15754
'41460, 용인시,'45,40 - 44세,1998,22427,12434,9993
'41460, 용인시,'50,45 - 49세,1998,13779,7133,6646
'41460, 용인시,'55,50 - 54세,1998,11963,6108,5855
'41460, 용인시,'60,55 - 59세,1998,11113,5408,5705
'41460, 용인시,'65,60 - 64세,1998,9288,4295,4993
'41460, 용인시,'70,65 - 69세,1998,6384,2593,3791
'41460, 용인시,'75,70 - 74세,1998,4383,1613,2770
'41460, 용인시,'80,75 - 79세,1998,3124,1123,2001
'41460, 용인시,'85,80 - 84세,1998,1687,559,1128
'41460, 용인시,'90,85+ ,1998,953,244,709
'4146025000,  기흥읍,'00,계,1998,57677,29524,28153
'4146025000,  기흥읍,'05,0 - 4세,1998,6115,3159,2956
'4146025000,  기흥읍,'10,5 - 9세,1998,5325,2669,2656
'4146025000,  기흥읍,'15,10 - 14세,1998,3665,1888,1777
'4146025000,  기흥읍,'20,15 - 19세,1998,3713,1890,1823
'4146025000,  기흥읍,'25,20 - 24세,1998,4228,2096,2132
'4146025000,  기흥읍,'30,25 - 29세,1998,7272,3795,3477
'4146025000,  기흥읍,'35,30 - 34세,1998,7522,3812,3710
'4146025000,  기흥읍,'40,35 - 39세,1998,6515,3648,2867
'4146025000,  기흥읍,'45,40 - 44세,1998,3987,2220,1767
'4146025000,  기흥읍,'50,45 - 49세,1998,2295,1200,1095
'4146025000,  기흥읍,'55,50 - 54세,1998,1894,987,907
'4146025000,  기흥읍,'60,55 - 59세,1998,1609,786,823
'4146025000,  기흥읍,'65,60 - 64세,1998,1279,578,701
'4146025000,  기흥읍,'70,65 - 69세,1998,876,344,532
'4146025000,  기흥읍,'75,70 - 74세,1998,598,203,395
'4146025000,  기흥읍,'80,75 - 79세,1998,420,141,279
'4146025000,  기흥읍,'85,80 - 84세,1998,240,79,161
'4146025000,  기흥읍,'90,85+ ,1998,124,29,95
'4146025300,  수지읍,'00,계,1998,79332,40088,39244
'4146025300,  수지읍,'05,0 - 4세,1998,9326,4850,4476
'4146025300,  수지읍,'10,5 - 9세,1998,9021,4743,4278
'4146025300,  수지읍,'15,10 - 14세,1998,4729,2438,2291
'4146025300,  수지읍,'20,15 - 19세,1998,3879,2081,1798
'4146025300,  수지읍,'25,20 - 24세,1998,4000,2149,1851
'4146025300,  수지읍,'30,25 - 29세,1998,7266,3159,4107
'4146025300,  수지읍,'35,30 - 34세,1998,11763,5372,6391
'4146025300,  수지읍,'40,35 - 39세,1998,10452,6053,4399
'4146025300,  수지읍,'45,40 - 44세,1998,5400,3061,2339
'4146025300,  수지읍,'50,45 - 49세,1998,3067,1528,1539
'4146025300,  수지읍,'55,50 - 54세,1998,2844,1396,1448
'4146025300,  수지읍,'60,55 - 59세,1998,2515,1249,1266
'4146025300,  수지읍,'65,60 - 64세,1998,1920,868,1052
'4146025300,  수지읍,'70,65 - 69세,1998,1254,525,729
'4146025300,  수지읍,'75,70 - 74세,1998,837,286,551
'4146025300,  수지읍,'80,75 - 79세,1998,553,204,349
'4146025300,  수지읍,'85,80 - 84세,1998,319,84,235
'4146025300,  수지읍,'90,85+ ,1998,187,42,145
'4146031000,  포곡면,'00,계,1998,22357,11431,10926
'4146031000,  포곡면,'05,0 - 4세,1998,2352,1233,1119
'4146031000,  포곡면,'10,5 - 9세,1998,1862,981,881
'4146031000,  포곡면,'15,10 - 14세,1998,1429,704,725
'4146031000,  포곡면,'20,15 - 19세,1998,1477,733,744
'4146031000,  포곡면,'25,20 - 24세,1998,1683,846,837
'4146031000,  포곡면,'30,25 - 29세,1998,2705,1361,1344
'4146031000,  포곡면,'35,30 - 34세,1998,2793,1518,1275
'4146031000,  포곡면,'40,35 - 39세,1998,2260,1280,980
'4146031000,  포곡면,'45,40 - 44세,1998,1432,793,639
'4146031000,  포곡면,'50,45 - 49세,1998,931,457,474
'4146031000,  포곡면,'55,50 - 54세,1998,827,416,411
'4146031000,  포곡면,'60,55 - 59세,1998,801,383,418
'4146031000,  포곡면,'65,60 - 64세,1998,664,313,351
'4146031000,  포곡면,'70,65 - 69세,1998,455,173,282
'4146031000,  포곡면,'75,70 - 74세,1998,285,102,183
'4146031000,  포곡면,'80,75 - 79세,1998,224,83,141
'4146031000,  포곡면,'85,80 - 84세,1998,120,37,83
'4146031000,  포곡면,'90,85+ ,1998,57,18,39
'4146032000,  모현면,'00,계,1998,17095,8818,8277
'4146032000,  모현면,'05,0 - 4세,1998,1443,735,708
'4146032000,  모현면,'10,5 - 9세,1998,1468,751,717
'4146032000,  모현면,'15,10 - 14세,1998,1077,568,509
'4146032000,  모현면,'20,15 - 19세,1998,1290,668,622
'4146032000,  모현면,'25,20 - 24세,1998,1258,678,580
'4146032000,  모현면,'30,25 - 29세,1998,1653,843,810
'4146032000,  모현면,'35,30 - 34세,1998,1838,950,888
'4146032000,  모현면,'40,35 - 39세,1998,1772,1010,762
'4146032000,  모현면,'45,40 - 44세,1998,1301,696,605
'4146032000,  모현면,'50,45 - 49세,1998,880,483,397
'4146032000,  모현면,'55,50 - 54세,1998,751,393,358
'4146032000,  모현면,'60,55 - 59세,1998,727,342,385
'4146032000,  모현면,'65,60 - 64세,1998,590,301,289
'4146032000,  모현면,'70,65 - 69세,1998,412,167,245
'4146032000,  모현면,'75,70 - 74세,1998,276,109,167
'4146032000,  모현면,'80,75 - 79세,1998,199,77,122
'4146032000,  모현면,'85,80 - 84세,1998,104,39,65
'4146032000,  모현면,'90,85+ ,1998,56,8,48
'4146033000,  구성면,'00,계,1998,23023,12055,10968
'4146033000,  구성면,'05,0 - 4세,1998,2521,1304,1217
'4146033000,  구성면,'10,5 - 9세,1998,2082,1104,978
'4146033000,  구성면,'15,10 - 14세,1998,1252,669,583
'4146033000,  구성면,'20,15 - 19세,1998,1410,760,650
'4146033000,  구성면,'25,20 - 24세,1998,1728,1044,684
'4146033000,  구성면,'30,25 - 29세,1998,2496,1222,1274
'4146033000,  구성면,'35,30 - 34세,1998,3092,1588,1504
'4146033000,  구성면,'40,35 - 39세,1998,2587,1502,1085
'4146033000,  구성면,'45,40 - 44세,1998,1482,807,675
'4146033000,  구성면,'50,45 - 49세,1998,929,507,422
'4146033000,  구성면,'55,50 - 54세,1998,841,432,409
'4146033000,  구성면,'60,55 - 59세,1998,799,393,406
'4146033000,  구성면,'65,60 - 64세,1998,658,302,356
'4146033000,  구성면,'70,65 - 69세,1998,418,167,251
'4146033000,  구성면,'75,70 - 74세,1998,311,117,194
'4146033000,  구성면,'80,75 - 79세,1998,226,71,155
'4146033000,  구성면,'85,80 - 84세,1998,123,46,77
'4146033000,  구성면,'90,85+ ,1998,68,20,48
'4146034000,  남사면,'00,계,1998,7544,3872,3672
'4146034000,  남사면,'05,0 - 4세,1998,430,205,225
'4146034000,  남사면,'10,5 - 9세,1998,503,246,257
'4146034000,  남사면,'15,10 - 14세,1998,446,223,223
'4146034000,  남사면,'20,15 - 19세,1998,583,306,277
'4146034000,  남사면,'25,20 - 24세,1998,657,369,288
'4146034000,  남사면,'30,25 - 29세,1998,641,383,258
'4146034000,  남사면,'35,30 - 34세,1998,603,323,280
'4146034000,  남사면,'40,35 - 39세,1998,580,334,246
'4146034000,  남사면,'45,40 - 44세,1998,490,276,214
'4146034000,  남사면,'50,45 - 49세,1998,400,192,208
'4146034000,  남사면,'55,50 - 54세,1998,408,206,202
'4146034000,  남사면,'60,55 - 59세,1998,453,215,238
'4146034000,  남사면,'65,60 - 64세,1998,491,229,262
'4146034000,  남사면,'70,65 - 69세,1998,330,144,186
'4146034000,  남사면,'75,70 - 74세,1998,229,103,126
'4146034000,  남사면,'80,75 - 79세,1998,160,70,90
'4146034000,  남사면,'85,80 - 84세,1998,85,32,53
'4146034000,  남사면,'90,85+ ,1998,55,16,39
'4146035000,  이동면,'00,계,1998,13260,6734,6526
'4146035000,  이동면,'05,0 - 4세,1998,1128,597,531
'4146035000,  이동면,'10,5 - 9세,1998,1061,533,528
'4146035000,  이동면,'15,10 - 14세,1998,806,429,377
'4146035000,  이동면,'20,15 - 19세,1998,902,464,438
'4146035000,  이동면,'25,20 - 24세,1998,992,512,480
'4146035000,  이동면,'30,25 - 29세,1998,1313,671,642
'4146035000,  이동면,'35,30 - 34세,1998,1418,742,676
'4146035000,  이동면,'40,35 - 39세,1998,1317,778,539
'4146035000,  이동면,'45,40 - 44세,1998,882,473,409
'4146035000,  이동면,'50,45 - 49세,1998,642,309,333
'4146035000,  이동면,'55,50 - 54세,1998,602,312,290
'4146035000,  이동면,'60,55 - 59세,1998,592,271,321
'4146035000,  이동면,'65,60 - 64세,1998,553,244,309
'4146035000,  이동면,'70,65 - 69세,1998,366,149,217
'4146035000,  이동면,'75,70 - 74세,1998,314,123,191
'4146035000,  이동면,'80,75 - 79세,1998,200,70,130
'4146035000,  이동면,'85,80 - 84세,1998,112,42,70
'4146035000,  이동면,'90,85+ ,1998,60,15,45
'4146036000,  원삼면,'00,계,1998,7497,3854,3643
'4146036000,  원삼면,'05,0 - 4세,1998,434,242,192
'4146036000,  원삼면,'10,5 - 9세,1998,474,243,231
'4146036000,  원삼면,'15,10 - 14세,1998,455,226,229
'4146036000,  원삼면,'20,15 - 19세,1998,559,289,270
'4146036000,  원삼면,'25,20 - 24세,1998,627,342,285
'4146036000,  원삼면,'30,25 - 29세,1998,589,344,245
'4146036000,  원삼면,'35,30 - 34세,1998,570,319,251
'4146036000,  원삼면,'40,35 - 39세,1998,623,359,264
'4146036000,  원삼면,'45,40 - 44세,1998,532,291,241
'4146036000,  원삼면,'50,45 - 49세,1998,422,224,198
'4146036000,  원삼면,'55,50 - 54세,1998,403,205,198
'4146036000,  원삼면,'60,55 - 59세,1998,442,201,241
'4146036000,  원삼면,'65,60 - 64세,1998,443,209,234
'4146036000,  원삼면,'70,65 - 69세,1998,383,151,232
'4146036000,  원삼면,'75,70 - 74세,1998,220,95,125
'4146036000,  원삼면,'80,75 - 79세,1998,180,62,118
'4146036000,  원삼면,'85,80 - 84세,1998,88,39,49
'4146036000,  원삼면,'90,85+ ,1998,53,13,40
'4146037000,  백암면,'00,계,1998,10456,5255,5201
'4146037000,  백암면,'05,0 - 4세,1998,624,314,310
'4146037000,  백암면,'10,5 - 9세,1998,693,339,354
'4146037000,  백암면,'15,10 - 14세,1998,660,326,334
'4146037000,  백암면,'20,15 - 19세,1998,879,443,436
'4146037000,  백암면,'25,20 - 24세,1998,847,460,387
'4146037000,  백암면,'30,25 - 29세,1998,796,463,333
'4146037000,  백암면,'35,30 - 34세,1998,756,403,353
'4146037000,  백암면,'40,35 - 39세,1998,950,502,448
'4146037000,  백암면,'45,40 - 44세,1998,753,423,330
'4146037000,  백암면,'50,45 - 49세,1998,570,304,266
'4146037000,  백암면,'55,50 - 54세,1998,507,253,254
'4146037000,  백암면,'60,55 - 59세,1998,601,276,325
'4146037000,  백암면,'65,60 - 64세,1998,634,301,333
'4146037000,  백암면,'70,65 - 69세,1998,428,185,243
'4146037000,  백암면,'75,70 - 74세,1998,315,120,195
'4146037000,  백암면,'80,75 - 79세,1998,231,80,151
'4146037000,  백암면,'85,80 - 84세,1998,141,38,103
'4146037000,  백암면,'90,85+ ,1998,71,25,46
'4146038000,  양지면,'00,계,1998,12235,6248,5987
'4146038000,  양지면,'05,0 - 4세,1998,855,425,430
'4146038000,  양지면,'10,5 - 9세,1998,1003,515,488
'4146038000,  양지면,'15,10 - 14세,1998,959,512,447
'4146038000,  양지면,'20,15 - 19세,1998,992,515,477
'4146038000,  양지면,'25,20 - 24세,1998,880,468,412
'4146038000,  양지면,'30,25 - 29세,1998,1114,579,535
'4146038000,  양지면,'35,30 - 34세,1998,1153,570,583
'4146038000,  양지면,'40,35 - 39세,1998,1280,674,606
'4146038000,  양지면,'45,40 - 44세,1998,983,560,423
'4146038000,  양지면,'50,45 - 49세,1998,642,349,293
'4146038000,  양지면,'55,50 - 54세,1998,497,264,233
'4146038000,  양지면,'60,55 - 59세,1998,487,244,243
'4146038000,  양지면,'65,60 - 64세,1998,472,212,260
'4146038000,  양지면,'70,65 - 69세,1998,351,147,204
'4146038000,  양지면,'75,70 - 74세,1998,241,104,137
'4146038000,  양지면,'80,75 - 79세,1998,172,63,109
'4146038000,  양지면,'85,80 - 84세,1998,88,28,60
'4146038000,  양지면,'90,85+ ,1998,66,19,47
'4146051000,  중앙동,'00,계,1998,21567,10857,10710
'4146051000,  중앙동,'05,0 - 4세,1998,1841,944,897
'4146051000,  중앙동,'10,5 - 9세,1998,1870,996,874
'4146051000,  중앙동,'15,10 - 14세,1998,1564,838,726
'4146051000,  중앙동,'20,15 - 19세,1998,1768,887,881
'4146051000,  중앙동,'25,20 - 24세,1998,1726,862,864
'4146051000,  중앙동,'30,25 - 29세,1998,2245,1119,1126
'4146051000,  중앙동,'35,30 - 34세,1998,2333,1147,1186
'4146051000,  중앙동,'40,35 - 39세,1998,2360,1203,1157
'4146051000,  중앙동,'45,40 - 44세,1998,1797,972,825
'4146051000,  중앙동,'50,45 - 49세,1998,1052,535,517
'4146051000,  중앙동,'55,50 - 54세,1998,845,438,407
'4146051000,  중앙동,'60,55 - 59세,1998,687,343,344
'4146051000,  중앙동,'65,60 - 64세,1998,532,248,284
'4146051000,  중앙동,'70,65 - 69세,1998,377,150,227
'4146051000,  중앙동,'75,70 - 74세,1998,243,73,170
'4146051000,  중앙동,'80,75 - 79세,1998,183,63,120
'4146051000,  중앙동,'85,80 - 84세,1998,91,27,64
'4146051000,  중앙동,'90,85+ ,1998,53,12,41
'4146052000,  역삼동,'00,계,1998,17360,8801,8559
'4146052000,  역삼동,'05,0 - 4세,1998,1545,800,745
'4146052000,  역삼동,'10,5 - 9세,1998,1663,868,795
'4146052000,  역삼동,'15,10 - 14세,1998,1331,717,614
'4146052000,  역삼동,'20,15 - 19세,1998,1385,709,676
'4146052000,  역삼동,'25,20 - 24세,1998,1322,655,667
'4146052000,  역삼동,'30,25 - 29세,1998,1916,952,964
'4146052000,  역삼동,'35,30 - 34세,1998,1906,932,974
'4146052000,  역삼동,'40,35 - 39세,1998,1974,1002,972
'4146052000,  역삼동,'45,40 - 44세,1998,1404,755,649
'4146052000,  역삼동,'50,45 - 49세,1998,793,421,372
'4146052000,  역삼동,'55,50 - 54세,1998,594,317,277
'4146052000,  역삼동,'60,55 - 59세,1998,514,261,253
'4146052000,  역삼동,'65,60 - 64세,1998,368,182,186
'4146052000,  역삼동,'70,65 - 69세,1998,254,102,152
'4146052000,  역삼동,'75,70 - 74세,1998,166,56,110
'4146052000,  역삼동,'80,75 - 79세,1998,117,37,80
'4146052000,  역삼동,'85,80 - 84세,1998,77,29,48
'4146052000,  역삼동,'90,85+ ,1998,31,6,25
'4146053000,  유림동,'00,계,1998,18042,9214,8828
'4146053000,  유림동,'05,0 - 4세,1998,2295,1181,1114
'4146053000,  유림동,'10,5 - 9세,1998,1744,918,826
'4146053000,  유림동,'15,10 - 14세,1998,1106,561,545
'4146053000,  유림동,'20,15 - 19세,1998,1129,552,577
'4146053000,  유림동,'25,20 - 24세,1998,1125,547,578
'4146053000,  유림동,'30,25 - 29세,1998,2258,1020,1238
'4146053000,  유림동,'35,30 - 34세,1998,2578,1355,1223
'4146053000,  유림동,'40,35 - 39세,1998,2008,1174,834
'4146053000,  유림동,'45,40 - 44세,1998,1103,622,481
'4146053000,  유림동,'50,45 - 49세,1998,648,351,297
'4146053000,  유림동,'55,50 - 54세,1998,497,254,243
'4146053000,  유림동,'60,55 - 59세,1998,491,238,253
'4146053000,  유림동,'65,60 - 64세,1998,402,186,216
'4146053000,  유림동,'70,65 - 69세,1998,256,99,157
'4146053000,  유림동,'75,70 - 74세,1998,167,62,105
'4146053000,  유림동,'80,75 - 79세,1998,153,61,92
'4146053000,  유림동,'85,80 - 84세,1998,45,21,24
'4146053000,  유림동,'90,85+ ,1998,37,12,25
'4146054000,  동부동,'00,계,1998,10948,5540,5408
'4146054000,  동부동,'05,0 - 4세,1998,895,477,418
'4146054000,  동부동,'10,5 - 9세,1998,976,498,478
'4146054000,  동부동,'15,10 - 14세,1998,786,394,392
'4146054000,  동부동,'20,15 - 19세,1998,886,461,425
'4146054000,  동부동,'25,20 - 24세,1998,852,422,430
'4146054000,  동부동,'30,25 - 29세,1998,1055,515,540
'4146054000,  동부동,'35,30 - 34세,1998,1129,579,550
'4146054000,  동부동,'40,35 - 39세,1998,1250,655,595
'4146054000,  동부동,'45,40 - 44세,1998,881,485,396
'4146054000,  동부동,'50,45 - 49세,1998,508,273,235
'4146054000,  동부동,'55,50 - 54세,1998,453,235,218
'4146054000,  동부동,'60,55 - 59세,1998,395,206,189
'4146054000,  동부동,'65,60 - 64세,1998,282,122,160
'4146054000,  동부동,'70,65 - 69세,1998,224,90,134
'4146054000,  동부동,'75,70 - 74세,1998,181,60,121
'4146054000,  동부동,'80,75 - 79세,1998,106,41,65
'4146054000,  동부동,'85,80 - 84세,1998,54,18,36
'4146054000,  동부동,'90,85+ ,1998,35,9,26
'41480, 파주시,'00,계,1998,178803,91203,87600
'41480, 파주시,'05,0 - 4세,1998,13174,6972,6202
'41480, 파주시,'10,5 - 9세,1998,13142,6837,6305
'41480, 파주시,'15,10 - 14세,1998,10826,5602,5224
'41480, 파주시,'20,15 - 19세,1998,13234,6787,6447
'41480, 파주시,'25,20 - 24세,1998,13541,6977,6564
'41480, 파주시,'30,25 - 29세,1998,16997,9131,7866
'41480, 파주시,'35,30 - 34세,1998,17023,8926,8097
'41480, 파주시,'40,35 - 39세,1998,17097,9455,7642
'41480, 파주시,'45,40 - 44세,1998,13471,7336,6135
'41480, 파주시,'50,45 - 49세,1998,8597,4467,4130
'41480, 파주시,'55,50 - 54세,1998,8488,4272,4216
'41480, 파주시,'60,55 - 59세,1998,9420,4310,5110
'41480, 파주시,'65,60 - 64세,1998,8491,3941,4550
'41480, 파주시,'70,65 - 69세,1998,6012,2631,3381
'41480, 파주시,'75,70 - 74세,1998,3962,1490,2472
'41480, 파주시,'80,75 - 79세,1998,2914,1245,1669
'41480, 파주시,'85,80 - 84세,1998,1547,573,974
'41480, 파주시,'90,85+ ,1998,867,251,616
'4148025000,  문산읍,'00,계,1998,28990,14488,14502
'4148025000,  문산읍,'05,0 - 4세,1998,1935,1002,933
'4148025000,  문산읍,'10,5 - 9세,1998,2131,1140,991
'4148025000,  문산읍,'15,10 - 14세,1998,2002,939,1063
'4148025000,  문산읍,'20,15 - 19세,1998,2272,1143,1129
'4148025000,  문산읍,'25,20 - 24세,1998,2171,1135,1036
'4148025000,  문산읍,'30,25 - 29세,1998,2722,1474,1248
'4148025000,  문산읍,'35,30 - 34세,1998,2579,1305,1274
'4148025000,  문산읍,'40,35 - 39세,1998,2728,1424,1304
'4148025000,  문산읍,'45,40 - 44세,1998,2174,1145,1029
'4148025000,  문산읍,'50,45 - 49세,1998,1383,678,705
'4148025000,  문산읍,'55,50 - 54세,1998,1422,717,705
'4148025000,  문산읍,'60,55 - 59세,1998,1690,717,973
'4148025000,  문산읍,'65,60 - 64세,1998,1434,691,743
'4148025000,  문산읍,'70,65 - 69세,1998,947,428,519
'4148025000,  문산읍,'75,70 - 74세,1998,626,244,382
'4148025000,  문산읍,'80,75 - 79세,1998,452,192,260
'4148025000,  문산읍,'85,80 - 84세,1998,212,78,134
'4148025000,  문산읍,'90,85+ ,1998,110,36,74
'4148025300,  파주읍,'00,계,1998,16167,8339,7828
'4148025300,  파주읍,'05,0 - 4세,1998,997,532,465
'4148025300,  파주읍,'10,5 - 9세,1998,936,477,459
'4148025300,  파주읍,'15,10 - 14세,1998,935,504,431
'4148025300,  파주읍,'20,15 - 19세,1998,1292,688,604
'4148025300,  파주읍,'25,20 - 24세,1998,1321,673,648
'4148025300,  파주읍,'30,25 - 29세,1998,1472,831,641
'4148025300,  파주읍,'35,30 - 34세,1998,1383,797,586
'4148025300,  파주읍,'40,35 - 39세,1998,1422,810,612
'4148025300,  파주읍,'45,40 - 44세,1998,1222,656,566
'4148025300,  파주읍,'50,45 - 49세,1998,834,436,398
'4148025300,  파주읍,'55,50 - 54세,1998,857,397,460
'4148025300,  파주읍,'60,55 - 59세,1998,1003,454,549
'4148025300,  파주읍,'65,60 - 64세,1998,946,424,522
'4148025300,  파주읍,'70,65 - 69세,1998,628,297,331
'4148025300,  파주읍,'75,70 - 74세,1998,436,159,277
'4148025300,  파주읍,'80,75 - 79세,1998,283,146,137
'4148025300,  파주읍,'85,80 - 84세,1998,134,43,91
'4148025300,  파주읍,'90,85+ ,1998,66,15,51
'4148025600,  법원읍,'00,계,1998,16393,8514,7879
'4148025600,  법원읍,'05,0 - 4세,1998,1081,577,504
'4148025600,  법원읍,'10,5 - 9세,1998,1108,588,520
'4148025600,  법원읍,'15,10 - 14세,1998,978,526,452
'4148025600,  법원읍,'20,15 - 19세,1998,1319,688,631
'4148025600,  법원읍,'25,20 - 24세,1998,1311,695,616
'4148025600,  법원읍,'30,25 - 29세,1998,1572,864,708
'4148025600,  법원읍,'35,30 - 34세,1998,1440,775,665
'4148025600,  법원읍,'40,35 - 39세,1998,1556,882,674
'4148025600,  법원읍,'45,40 - 44세,1998,1286,712,574
'4148025600,  법원읍,'50,45 - 49세,1998,761,417,344
'4148025600,  법원읍,'55,50 - 54세,1998,755,368,387
'4148025600,  법원읍,'60,55 - 59세,1998,891,405,486
'4148025600,  법원읍,'65,60 - 64세,1998,840,371,469
'4148025600,  법원읍,'70,65 - 69세,1998,595,272,323
'4148025600,  법원읍,'75,70 - 74세,1998,401,153,248
'4148025600,  법원읍,'80,75 - 79세,1998,298,142,156
'4148025600,  법원읍,'85,80 - 84세,1998,127,54,73
'4148025600,  법원읍,'90,85+ ,1998,74,25,49
'4148031000,  월롱면,'00,계,1998,6640,3460,3180
'4148031000,  월롱면,'05,0 - 4세,1998,427,237,190
'4148031000,  월롱면,'10,5 - 9세,1998,387,213,174
'4148031000,  월롱면,'15,10 - 14세,1998,367,198,169
'4148031000,  월롱면,'20,15 - 19세,1998,529,265,264
'4148031000,  월롱면,'25,20 - 24세,1998,571,314,257
'4148031000,  월롱면,'30,25 - 29세,1998,643,385,258
'4148031000,  월롱면,'35,30 - 34세,1998,537,305,232
'4148031000,  월롱면,'40,35 - 39세,1998,623,340,283
'4148031000,  월롱면,'45,40 - 44세,1998,489,265,224
'4148031000,  월롱면,'50,45 - 49세,1998,353,185,168
'4148031000,  월롱면,'55,50 - 54세,1998,331,182,149
'4148031000,  월롱면,'60,55 - 59세,1998,357,155,202
'4148031000,  월롱면,'65,60 - 64세,1998,386,163,223
'4148031000,  월롱면,'70,65 - 69세,1998,259,120,139
'4148031000,  월롱면,'75,70 - 74세,1998,170,60,110
'4148031000,  월롱면,'80,75 - 79세,1998,115,42,73
'4148031000,  월롱면,'85,80 - 84세,1998,57,24,33
'4148031000,  월롱면,'90,85+ ,1998,39,7,32
'4148032000,  탄현면,'00,계,1998,6980,3583,3397
'4148032000,  탄현면,'05,0 - 4세,1998,431,228,203
'4148032000,  탄현면,'10,5 - 9세,1998,429,222,207
'4148032000,  탄현면,'15,10 - 14세,1998,389,210,179
'4148032000,  탄현면,'20,15 - 19세,1998,475,249,226
'4148032000,  탄현면,'25,20 - 24세,1998,581,301,280
'4148032000,  탄현면,'30,25 - 29세,1998,633,388,245
'4148032000,  탄현면,'35,30 - 34세,1998,525,270,255
'4148032000,  탄현면,'40,35 - 39세,1998,582,330,252
'4148032000,  탄현면,'45,40 - 44세,1998,477,260,217
'4148032000,  탄현면,'50,45 - 49세,1998,336,166,170
'4148032000,  탄현면,'55,50 - 54세,1998,358,192,166
'4148032000,  탄현면,'60,55 - 59세,1998,467,211,256
'4148032000,  탄현면,'65,60 - 64세,1998,442,207,235
'4148032000,  탄현면,'70,65 - 69세,1998,320,133,187
'4148032000,  탄현면,'75,70 - 74세,1998,207,83,124
'4148032000,  탄현면,'80,75 - 79세,1998,180,72,108
'4148032000,  탄현면,'85,80 - 84세,1998,93,47,46
'4148032000,  탄현면,'90,85+ ,1998,55,14,41
'4148033000,  교하면,'00,계,1998,14422,7445,6977
'4148033000,  교하면,'05,0 - 4세,1998,922,508,414
'4148033000,  교하면,'10,5 - 9세,1998,977,483,494
'4148033000,  교하면,'15,10 - 14세,1998,770,416,354
'4148033000,  교하면,'20,15 - 19세,1998,1102,536,566
'4148033000,  교하면,'25,20 - 24세,1998,1130,596,534
'4148033000,  교하면,'30,25 - 29세,1998,1202,688,514
'4148033000,  교하면,'35,30 - 34세,1998,1180,632,548
'4148033000,  교하면,'40,35 - 39세,1998,1269,706,563
'4148033000,  교하면,'45,40 - 44세,1998,1088,619,469
'4148033000,  교하면,'50,45 - 49세,1998,807,439,368
'4148033000,  교하면,'55,50 - 54세,1998,749,383,366
'4148033000,  교하면,'60,55 - 59세,1998,869,442,427
'4148033000,  교하면,'65,60 - 64세,1998,793,377,416
'4148033000,  교하면,'70,65 - 69세,1998,611,250,361
'4148033000,  교하면,'75,70 - 74세,1998,399,152,247
'4148033000,  교하면,'80,75 - 79세,1998,294,111,183
'4148033000,  교하면,'85,80 - 84세,1998,164,70,94
'4148033000,  교하면,'90,85+ ,1998,96,37,59
'4148034000,  조리면,'00,계,1998,19183,9768,9415
'4148034000,  조리면,'05,0 - 4세,1998,1702,878,824
'4148034000,  조리면,'10,5 - 9세,1998,1580,805,775
'4148034000,  조리면,'15,10 - 14세,1998,1119,578,541
'4148034000,  조리면,'20,15 - 19세,1998,1216,638,578
'4148034000,  조리면,'25,20 - 24세,1998,1390,701,689
'4148034000,  조리면,'30,25 - 29세,1998,1950,973,977
'4148034000,  조리면,'35,30 - 34세,1998,2202,1149,1053
'4148034000,  조리면,'40,35 - 39세,1998,1991,1129,862
'4148034000,  조리면,'45,40 - 44세,1998,1439,787,652
'4148034000,  조리면,'50,45 - 49세,1998,864,454,410
'4148034000,  조리면,'55,50 - 54세,1998,855,412,443
'4148034000,  조리면,'60,55 - 59세,1998,869,434,435
'4148034000,  조리면,'65,60 - 64세,1998,739,344,395
'4148034000,  조리면,'70,65 - 69세,1998,514,209,305
'4148034000,  조리면,'75,70 - 74세,1998,320,123,197
'4148034000,  조리면,'80,75 - 79세,1998,228,91,137
'4148034000,  조리면,'85,80 - 84세,1998,149,47,102
'4148034000,  조리면,'90,85+ ,1998,56,16,40
'4148035000,  광탄면,'00,계,1998,13328,6893,6435
'4148035000,  광탄면,'05,0 - 4세,1998,861,462,399
'4148035000,  광탄면,'10,5 - 9세,1998,991,507,484
'4148035000,  광탄면,'15,10 - 14세,1998,775,406,369
'4148035000,  광탄면,'20,15 - 19세,1998,919,502,417
'4148035000,  광탄면,'25,20 - 24세,1998,1028,539,489
'4148035000,  광탄면,'30,25 - 29세,1998,1129,648,481
'4148035000,  광탄면,'35,30 - 34세,1998,1220,659,561
'4148035000,  광탄면,'40,35 - 39세,1998,1206,670,536
'4148035000,  광탄면,'45,40 - 44세,1998,1000,566,434
'4148035000,  광탄면,'50,45 - 49세,1998,651,337,314
'4148035000,  광탄면,'55,50 - 54세,1998,667,342,325
'4148035000,  광탄면,'60,55 - 59세,1998,747,356,391
'4148035000,  광탄면,'65,60 - 64세,1998,699,334,365
'4148035000,  광탄면,'70,65 - 69세,1998,542,245,297
'4148035000,  광탄면,'75,70 - 74세,1998,353,153,200
'4148035000,  광탄면,'80,75 - 79세,1998,250,99,151
'4148035000,  광탄면,'85,80 - 84세,1998,173,44,129
'4148035000,  광탄면,'90,85+ ,1998,117,24,93
'4148036000,  파평면,'00,계,1998,6030,3030,3000
'4148036000,  파평면,'05,0 - 4세,1998,360,190,170
'4148036000,  파평면,'10,5 - 9세,1998,303,150,153
'4148036000,  파평면,'15,10 - 14세,1998,318,144,174
'4148036000,  파평면,'20,15 - 19세,1998,476,221,255
'4148036000,  파평면,'25,20 - 24세,1998,460,241,219
'4148036000,  파평면,'30,25 - 29세,1998,565,320,245
'4148036000,  파평면,'35,30 - 34세,1998,425,261,164
'4148036000,  파평면,'40,35 - 39세,1998,451,262,189
'4148036000,  파평면,'45,40 - 44세,1998,447,235,212
'4148036000,  파평면,'50,45 - 49세,1998,255,128,127
'4148036000,  파평면,'55,50 - 54세,1998,326,166,160
'4148036000,  파평면,'60,55 - 59세,1998,442,189,253
'4148036000,  파평면,'65,60 - 64세,1998,383,196,187
'4148036000,  파평면,'70,65 - 69세,1998,280,113,167
'4148036000,  파평면,'75,70 - 74세,1998,207,76,131
'4148036000,  파평면,'80,75 - 79세,1998,169,75,94
'4148036000,  파평면,'85,80 - 84세,1998,93,37,56
'4148036000,  파평면,'90,85+ ,1998,70,26,44
'4148037000,  적성면,'00,계,1998,9541,4880,4661
'4148037000,  적성면,'05,0 - 4세,1998,620,315,305
'4148037000,  적성면,'10,5 - 9세,1998,668,354,314
'4148037000,  적성면,'15,10 - 14세,1998,657,336,321
'4148037000,  적성면,'20,15 - 19세,1998,822,404,418
'4148037000,  적성면,'25,20 - 24세,1998,719,420,299
'4148037000,  적성면,'30,25 - 29세,1998,841,479,362
'4148037000,  적성면,'35,30 - 34세,1998,802,408,394
'4148037000,  적성면,'40,35 - 39세,1998,833,448,385
'4148037000,  적성면,'45,40 - 44세,1998,743,400,343
'4148037000,  적성면,'50,45 - 49세,1998,433,223,210
'4148037000,  적성면,'55,50 - 54세,1998,515,266,249
'4148037000,  적성면,'60,55 - 59세,1998,568,263,305
'4148037000,  적성면,'65,60 - 64세,1998,470,220,250
'4148037000,  적성면,'70,65 - 69세,1998,312,143,169
'4148037000,  적성면,'75,70 - 74세,1998,221,78,143
'4148037000,  적성면,'80,75 - 79세,1998,175,78,97
'4148037000,  적성면,'85,80 - 84세,1998,94,34,60
'4148037000,  적성면,'90,85+ ,1998,48,11,37
'4148038000,  군내면,'00,계,1998,666,331,335
'4148038000,  군내면,'05,0 - 4세,1998,36,19,17
'4148038000,  군내면,'10,5 - 9세,1998,43,18,25
'4148038000,  군내면,'15,10 - 14세,1998,40,18,22
'4148038000,  군내면,'20,15 - 19세,1998,49,23,26
'4148038000,  군내면,'25,20 - 24세,1998,64,30,34
'4148038000,  군내면,'30,25 - 29세,1998,57,33,24
'4148038000,  군내면,'35,30 - 34세,1998,44,20,24
'4148038000,  군내면,'40,35 - 39세,1998,55,32,23
'4148038000,  군내면,'45,40 - 44세,1998,45,26,19
'4148038000,  군내면,'50,45 - 49세,1998,39,17,22
'4148038000,  군내면,'55,50 - 54세,1998,48,26,22
'4148038000,  군내면,'60,55 - 59세,1998,49,25,24
'4148038000,  군내면,'65,60 - 64세,1998,37,14,23
'4148038000,  군내면,'70,65 - 69세,1998,30,21,9
'4148038000,  군내면,'75,70 - 74세,1998,8,4,4
'4148038000,  군내면,'80,75 - 79세,1998,12,4,8
'4148038000,  군내면,'85,80 - 84세,1998,4,0,4
'4148038000,  군내면,'90,85+ ,1998,6,1,5
'4148051000,  금촌1동,'00,계,1998,19032,9642,9390
'4148051000,  금촌1동,'05,0 - 4세,1998,1738,921,817
'4148051000,  금촌1동,'10,5 - 9세,1998,1625,844,781
'4148051000,  금촌1동,'15,10 - 14세,1998,1198,653,545
'4148051000,  금촌1동,'20,15 - 19세,1998,1320,685,635
'4148051000,  금촌1동,'25,20 - 24세,1998,1406,677,729
'4148051000,  금촌1동,'30,25 - 29세,1998,2069,1022,1047
'4148051000,  금촌1동,'35,30 - 34세,1998,2094,1089,1005
'4148051000,  금촌1동,'40,35 - 39세,1998,2006,1072,934
'4148051000,  금촌1동,'45,40 - 44세,1998,1406,770,636
'4148051000,  금촌1동,'50,45 - 49세,1998,871,462,409
'4148051000,  금촌1동,'55,50 - 54세,1998,771,392,379
'4148051000,  금촌1동,'60,55 - 59세,1998,698,299,399
'4148051000,  금촌1동,'65,60 - 64세,1998,647,301,346
'4148051000,  금촌1동,'70,65 - 69세,1998,501,197,304
'4148051000,  금촌1동,'75,70 - 74세,1998,302,110,192
'4148051000,  금촌1동,'80,75 - 79세,1998,207,90,117
'4148051000,  금촌1동,'85,80 - 84세,1998,107,37,70
'4148051000,  금촌1동,'90,85+ ,1998,66,21,45
'4148052000,  금촌2동,'00,계,1998,21431,10830,10601
'4148052000,  금촌2동,'05,0 - 4세,1998,2064,1103,961
'4148052000,  금촌2동,'10,5 - 9세,1998,1964,1036,928
'4148052000,  금촌2동,'15,10 - 14세,1998,1278,674,604
'4148052000,  금촌2동,'20,15 - 19세,1998,1443,745,698
'4148052000,  금촌2동,'25,20 - 24세,1998,1389,655,734
'4148052000,  금촌2동,'30,25 - 29세,1998,2142,1026,1116
'4148052000,  금촌2동,'35,30 - 34세,1998,2592,1256,1336
'4148052000,  금촌2동,'40,35 - 39세,1998,2375,1350,1025
'4148052000,  금촌2동,'45,40 - 44세,1998,1655,895,760
'4148052000,  금촌2동,'50,45 - 49세,1998,1010,525,485
'4148052000,  금촌2동,'55,50 - 54세,1998,834,429,405
'4148052000,  금촌2동,'60,55 - 59세,1998,770,360,410
'4148052000,  금촌2동,'65,60 - 64세,1998,675,299,376
'4148052000,  금촌2동,'70,65 - 69세,1998,473,203,270
'4148052000,  금촌2동,'75,70 - 74세,1998,312,95,217
'4148052000,  금촌2동,'80,75 - 79세,1998,251,103,148
'4148052000,  금촌2동,'85,80 - 84세,1998,140,58,82
'4148052000,  금촌2동,'90,85+ ,1998,64,18,46
'41500, 이천시,'00,계,1998,175400,89090,86310
'41500, 이천시,'05,0 - 4세,1998,15739,8195,7544
'41500, 이천시,'10,5 - 9세,1998,14517,7584,6933
'41500, 이천시,'15,10 - 14세,1998,12461,6383,6078
'41500, 이천시,'20,15 - 19세,1998,13124,6659,6465
'41500, 이천시,'25,20 - 24세,1998,13647,6700,6947
'41500, 이천시,'30,25 - 29세,1998,18812,9797,9015
'41500, 이천시,'35,30 - 34세,1998,18257,9524,8733
'41500, 이천시,'40,35 - 39세,1998,17445,9384,8061
'41500, 이천시,'45,40 - 44세,1998,12653,7027,5626
'41500, 이천시,'50,45 - 49세,1998,7687,4009,3678
'41500, 이천시,'55,50 - 54세,1998,6332,3292,3040
'41500, 이천시,'60,55 - 59세,1998,6746,3256,3490
'41500, 이천시,'65,60 - 64세,1998,6248,2851,3397
'41500, 이천시,'70,65 - 69세,1998,4528,1851,2677
'41500, 이천시,'75,70 - 74세,1998,3116,1171,1945
'41500, 이천시,'80,75 - 79세,1998,2180,795,1385
'41500, 이천시,'85,80 - 84세,1998,1225,427,798
'41500, 이천시,'90,85+ ,1998,683,185,498
'4150025000,  장호원읍,'00,계,1998,18752,9460,9292
'4150025000,  장호원읍,'05,0 - 4세,1998,1397,729,668
'4150025000,  장호원읍,'10,5 - 9세,1998,1501,789,712
'4150025000,  장호원읍,'15,10 - 14세,1998,1349,698,651
'4150025000,  장호원읍,'20,15 - 19세,1998,1613,812,801
'4150025000,  장호원읍,'25,20 - 24세,1998,1431,775,656
'4150025000,  장호원읍,'30,25 - 29세,1998,1593,808,785
'4150025000,  장호원읍,'35,30 - 34세,1998,1599,815,784
'4150025000,  장호원읍,'40,35 - 39세,1998,1820,943,877
'4150025000,  장호원읍,'45,40 - 44세,1998,1394,782,612
'4150025000,  장호원읍,'50,45 - 49세,1998,946,474,472
'4150025000,  장호원읍,'55,50 - 54세,1998,800,402,398
'4150025000,  장호원읍,'60,55 - 59세,1998,883,437,446
'4150025000,  장호원읍,'65,60 - 64세,1998,839,368,471
'4150025000,  장호원읍,'70,65 - 69세,1998,640,245,395
'4150025000,  장호원읍,'75,70 - 74세,1998,440,189,251
'4150025000,  장호원읍,'80,75 - 79세,1998,279,119,160
'4150025000,  장호원읍,'85,80 - 84세,1998,144,53,91
'4150025000,  장호원읍,'90,85+ ,1998,84,22,62
'4150025300,  부발읍,'00,계,1998,26613,13743,12870
'4150025300,  부발읍,'05,0 - 4세,1998,2978,1551,1427
'4150025300,  부발읍,'10,5 - 9세,1998,2580,1344,1236
'4150025300,  부발읍,'15,10 - 14세,1998,1618,790,828
'4150025300,  부발읍,'20,15 - 19세,1998,1618,810,808
'4150025300,  부발읍,'25,20 - 24세,1998,2312,1063,1249
'4150025300,  부발읍,'30,25 - 29세,1998,3781,2010,1771
'4150025300,  부발읍,'35,30 - 34세,1998,3308,1809,1499
'4150025300,  부발읍,'40,35 - 39세,1998,2510,1412,1098
'4150025300,  부발읍,'45,40 - 44세,1998,1619,913,706
'4150025300,  부발읍,'50,45 - 49세,1998,926,506,420
'4150025300,  부발읍,'55,50 - 54세,1998,748,410,338
'4150025300,  부발읍,'60,55 - 59세,1998,745,373,372
'4150025300,  부발읍,'65,60 - 64세,1998,678,294,384
'4150025300,  부발읍,'70,65 - 69세,1998,481,208,273
'4150025300,  부발읍,'75,70 - 74세,1998,329,126,203
'4150025300,  부발읍,'80,75 - 79세,1998,212,74,138
'4150025300,  부발읍,'85,80 - 84세,1998,117,38,79
'4150025300,  부발읍,'90,85+ ,1998,53,12,41
'4150031000,  신둔면,'00,계,1998,8882,4542,4340
'4150031000,  신둔면,'05,0 - 4세,1998,704,344,360
'4150031000,  신둔면,'10,5 - 9세,1998,614,305,309
'4150031000,  신둔면,'15,10 - 14세,1998,605,316,289
'4150031000,  신둔면,'20,15 - 19세,1998,716,382,334
'4150031000,  신둔면,'25,20 - 24세,1998,693,357,336
'4150031000,  신둔면,'30,25 - 29세,1998,795,420,375
'4150031000,  신둔면,'35,30 - 34세,1998,827,434,393
'4150031000,  신둔면,'40,35 - 39세,1998,865,496,369
'4150031000,  신둔면,'45,40 - 44세,1998,633,366,267
'4150031000,  신둔면,'50,45 - 49세,1998,455,236,219
'4150031000,  신둔면,'55,50 - 54세,1998,371,185,186
'4150031000,  신둔면,'60,55 - 59세,1998,434,220,214
'4150031000,  신둔면,'65,60 - 64세,1998,390,190,200
'4150031000,  신둔면,'70,65 - 69세,1998,306,125,181
'4150031000,  신둔면,'75,70 - 74세,1998,202,75,127
'4150031000,  신둔면,'80,75 - 79세,1998,148,53,95
'4150031000,  신둔면,'85,80 - 84세,1998,86,25,61
'4150031000,  신둔면,'90,85+ ,1998,38,13,25
'4150032000,  백사면,'00,계,1998,8233,4214,4019
'4150032000,  백사면,'05,0 - 4세,1998,747,377,370
'4150032000,  백사면,'10,5 - 9세,1998,474,263,211
'4150032000,  백사면,'15,10 - 14세,1998,466,224,242
'4150032000,  백사면,'20,15 - 19세,1998,549,283,266
'4150032000,  백사면,'25,20 - 24세,1998,646,348,298
'4150032000,  백사면,'30,25 - 29세,1998,835,404,431
'4150032000,  백사면,'35,30 - 34세,1998,822,458,364
'4150032000,  백사면,'40,35 - 39세,1998,768,443,325
'4150032000,  백사면,'45,40 - 44세,1998,544,313,231
'4150032000,  백사면,'50,45 - 49세,1998,378,205,173
'4150032000,  백사면,'55,50 - 54세,1998,354,177,177
'4150032000,  백사면,'60,55 - 59세,1998,419,206,213
'4150032000,  백사면,'65,60 - 64세,1998,436,200,236
'4150032000,  백사면,'70,65 - 69세,1998,302,116,186
'4150032000,  백사면,'75,70 - 74세,1998,211,93,118
'4150032000,  백사면,'80,75 - 79세,1998,148,60,88
'4150032000,  백사면,'85,80 - 84세,1998,97,32,65
'4150032000,  백사면,'90,85+ ,1998,37,12,25
'4150033000,  호법면,'00,계,1998,5127,2651,2476
'4150033000,  호법면,'05,0 - 4세,1998,307,161,146
'4150033000,  호법면,'10,5 - 9세,1998,283,141,142
'4150033000,  호법면,'15,10 - 14세,1998,289,158,131
'4150033000,  호법면,'20,15 - 19세,1998,430,214,216
'4150033000,  호법면,'25,20 - 24세,1998,432,244,188
'4150033000,  호법면,'30,25 - 29세,1998,445,256,189
'4150033000,  호법면,'35,30 - 34세,1998,378,239,139
'4150033000,  호법면,'40,35 - 39세,1998,388,201,187
'4150033000,  호법면,'45,40 - 44세,1998,376,212,164
'4150033000,  호법면,'50,45 - 49세,1998,271,129,142
'4150033000,  호법면,'55,50 - 54세,1998,277,145,132
'4150033000,  호법면,'60,55 - 59세,1998,317,147,170
'4150033000,  호법면,'65,60 - 64세,1998,301,151,150
'4150033000,  호법면,'70,65 - 69세,1998,236,94,142
'4150033000,  호법면,'75,70 - 74세,1998,189,78,111
'4150033000,  호법면,'80,75 - 79세,1998,105,40,65
'4150033000,  호법면,'85,80 - 84세,1998,67,29,38
'4150033000,  호법면,'90,85+ ,1998,36,12,24
'4150034000,  마장면,'00,계,1998,7647,3930,3717
'4150034000,  마장면,'05,0 - 4세,1998,487,271,216
'4150034000,  마장면,'10,5 - 9세,1998,492,265,227
'4150034000,  마장면,'15,10 - 14세,1998,492,240,252
'4150034000,  마장면,'20,15 - 19세,1998,591,304,287
'4150034000,  마장면,'25,20 - 24세,1998,672,367,305
'4150034000,  마장면,'30,25 - 29세,1998,707,397,310
'4150034000,  마장면,'35,30 - 34세,1998,616,330,286
'4150034000,  마장면,'40,35 - 39세,1998,651,362,289
'4150034000,  마장면,'45,40 - 44세,1998,512,287,225
'4150034000,  마장면,'50,45 - 49세,1998,423,216,207
'4150034000,  마장면,'55,50 - 54세,1998,396,206,190
'4150034000,  마장면,'60,55 - 59세,1998,436,194,242
'4150034000,  마장면,'65,60 - 64세,1998,402,201,201
'4150034000,  마장면,'70,65 - 69세,1998,298,129,169
'4150034000,  마장면,'75,70 - 74세,1998,200,70,130
'4150034000,  마장면,'80,75 - 79세,1998,152,55,97
'4150034000,  마장면,'85,80 - 84세,1998,69,22,47
'4150034000,  마장면,'90,85+ ,1998,51,14,37
'4150035000,  대월면,'00,계,1998,13487,6989,6498
'4150035000,  대월면,'05,0 - 4세,1998,1625,829,796
'4150035000,  대월면,'10,5 - 9세,1998,912,488,424
'4150035000,  대월면,'15,10 - 14세,1998,706,378,328
'4150035000,  대월면,'20,15 - 19세,1998,891,452,439
'4150035000,  대월면,'25,20 - 24세,1998,1014,436,578
'4150035000,  대월면,'30,25 - 29세,1998,1851,976,875
'4150035000,  대월면,'35,30 - 34세,1998,1824,1018,806
'4150035000,  대월면,'40,35 - 39세,1998,1270,756,514
'4150035000,  대월면,'45,40 - 44세,1998,828,480,348
'4150035000,  대월면,'50,45 - 49세,1998,481,257,224
'4150035000,  대월면,'55,50 - 54세,1998,451,242,209
'4150035000,  대월면,'60,55 - 59세,1998,467,227,240
'4150035000,  대월면,'65,60 - 64세,1998,372,160,212
'4150035000,  대월면,'70,65 - 69세,1998,275,125,150
'4150035000,  대월면,'75,70 - 74세,1998,184,57,127
'4150035000,  대월면,'80,75 - 79세,1998,185,61,124
'4150035000,  대월면,'85,80 - 84세,1998,99,34,65
'4150035000,  대월면,'90,85+ ,1998,52,13,39
'4150036000,  모가면,'00,계,1998,5541,2868,2673
'4150036000,  모가면,'05,0 - 4세,1998,302,165,137
'4150036000,  모가면,'10,5 - 9세,1998,284,150,134
'4150036000,  모가면,'15,10 - 14세,1998,360,190,170
'4150036000,  모가면,'20,15 - 19세,1998,512,270,242
'4150036000,  모가면,'25,20 - 24세,1998,472,259,213
'4150036000,  모가면,'30,25 - 29세,1998,390,240,150
'4150036000,  모가면,'35,30 - 34세,1998,383,220,163
'4150036000,  모가면,'40,35 - 39세,1998,454,246,208
'4150036000,  모가면,'45,40 - 44세,1998,421,239,182
'4150036000,  모가면,'50,45 - 49세,1998,281,147,134
'4150036000,  모가면,'55,50 - 54세,1998,263,128,135
'4150036000,  모가면,'60,55 - 59세,1998,378,173,205
'4150036000,  모가면,'65,60 - 64세,1998,387,178,209
'4150036000,  모가면,'70,65 - 69세,1998,241,95,146
'4150036000,  모가면,'75,70 - 74세,1998,164,74,90
'4150036000,  모가면,'80,75 - 79세,1998,126,54,72
'4150036000,  모가면,'85,80 - 84세,1998,70,29,41
'4150036000,  모가면,'90,85+ ,1998,53,11,42
'4150037000,  설성면,'00,계,1998,6317,3227,3090
'4150037000,  설성면,'05,0 - 4세,1998,308,154,154
'4150037000,  설성면,'10,5 - 9세,1998,327,179,148
'4150037000,  설성면,'15,10 - 14세,1998,391,176,215
'4150037000,  설성면,'20,15 - 19세,1998,563,275,288
'4150037000,  설성면,'25,20 - 24세,1998,575,324,251
'4150037000,  설성면,'30,25 - 29세,1998,446,265,181
'4150037000,  설성면,'35,30 - 34세,1998,415,236,179
'4150037000,  설성면,'40,35 - 39세,1998,493,288,205
'4150037000,  설성면,'45,40 - 44세,1998,502,277,225
'4150037000,  설성면,'50,45 - 49세,1998,337,177,160
'4150037000,  설성면,'55,50 - 54세,1998,292,144,148
'4150037000,  설성면,'60,55 - 59세,1998,399,196,203
'4150037000,  설성면,'65,60 - 64세,1998,485,228,257
'4150037000,  설성면,'70,65 - 69세,1998,330,147,183
'4150037000,  설성면,'75,70 - 74세,1998,198,81,117
'4150037000,  설성면,'80,75 - 79세,1998,127,37,90
'4150037000,  설성면,'85,80 - 84세,1998,77,30,47
'4150037000,  설성면,'90,85+ ,1998,52,13,39
'4150038000,  율면,'00,계,1998,3814,1953,1861
'4150038000,  율면,'05,0 - 4세,1998,152,71,81
'4150038000,  율면,'10,5 - 9세,1998,189,96,93
'4150038000,  율면,'15,10 - 14세,1998,207,107,100
'4150038000,  율면,'20,15 - 19세,1998,314,170,144
'4150038000,  율면,'25,20 - 24세,1998,336,192,144
'4150038000,  율면,'30,25 - 29세,1998,226,156,70
'4150038000,  율면,'35,30 - 34세,1998,197,109,88
'4150038000,  율면,'40,35 - 39세,1998,287,166,121
'4150038000,  율면,'45,40 - 44세,1998,267,150,117
'4150038000,  율면,'50,45 - 49세,1998,207,114,93
'4150038000,  율면,'55,50 - 54세,1998,191,88,103
'4150038000,  율면,'60,55 - 59세,1998,260,121,139
'4150038000,  율면,'65,60 - 64세,1998,331,154,177
'4150038000,  율면,'70,65 - 69세,1998,259,100,159
'4150038000,  율면,'75,70 - 74세,1998,167,70,97
'4150038000,  율면,'80,75 - 79세,1998,110,51,59
'4150038000,  율면,'85,80 - 84세,1998,67,24,43
'4150038000,  율면,'90,85+ ,1998,47,14,33
'4150051000,  창전동,'00,계,1998,45482,22497,22985
'4150051000,  창전동,'05,0 - 4세,1998,4596,2405,2191
'4150051000,  창전동,'10,5 - 9세,1998,4869,2509,2360
'4150051000,  창전동,'15,10 - 14세,1998,4040,2090,1950
'4150051000,  창전동,'20,15 - 19세,1998,3236,1656,1580
'4150051000,  창전동,'25,20 - 24세,1998,2899,1254,1645
'4150051000,  창전동,'30,25 - 29세,1998,4798,2255,2543
'4150051000,  창전동,'35,30 - 34세,1998,5373,2533,2840
'4150051000,  창전동,'40,35 - 39세,1998,5414,2778,2636
'4150051000,  창전동,'45,40 - 44세,1998,3601,1983,1618
'4150051000,  창전동,'50,45 - 49세,1998,1789,935,854
'4150051000,  창전동,'55,50 - 54세,1998,1212,641,571
'4150051000,  창전동,'60,55 - 59세,1998,1081,513,568
'4150051000,  창전동,'65,60 - 64세,1998,876,380,496
'4150051000,  창전동,'70,65 - 69세,1998,633,240,393
'4150051000,  창전동,'75,70 - 74세,1998,460,142,318
'4150051000,  창전동,'80,75 - 79세,1998,308,100,208
'4150051000,  창전동,'85,80 - 84세,1998,198,59,139
'4150051000,  창전동,'90,85+ ,1998,99,24,75
'4150052000,  중리동,'00,계,1998,14265,7432,6833
'4150052000,  중리동,'05,0 - 4세,1998,1109,626,483
'4150052000,  중리동,'10,5 - 9세,1998,1115,594,521
'4150052000,  중리동,'15,10 - 14세,1998,1093,575,518
'4150052000,  중리동,'20,15 - 19세,1998,1166,603,563
'4150052000,  중리동,'25,20 - 24세,1998,1312,691,621
'4150052000,  중리동,'30,25 - 29세,1998,1711,1012,699
'4150052000,  중리동,'35,30 - 34세,1998,1310,689,621
'4150052000,  중리동,'40,35 - 39세,1998,1357,673,684
'4150052000,  중리동,'45,40 - 44세,1998,1062,544,518
'4150052000,  중리동,'50,45 - 49세,1998,661,329,332
'4150052000,  중리동,'55,50 - 54세,1998,595,322,273
'4150052000,  중리동,'60,55 - 59세,1998,532,272,260
'4150052000,  중리동,'65,60 - 64세,1998,432,201,231
'4150052000,  중리동,'70,65 - 69세,1998,306,132,174
'4150052000,  중리동,'75,70 - 74세,1998,215,68,147
'4150052000,  중리동,'80,75 - 79세,1998,159,55,104
'4150052000,  중리동,'85,80 - 84세,1998,85,31,54
'4150052000,  중리동,'90,85+ ,1998,45,15,30
'4150053000,  관고동,'00,계,1998,11240,5584,5656
'4150053000,  관고동,'05,0 - 4세,1998,1027,512,515
'4150053000,  관고동,'10,5 - 9세,1998,877,461,416
'4150053000,  관고동,'15,10 - 14세,1998,845,441,404
'4150053000,  관고동,'20,15 - 19세,1998,925,428,497
'4150053000,  관고동,'25,20 - 24세,1998,853,390,463
'4150053000,  관고동,'30,25 - 29세,1998,1234,598,636
'4150053000,  관고동,'35,30 - 34세,1998,1205,634,571
'4150053000,  관고동,'40,35 - 39세,1998,1168,620,548
'4150053000,  관고동,'45,40 - 44세,1998,894,481,413
'4150053000,  관고동,'50,45 - 49세,1998,532,284,248
'4150053000,  관고동,'55,50 - 54세,1998,382,202,180
'4150053000,  관고동,'60,55 - 59세,1998,395,177,218
'4150053000,  관고동,'65,60 - 64세,1998,319,146,173
'4150053000,  관고동,'70,65 - 69세,1998,221,95,126
'4150053000,  관고동,'75,70 - 74세,1998,157,48,109
'4150053000,  관고동,'80,75 - 79세,1998,121,36,85
'4150053000,  관고동,'85,80 - 84세,1998,49,21,28
'4150053000,  관고동,'90,85+ ,1998,36,10,26
'41550, 안성시,'00,계,1998,129957,65693,64264
'41550, 안성시,'05,0 - 4세,1998,8896,4627,4269
'41550, 안성시,'10,5 - 9세,1998,8901,4636,4265
'41550, 안성시,'15,10 - 14세,1998,8493,4347,4146
'41550, 안성시,'20,15 - 19세,1998,11180,5701,5479
'41550, 안성시,'25,20 - 24세,1998,10701,5637,5064
'41550, 안성시,'30,25 - 29세,1998,11830,6405,5425
'41550, 안성시,'35,30 - 34세,1998,10866,5749,5117
'41550, 안성시,'40,35 - 39세,1998,11442,6105,5337
'41550, 안성시,'45,40 - 44세,1998,9433,4960,4473
'41550, 안성시,'50,45 - 49세,1998,6784,3519,3265
'41550, 안성시,'55,50 - 54세,1998,6088,3034,3054
'41550, 안성시,'60,55 - 59세,1998,6754,3130,3624
'41550, 안성시,'65,60 - 64세,1998,6609,3070,3539
'41550, 안성시,'70,65 - 69세,1998,4653,1964,2689
'41550, 안성시,'75,70 - 74세,1998,3166,1286,1880
'41550, 안성시,'80,75 - 79세,1998,2269,916,1353
'41550, 안성시,'85,80 - 84세,1998,1206,414,792
'41550, 안성시,'90,85+ ,1998,686,193,493
'4155031000,  보개면,'00,계,1998,6504,3285,3219
'4155031000,  보개면,'05,0 - 4세,1998,321,177,144
'4155031000,  보개면,'10,5 - 9세,1998,280,134,146
'4155031000,  보개면,'15,10 - 14세,1998,385,190,195
'4155031000,  보개면,'20,15 - 19세,1998,568,290,278
'4155031000,  보개면,'25,20 - 24세,1998,652,363,289
'4155031000,  보개면,'30,25 - 29세,1998,462,285,177
'4155031000,  보개면,'35,30 - 34세,1998,386,222,164
'4155031000,  보개면,'40,35 - 39세,1998,457,235,222
'4155031000,  보개면,'45,40 - 44세,1998,477,252,225
'4155031000,  보개면,'50,45 - 49세,1998,354,179,175
'4155031000,  보개면,'55,50 - 54세,1998,381,179,202
'4155031000,  보개면,'60,55 - 59세,1998,454,209,245
'4155031000,  보개면,'65,60 - 64세,1998,468,237,231
'4155031000,  보개면,'70,65 - 69세,1998,341,144,197
'4155031000,  보개면,'75,70 - 74세,1998,225,88,137
'4155031000,  보개면,'80,75 - 79세,1998,150,62,88
'4155031000,  보개면,'85,80 - 84세,1998,81,24,57
'4155031000,  보개면,'90,85+ ,1998,62,15,47
'4155032000,  금광면,'00,계,1998,4724,2383,2341
'4155032000,  금광면,'05,0 - 4세,1998,195,104,91
'4155032000,  금광면,'10,5 - 9세,1998,230,115,115
'4155032000,  금광면,'15,10 - 14세,1998,308,151,157
'4155032000,  금광면,'20,15 - 19세,1998,449,224,225
'4155032000,  금광면,'25,20 - 24세,1998,386,222,164
'4155032000,  금광면,'30,25 - 29세,1998,337,210,127
'4155032000,  금광면,'35,30 - 34세,1998,295,165,130
'4155032000,  금광면,'40,35 - 39세,1998,316,167,149
'4155032000,  금광면,'45,40 - 44세,1998,350,192,158
'4155032000,  금광면,'50,45 - 49세,1998,249,123,126
'4155032000,  금광면,'55,50 - 54세,1998,235,119,116
'4155032000,  금광면,'60,55 - 59세,1998,344,161,183
'4155032000,  금광면,'65,60 - 64세,1998,364,165,199
'4155032000,  금광면,'70,65 - 69세,1998,246,92,154
'4155032000,  금광면,'75,70 - 74세,1998,180,81,99
'4155032000,  금광면,'80,75 - 79세,1998,127,59,68
'4155032000,  금광면,'85,80 - 84세,1998,76,28,48
'4155032000,  금광면,'90,85+ ,1998,37,5,32
'4155033000,  서운면,'00,계,1998,4865,2492,2373
'4155033000,  서운면,'05,0 - 4세,1998,235,123,112
'4155033000,  서운면,'10,5 - 9세,1998,261,131,130
'4155033000,  서운면,'15,10 - 14세,1998,282,137,145
'4155033000,  서운면,'20,15 - 19세,1998,436,225,211
'4155033000,  서운면,'25,20 - 24세,1998,447,238,209
'4155033000,  서운면,'30,25 - 29세,1998,419,259,160
'4155033000,  서운면,'35,30 - 34세,1998,320,180,140
'4155033000,  서운면,'40,35 - 39세,1998,358,200,158
'4155033000,  서운면,'45,40 - 44세,1998,338,173,165
'4155033000,  서운면,'50,45 - 49세,1998,273,138,135
'4155033000,  서운면,'55,50 - 54세,1998,229,125,104
'4155033000,  서운면,'60,55 - 59세,1998,339,152,187
'4155033000,  서운면,'65,60 - 64세,1998,322,156,166
'4155033000,  서운면,'70,65 - 69세,1998,244,115,129
'4155033000,  서운면,'75,70 - 74세,1998,148,57,91
'4155033000,  서운면,'80,75 - 79세,1998,109,47,62
'4155033000,  서운면,'85,80 - 84세,1998,63,23,40
'4155033000,  서운면,'90,85+ ,1998,42,13,29
'4155034000,  미양면,'00,계,1998,6918,3498,3420
'4155034000,  미양면,'05,0 - 4세,1998,359,189,170
'4155034000,  미양면,'10,5 - 9세,1998,325,170,155
'4155034000,  미양면,'15,10 - 14세,1998,452,231,221
'4155034000,  미양면,'20,15 - 19세,1998,637,318,319
'4155034000,  미양면,'25,20 - 24세,1998,616,325,291
'4155034000,  미양면,'30,25 - 29세,1998,592,358,234
'4155034000,  미양면,'35,30 - 34세,1998,434,235,199
'4155034000,  미양면,'40,35 - 39세,1998,515,277,238
'4155034000,  미양면,'45,40 - 44세,1998,510,252,258
'4155034000,  미양면,'50,45 - 49세,1998,409,235,174
'4155034000,  미양면,'55,50 - 54세,1998,348,173,175
'4155034000,  미양면,'60,55 - 59세,1998,454,207,247
'4155034000,  미양면,'65,60 - 64세,1998,466,197,269
'4155034000,  미양면,'70,65 - 69세,1998,330,147,183
'4155034000,  미양면,'75,70 - 74세,1998,224,104,120
'4155034000,  미양면,'80,75 - 79세,1998,139,54,85
'4155034000,  미양면,'85,80 - 84세,1998,61,14,47
'4155034000,  미양면,'90,85+ ,1998,47,12,35
'4155035000,  대덕면,'00,계,1998,6995,3660,3335
'4155035000,  대덕면,'05,0 - 4세,1998,450,220,230
'4155035000,  대덕면,'10,5 - 9세,1998,421,215,206
'4155035000,  대덕면,'15,10 - 14세,1998,416,198,218
'4155035000,  대덕면,'20,15 - 19세,1998,591,324,267
'4155035000,  대덕면,'25,20 - 24세,1998,682,391,291
'4155035000,  대덕면,'30,25 - 29세,1998,708,437,271
'4155035000,  대덕면,'35,30 - 34세,1998,553,294,259
'4155035000,  대덕면,'40,35 - 39세,1998,544,302,242
'4155035000,  대덕면,'45,40 - 44세,1998,459,235,224
'4155035000,  대덕면,'50,45 - 49세,1998,376,193,183
'4155035000,  대덕면,'55,50 - 54세,1998,361,186,175
'4155035000,  대덕면,'60,55 - 59세,1998,372,194,178
'4155035000,  대덕면,'65,60 - 64세,1998,379,177,202
'4155035000,  대덕면,'70,65 - 69세,1998,260,125,135
'4155035000,  대덕면,'75,70 - 74세,1998,187,77,110
'4155035000,  대덕면,'80,75 - 79세,1998,130,53,77
'4155035000,  대덕면,'85,80 - 84세,1998,75,31,44
'4155035000,  대덕면,'90,85+ ,1998,31,8,23
'4155036000,  양성면,'00,계,1998,5920,2985,2935
'4155036000,  양성면,'05,0 - 4세,1998,285,149,136
'4155036000,  양성면,'10,5 - 9세,1998,274,152,122
'4155036000,  양성면,'15,10 - 14세,1998,348,175,173
'4155036000,  양성면,'20,15 - 19세,1998,535,256,279
'4155036000,  양성면,'25,20 - 24세,1998,529,287,242
'4155036000,  양성면,'30,25 - 29세,1998,436,263,173
'4155036000,  양성면,'35,30 - 34세,1998,387,222,165
'4155036000,  양성면,'40,35 - 39세,1998,461,238,223
'4155036000,  양성면,'45,40 - 44세,1998,495,258,237
'4155036000,  양성면,'50,45 - 49세,1998,340,174,166
'4155036000,  양성면,'55,50 - 54세,1998,304,155,149
'4155036000,  양성면,'60,55 - 59세,1998,373,165,208
'4155036000,  양성면,'65,60 - 64세,1998,348,149,199
'4155036000,  양성면,'70,65 - 69세,1998,307,138,169
'4155036000,  양성면,'75,70 - 74세,1998,208,87,121
'4155036000,  양성면,'80,75 - 79세,1998,151,61,90
'4155036000,  양성면,'85,80 - 84세,1998,92,37,55
'4155036000,  양성면,'90,85+ ,1998,47,19,28
'4155037000,  공도면,'00,계,1998,14038,7195,6843
'4155037000,  공도면,'05,0 - 4세,1998,1139,571,568
'4155037000,  공도면,'10,5 - 9세,1998,938,501,437
'4155037000,  공도면,'15,10 - 14세,1998,824,448,376
'4155037000,  공도면,'20,15 - 19세,1998,1049,538,511
'4155037000,  공도면,'25,20 - 24세,1998,1124,599,525
'4155037000,  공도면,'30,25 - 29세,1998,1595,852,743
'4155037000,  공도면,'35,30 - 34세,1998,1361,743,618
'4155037000,  공도면,'40,35 - 39세,1998,1270,701,569
'4155037000,  공도면,'45,40 - 44세,1998,936,501,435
'4155037000,  공도면,'50,45 - 49세,1998,717,375,342
'4155037000,  공도면,'55,50 - 54세,1998,627,310,317
'4155037000,  공도면,'60,55 - 59세,1998,686,318,368
'4155037000,  공도면,'65,60 - 64세,1998,636,285,351
'4155037000,  공도면,'70,65 - 69세,1998,443,196,247
'4155037000,  공도면,'75,70 - 74세,1998,285,110,175
'4155037000,  공도면,'80,75 - 79세,1998,240,98,142
'4155037000,  공도면,'85,80 - 84세,1998,104,34,70
'4155037000,  공도면,'90,85+ ,1998,64,15,49
'4155038000,  원곡면,'00,계,1998,3930,1988,1942
'4155038000,  원곡면,'05,0 - 4세,1998,214,107,107
'4155038000,  원곡면,'10,5 - 9세,1998,216,109,107
'4155038000,  원곡면,'15,10 - 14세,1998,233,122,111
'4155038000,  원곡면,'20,15 - 19세,1998,393,203,190
'4155038000,  원곡면,'25,20 - 24세,1998,309,156,153
'4155038000,  원곡면,'30,25 - 29세,1998,294,166,128
'4155038000,  원곡면,'35,30 - 34세,1998,258,141,117
'4155038000,  원곡면,'40,35 - 39세,1998,289,165,124
'4155038000,  원곡면,'45,40 - 44세,1998,297,160,137
'4155038000,  원곡면,'50,45 - 49세,1998,226,123,103
'4155038000,  원곡면,'55,50 - 54세,1998,217,117,100
'4155038000,  원곡면,'60,55 - 59세,1998,249,96,153
'4155038000,  원곡면,'65,60 - 64세,1998,248,118,130
'4155038000,  원곡면,'70,65 - 69세,1998,193,89,104
'4155038000,  원곡면,'75,70 - 74세,1998,128,55,73
'4155038000,  원곡면,'80,75 - 79세,1998,81,34,47
'4155038000,  원곡면,'85,80 - 84세,1998,48,14,34
'4155038000,  원곡면,'90,85+ ,1998,37,13,24
'4155039000,  일죽면,'00,계,1998,8879,4514,4365
'4155039000,  일죽면,'05,0 - 4세,1998,460,249,211
'4155039000,  일죽면,'10,5 - 9세,1998,527,257,270
'4155039000,  일죽면,'15,10 - 14세,1998,536,261,275
'4155039000,  일죽면,'20,15 - 19세,1998,824,430,394
'4155039000,  일죽면,'25,20 - 24세,1998,764,424,340
'4155039000,  일죽면,'30,25 - 29세,1998,622,375,247
'4155039000,  일죽면,'35,30 - 34세,1998,566,296,270
'4155039000,  일죽면,'40,35 - 39세,1998,685,362,323
'4155039000,  일죽면,'45,40 - 44세,1998,661,352,309
'4155039000,  일죽면,'50,45 - 49세,1998,542,305,237
'4155039000,  일죽면,'55,50 - 54세,1998,470,234,236
'4155039000,  일죽면,'60,55 - 59세,1998,561,268,293
'4155039000,  일죽면,'65,60 - 64세,1998,560,250,310
'4155039000,  일죽면,'70,65 - 69세,1998,413,162,251
'4155039000,  일죽면,'75,70 - 74세,1998,302,144,158
'4155039000,  일죽면,'80,75 - 79세,1998,214,86,128
'4155039000,  일죽면,'85,80 - 84세,1998,104,32,72
'4155039000,  일죽면,'90,85+ ,1998,68,27,41
'4155040000,  죽산면,'00,계,1998,7665,3906,3759
'4155040000,  죽산면,'05,0 - 4세,1998,461,251,210
'4155040000,  죽산면,'10,5 - 9세,1998,461,249,212
'4155040000,  죽산면,'15,10 - 14세,1998,454,221,233
'4155040000,  죽산면,'20,15 - 19세,1998,661,323,338
'4155040000,  죽산면,'25,20 - 24세,1998,607,345,262
'4155040000,  죽산면,'30,25 - 29세,1998,664,390,274
'4155040000,  죽산면,'35,30 - 34세,1998,535,290,245
'4155040000,  죽산면,'40,35 - 39세,1998,612,323,289
'4155040000,  죽산면,'45,40 - 44세,1998,519,284,235
'4155040000,  죽산면,'50,45 - 49세,1998,418,211,207
'4155040000,  죽산면,'55,50 - 54세,1998,406,190,216
'4155040000,  죽산면,'60,55 - 59세,1998,486,232,254
'4155040000,  죽산면,'65,60 - 64세,1998,550,264,286
'4155040000,  죽산면,'70,65 - 69세,1998,329,141,188
'4155040000,  죽산면,'75,70 - 74세,1998,217,82,135
'4155040000,  죽산면,'80,75 - 79세,1998,162,64,98
'4155040000,  죽산면,'85,80 - 84세,1998,81,33,48
'4155040000,  죽산면,'90,85+ ,1998,42,13,29
'4155041000,  삼죽면,'00,계,1998,3988,2089,1899
'4155041000,  삼죽면,'05,0 - 4세,1998,194,110,84
'4155041000,  삼죽면,'10,5 - 9세,1998,220,131,89
'4155041000,  삼죽면,'15,10 - 14세,1998,172,98,74
'4155041000,  삼죽면,'20,15 - 19세,1998,335,170,165
'4155041000,  삼죽면,'25,20 - 24세,1998,351,202,149
'4155041000,  삼죽면,'30,25 - 29세,1998,311,188,123
'4155041000,  삼죽면,'35,30 - 34세,1998,263,146,117
'4155041000,  삼죽면,'40,35 - 39세,1998,304,186,118
'4155041000,  삼죽면,'45,40 - 44세,1998,263,142,121
'4155041000,  삼죽면,'50,45 - 49세,1998,209,98,111
'4155041000,  삼죽면,'55,50 - 54세,1998,229,115,114
'4155041000,  삼죽면,'60,55 - 59세,1998,293,124,169
'4155041000,  삼죽면,'65,60 - 64세,1998,315,146,169
'4155041000,  삼죽면,'70,65 - 69세,1998,230,107,123
'4155041000,  삼죽면,'75,70 - 74세,1998,120,52,68
'4155041000,  삼죽면,'80,75 - 79세,1998,94,40,54
'4155041000,  삼죽면,'85,80 - 84세,1998,63,28,35
'4155041000,  삼죽면,'90,85+ ,1998,22,6,16
'4155042000,  고삼면,'00,계,1998,2372,1204,1168
'4155042000,  고삼면,'05,0 - 4세,1998,101,56,45
'4155042000,  고삼면,'10,5 - 9세,1998,117,68,49
'4155042000,  고삼면,'15,10 - 14세,1998,166,83,83
'4155042000,  고삼면,'20,15 - 19세,1998,230,114,116
'4155042000,  고삼면,'25,20 - 24세,1998,168,95,73
'4155042000,  고삼면,'30,25 - 29세,1998,182,111,71
'4155042000,  고삼면,'35,30 - 34세,1998,131,75,56
'4155042000,  고삼면,'40,35 - 39세,1998,185,95,90
'4155042000,  고삼면,'45,40 - 44세,1998,179,106,73
'4155042000,  고삼면,'50,45 - 49세,1998,121,52,69
'4155042000,  고삼면,'55,50 - 54세,1998,110,55,55
'4155042000,  고삼면,'60,55 - 59세,1998,152,66,86
'4155042000,  고삼면,'65,60 - 64세,1998,169,89,80
'4155042000,  고삼면,'70,65 - 69세,1998,156,57,99
'4155042000,  고삼면,'75,70 - 74세,1998,88,38,50
'4155042000,  고삼면,'80,75 - 79세,1998,60,27,33
'4155042000,  고삼면,'85,80 - 84세,1998,42,15,27
'4155042000,  고삼면,'90,85+ ,1998,15,2,13
'4155051000,  안성1동,'00,계,1998,16579,8239,8340
'4155051000,  안성1동,'05,0 - 4세,1998,1120,565,555
'4155051000,  안성1동,'10,5 - 9세,1998,1379,708,671
'4155051000,  안성1동,'15,10 - 14세,1998,1221,638,583
'4155051000,  안성1동,'20,15 - 19세,1998,1513,795,718
'4155051000,  안성1동,'25,20 - 24세,1998,1356,687,669
'4155051000,  안성1동,'30,25 - 29세,1998,1425,750,675
'4155051000,  안성1동,'35,30 - 34세,1998,1363,662,701
'4155051000,  안성1동,'40,35 - 39세,1998,1605,801,804
'4155051000,  안성1동,'45,40 - 44세,1998,1277,656,621
'4155051000,  안성1동,'50,45 - 49세,1998,904,434,470
'4155051000,  안성1동,'55,50 - 54세,1998,798,396,402
'4155051000,  안성1동,'60,55 - 59세,1998,731,364,367
'4155051000,  안성1동,'65,60 - 64세,1998,685,326,359
'4155051000,  안성1동,'70,65 - 69세,1998,424,171,253
'4155051000,  안성1동,'75,70 - 74세,1998,314,120,194
'4155051000,  안성1동,'80,75 - 79세,1998,255,98,157
'4155051000,  안성1동,'85,80 - 84세,1998,133,48,85
'4155051000,  안성1동,'90,85+ ,1998,76,20,56
'4155052000,  안성2동,'00,계,1998,15488,7805,7683
'4155052000,  안성2동,'05,0 - 4세,1998,1273,704,569
'4155052000,  안성2동,'10,5 - 9세,1998,1207,624,583
'4155052000,  안성2동,'15,10 - 14세,1998,1094,580,514
'4155052000,  안성2동,'20,15 - 19세,1998,1345,690,655
'4155052000,  안성2동,'25,20 - 24세,1998,1266,629,637
'4155052000,  안성2동,'30,25 - 29세,1998,1587,748,839
'4155052000,  안성2동,'35,30 - 34세,1998,1581,833,748
'4155052000,  안성2동,'40,35 - 39세,1998,1586,858,728
'4155052000,  안성2동,'45,40 - 44세,1998,1152,619,533
'4155052000,  안성2동,'50,45 - 49세,1998,757,387,370
'4155052000,  안성2동,'55,50 - 54세,1998,640,311,329
'4155052000,  안성2동,'60,55 - 59세,1998,562,253,309
'4155052000,  안성2동,'65,60 - 64세,1998,507,227,280
'4155052000,  안성2동,'70,65 - 69세,1998,371,141,230
'4155052000,  안성2동,'75,70 - 74세,1998,257,94,163
'4155052000,  안성2동,'80,75 - 79세,1998,172,65,107
'4155052000,  안성2동,'85,80 - 84세,1998,94,26,68
'4155052000,  안성2동,'90,85+ ,1998,37,16,21
'4155053000,  안성3동,'00,계,1998,21092,10450,10642
'4155053000,  안성3동,'05,0 - 4세,1998,2089,1052,1037
'4155053000,  안성3동,'10,5 - 9세,1998,2045,1072,973
'4155053000,  안성3동,'15,10 - 14세,1998,1602,814,788
'4155053000,  안성3동,'20,15 - 19세,1998,1614,801,813
'4155053000,  안성3동,'25,20 - 24세,1998,1444,674,770
'4155053000,  안성3동,'30,25 - 29세,1998,2196,1013,1183
'4155053000,  안성3동,'35,30 - 34세,1998,2433,1245,1188
'4155053000,  안성3동,'40,35 - 39세,1998,2255,1195,1060
'4155053000,  안성3동,'45,40 - 44세,1998,1520,778,742
'4155053000,  안성3동,'50,45 - 49세,1998,889,492,397
'4155053000,  안성3동,'55,50 - 54세,1998,733,369,364
'4155053000,  안성3동,'60,55 - 59세,1998,698,321,377
'4155053000,  안성3동,'65,60 - 64세,1998,592,284,308
'4155053000,  안성3동,'70,65 - 69세,1998,366,139,227
'4155053000,  안성3동,'75,70 - 74세,1998,283,97,186
'4155053000,  안성3동,'80,75 - 79세,1998,185,68,117
'4155053000,  안성3동,'85,80 - 84세,1998,89,27,62
'4155053000,  안성3동,'90,85+ ,1998,59,9,50
'41570, 김포시,'00,계,1998,127865,65379,62486
'41570, 김포시,'05,0 - 4세,1998,10507,5567,4940
'41570, 김포시,'10,5 - 9세,1998,10733,5522,5211
'41570, 김포시,'15,10 - 14세,1998,8146,4041,4105
'41570, 김포시,'20,15 - 19세,1998,8868,4504,4364
'41570, 김포시,'25,20 - 24세,1998,8958,4790,4168
'41570, 김포시,'30,25 - 29세,1998,11633,5979,5654
'41570, 김포시,'35,30 - 34세,1998,13551,6921,6630
'41570, 김포시,'40,35 - 39세,1998,14142,7894,6248
'41570, 김포시,'45,40 - 44세,1998,9860,5567,4293
'41570, 김포시,'50,45 - 49세,1998,6203,3238,2965
'41570, 김포시,'55,50 - 54세,1998,5622,2906,2716
'41570, 김포시,'60,55 - 59세,1998,5612,2665,2947
'41570, 김포시,'65,60 - 64세,1998,4979,2377,2602
'41570, 김포시,'70,65 - 69세,1998,3446,1375,2071
'41570, 김포시,'75,70 - 74세,1998,2412,878,1534
'41570, 김포시,'80,75 - 79세,1998,1683,671,1012
'41570, 김포시,'85,80 - 84세,1998,956,326,630
'41570, 김포시,'90,85+ ,1998,554,158,396
'4157031000,  고촌면,'00,계,1998,12028,6196,5832
'4157031000,  고촌면,'05,0 - 4세,1998,825,436,389
'4157031000,  고촌면,'10,5 - 9세,1998,920,459,461
'4157031000,  고촌면,'15,10 - 14세,1998,688,345,343
'4157031000,  고촌면,'20,15 - 19세,1998,885,465,420
'4157031000,  고촌면,'25,20 - 24세,1998,891,459,432
'4157031000,  고촌면,'30,25 - 29세,1998,1024,553,471
'4157031000,  고촌면,'35,30 - 34세,1998,1116,578,538
'4157031000,  고촌면,'40,35 - 39세,1998,1287,726,561
'4157031000,  고촌면,'45,40 - 44세,1998,1012,573,439
'4157031000,  고촌면,'50,45 - 49세,1998,665,377,288
'4157031000,  고촌면,'55,50 - 54세,1998,631,329,302
'4157031000,  고촌면,'60,55 - 59세,1998,607,286,321
'4157031000,  고촌면,'65,60 - 64세,1998,524,263,261
'4157031000,  고촌면,'70,65 - 69세,1998,383,139,244
'4157031000,  고촌면,'75,70 - 74세,1998,258,99,159
'4157031000,  고촌면,'80,75 - 79세,1998,180,71,109
'4157031000,  고촌면,'85,80 - 84세,1998,89,28,61
'4157031000,  고촌면,'90,85+ ,1998,43,10,33
'4157032000,  양촌면,'00,계,1998,12583,6485,6098
'4157032000,  양촌면,'05,0 - 4세,1998,701,375,326
'4157032000,  양촌면,'10,5 - 9세,1998,769,408,361
'4157032000,  양촌면,'15,10 - 14세,1998,702,349,353
'4157032000,  양촌면,'20,15 - 19세,1998,1087,562,525
'4157032000,  양촌면,'25,20 - 24세,1998,1043,570,473
'4157032000,  양촌면,'30,25 - 29세,1998,1052,587,465
'4157032000,  양촌면,'35,30 - 34세,1998,1006,557,449
'4157032000,  양촌면,'40,35 - 39세,1998,1179,688,491
'4157032000,  양촌면,'45,40 - 44세,1998,987,530,457
'4157032000,  양촌면,'50,45 - 49세,1998,763,390,373
'4157032000,  양촌면,'55,50 - 54세,1998,687,363,324
'4157032000,  양촌면,'60,55 - 59세,1998,739,346,393
'4157032000,  양촌면,'65,60 - 64세,1998,616,300,316
'4157032000,  양촌면,'70,65 - 69세,1998,454,178,276
'4157032000,  양촌면,'75,70 - 74세,1998,293,96,197
'4157032000,  양촌면,'80,75 - 79세,1998,259,105,154
'4157032000,  양촌면,'85,80 - 84세,1998,159,52,107
'4157032000,  양촌면,'90,85+ ,1998,87,29,58
'4157033000,  통진면,'00,계,1998,17063,8710,8353
'4157033000,  통진면,'05,0 - 4세,1998,1437,745,692
'4157033000,  통진면,'10,5 - 9세,1998,1288,682,606
'4157033000,  통진면,'15,10 - 14세,1998,1128,571,557
'4157033000,  통진면,'20,15 - 19세,1998,1224,594,630
'4157033000,  통진면,'25,20 - 24세,1998,1348,727,621
'4157033000,  통진면,'30,25 - 29세,1998,1723,924,799
'4157033000,  통진면,'35,30 - 34세,1998,1692,890,802
'4157033000,  통진면,'40,35 - 39세,1998,1745,953,792
'4157033000,  통진면,'45,40 - 44세,1998,1296,713,583
'4157033000,  통진면,'50,45 - 49세,1998,808,397,411
'4157033000,  통진면,'55,50 - 54세,1998,716,373,343
'4157033000,  통진면,'60,55 - 59세,1998,722,328,394
'4157033000,  통진면,'65,60 - 64세,1998,694,331,363
'4157033000,  통진면,'70,65 - 69세,1998,489,203,286
'4157033000,  통진면,'75,70 - 74세,1998,320,125,195
'4157033000,  통진면,'80,75 - 79세,1998,233,92,141
'4157033000,  통진면,'85,80 - 84세,1998,133,44,89
'4157033000,  통진면,'90,85+ ,1998,67,18,49
'4157034000,  대곶면,'00,계,1998,9373,4850,4523
'4157034000,  대곶면,'05,0 - 4세,1998,556,272,284
'4157034000,  대곶면,'10,5 - 9세,1998,598,315,283
'4157034000,  대곶면,'15,10 - 14세,1998,522,248,274
'4157034000,  대곶면,'20,15 - 19세,1998,707,345,362
'4157034000,  대곶면,'25,20 - 24세,1998,797,445,352
'4157034000,  대곶면,'30,25 - 29세,1998,799,487,312
'4157034000,  대곶면,'35,30 - 34세,1998,770,436,334
'4157034000,  대곶면,'40,35 - 39세,1998,830,487,343
'4157034000,  대곶면,'45,40 - 44세,1998,655,363,292
'4157034000,  대곶면,'50,45 - 49세,1998,496,246,250
'4157034000,  대곶면,'55,50 - 54세,1998,555,292,263
'4157034000,  대곶면,'60,55 - 59세,1998,556,260,296
'4157034000,  대곶면,'65,60 - 64세,1998,525,251,274
'4157034000,  대곶면,'70,65 - 69세,1998,342,151,191
'4157034000,  대곶면,'75,70 - 74세,1998,293,108,185
'4157034000,  대곶면,'80,75 - 79세,1998,181,77,104
'4157034000,  대곶면,'85,80 - 84세,1998,121,49,72
'4157034000,  대곶면,'90,85+ ,1998,70,18,52
'4157035000,  월곶면,'00,계,1998,6269,3254,3015
'4157035000,  월곶면,'05,0 - 4세,1998,316,172,144
'4157035000,  월곶면,'10,5 - 9세,1998,383,201,182
'4157035000,  월곶면,'15,10 - 14세,1998,351,157,194
'4157035000,  월곶면,'20,15 - 19세,1998,511,256,255
'4157035000,  월곶면,'25,20 - 24세,1998,509,294,215
'4157035000,  월곶면,'30,25 - 29세,1998,551,343,208
'4157035000,  월곶면,'35,30 - 34세,1998,490,283,207
'4157035000,  월곶면,'40,35 - 39세,1998,523,280,243
'4157035000,  월곶면,'45,40 - 44세,1998,547,306,241
'4157035000,  월곶면,'50,45 - 49세,1998,339,167,172
'4157035000,  월곶면,'55,50 - 54세,1998,342,180,162
'4157035000,  월곶면,'60,55 - 59세,1998,363,171,192
'4157035000,  월곶면,'65,60 - 64세,1998,341,170,171
'4157035000,  월곶면,'70,65 - 69세,1998,247,91,156
'4157035000,  월곶면,'75,70 - 74세,1998,195,83,112
'4157035000,  월곶면,'80,75 - 79세,1998,130,57,73
'4157035000,  월곶면,'85,80 - 84세,1998,79,24,55
'4157035000,  월곶면,'90,85+ ,1998,52,19,33
'4157036000,  하성면,'00,계,1998,9387,4810,4577
'4157036000,  하성면,'05,0 - 4세,1998,524,288,236
'4157036000,  하성면,'10,5 - 9세,1998,586,309,277
'4157036000,  하성면,'15,10 - 14세,1998,598,292,306
'4157036000,  하성면,'20,15 - 19세,1998,751,376,375
'4157036000,  하성면,'25,20 - 24세,1998,756,439,317
'4157036000,  하성면,'30,25 - 29세,1998,762,435,327
'4157036000,  하성면,'35,30 - 34세,1998,717,390,327
'4157036000,  하성면,'40,35 - 39세,1998,849,453,396
'4157036000,  하성면,'45,40 - 44세,1998,712,396,316
'4157036000,  하성면,'50,45 - 49세,1998,514,268,246
'4157036000,  하성면,'55,50 - 54세,1998,531,267,264
'4157036000,  하성면,'60,55 - 59세,1998,543,253,290
'4157036000,  하성면,'65,60 - 64세,1998,554,270,284
'4157036000,  하성면,'70,65 - 69세,1998,379,155,224
'4157036000,  하성면,'75,70 - 74세,1998,250,86,164
'4157036000,  하성면,'80,75 - 79세,1998,201,80,121
'4157036000,  하성면,'85,80 - 84세,1998,102,38,64
'4157036000,  하성면,'90,85+ ,1998,58,15,43
'4157051000,  김포1동,'00,계,1998,29853,14969,14884
'4157051000,  김포1동,'05,0 - 4세,1998,2904,1513,1391
'4157051000,  김포1동,'10,5 - 9세,1998,3309,1662,1647
'4157051000,  김포1동,'15,10 - 14세,1998,2266,1133,1133
'4157051000,  김포1동,'20,15 - 19세,1998,1806,899,907
'4157051000,  김포1동,'25,20 - 24세,1998,1636,850,786
'4157051000,  김포1동,'30,25 - 29세,1998,2510,1160,1350
'4157051000,  김포1동,'35,30 - 34세,1998,3629,1655,1974
'4157051000,  김포1동,'40,35 - 39세,1998,4121,2252,1869
'4157051000,  김포1동,'45,40 - 44세,1998,2384,1370,1014
'4157051000,  김포1동,'50,45 - 49세,1998,1231,669,562
'4157051000,  김포1동,'55,50 - 54세,1998,995,511,484
'4157051000,  김포1동,'60,55 - 59세,1998,940,448,492
'4157051000,  김포1동,'65,60 - 64세,1998,755,355,400
'4157051000,  김포1동,'70,65 - 69세,1998,541,206,335
'4157051000,  김포1동,'75,70 - 74세,1998,392,131,261
'4157051000,  김포1동,'80,75 - 79세,1998,237,92,145
'4157051000,  김포1동,'85,80 - 84세,1998,122,42,80
'4157051000,  김포1동,'90,85+ ,1998,75,21,54
'4157052000,  김포2동,'00,계,1998,5928,3106,2822
'4157052000,  김포2동,'05,0 - 4세,1998,382,206,176
'4157052000,  김포2동,'10,5 - 9세,1998,468,228,240
'4157052000,  김포2동,'15,10 - 14세,1998,398,201,197
'4157052000,  김포2동,'20,15 - 19세,1998,453,234,219
'4157052000,  김포2동,'25,20 - 24세,1998,412,217,195
'4157052000,  김포2동,'30,25 - 29세,1998,540,285,255
'4157052000,  김포2동,'35,30 - 34세,1998,588,313,275
'4157052000,  김포2동,'40,35 - 39세,1998,624,352,272
'4157052000,  김포2동,'45,40 - 44세,1998,484,296,188
'4157052000,  김포2동,'50,45 - 49세,1998,296,170,126
'4157052000,  김포2동,'55,50 - 54세,1998,276,149,127
'4157052000,  김포2동,'60,55 - 59세,1998,297,159,138
'4157052000,  김포2동,'65,60 - 64세,1998,260,119,141
'4157052000,  김포2동,'70,65 - 69세,1998,183,69,114
'4157052000,  김포2동,'75,70 - 74세,1998,122,54,68
'4157052000,  김포2동,'80,75 - 79세,1998,76,28,48
'4157052000,  김포2동,'85,80 - 84세,1998,41,16,25
'4157052000,  김포2동,'90,85+ ,1998,28,10,18
'4157053000,  김포3동,'00,계,1998,25381,12999,12382
'4157053000,  김포3동,'05,0 - 4세,1998,2862,1560,1302
'4157053000,  김포3동,'10,5 - 9세,1998,2412,1258,1154
'4157053000,  김포3동,'15,10 - 14세,1998,1493,745,748
'4157053000,  김포3동,'20,15 - 19세,1998,1444,773,671
'4157053000,  김포3동,'25,20 - 24세,1998,1566,789,777
'4157053000,  김포3동,'30,25 - 29세,1998,2672,1205,1467
'4157053000,  김포3동,'35,30 - 34세,1998,3543,1819,1724
'4157053000,  김포3동,'40,35 - 39세,1998,2984,1703,1281
'4157053000,  김포3동,'45,40 - 44세,1998,1783,1020,763
'4157053000,  김포3동,'50,45 - 49세,1998,1091,554,537
'4157053000,  김포3동,'55,50 - 54세,1998,889,442,447
'4157053000,  김포3동,'60,55 - 59세,1998,845,414,431
'4157053000,  김포3동,'65,60 - 64세,1998,710,318,392
'4157053000,  김포3동,'70,65 - 69세,1998,428,183,245
'4157053000,  김포3동,'75,70 - 74세,1998,289,96,193
'4157053000,  김포3동,'80,75 - 79세,1998,186,69,117
'4157053000,  김포3동,'85,80 - 84세,1998,110,33,77
'4157053000,  김포3동,'90,85+ ,1998,74,18,56
'41710, 양주군,'00,계,1998,101810,52876,48934
'41710, 양주군,'05,0 - 4세,1998,8073,4189,3884
'41710, 양주군,'10,5 - 9세,1998,8324,4303,4021
'41710, 양주군,'15,10 - 14세,1998,7240,3714,3526
'41710, 양주군,'20,15 - 19세,1998,7883,4066,3817
'41710, 양주군,'25,20 - 24세,1998,7208,3918,3290
'41710, 양주군,'30,25 - 29세,1998,9609,5038,4571
'41710, 양주군,'35,30 - 34세,1998,10435,5574,4861
'41710, 양주군,'40,35 - 39세,1998,10789,5956,4833
'41710, 양주군,'45,40 - 44세,1998,8278,4732,3546
'41710, 양주군,'50,45 - 49세,1998,4837,2605,2232
'41710, 양주군,'55,50 - 54세,1998,4225,2245,1980
'41710, 양주군,'60,55 - 59세,1998,4297,2089,2208
'41710, 양주군,'65,60 - 64세,1998,3871,1827,2044
'41710, 양주군,'70,65 - 69세,1998,2560,1068,1492
'41710, 양주군,'75,70 - 74세,1998,1809,689,1120
'41710, 양주군,'80,75 - 79세,1998,1281,518,763
'41710, 양주군,'85,80 - 84세,1998,704,239,465
'41710, 양주군,'90,85+ ,1998,387,106,281
'4171025000,  회천읍,'00,계,1998,36101,18706,17395
'4171025000,  회천읍,'05,0 - 4세,1998,3216,1698,1518
'4171025000,  회천읍,'10,5 - 9세,1998,3336,1720,1616
'4171025000,  회천읍,'15,10 - 14세,1998,2863,1473,1390
'4171025000,  회천읍,'20,15 - 19세,1998,2670,1347,1323
'4171025000,  회천읍,'25,20 - 24세,1998,2393,1269,1124
'4171025000,  회천읍,'30,25 - 29세,1998,3539,1793,1746
'4171025000,  회천읍,'35,30 - 34세,1998,4180,2133,2047
'4171025000,  회천읍,'40,35 - 39세,1998,4272,2377,1895
'4171025000,  회천읍,'45,40 - 44세,1998,2955,1718,1237
'4171025000,  회천읍,'50,45 - 49세,1998,1501,816,685
'4171025000,  회천읍,'55,50 - 54세,1998,1279,681,598
'4171025000,  회천읍,'60,55 - 59세,1998,1205,588,617
'4171025000,  회천읍,'65,60 - 64세,1998,1013,471,542
'4171025000,  회천읍,'70,65 - 69세,1998,663,272,391
'4171025000,  회천읍,'75,70 - 74세,1998,439,147,292
'4171025000,  회천읍,'80,75 - 79세,1998,311,134,177
'4171025000,  회천읍,'85,80 - 84세,1998,170,47,123
'4171025000,  회천읍,'90,85+ ,1998,96,22,74
'4171031000,  주내면,'00,계,1998,14143,7316,6827
'4171031000,  주내면,'05,0 - 4세,1998,897,471,426
'4171031000,  주내면,'10,5 - 9세,1998,993,505,488
'4171031000,  주내면,'15,10 - 14세,1998,1019,524,495
'4171031000,  주내면,'20,15 - 19세,1998,1206,605,601
'4171031000,  주내면,'25,20 - 24세,1998,1059,576,483
'4171031000,  주내면,'30,25 - 29세,1998,1255,674,581
'4171031000,  주내면,'35,30 - 34세,1998,1285,713,572
'4171031000,  주내면,'40,35 - 39세,1998,1360,756,604
'4171031000,  주내면,'45,40 - 44세,1998,1205,668,537
'4171031000,  주내면,'50,45 - 49세,1998,726,371,355
'4171031000,  주내면,'55,50 - 54세,1998,670,346,324
'4171031000,  주내면,'60,55 - 59세,1998,721,356,365
'4171031000,  주내면,'65,60 - 64세,1998,646,319,327
'4171031000,  주내면,'70,65 - 69세,1998,430,188,242
'4171031000,  주내면,'75,70 - 74세,1998,294,116,178
'4171031000,  주내면,'80,75 - 79세,1998,189,65,124
'4171031000,  주내면,'85,80 - 84세,1998,119,40,79
'4171031000,  주내면,'90,85+ ,1998,69,23,46
'4171032000,  은현면,'00,계,1998,9103,4777,4326
'4171032000,  은현면,'05,0 - 4세,1998,629,300,329
'4171032000,  은현면,'10,5 - 9세,1998,641,350,291
'4171032000,  은현면,'15,10 - 14세,1998,657,322,335
'4171032000,  은현면,'20,15 - 19세,1998,779,393,386
'4171032000,  은현면,'25,20 - 24세,1998,688,376,312
'4171032000,  은현면,'30,25 - 29세,1998,848,494,354
'4171032000,  은현면,'35,30 - 34세,1998,785,435,350
'4171032000,  은현면,'40,35 - 39세,1998,856,460,396
'4171032000,  은현면,'45,40 - 44세,1998,747,422,325
'4171032000,  은현면,'50,45 - 49세,1998,506,295,211
'4171032000,  은현면,'55,50 - 54세,1998,429,223,206
'4171032000,  은현면,'60,55 - 59세,1998,460,236,224
'4171032000,  은현면,'65,60 - 64세,1998,398,198,200
'4171032000,  은현면,'70,65 - 69세,1998,243,109,134
'4171032000,  은현면,'75,70 - 74세,1998,200,80,120
'4171032000,  은현면,'80,75 - 79세,1998,127,43,84
'4171032000,  은현면,'85,80 - 84세,1998,67,25,42
'4171032000,  은현면,'90,85+ ,1998,43,16,27
'4171033000,  남면,'00,계,1998,9433,4923,4510
'4171033000,  남면,'05,0 - 4세,1998,672,337,335
'4171033000,  남면,'10,5 - 9세,1998,733,412,321
'4171033000,  남면,'15,10 - 14세,1998,628,310,318
'4171033000,  남면,'20,15 - 19세,1998,752,389,363
'4171033000,  남면,'25,20 - 24세,1998,653,348,305
'4171033000,  남면,'30,25 - 29세,1998,864,500,364
'4171033000,  남면,'35,30 - 34세,1998,859,464,395
'4171033000,  남면,'40,35 - 39세,1998,947,511,436
'4171033000,  남면,'45,40 - 44세,1998,768,475,293
'4171033000,  남면,'50,45 - 49세,1998,475,265,210
'4171033000,  남면,'55,50 - 54세,1998,395,211,184
'4171033000,  남면,'60,55 - 59세,1998,416,187,229
'4171033000,  남면,'65,60 - 64세,1998,425,194,231
'4171033000,  남면,'70,65 - 69세,1998,312,119,193
'4171033000,  남면,'75,70 - 74세,1998,229,86,143
'4171033000,  남면,'80,75 - 79세,1998,170,70,100
'4171033000,  남면,'85,80 - 84세,1998,92,32,60
'4171033000,  남면,'90,85+ ,1998,43,13,30
'4171034000,  광적면,'00,계,1998,11386,5983,5403
'4171034000,  광적면,'05,0 - 4세,1998,871,448,423
'4171034000,  광적면,'10,5 - 9세,1998,931,472,459
'4171034000,  광적면,'15,10 - 14세,1998,755,373,382
'4171034000,  광적면,'20,15 - 19세,1998,865,463,402
'4171034000,  광적면,'25,20 - 24세,1998,874,478,396
'4171034000,  광적면,'30,25 - 29세,1998,1055,568,487
'4171034000,  광적면,'35,30 - 34세,1998,1135,618,517
'4171034000,  광적면,'40,35 - 39세,1998,1208,685,523
'4171034000,  광적면,'45,40 - 44세,1998,853,485,368
'4171034000,  광적면,'50,45 - 49세,1998,547,301,246
'4171034000,  광적면,'55,50 - 54세,1998,502,283,219
'4171034000,  광적면,'60,55 - 59세,1998,495,253,242
'4171034000,  광적면,'65,60 - 64세,1998,480,230,250
'4171034000,  광적면,'70,65 - 69세,1998,310,129,181
'4171034000,  광적면,'75,70 - 74세,1998,219,92,127
'4171034000,  광적면,'80,75 - 79세,1998,161,63,98
'4171034000,  광적면,'85,80 - 84세,1998,79,30,49
'4171034000,  광적면,'90,85+ ,1998,46,12,34
'4171035000,  백석면,'00,계,1998,13433,6928,6505
'4171035000,  백석면,'05,0 - 4세,1998,1191,624,567
'4171035000,  백석면,'10,5 - 9세,1998,1152,570,582
'4171035000,  백석면,'15,10 - 14세,1998,870,461,409
'4171035000,  백석면,'20,15 - 19세,1998,962,538,424
'4171035000,  백석면,'25,20 - 24세,1998,893,496,397
'4171035000,  백석면,'30,25 - 29세,1998,1311,613,698
'4171035000,  백석면,'35,30 - 34세,1998,1507,832,675
'4171035000,  백석면,'40,35 - 39세,1998,1435,766,669
'4171035000,  백석면,'45,40 - 44세,1998,1064,608,456
'4171035000,  백석면,'50,45 - 49세,1998,608,339,269
'4171035000,  백석면,'55,50 - 54세,1998,478,237,241
'4171035000,  백석면,'60,55 - 59세,1998,571,265,306
'4171035000,  백석면,'65,60 - 64세,1998,521,227,294
'4171035000,  백석면,'70,65 - 69세,1998,332,148,184
'4171035000,  백석면,'75,70 - 74세,1998,221,89,132
'4171035000,  백석면,'80,75 - 79세,1998,173,74,99
'4171035000,  백석면,'85,80 - 84세,1998,89,32,57
'4171035000,  백석면,'90,85+ ,1998,55,9,46
'4171036000,  장흥면,'00,계,1998,8211,4243,3968
'4171036000,  장흥면,'05,0 - 4세,1998,597,311,286
'4171036000,  장흥면,'10,5 - 9세,1998,538,274,264
'4171036000,  장흥면,'15,10 - 14세,1998,448,251,197
'4171036000,  장흥면,'20,15 - 19세,1998,649,331,318
'4171036000,  장흥면,'25,20 - 24세,1998,648,375,273
'4171036000,  장흥면,'30,25 - 29세,1998,737,396,341
'4171036000,  장흥면,'35,30 - 34세,1998,684,379,305
'4171036000,  장흥면,'40,35 - 39세,1998,711,401,310
'4171036000,  장흥면,'45,40 - 44세,1998,686,356,330
'4171036000,  장흥면,'50,45 - 49세,1998,474,218,256
'4171036000,  장흥면,'55,50 - 54세,1998,472,264,208
'4171036000,  장흥면,'60,55 - 59세,1998,429,204,225
'4171036000,  장흥면,'65,60 - 64세,1998,388,188,200
'4171036000,  장흥면,'70,65 - 69세,1998,270,103,167
'4171036000,  장흥면,'75,70 - 74세,1998,207,79,128
'4171036000,  장흥면,'80,75 - 79세,1998,150,69,81
'4171036000,  장흥면,'85,80 - 84세,1998,88,33,55
'4171036000,  장흥면,'90,85+ ,1998,35,11,24
'41730, 여주군,'00,계,1998,101223,51289,49934
'41730, 여주군,'05,0 - 4세,1998,7013,3689,3324
'41730, 여주군,'10,5 - 9세,1998,7285,3846,3439
'41730, 여주군,'15,10 - 14세,1998,6680,3455,3225
'41730, 여주군,'20,15 - 19세,1998,8528,4201,4327
'41730, 여주군,'25,20 - 24세,1998,8155,4324,3831
'41730, 여주군,'30,25 - 29세,1998,8501,4637,3864
'41730, 여주군,'35,30 - 34세,1998,8699,4595,4104
'41730, 여주군,'40,35 - 39세,1998,8935,4736,4199
'41730, 여주군,'45,40 - 44세,1998,7381,3992,3389
'41730, 여주군,'50,45 - 49세,1998,5241,2751,2490
'41730, 여주군,'55,50 - 54세,1998,4648,2352,2296
'41730, 여주군,'60,55 - 59세,1998,5447,2566,2881
'41730, 여주군,'65,60 - 64세,1998,5197,2487,2710
'41730, 여주군,'70,65 - 69세,1998,3667,1469,2198
'41730, 여주군,'75,70 - 74세,1998,2566,995,1571
'41730, 여주군,'80,75 - 79세,1998,1794,691,1103
'41730, 여주군,'85,80 - 84세,1998,913,330,583
'41730, 여주군,'90,85+ ,1998,573,173,400
'4173025000,  여주읍,'00,계,1998,34169,17088,17081
'4173025000,  여주읍,'05,0 - 4세,1998,2742,1426,1316
'4173025000,  여주읍,'10,5 - 9세,1998,3234,1730,1504
'4173025000,  여주읍,'15,10 - 14세,1998,2614,1385,1229
'4173025000,  여주읍,'20,15 - 19세,1998,2913,1418,1495
'4173025000,  여주읍,'25,20 - 24세,1998,2468,1241,1227
'4173025000,  여주읍,'30,25 - 29세,1998,2970,1494,1476
'4173025000,  여주읍,'35,30 - 34세,1998,3462,1679,1783
'4173025000,  여주읍,'40,35 - 39세,1998,3595,1858,1737
'4173025000,  여주읍,'45,40 - 44세,1998,2671,1378,1293
'4173025000,  여주읍,'50,45 - 49세,1998,1719,912,807
'4173025000,  여주읍,'55,50 - 54세,1998,1305,671,634
'4173025000,  여주읍,'60,55 - 59세,1998,1348,631,717
'4173025000,  여주읍,'65,60 - 64세,1998,1106,524,582
'4173025000,  여주읍,'70,65 - 69세,1998,760,297,463
'4173025000,  여주읍,'75,70 - 74세,1998,552,201,351
'4173025000,  여주읍,'80,75 - 79세,1998,398,134,264
'4173025000,  여주읍,'85,80 - 84세,1998,197,66,131
'4173025000,  여주읍,'90,85+ ,1998,115,43,72
'4173031000,  점동면,'00,계,1998,5715,2863,2852
'4173031000,  점동면,'05,0 - 4세,1998,331,164,167
'4173031000,  점동면,'10,5 - 9세,1998,305,162,143
'4173031000,  점동면,'15,10 - 14세,1998,347,177,170
'4173031000,  점동면,'20,15 - 19세,1998,480,233,247
'4173031000,  점동면,'25,20 - 24세,1998,470,272,198
'4173031000,  점동면,'30,25 - 29세,1998,367,212,155
'4173031000,  점동면,'35,30 - 34세,1998,380,212,168
'4173031000,  점동면,'40,35 - 39세,1998,458,250,208
'4173031000,  점동면,'45,40 - 44세,1998,391,212,179
'4173031000,  점동면,'50,45 - 49세,1998,335,168,167
'4173031000,  점동면,'55,50 - 54세,1998,295,159,136
'4173031000,  점동면,'60,55 - 59세,1998,372,163,209
'4173031000,  점동면,'65,60 - 64세,1998,389,186,203
'4173031000,  점동면,'70,65 - 69세,1998,304,111,193
'4173031000,  점동면,'75,70 - 74세,1998,197,70,127
'4173031000,  점동면,'80,75 - 79세,1998,159,61,98
'4173031000,  점동면,'85,80 - 84세,1998,82,38,44
'4173031000,  점동면,'90,85+ ,1998,53,13,40
'4173032000,  가남면,'00,계,1998,13884,7178,6706
'4173032000,  가남면,'05,0 - 4세,1998,1030,567,463
'4173032000,  가남면,'10,5 - 9세,1998,926,479,447
'4173032000,  가남면,'15,10 - 14세,1998,833,423,410
'4173032000,  가남면,'20,15 - 19세,1998,1176,610,566
'4173032000,  가남면,'25,20 - 24세,1998,1197,623,574
'4173032000,  가남면,'30,25 - 29세,1998,1320,726,594
'4173032000,  가남면,'35,30 - 34세,1998,1204,672,532
'4173032000,  가남면,'40,35 - 39세,1998,1141,610,531
'4173032000,  가남면,'45,40 - 44세,1998,992,540,452
'4173032000,  가남면,'50,45 - 49세,1998,803,424,379
'4173032000,  가남면,'55,50 - 54세,1998,623,327,296
'4173032000,  가남면,'60,55 - 59세,1998,713,354,359
'4173032000,  가남면,'65,60 - 64세,1998,733,346,387
'4173032000,  가남면,'70,65 - 69세,1998,495,215,280
'4173032000,  가남면,'75,70 - 74세,1998,331,141,190
'4173032000,  가남면,'80,75 - 79세,1998,211,78,133
'4173032000,  가남면,'85,80 - 84세,1998,98,32,66
'4173032000,  가남면,'90,85+ ,1998,58,11,47
'4173033000,  흥천면,'00,계,1998,5777,2954,2823
'4173033000,  흥천면,'05,0 - 4세,1998,274,155,119
'4173033000,  흥천면,'10,5 - 9세,1998,299,134,165
'4173033000,  흥천면,'15,10 - 14세,1998,323,170,153
'4173033000,  흥천면,'20,15 - 19세,1998,515,257,258
'4173033000,  흥천면,'25,20 - 24세,1998,500,259,241
'4173033000,  흥천면,'30,25 - 29세,1998,407,236,171
'4173033000,  흥천면,'35,30 - 34세,1998,374,219,155
'4173033000,  흥천면,'40,35 - 39세,1998,411,220,191
'4173033000,  흥천면,'45,40 - 44세,1998,414,236,178
'4173033000,  흥천면,'50,45 - 49세,1998,308,180,128
'4173033000,  흥천면,'55,50 - 54세,1998,332,166,166
'4173033000,  흥천면,'60,55 - 59세,1998,390,184,206
'4173033000,  흥천면,'65,60 - 64세,1998,426,223,203
'4173033000,  흥천면,'70,65 - 69세,1998,303,116,187
'4173033000,  흥천면,'75,70 - 74세,1998,232,91,141
'4173033000,  흥천면,'80,75 - 79세,1998,136,54,82
'4173033000,  흥천면,'85,80 - 84세,1998,72,33,39
'4173033000,  흥천면,'90,85+ ,1998,61,21,40
'4173034000,  금사면,'00,계,1998,3026,1521,1505
'4173034000,  금사면,'05,0 - 4세,1998,177,105,72
'4173034000,  금사면,'10,5 - 9세,1998,172,103,69
'4173034000,  금사면,'15,10 - 14세,1998,153,70,83
'4173034000,  금사면,'20,15 - 19세,1998,207,87,120
'4173034000,  금사면,'25,20 - 24세,1998,236,124,112
'4173034000,  금사면,'30,25 - 29세,1998,228,125,103
'4173034000,  금사면,'35,30 - 34세,1998,224,129,95
'4173034000,  금사면,'40,35 - 39세,1998,214,123,91
'4173034000,  금사면,'45,40 - 44세,1998,202,123,79
'4173034000,  금사면,'50,45 - 49세,1998,154,65,89
'4173034000,  금사면,'55,50 - 54세,1998,184,79,105
'4173034000,  금사면,'60,55 - 59세,1998,227,100,127
'4173034000,  금사면,'65,60 - 64세,1998,231,112,119
'4173034000,  금사면,'70,65 - 69세,1998,154,63,91
'4173034000,  금사면,'75,70 - 74세,1998,128,57,71
'4173034000,  금사면,'80,75 - 79세,1998,83,35,48
'4173034000,  금사면,'85,80 - 84세,1998,32,13,19
'4173034000,  금사면,'90,85+ ,1998,20,8,12
'4173035000,  능서면,'00,계,1998,7950,4044,3906
'4173035000,  능서면,'05,0 - 4세,1998,431,216,215
'4173035000,  능서면,'10,5 - 9세,1998,512,266,246
'4173035000,  능서면,'15,10 - 14세,1998,556,290,266
'4173035000,  능서면,'20,15 - 19세,1998,720,355,365
'4173035000,  능서면,'25,20 - 24세,1998,675,372,303
'4173035000,  능서면,'30,25 - 29세,1998,568,351,217
'4173035000,  능서면,'35,30 - 34세,1998,578,312,266
'4173035000,  능서면,'40,35 - 39세,1998,644,345,299
'4173035000,  능서면,'45,40 - 44세,1998,581,328,253
'4173035000,  능서면,'50,45 - 49세,1998,404,211,193
'4173035000,  능서면,'55,50 - 54세,1998,395,190,205
'4173035000,  능서면,'60,55 - 59세,1998,488,218,270
'4173035000,  능서면,'65,60 - 64세,1998,464,229,235
'4173035000,  능서면,'70,65 - 69세,1998,362,143,219
'4173035000,  능서면,'75,70 - 74세,1998,253,93,160
'4173035000,  능서면,'80,75 - 79세,1998,189,84,105
'4173035000,  능서면,'85,80 - 84세,1998,75,26,49
'4173035000,  능서면,'90,85+ ,1998,55,15,40
'4173036000,  대신면,'00,계,1998,9166,4620,4546
'4173036000,  대신면,'05,0 - 4세,1998,462,223,239
'4173036000,  대신면,'10,5 - 9세,1998,485,244,241
'4173036000,  대신면,'15,10 - 14세,1998,551,287,264
'4173036000,  대신면,'20,15 - 19세,1998,817,389,428
'4173036000,  대신면,'25,20 - 24세,1998,796,463,333
'4173036000,  대신면,'30,25 - 29세,1998,662,400,262
'4173036000,  대신면,'35,30 - 34세,1998,609,334,275
'4173036000,  대신면,'40,35 - 39세,1998,657,344,313
'4173036000,  대신면,'45,40 - 44세,1998,677,367,310
'4173036000,  대신면,'50,45 - 49세,1998,488,260,228
'4173036000,  대신면,'55,50 - 54세,1998,496,247,249
'4173036000,  대신면,'60,55 - 59세,1998,664,311,353
'4173036000,  대신면,'65,60 - 64세,1998,682,336,346
'4173036000,  대신면,'70,65 - 69세,1998,444,172,272
'4173036000,  대신면,'75,70 - 74세,1998,296,115,181
'4173036000,  대신면,'80,75 - 79세,1998,206,78,128
'4173036000,  대신면,'85,80 - 84세,1998,108,35,73
'4173036000,  대신면,'90,85+ ,1998,66,15,51
'4173037000,  북내면,'00,계,1998,15291,7896,7395
'4173037000,  북내면,'05,0 - 4세,1998,1236,667,569
'4173037000,  북내면,'10,5 - 9세,1998,1033,563,470
'4173037000,  북내면,'15,10 - 14세,1998,963,494,469
'4173037000,  북내면,'20,15 - 19세,1998,1202,610,592
'4173037000,  북내면,'25,20 - 24세,1998,1296,677,619
'4173037000,  북내면,'30,25 - 29세,1998,1506,821,685
'4173037000,  북내면,'35,30 - 34세,1998,1472,821,651
'4173037000,  북내면,'40,35 - 39세,1998,1383,743,640
'4173037000,  북내면,'45,40 - 44세,1998,1010,569,441
'4173037000,  북내면,'50,45 - 49세,1998,675,357,318
'4173037000,  북내면,'55,50 - 54세,1998,647,321,326
'4173037000,  북내면,'60,55 - 59세,1998,814,399,415
'4173037000,  북내면,'65,60 - 64세,1998,716,328,388
'4173037000,  북내면,'70,65 - 69세,1998,516,207,309
'4173037000,  북내면,'75,70 - 74세,1998,347,134,213
'4173037000,  북내면,'80,75 - 79세,1998,250,107,143
'4173037000,  북내면,'85,80 - 84세,1998,135,51,84
'4173037000,  북내면,'90,85+ ,1998,90,27,63
'4173038000,  강천면,'00,계,1998,3932,1965,1967
'4173038000,  강천면,'05,0 - 4세,1998,189,101,88
'4173038000,  강천면,'10,5 - 9세,1998,186,91,95
'4173038000,  강천면,'15,10 - 14세,1998,213,101,112
'4173038000,  강천면,'20,15 - 19세,1998,329,157,172
'4173038000,  강천면,'25,20 - 24세,1998,338,186,152
'4173038000,  강천면,'30,25 - 29세,1998,283,166,117
'4173038000,  강천면,'35,30 - 34세,1998,248,137,111
'4173038000,  강천면,'40,35 - 39세,1998,262,146,116
'4173038000,  강천면,'45,40 - 44세,1998,273,153,120
'4173038000,  강천면,'50,45 - 49세,1998,234,114,120
'4173038000,  강천면,'55,50 - 54세,1998,240,125,115
'4173038000,  강천면,'60,55 - 59세,1998,246,120,126
'4173038000,  강천면,'65,60 - 64세,1998,294,129,165
'4173038000,  강천면,'70,65 - 69세,1998,204,89,115
'4173038000,  강천면,'75,70 - 74세,1998,157,63,94
'4173038000,  강천면,'80,75 - 79세,1998,118,46,72
'4173038000,  강천면,'85,80 - 84세,1998,78,26,52
'4173038000,  강천면,'90,85+ ,1998,40,15,25
'4173039000,  산북면,'00,계,1998,2313,1160,1153
'4173039000,  산북면,'05,0 - 4세,1998,141,65,76
'4173039000,  산북면,'10,5 - 9세,1998,133,74,59
'4173039000,  산북면,'15,10 - 14세,1998,127,58,69
'4173039000,  산북면,'20,15 - 19세,1998,169,85,84
'4173039000,  산북면,'25,20 - 24세,1998,179,107,72
'4173039000,  산북면,'30,25 - 29세,1998,190,106,84
'4173039000,  산북면,'35,30 - 34세,1998,148,80,68
'4173039000,  산북면,'40,35 - 39세,1998,170,97,73
'4173039000,  산북면,'45,40 - 44세,1998,170,86,84
'4173039000,  산북면,'50,45 - 49세,1998,121,60,61
'4173039000,  산북면,'55,50 - 54세,1998,131,67,64
'4173039000,  산북면,'60,55 - 59세,1998,185,86,99
'4173039000,  산북면,'65,60 - 64세,1998,156,74,82
'4173039000,  산북면,'70,65 - 69세,1998,125,56,69
'4173039000,  산북면,'75,70 - 74세,1998,73,30,43
'4173039000,  산북면,'80,75 - 79세,1998,44,14,30
'4173039000,  산북면,'85,80 - 84세,1998,36,10,26
'4173039000,  산북면,'90,85+ ,1998,15,5,10
'41750, 화성군,'00,계,1998,178743,92106,86637
'41750, 화성군,'05,0 - 4세,1998,14321,7371,6950
'41750, 화성군,'10,5 - 9세,1998,12662,6569,6093
'41750, 화성군,'15,10 - 14세,1998,10022,5068,4954
'41750, 화성군,'20,15 - 19세,1998,13364,6895,6469
'41750, 화성군,'25,20 - 24세,1998,14272,7569,6703
'41750, 화성군,'30,25 - 29세,1998,17971,9897,8074
'41750, 화성군,'35,30 - 34세,1998,17329,9629,7700
'41750, 화성군,'40,35 - 39세,1998,15970,8961,7009
'41750, 화성군,'45,40 - 44세,1998,12008,6530,5478
'41750, 화성군,'50,45 - 49세,1998,8852,4618,4234
'41750, 화성군,'55,50 - 54세,1998,8572,4469,4103
'41750, 화성군,'60,55 - 59세,1998,8938,4256,4682
'41750, 화성군,'65,60 - 64세,1998,8718,4099,4619
'41750, 화성군,'70,65 - 69세,1998,6202,2624,3578
'41750, 화성군,'75,70 - 74세,1998,4100,1657,2443
'41750, 화성군,'80,75 - 79세,1998,2869,1124,1745
'41750, 화성군,'85,80 - 84세,1998,1581,525,1056
'41750, 화성군,'90,85+ ,1998,992,245,747
'4175025000,  태안읍,'00,계,1998,35991,18520,17471
'4175025000,  태안읍,'05,0 - 4세,1998,3731,1927,1804
'4175025000,  태안읍,'10,5 - 9세,1998,3227,1668,1559
'4175025000,  태안읍,'15,10 - 14세,1998,2064,1083,981
'4175025000,  태안읍,'20,15 - 19세,1998,2677,1395,1282
'4175025000,  태안읍,'25,20 - 24세,1998,2654,1323,1331
'4175025000,  태안읍,'30,25 - 29세,1998,4116,2074,2042
'4175025000,  태안읍,'35,30 - 34세,1998,4417,2306,2111
'4175025000,  태안읍,'40,35 - 39세,1998,3743,2147,1596
'4175025000,  태안읍,'45,40 - 44세,1998,2464,1343,1121
'4175025000,  태안읍,'50,45 - 49세,1998,1553,832,721
'4175025000,  태안읍,'55,50 - 54세,1998,1410,722,688
'4175025000,  태안읍,'60,55 - 59세,1998,1164,576,588
'4175025000,  태안읍,'65,60 - 64세,1998,1014,462,552
'4175025000,  태안읍,'70,65 - 69세,1998,695,295,400
'4175025000,  태안읍,'75,70 - 74세,1998,458,169,289
'4175025000,  태안읍,'80,75 - 79세,1998,339,126,213
'4175025000,  태안읍,'85,80 - 84세,1998,171,53,118
'4175025000,  태안읍,'90,85+ ,1998,94,19,75
'4175025300,  봉담읍,'00,계,1998,19603,10148,9455
'4175025300,  봉담읍,'05,0 - 4세,1998,1735,860,875
'4175025300,  봉담읍,'10,5 - 9세,1998,1536,806,730
'4175025300,  봉담읍,'15,10 - 14세,1998,1181,584,597
'4175025300,  봉담읍,'20,15 - 19세,1998,1364,700,664
'4175025300,  봉담읍,'25,20 - 24세,1998,1651,885,766
'4175025300,  봉담읍,'30,25 - 29세,1998,2219,1197,1022
'4175025300,  봉담읍,'35,30 - 34세,1998,2150,1172,978
'4175025300,  봉담읍,'40,35 - 39세,1998,1996,1089,907
'4175025300,  봉담읍,'45,40 - 44세,1998,1357,742,615
'4175025300,  봉담읍,'50,45 - 49세,1998,980,520,460
'4175025300,  봉담읍,'55,50 - 54세,1998,823,447,376
'4175025300,  봉담읍,'60,55 - 59세,1998,773,384,389
'4175025300,  봉담읍,'65,60 - 64세,1998,636,306,330
'4175025300,  봉담읍,'70,65 - 69세,1998,421,177,244
'4175025300,  봉담읍,'75,70 - 74세,1998,323,122,201
'4175025300,  봉담읍,'80,75 - 79세,1998,252,91,161
'4175025300,  봉담읍,'85,80 - 84세,1998,132,46,86
'4175025300,  봉담읍,'90,85+ ,1998,74,20,54
'4175032000,  매송면,'00,계,1998,9194,4678,4516
'4175032000,  매송면,'05,0 - 4세,1998,831,424,407
'4175032000,  매송면,'10,5 - 9세,1998,765,393,372
'4175032000,  매송면,'15,10 - 14세,1998,534,282,252
'4175032000,  매송면,'20,15 - 19세,1998,661,344,317
'4175032000,  매송면,'25,20 - 24세,1998,702,350,352
'4175032000,  매송면,'30,25 - 29세,1998,1004,516,488
'4175032000,  매송면,'35,30 - 34세,1998,968,520,448
'4175032000,  매송면,'40,35 - 39세,1998,892,492,400
'4175032000,  매송면,'45,40 - 44세,1998,604,335,269
'4175032000,  매송면,'50,45 - 49세,1998,412,217,195
'4175032000,  매송면,'55,50 - 54세,1998,423,205,218
'4175032000,  매송면,'60,55 - 59세,1998,417,201,216
'4175032000,  매송면,'65,60 - 64세,1998,355,161,194
'4175032000,  매송면,'70,65 - 69세,1998,243,104,139
'4175032000,  매송면,'75,70 - 74세,1998,175,66,109
'4175032000,  매송면,'80,75 - 79세,1998,111,37,74
'4175032000,  매송면,'85,80 - 84세,1998,59,25,34
'4175032000,  매송면,'90,85+ ,1998,38,6,32
'4175034000,  비봉면,'00,계,1998,5475,2830,2645
'4175034000,  비봉면,'05,0 - 4세,1998,282,151,131
'4175034000,  비봉면,'10,5 - 9세,1998,279,154,125
'4175034000,  비봉면,'15,10 - 14세,1998,244,132,112
'4175034000,  비봉면,'20,15 - 19세,1998,459,247,212
'4175034000,  비봉면,'25,20 - 24세,1998,431,234,197
'4175034000,  비봉면,'30,25 - 29세,1998,423,256,167
'4175034000,  비봉면,'35,30 - 34세,1998,388,206,182
'4175034000,  비봉면,'40,35 - 39세,1998,427,242,185
'4175034000,  비봉면,'45,40 - 44세,1998,377,212,165
'4175034000,  비봉면,'50,45 - 49세,1998,309,163,146
'4175034000,  비봉면,'55,50 - 54세,1998,335,173,162
'4175034000,  비봉면,'60,55 - 59세,1998,383,177,206
'4175034000,  비봉면,'65,60 - 64세,1998,364,177,187
'4175034000,  비봉면,'70,65 - 69세,1998,331,141,190
'4175034000,  비봉면,'75,70 - 74세,1998,205,85,120
'4175034000,  비봉면,'80,75 - 79세,1998,133,49,84
'4175034000,  비봉면,'85,80 - 84세,1998,63,20,43
'4175034000,  비봉면,'90,85+ ,1998,42,11,31
'4175035000,  남양면,'00,계,1998,11686,6063,5623
'4175035000,  남양면,'05,0 - 4세,1998,802,411,391
'4175035000,  남양면,'10,5 - 9세,1998,805,439,366
'4175035000,  남양면,'15,10 - 14세,1998,663,303,360
'4175035000,  남양면,'20,15 - 19세,1998,812,436,376
'4175035000,  남양면,'25,20 - 24세,1998,852,475,377
'4175035000,  남양면,'30,25 - 29세,1998,1042,607,435
'4175035000,  남양면,'35,30 - 34세,1998,1093,605,488
'4175035000,  남양면,'40,35 - 39세,1998,1095,627,468
'4175035000,  남양면,'45,40 - 44세,1998,754,411,343
'4175035000,  남양면,'50,45 - 49세,1998,587,322,265
'4175035000,  남양면,'55,50 - 54세,1998,594,316,278
'4175035000,  남양면,'60,55 - 59세,1998,638,290,348
'4175035000,  남양면,'65,60 - 64세,1998,678,315,363
'4175035000,  남양면,'70,65 - 69세,1998,509,228,281
'4175035000,  남양면,'75,70 - 74세,1998,314,124,190
'4175035000,  남양면,'80,75 - 79세,1998,223,93,130
'4175035000,  남양면,'85,80 - 84세,1998,140,44,96
'4175035000,  남양면,'90,85+ ,1998,85,17,68
'4175036000,  마도면,'00,계,1998,4446,2267,2179
'4175036000,  마도면,'05,0 - 4세,1998,216,112,104
'4175036000,  마도면,'10,5 - 9세,1998,234,111,123
'4175036000,  마도면,'15,10 - 14세,1998,211,110,101
'4175036000,  마도면,'20,15 - 19세,1998,346,183,163
'4175036000,  마도면,'25,20 - 24세,1998,404,216,188
'4175036000,  마도면,'30,25 - 29세,1998,341,213,128
'4175036000,  마도면,'35,30 - 34세,1998,298,166,132
'4175036000,  마도면,'40,35 - 39세,1998,326,188,138
'4175036000,  마도면,'45,40 - 44세,1998,300,166,134
'4175036000,  마도면,'50,45 - 49세,1998,257,116,141
'4175036000,  마도면,'55,50 - 54세,1998,252,135,117
'4175036000,  마도면,'60,55 - 59세,1998,316,160,156
'4175036000,  마도면,'65,60 - 64세,1998,318,155,163
'4175036000,  마도면,'70,65 - 69세,1998,232,92,140
'4175036000,  마도면,'75,70 - 74세,1998,170,61,109
'4175036000,  마도면,'80,75 - 79세,1998,108,44,64
'4175036000,  마도면,'85,80 - 84세,1998,67,27,40
'4175036000,  마도면,'90,85+ ,1998,50,12,38
'4175037000,  송산면,'00,계,1998,10343,5250,5093
'4175037000,  송산면,'05,0 - 4세,1998,479,245,234
'4175037000,  송산면,'10,5 - 9세,1998,603,306,297
'4175037000,  송산면,'15,10 - 14세,1998,619,307,312
'4175037000,  송산면,'20,15 - 19세,1998,796,436,360
'4175037000,  송산면,'25,20 - 24세,1998,870,503,367
'4175037000,  송산면,'30,25 - 29세,1998,687,399,288
'4175037000,  송산면,'35,30 - 34세,1998,692,376,316
'4175037000,  송산면,'40,35 - 39세,1998,875,462,413
'4175037000,  송산면,'45,40 - 44세,1998,688,377,311
'4175037000,  송산면,'50,45 - 49세,1998,587,291,296
'4175037000,  송산면,'55,50 - 54세,1998,590,279,311
'4175037000,  송산면,'60,55 - 59세,1998,735,347,388
'4175037000,  송산면,'65,60 - 64세,1998,749,365,384
'4175037000,  송산면,'70,65 - 69세,1998,519,223,296
'4175037000,  송산면,'75,70 - 74세,1998,357,142,215
'4175037000,  송산면,'80,75 - 79세,1998,247,103,144
'4175037000,  송산면,'85,80 - 84세,1998,151,55,96
'4175037000,  송산면,'90,85+ ,1998,99,34,65
'4175038000,  서신면,'00,계,1998,6102,3141,2961
'4175038000,  서신면,'05,0 - 4세,1998,299,167,132
'4175038000,  서신면,'10,5 - 9세,1998,313,153,160
'4175038000,  서신면,'15,10 - 14세,1998,300,152,148
'4175038000,  서신면,'20,15 - 19세,1998,446,215,231
'4175038000,  서신면,'25,20 - 24세,1998,519,282,237
'4175038000,  서신면,'30,25 - 29세,1998,428,275,153
'4175038000,  서신면,'35,30 - 34세,1998,409,233,176
'4175038000,  서신면,'40,35 - 39세,1998,430,249,181
'4175038000,  서신면,'45,40 - 44세,1998,438,225,213
'4175038000,  서신면,'50,45 - 49세,1998,347,177,170
'4175038000,  서신면,'55,50 - 54세,1998,370,208,162
'4175038000,  서신면,'60,55 - 59세,1998,460,211,249
'4175038000,  서신면,'65,60 - 64세,1998,500,246,254
'4175038000,  서신면,'70,65 - 69세,1998,316,136,180
'4175038000,  서신면,'75,70 - 74세,1998,203,89,114
'4175038000,  서신면,'80,75 - 79세,1998,176,72,104
'4175038000,  서신면,'85,80 - 84세,1998,89,31,58
'4175038000,  서신면,'90,85+ ,1998,59,20,39
'4175039000,  팔탄면,'00,계,1998,7099,3641,3458
'4175039000,  팔탄면,'05,0 - 4세,1998,441,218,223
'4175039000,  팔탄면,'10,5 - 9세,1998,402,198,204
'4175039000,  팔탄면,'15,10 - 14세,1998,395,198,197
'4175039000,  팔탄면,'20,15 - 19세,1998,562,287,275
'4175039000,  팔탄면,'25,20 - 24세,1998,596,315,281
'4175039000,  팔탄면,'30,25 - 29세,1998,593,341,252
'4175039000,  팔탄면,'35,30 - 34세,1998,538,315,223
'4175039000,  팔탄면,'40,35 - 39세,1998,603,320,283
'4175039000,  팔탄면,'45,40 - 44세,1998,481,271,210
'4175039000,  팔탄면,'50,45 - 49세,1998,377,197,180
'4175039000,  팔탄면,'55,50 - 54세,1998,386,207,179
'4175039000,  팔탄면,'60,55 - 59세,1998,436,199,237
'4175039000,  팔탄면,'65,60 - 64세,1998,477,239,238
'4175039000,  팔탄면,'70,65 - 69세,1998,348,153,195
'4175039000,  팔탄면,'75,70 - 74세,1998,218,100,118
'4175039000,  팔탄면,'80,75 - 79세,1998,129,48,81
'4175039000,  팔탄면,'85,80 - 84세,1998,73,22,51
'4175039000,  팔탄면,'90,85+ ,1998,44,13,31
'4175040000,  장안면,'00,계,1998,11194,5789,5405
'4175040000,  장안면,'05,0 - 4세,1998,926,473,453
'4175040000,  장안면,'10,5 - 9세,1998,768,410,358
'4175040000,  장안면,'15,10 - 14세,1998,537,258,279
'4175040000,  장안면,'20,15 - 19세,1998,815,405,410
'4175040000,  장안면,'25,20 - 24세,1998,929,485,444
'4175040000,  장안면,'30,25 - 29세,1998,1161,622,539
'4175040000,  장안면,'35,30 - 34세,1998,1123,699,424
'4175040000,  장안면,'40,35 - 39세,1998,813,481,332
'4175040000,  장안면,'45,40 - 44세,1998,627,324,303
'4175040000,  장안면,'50,45 - 49세,1998,533,273,260
'4175040000,  장안면,'55,50 - 54세,1998,542,260,282
'4175040000,  장안면,'60,55 - 59세,1998,696,340,356
'4175040000,  장안면,'65,60 - 64세,1998,667,326,341
'4175040000,  장안면,'70,65 - 69세,1998,424,190,234
'4175040000,  장안면,'75,70 - 74세,1998,268,112,156
'4175040000,  장안면,'80,75 - 79세,1998,197,75,122
'4175040000,  장안면,'85,80 - 84세,1998,114,37,77
'4175040000,  장안면,'90,85+ ,1998,54,19,35
'4175041000,  우정면,'00,계,1998,18099,9425,8674
'4175041000,  우정면,'05,0 - 4세,1998,1937,998,939
'4175041000,  우정면,'10,5 - 9세,1998,1142,599,543
'4175041000,  우정면,'15,10 - 14세,1998,913,441,472
'4175041000,  우정면,'20,15 - 19세,1998,1239,631,608
'4175041000,  우정면,'25,20 - 24세,1998,1308,698,610
'4175041000,  우정면,'30,25 - 29세,1998,2359,1379,980
'4175041000,  우정면,'35,30 - 34세,1998,1925,1187,738
'4175041000,  우정면,'40,35 - 39세,1998,1248,686,562
'4175041000,  우정면,'45,40 - 44세,1998,1063,544,519
'4175041000,  우정면,'50,45 - 49세,1998,826,420,406
'4175041000,  우정면,'55,50 - 54세,1998,822,418,404
'4175041000,  우정면,'60,55 - 59세,1998,862,409,453
'4175041000,  우정면,'65,60 - 64세,1998,873,394,479
'4175041000,  우정면,'70,65 - 69세,1998,627,259,368
'4175041000,  우정면,'75,70 - 74세,1998,434,180,254
'4175041000,  우정면,'80,75 - 79세,1998,258,101,157
'4175041000,  우정면,'85,80 - 84세,1998,166,55,111
'4175041000,  우정면,'90,85+ ,1998,97,26,71
'4175042000,  향남면,'00,계,1998,14707,7443,7264
'4175042000,  향남면,'05,0 - 4세,1998,1102,571,531
'4175042000,  향남면,'10,5 - 9세,1998,1024,516,508
'4175042000,  향남면,'15,10 - 14세,1998,884,445,439
'4175042000,  향남면,'20,15 - 19세,1998,1179,583,596
'4175042000,  향남면,'25,20 - 24세,1998,1135,570,565
'4175042000,  향남면,'30,25 - 29세,1998,1359,734,625
'4175042000,  향남면,'35,30 - 34세,1998,1302,724,578
'4175042000,  향남면,'40,35 - 39세,1998,1378,748,630
'4175042000,  향남면,'45,40 - 44세,1998,1071,584,487
'4175042000,  향남면,'50,45 - 49세,1998,752,402,350
'4175042000,  향남면,'55,50 - 54세,1998,708,372,336
'4175042000,  향남면,'60,55 - 59세,1998,722,333,389
'4175042000,  향남면,'65,60 - 64세,1998,748,339,409
'4175042000,  향남면,'70,65 - 69세,1998,523,199,324
'4175042000,  향남면,'75,70 - 74세,1998,384,175,209
'4175042000,  향남면,'80,75 - 79세,1998,222,90,132
'4175042000,  향남면,'85,80 - 84세,1998,122,39,83
'4175042000,  향남면,'90,85+ ,1998,92,19,73
'4175043000,  양감면,'00,계,1998,4352,2282,2070
'4175043000,  양감면,'05,0 - 4세,1998,233,125,108
'4175043000,  양감면,'10,5 - 9세,1998,255,120,135
'4175043000,  양감면,'15,10 - 14세,1998,259,141,118
'4175043000,  양감면,'20,15 - 19세,1998,353,177,176
'4175043000,  양감면,'25,20 - 24세,1998,378,219,159
'4175043000,  양감면,'30,25 - 29세,1998,356,223,133
'4175043000,  양감면,'35,30 - 34세,1998,327,188,139
'4175043000,  양감면,'40,35 - 39세,1998,369,215,154
'4175043000,  양감면,'45,40 - 44세,1998,300,167,133
'4175043000,  양감면,'50,45 - 49세,1998,238,125,113
'4175043000,  양감면,'55,50 - 54세,1998,241,139,102
'4175043000,  양감면,'60,55 - 59세,1998,252,104,148
'4175043000,  양감면,'65,60 - 64세,1998,282,145,137
'4175043000,  양감면,'70,65 - 69세,1998,205,86,119
'4175043000,  양감면,'75,70 - 74세,1998,116,42,74
'4175043000,  양감면,'80,75 - 79세,1998,99,46,53
'4175043000,  양감면,'85,80 - 84세,1998,47,10,37
'4175043000,  양감면,'90,85+ ,1998,42,10,32
'4175044000,  정남면,'00,계,1998,9731,5002,4729
'4175044000,  정남면,'05,0 - 4세,1998,615,308,307
'4175044000,  정남면,'10,5 - 9세,1998,663,352,311
'4175044000,  정남면,'15,10 - 14세,1998,609,310,299
'4175044000,  정남면,'20,15 - 19세,1998,769,404,365
'4175044000,  정남면,'25,20 - 24세,1998,817,448,369
'4175044000,  정남면,'30,25 - 29세,1998,877,502,375
'4175044000,  정남면,'35,30 - 34세,1998,781,432,349
'4175044000,  정남면,'40,35 - 39세,1998,861,484,377
'4175044000,  정남면,'45,40 - 44세,1998,689,392,297
'4175044000,  정남면,'50,45 - 49세,1998,504,247,257
'4175044000,  정남면,'55,50 - 54세,1998,493,277,216
'4175044000,  정남면,'60,55 - 59세,1998,505,240,265
'4175044000,  정남면,'65,60 - 64세,1998,507,211,296
'4175044000,  정남면,'70,65 - 69세,1998,426,178,248
'4175044000,  정남면,'75,70 - 74세,1998,238,100,138
'4175044000,  정남면,'80,75 - 79세,1998,205,76,129
'4175044000,  정남면,'85,80 - 84세,1998,99,31,68
'4175044000,  정남면,'90,85+ ,1998,73,10,63
'4175045000,  동탄면,'00,계,1998,10721,5627,5094
'4175045000,  동탄면,'05,0 - 4세,1998,692,381,311
'4175045000,  동탄면,'10,5 - 9세,1998,646,344,302
'4175045000,  동탄면,'15,10 - 14세,1998,609,322,287
'4175045000,  동탄면,'20,15 - 19세,1998,886,452,434
'4175045000,  동탄면,'25,20 - 24세,1998,1026,566,460
'4175045000,  동탄면,'30,25 - 29세,1998,1006,559,447
'4175045000,  동탄면,'35,30 - 34세,1998,918,500,418
'4175045000,  동탄면,'40,35 - 39세,1998,914,531,383
'4175045000,  동탄면,'45,40 - 44세,1998,795,437,358
'4175045000,  동탄면,'50,45 - 49세,1998,590,316,274
'4175045000,  동탄면,'55,50 - 54세,1998,583,311,272
'4175045000,  동탄면,'60,55 - 59세,1998,579,285,294
'4175045000,  동탄면,'65,60 - 64세,1998,550,258,292
'4175045000,  동탄면,'70,65 - 69세,1998,383,163,220
'4175045000,  동탄면,'75,70 - 74세,1998,237,90,147
'4175045000,  동탄면,'80,75 - 79세,1998,170,73,97
'4175045000,  동탄면,'85,80 - 84세,1998,88,30,58
'4175045000,  동탄면,'90,85+ ,1998,49,9,40
'41790, 광주군,'00,계,1998,114789,59217,55572
'41790, 광주군,'05,0 - 4세,1998,9551,4957,4594
'41790, 광주군,'10,5 - 9세,1998,9402,4852,4550
'41790, 광주군,'15,10 - 14세,1998,7781,3976,3805
'41790, 광주군,'20,15 - 19세,1998,8427,4337,4090
'41790, 광주군,'25,20 - 24세,1998,8255,4361,3894
'41790, 광주군,'30,25 - 29세,1998,10908,5613,5295
'41790, 광주군,'35,30 - 34세,1998,12383,6486,5897
'41790, 광주군,'40,35 - 39세,1998,12159,6812,5347
'41790, 광주군,'45,40 - 44세,1998,9001,5141,3860
'41790, 광주군,'50,45 - 49세,1998,5789,3090,2699
'41790, 광주군,'55,50 - 54세,1998,4864,2531,2333
'41790, 광주군,'60,55 - 59세,1998,4799,2337,2462
'41790, 광주군,'65,60 - 64세,1998,4102,1941,2161
'41790, 광주군,'70,65 - 69세,1998,2879,1195,1684
'41790, 광주군,'75,70 - 74세,1998,1896,709,1187
'41790, 광주군,'80,75 - 79세,1998,1345,504,841
'41790, 광주군,'85,80 - 84세,1998,798,269,529
'41790, 광주군,'90,85+ ,1998,450,106,344
'4179025000,  광주읍,'00,계,1998,50392,25849,24543
'4179025000,  광주읍,'05,0 - 4세,1998,4432,2277,2155
'4179025000,  광주읍,'10,5 - 9세,1998,4586,2349,2237
'4179025000,  광주읍,'15,10 - 14세,1998,3710,1929,1781
'4179025000,  광주읍,'20,15 - 19세,1998,3886,1999,1887
'4179025000,  광주읍,'25,20 - 24세,1998,3560,1781,1779
'4179025000,  광주읍,'30,25 - 29세,1998,4877,2432,2445
'4179025000,  광주읍,'35,30 - 34세,1998,5814,2938,2876
'4179025000,  광주읍,'40,35 - 39세,1998,5755,3209,2546
'4179025000,  광주읍,'45,40 - 44세,1998,4075,2303,1772
'4179025000,  광주읍,'50,45 - 49세,1998,2440,1306,1134
'4179025000,  광주읍,'55,50 - 54세,1998,1876,981,895
'4179025000,  광주읍,'60,55 - 59세,1998,1679,844,835
'4179025000,  광주읍,'65,60 - 64세,1998,1387,657,730
'4179025000,  광주읍,'70,65 - 69세,1998,914,365,549
'4179025000,  광주읍,'75,70 - 74세,1998,602,215,387
'4179025000,  광주읍,'80,75 - 79세,1998,426,158,268
'4179025000,  광주읍,'85,80 - 84세,1998,233,79,154
'4179025000,  광주읍,'90,85+ ,1998,140,27,113
'4179031000,  오포면,'00,계,1998,20881,10776,10105
'4179031000,  오포면,'05,0 - 4세,1998,1769,882,887
'4179031000,  오포면,'10,5 - 9세,1998,1624,845,779
'4179031000,  오포면,'15,10 - 14세,1998,1313,636,677
'4179031000,  오포면,'20,15 - 19세,1998,1566,809,757
'4179031000,  오포면,'25,20 - 24세,1998,1535,840,695
'4179031000,  오포면,'30,25 - 29세,1998,2184,1123,1061
'4179031000,  오포면,'35,30 - 34세,1998,2337,1250,1087
'4179031000,  오포면,'40,35 - 39세,1998,2148,1200,948
'4179031000,  오포면,'45,40 - 44세,1998,1649,924,725
'4179031000,  오포면,'50,45 - 49세,1998,1126,606,520
'4179031000,  오포면,'55,50 - 54세,1998,901,465,436
'4179031000,  오포면,'60,55 - 59세,1998,905,440,465
'4179031000,  오포면,'65,60 - 64세,1998,663,319,344
'4179031000,  오포면,'70,65 - 69세,1998,479,212,267
'4179031000,  오포면,'75,70 - 74세,1998,299,114,185
'4179031000,  오포면,'80,75 - 79세,1998,197,58,139
'4179031000,  오포면,'85,80 - 84세,1998,123,34,89
'4179031000,  오포면,'90,85+ ,1998,63,19,44
'4179032000,  초월면,'00,계,1998,12381,6572,5809
'4179032000,  초월면,'05,0 - 4세,1998,1045,568,477
'4179032000,  초월면,'10,5 - 9세,1998,857,435,422
'4179032000,  초월면,'15,10 - 14세,1998,854,446,408
'4179032000,  초월면,'20,15 - 19세,1998,861,441,420
'4179032000,  초월면,'25,20 - 24세,1998,847,460,387
'4179032000,  초월면,'30,25 - 29세,1998,1197,637,560
'4179032000,  초월면,'35,30 - 34세,1998,1314,740,574
'4179032000,  초월면,'40,35 - 39세,1998,1311,777,534
'4179032000,  초월면,'45,40 - 44세,1998,954,595,359
'4179032000,  초월면,'50,45 - 49세,1998,612,332,280
'4179032000,  초월면,'55,50 - 54세,1998,548,289,259
'4179032000,  초월면,'60,55 - 59세,1998,554,247,307
'4179032000,  초월면,'65,60 - 64세,1998,572,271,301
'4179032000,  초월면,'70,65 - 69세,1998,343,142,201
'4179032000,  초월면,'75,70 - 74세,1998,223,93,130
'4179032000,  초월면,'80,75 - 79세,1998,150,56,94
'4179032000,  초월면,'85,80 - 84세,1998,86,28,58
'4179032000,  초월면,'90,85+ ,1998,53,15,38
'4179033000,  실촌면,'00,계,1998,14366,7441,6925
'4179033000,  실촌면,'05,0 - 4세,1998,1237,657,580
'4179033000,  실촌면,'10,5 - 9세,1998,1248,645,603
'4179033000,  실촌면,'15,10 - 14세,1998,952,498,454
'4179033000,  실촌면,'20,15 - 19세,1998,972,483,489
'4179033000,  실촌면,'25,20 - 24세,1998,1043,555,488
'4179033000,  실촌면,'30,25 - 29세,1998,1313,671,642
'4179033000,  실촌면,'35,30 - 34세,1998,1542,822,720
'4179033000,  실촌면,'40,35 - 39세,1998,1442,801,641
'4179033000,  실촌면,'45,40 - 44세,1998,1084,629,455
'4179033000,  실촌면,'50,45 - 49세,1998,658,368,290
'4179033000,  실촌면,'55,50 - 54세,1998,582,317,265
'4179033000,  실촌면,'60,55 - 59세,1998,622,299,323
'4179033000,  실촌면,'65,60 - 64세,1998,600,270,330
'4179033000,  실촌면,'70,65 - 69세,1998,412,180,232
'4179033000,  실촌면,'75,70 - 74세,1998,274,94,180
'4179033000,  실촌면,'80,75 - 79세,1998,198,92,106
'4179033000,  실촌면,'85,80 - 84세,1998,119,42,77
'4179033000,  실촌면,'90,85+ ,1998,68,18,50
'4179034000,  도척면,'00,계,1998,6455,3306,3149
'4179034000,  도척면,'05,0 - 4세,1998,436,235,201
'4179034000,  도척면,'10,5 - 9세,1998,480,280,200
'4179034000,  도척면,'15,10 - 14세,1998,438,213,225
'4179034000,  도척면,'20,15 - 19세,1998,466,235,231
'4179034000,  도척면,'25,20 - 24세,1998,456,243,213
'4179034000,  도척면,'30,25 - 29세,1998,523,293,230
'4179034000,  도척면,'35,30 - 34세,1998,567,294,273
'4179034000,  도척면,'40,35 - 39세,1998,629,352,277
'4179034000,  도척면,'45,40 - 44세,1998,482,280,202
'4179034000,  도척면,'50,45 - 49세,1998,333,170,163
'4179034000,  도척면,'55,50 - 54세,1998,312,158,154
'4179034000,  도척면,'60,55 - 59세,1998,351,177,174
'4179034000,  도척면,'65,60 - 64세,1998,275,129,146
'4179034000,  도척면,'70,65 - 69세,1998,252,104,148
'4179034000,  도척면,'75,70 - 74세,1998,167,63,104
'4179034000,  도척면,'80,75 - 79세,1998,129,38,91
'4179034000,  도척면,'85,80 - 84세,1998,99,31,68
'4179034000,  도척면,'90,85+ ,1998,60,11,49
'4179035000,  퇴촌면,'00,계,1998,5812,2957,2855
'4179035000,  퇴촌면,'05,0 - 4세,1998,398,219,179
'4179035000,  퇴촌면,'10,5 - 9세,1998,394,196,198
'4179035000,  퇴촌면,'15,10 - 14세,1998,289,153,136
'4179035000,  퇴촌면,'20,15 - 19세,1998,363,205,158
'4179035000,  퇴촌면,'25,20 - 24세,1998,449,264,185
'4179035000,  퇴촌면,'30,25 - 29세,1998,457,243,214
'4179035000,  퇴촌면,'35,30 - 34세,1998,507,264,243
'4179035000,  퇴촌면,'40,35 - 39세,1998,556,300,256
'4179035000,  퇴촌면,'45,40 - 44세,1998,424,237,187
'4179035000,  퇴촌면,'50,45 - 49세,1998,354,160,194
'4179035000,  퇴촌면,'55,50 - 54세,1998,349,175,174
'4179035000,  퇴촌면,'60,55 - 59세,1998,339,162,177
'4179035000,  퇴촌면,'65,60 - 64세,1998,302,140,162
'4179035000,  퇴촌면,'70,65 - 69세,1998,238,94,144
'4179035000,  퇴촌면,'75,70 - 74세,1998,183,65,118
'4179035000,  퇴촌면,'80,75 - 79세,1998,114,45,69
'4179035000,  퇴촌면,'85,80 - 84세,1998,69,29,40
'4179035000,  퇴촌면,'90,85+ ,1998,27,6,21
'4179036000,  남종면,'00,계,1998,1893,982,911
'4179036000,  남종면,'05,0 - 4세,1998,100,51,49
'4179036000,  남종면,'10,5 - 9세,1998,85,41,44
'4179036000,  남종면,'15,10 - 14세,1998,73,29,44
'4179036000,  남종면,'20,15 - 19세,1998,149,79,70
'4179036000,  남종면,'25,20 - 24세,1998,135,87,48
'4179036000,  남종면,'30,25 - 29세,1998,146,88,58
'4179036000,  남종면,'35,30 - 34세,1998,117,71,46
'4179036000,  남종면,'40,35 - 39세,1998,139,69,70
'4179036000,  남종면,'45,40 - 44세,1998,155,83,72
'4179036000,  남종면,'50,45 - 49세,1998,112,68,44
'4179036000,  남종면,'55,50 - 54세,1998,118,54,64
'4179036000,  남종면,'60,55 - 59세,1998,150,70,80
'4179036000,  남종면,'65,60 - 64세,1998,125,69,56
'4179036000,  남종면,'70,65 - 69세,1998,107,45,62
'4179036000,  남종면,'75,70 - 74세,1998,68,31,37
'4179036000,  남종면,'80,75 - 79세,1998,60,25,35
'4179036000,  남종면,'85,80 - 84세,1998,37,15,22
'4179036000,  남종면,'90,85+ ,1998,17,7,10
'4179037000,  중부면,'00,계,1998,2609,1334,1275
'4179037000,  중부면,'05,0 - 4세,1998,134,68,66
'4179037000,  중부면,'10,5 - 9세,1998,128,61,67
'4179037000,  중부면,'15,10 - 14세,1998,152,72,80
'4179037000,  중부면,'20,15 - 19세,1998,164,86,78
'4179037000,  중부면,'25,20 - 24세,1998,230,131,99
'4179037000,  중부면,'30,25 - 29세,1998,211,126,85
'4179037000,  중부면,'35,30 - 34세,1998,185,107,78
'4179037000,  중부면,'40,35 - 39세,1998,179,104,75
'4179037000,  중부면,'45,40 - 44세,1998,178,90,88
'4179037000,  중부면,'50,45 - 49세,1998,154,80,74
'4179037000,  중부면,'55,50 - 54세,1998,178,92,86
'4179037000,  중부면,'60,55 - 59세,1998,199,98,101
'4179037000,  중부면,'65,60 - 64세,1998,178,86,92
'4179037000,  중부면,'70,65 - 69세,1998,134,53,81
'4179037000,  중부면,'75,70 - 74세,1998,80,34,46
'4179037000,  중부면,'80,75 - 79세,1998,71,32,39
'4179037000,  중부면,'85,80 - 84세,1998,32,11,21
'4179037000,  중부면,'90,85+ ,1998,22,3,19
'41800, 연천군,'00,계,1998,54365,27920,26445
'41800, 연천군,'05,0 - 4세,1998,3285,1780,1505
'41800, 연천군,'10,5 - 9세,1998,3553,1879,1674
'41800, 연천군,'15,10 - 14세,1998,3443,1803,1640
'41800, 연천군,'20,15 - 19세,1998,4433,2239,2194
'41800, 연천군,'25,20 - 24세,1998,4497,2511,1986
'41800, 연천군,'30,25 - 29세,1998,4847,2792,2055
'41800, 연천군,'35,30 - 34세,1998,4325,2327,1998
'41800, 연천군,'40,35 - 39세,1998,4705,2507,2198
'41800, 연천군,'45,40 - 44세,1998,4146,2272,1874
'41800, 연천군,'50,45 - 49세,1998,2585,1244,1341
'41800, 연천군,'55,50 - 54세,1998,2831,1426,1405
'41800, 연천군,'60,55 - 59세,1998,3209,1415,1794
'41800, 연천군,'65,60 - 64세,1998,3045,1431,1614
'41800, 연천군,'70,65 - 69세,1998,2069,951,1118
'41800, 연천군,'75,70 - 74세,1998,1512,572,940
'41800, 연천군,'80,75 - 79세,1998,1048,453,595
'41800, 연천군,'85,80 - 84세,1998,518,213,305
'41800, 연천군,'90,85+ ,1998,314,105,209
'4180025000,  연천읍,'00,계,1998,9029,4676,4353
'4180025000,  연천읍,'05,0 - 4세,1998,570,322,248
'4180025000,  연천읍,'10,5 - 9세,1998,563,306,257
'4180025000,  연천읍,'15,10 - 14세,1998,540,279,261
'4180025000,  연천읍,'20,15 - 19세,1998,655,332,323
'4180025000,  연천읍,'25,20 - 24세,1998,754,422,332
'4180025000,  연천읍,'30,25 - 29세,1998,847,492,355
'4180025000,  연천읍,'35,30 - 34세,1998,715,392,323
'4180025000,  연천읍,'40,35 - 39세,1998,706,382,324
'4180025000,  연천읍,'45,40 - 44세,1998,670,382,288
'4180025000,  연천읍,'50,45 - 49세,1998,393,181,212
'4180025000,  연천읍,'55,50 - 54세,1998,477,225,252
'4180025000,  연천읍,'60,55 - 59세,1998,595,259,336
'4180025000,  연천읍,'65,60 - 64세,1998,560,262,298
'4180025000,  연천읍,'70,65 - 69세,1998,376,192,184
'4180025000,  연천읍,'75,70 - 74세,1998,273,115,158
'4180025000,  연천읍,'80,75 - 79세,1998,181,71,110
'4180025000,  연천읍,'85,80 - 84세,1998,94,42,52
'4180025000,  연천읍,'90,85+ ,1998,60,20,40
'4180025300,  전곡읍,'00,계,1998,20964,10735,10229
'4180025300,  전곡읍,'05,0 - 4세,1998,1482,814,668
'4180025300,  전곡읍,'10,5 - 9세,1998,1682,888,794
'4180025300,  전곡읍,'15,10 - 14세,1998,1488,760,728
'4180025300,  전곡읍,'20,15 - 19세,1998,1807,914,893
'4180025300,  전곡읍,'25,20 - 24세,1998,1694,921,773
'4180025300,  전곡읍,'30,25 - 29세,1998,1958,1073,885
'4180025300,  전곡읍,'35,30 - 34세,1998,1929,968,961
'4180025300,  전곡읍,'40,35 - 39세,1998,2057,1076,981
'4180025300,  전곡읍,'45,40 - 44세,1998,1697,923,774
'4180025300,  전곡읍,'50,45 - 49세,1998,985,484,501
'4180025300,  전곡읍,'55,50 - 54세,1998,952,504,448
'4180025300,  전곡읍,'60,55 - 59세,1998,893,414,479
'4180025300,  전곡읍,'65,60 - 64세,1998,838,375,463
'4180025300,  전곡읍,'70,65 - 69세,1998,574,260,314
'4180025300,  전곡읍,'75,70 - 74세,1998,451,157,294
'4180025300,  전곡읍,'80,75 - 79세,1998,298,136,162
'4180025300,  전곡읍,'85,80 - 84세,1998,107,46,61
'4180025300,  전곡읍,'90,85+ ,1998,72,22,50
'4180031000,  군남면,'00,계,1998,5058,2615,2443
'4180031000,  군남면,'05,0 - 4세,1998,225,118,107
'4180031000,  군남면,'10,5 - 9세,1998,235,111,124
'4180031000,  군남면,'15,10 - 14세,1998,292,163,129
'4180031000,  군남면,'20,15 - 19세,1998,422,211,211
'4180031000,  군남면,'25,20 - 24세,1998,451,271,180
'4180031000,  군남면,'30,25 - 29세,1998,414,260,154
'4180031000,  군남면,'35,30 - 34세,1998,320,188,132
'4180031000,  군남면,'40,35 - 39세,1998,385,203,182
'4180031000,  군남면,'45,40 - 44세,1998,348,200,148
'4180031000,  군남면,'50,45 - 49세,1998,256,125,131
'4180031000,  군남면,'55,50 - 54세,1998,292,148,144
'4180031000,  군남면,'60,55 - 59세,1998,387,169,218
'4180031000,  군남면,'65,60 - 64세,1998,363,172,191
'4180031000,  군남면,'70,65 - 69세,1998,238,111,127
'4180031000,  군남면,'75,70 - 74세,1998,169,58,111
'4180031000,  군남면,'80,75 - 79세,1998,142,66,76
'4180031000,  군남면,'85,80 - 84세,1998,79,30,49
'4180031000,  군남면,'90,85+ ,1998,40,11,29
'4180032000,  청산면,'00,계,1998,5867,2994,2873
'4180032000,  청산면,'05,0 - 4세,1998,310,171,139
'4180032000,  청산면,'10,5 - 9세,1998,350,189,161
'4180032000,  청산면,'15,10 - 14세,1998,358,193,165
'4180032000,  청산면,'20,15 - 19세,1998,469,241,228
'4180032000,  청산면,'25,20 - 24세,1998,470,253,217
'4180032000,  청산면,'30,25 - 29세,1998,539,299,240
'4180032000,  청산면,'35,30 - 34세,1998,479,271,208
'4180032000,  청산면,'40,35 - 39세,1998,513,280,233
'4180032000,  청산면,'45,40 - 44세,1998,490,246,244
'4180032000,  청산면,'50,45 - 49세,1998,292,143,149
'4180032000,  청산면,'55,50 - 54세,1998,305,158,147
'4180032000,  청산면,'60,55 - 59세,1998,363,151,212
'4180032000,  청산면,'65,60 - 64세,1998,342,161,181
'4180032000,  청산면,'70,65 - 69세,1998,247,114,133
'4180032000,  청산면,'75,70 - 74세,1998,158,57,101
'4180032000,  청산면,'80,75 - 79세,1998,107,40,67
'4180032000,  청산면,'85,80 - 84세,1998,45,19,26
'4180032000,  청산면,'90,85+ ,1998,30,8,22
'4180033000,  백학면,'00,계,1998,3400,1787,1613
'4180033000,  백학면,'05,0 - 4세,1998,155,87,68
'4180033000,  백학면,'10,5 - 9세,1998,180,93,87
'4180033000,  백학면,'15,10 - 14세,1998,184,101,83
'4180033000,  백학면,'20,15 - 19세,1998,290,164,126
'4180033000,  백학면,'25,20 - 24세,1998,283,165,118
'4180033000,  백학면,'30,25 - 29세,1998,250,159,91
'4180033000,  백학면,'35,30 - 34세,1998,219,127,92
'4180033000,  백학면,'40,35 - 39세,1998,257,146,111
'4180033000,  백학면,'45,40 - 44세,1998,252,150,102
'4180033000,  백학면,'50,45 - 49세,1998,146,62,84
'4180033000,  백학면,'55,50 - 54세,1998,215,107,108
'4180033000,  백학면,'60,55 - 59세,1998,272,114,158
'4180033000,  백학면,'65,60 - 64세,1998,267,134,133
'4180033000,  백학면,'70,65 - 69세,1998,170,78,92
'4180033000,  백학면,'75,70 - 74세,1998,127,52,75
'4180033000,  백학면,'80,75 - 79세,1998,60,20,40
'4180033000,  백학면,'85,80 - 84세,1998,46,16,30
'4180033000,  백학면,'90,85+ ,1998,27,12,15
'4180034000,  미산면,'00,계,1998,2186,1118,1068
'4180034000,  미산면,'05,0 - 4세,1998,100,55,45
'4180034000,  미산면,'10,5 - 9세,1998,108,64,44
'4180034000,  미산면,'15,10 - 14세,1998,117,56,61
'4180034000,  미산면,'20,15 - 19세,1998,186,93,93
'4180034000,  미산면,'25,20 - 24세,1998,176,105,71
'4180034000,  미산면,'30,25 - 29세,1998,158,96,62
'4180034000,  미산면,'35,30 - 34세,1998,131,70,61
'4180034000,  미산면,'40,35 - 39세,1998,152,88,64
'4180034000,  미산면,'45,40 - 44세,1998,150,77,73
'4180034000,  미산면,'50,45 - 49세,1998,106,54,52
'4180034000,  미산면,'55,50 - 54세,1998,160,71,89
'4180034000,  미산면,'60,55 - 59세,1998,170,76,94
'4180034000,  미산면,'65,60 - 64세,1998,162,84,78
'4180034000,  미산면,'70,65 - 69세,1998,108,48,60
'4180034000,  미산면,'75,70 - 74세,1998,84,29,55
'4180034000,  미산면,'80,75 - 79세,1998,58,30,28
'4180034000,  미산면,'85,80 - 84세,1998,37,11,26
'4180034000,  미산면,'90,85+ ,1998,23,11,12
'4180035000,  왕징면,'00,계,1998,1591,819,772
'4180035000,  왕징면,'05,0 - 4세,1998,73,32,41
'4180035000,  왕징면,'10,5 - 9세,1998,74,43,31
'4180035000,  왕징면,'15,10 - 14세,1998,79,43,36
'4180035000,  왕징면,'20,15 - 19세,1998,126,61,65
'4180035000,  왕징면,'25,20 - 24세,1998,153,90,63
'4180035000,  왕징면,'30,25 - 29세,1998,125,80,45
'4180035000,  왕징면,'35,30 - 34세,1998,88,52,36
'4180035000,  왕징면,'40,35 - 39세,1998,100,54,46
'4180035000,  왕징면,'45,40 - 44세,1998,120,68,52
'4180035000,  왕징면,'50,45 - 49세,1998,93,47,46
'4180035000,  왕징면,'55,50 - 54세,1998,102,44,58
'4180035000,  왕징면,'60,55 - 59세,1998,119,55,64
'4180035000,  왕징면,'65,60 - 64세,1998,104,51,53
'4180035000,  왕징면,'70,65 - 69세,1998,78,27,51
'4180035000,  왕징면,'75,70 - 74세,1998,60,25,35
'4180035000,  왕징면,'80,75 - 79세,1998,53,30,23
'4180035000,  왕징면,'85,80 - 84세,1998,31,11,20
'4180035000,  왕징면,'90,85+ ,1998,13,6,7
'4180036000,  신서면,'00,계,1998,5205,2642,2563
'4180036000,  신서면,'05,0 - 4세,1998,322,155,167
'4180036000,  신서면,'10,5 - 9세,1998,316,164,152
'4180036000,  신서면,'15,10 - 14세,1998,326,177,149
'4180036000,  신서면,'20,15 - 19세,1998,400,192,208
'4180036000,  신서면,'25,20 - 24세,1998,435,235,200
'4180036000,  신서면,'30,25 - 29세,1998,479,283,196
'4180036000,  신서면,'35,30 - 34세,1998,388,231,157
'4180036000,  신서면,'40,35 - 39세,1998,452,228,224
'4180036000,  신서면,'45,40 - 44세,1998,346,189,157
'4180036000,  신서면,'50,45 - 49세,1998,265,124,141
'4180036000,  신서면,'55,50 - 54세,1998,255,134,121
'4180036000,  신서면,'60,55 - 59세,1998,332,138,194
'4180036000,  신서면,'65,60 - 64세,1998,316,147,169
'4180036000,  신서면,'70,65 - 69세,1998,221,99,122
'4180036000,  신서면,'75,70 - 74세,1998,144,63,81
'4180036000,  신서면,'80,75 - 79세,1998,112,45,67
'4180036000,  신서면,'85,80 - 84세,1998,57,27,30
'4180036000,  신서면,'90,85+ ,1998,39,11,28
'4180037000,  중면,'00,계,1998,240,119,121
'4180037000,  중면,'05,0 - 4세,1998,17,8,9
'4180037000,  중면,'10,5 - 9세,1998,17,9,8
'4180037000,  중면,'15,10 - 14세,1998,11,2,9
'4180037000,  중면,'20,15 - 19세,1998,12,6,6
'4180037000,  중면,'25,20 - 24세,1998,13,6,7
'4180037000,  중면,'30,25 - 29세,1998,18,11,7
'4180037000,  중면,'35,30 - 34세,1998,20,10,10
'4180037000,  중면,'40,35 - 39세,1998,20,13,7
'4180037000,  중면,'45,40 - 44세,1998,17,10,7
'4180037000,  중면,'50,45 - 49세,1998,6,2,4
'4180037000,  중면,'55,50 - 54세,1998,14,8,6
'4180037000,  중면,'60,55 - 59세,1998,12,5,7
'4180037000,  중면,'65,60 - 64세,1998,21,10,11
'4180037000,  중면,'70,65 - 69세,1998,13,6,7
'4180037000,  중면,'75,70 - 74세,1998,12,5,7
'4180037000,  중면,'80,75 - 79세,1998,13,5,8
'4180037000,  중면,'85,80 - 84세,1998,3,3,0
'4180037000,  중면,'90,85+ ,1998,1,0,1
'4180038000,  장남면,'00,계,1998,825,415,410
'4180038000,  장남면,'05,0 - 4세,1998,31,18,13
'4180038000,  장남면,'10,5 - 9세,1998,28,12,16
'4180038000,  장남면,'15,10 - 14세,1998,48,29,19
'4180038000,  장남면,'20,15 - 19세,1998,66,25,41
'4180038000,  장남면,'25,20 - 24세,1998,68,43,25
'4180038000,  장남면,'30,25 - 29세,1998,59,39,20
'4180038000,  장남면,'35,30 - 34세,1998,36,18,18
'4180038000,  장남면,'40,35 - 39세,1998,63,37,26
'4180038000,  장남면,'45,40 - 44세,1998,56,27,29
'4180038000,  장남면,'50,45 - 49세,1998,43,22,21
'4180038000,  장남면,'55,50 - 54세,1998,59,27,32
'4180038000,  장남면,'60,55 - 59세,1998,66,34,32
'4180038000,  장남면,'65,60 - 64세,1998,72,35,37
'4180038000,  장남면,'70,65 - 69세,1998,44,16,28
'4180038000,  장남면,'75,70 - 74세,1998,34,11,23
'4180038000,  장남면,'80,75 - 79세,1998,24,10,14
'4180038000,  장남면,'85,80 - 84세,1998,19,8,11
'4180038000,  장남면,'90,85+ ,1998,9,4,5
'41810, 포천군,'00,계,1998,143257,73740,69517
'41810, 포천군,'05,0 - 4세,1998,11320,5998,5322
'41810, 포천군,'10,5 - 9세,1998,11492,5989,5503
'41810, 포천군,'15,10 - 14세,1998,9713,4938,4775
'41810, 포천군,'20,15 - 19세,1998,10359,5302,5057
'41810, 포천군,'25,20 - 24세,1998,10493,5496,4997
'41810, 포천군,'30,25 - 29세,1998,13275,7043,6232
'41810, 포천군,'35,30 - 34세,1998,14180,7445,6735
'41810, 포천군,'40,35 - 39세,1998,14548,8119,6429
'41810, 포천군,'45,40 - 44세,1998,11198,6423,4775
'41810, 포천군,'50,45 - 49세,1998,6278,3353,2925
'41810, 포천군,'55,50 - 54세,1998,6251,3098,3153
'41810, 포천군,'60,55 - 59세,1998,6844,3136,3708
'41810, 포천군,'65,60 - 64세,1998,6252,2885,3367
'41810, 포천군,'70,65 - 69세,1998,4296,1896,2400
'41810, 포천군,'75,70 - 74세,1998,2818,1107,1711
'41810, 포천군,'80,75 - 79세,1998,2131,883,1248
'41810, 포천군,'85,80 - 84세,1998,1123,404,719
'41810, 포천군,'90,85+ ,1998,686,225,461
'4181025000,  포천읍,'00,계,1998,30256,15376,14880
'4181025000,  포천읍,'05,0 - 4세,1998,2758,1459,1299
'4181025000,  포천읍,'10,5 - 9세,1998,2685,1396,1289
'4181025000,  포천읍,'15,10 - 14세,1998,2221,1116,1105
'4181025000,  포천읍,'20,15 - 19세,1998,2221,1139,1082
'4181025000,  포천읍,'25,20 - 24세,1998,2102,1022,1080
'4181025000,  포천읍,'30,25 - 29세,1998,3069,1522,1547
'4181025000,  포천읍,'35,30 - 34세,1998,3270,1684,1586
'4181025000,  포천읍,'40,35 - 39세,1998,3279,1793,1486
'4181025000,  포천읍,'45,40 - 44세,1998,2450,1365,1085
'4181025000,  포천읍,'50,45 - 49세,1998,1300,678,622
'4181025000,  포천읍,'55,50 - 54세,1998,1090,557,533
'4181025000,  포천읍,'60,55 - 59세,1998,1138,503,635
'4181025000,  포천읍,'65,60 - 64세,1998,972,447,525
'4181025000,  포천읍,'70,65 - 69세,1998,654,288,366
'4181025000,  포천읍,'75,70 - 74세,1998,455,175,280
'4181025000,  포천읍,'80,75 - 79세,1998,323,136,187
'4181025000,  포천읍,'85,80 - 84세,1998,171,66,105
'4181025000,  포천읍,'90,85+ ,1998,98,30,68
'4181025300,  소흘읍,'00,계,1998,29346,15092,14254
'4181025300,  소흘읍,'05,0 - 4세,1998,2807,1484,1323
'4181025300,  소흘읍,'10,5 - 9세,1998,2789,1461,1328
'4181025300,  소흘읍,'15,10 - 14세,1998,2036,1041,995
'4181025300,  소흘읍,'20,15 - 19세,1998,1864,936,928
'4181025300,  소흘읍,'25,20 - 24세,1998,1823,943,880
'4181025300,  소흘읍,'30,25 - 29세,1998,2862,1426,1436
'4181025300,  소흘읍,'35,30 - 34세,1998,3649,1813,1836
'4181025300,  소흘읍,'40,35 - 39세,1998,3529,1992,1537
'4181025300,  소흘읍,'45,40 - 44세,1998,2304,1335,969
'4181025300,  소흘읍,'50,45 - 49세,1998,1188,657,531
'4181025300,  소흘읍,'55,50 - 54세,1998,1071,527,544
'4181025300,  소흘읍,'60,55 - 59세,1998,985,472,513
'4181025300,  소흘읍,'65,60 - 64세,1998,868,408,460
'4181025300,  소흘읍,'70,65 - 69세,1998,639,270,369
'4181025300,  소흘읍,'75,70 - 74세,1998,395,136,259
'4181025300,  소흘읍,'80,75 - 79세,1998,290,113,177
'4181025300,  소흘읍,'85,80 - 84세,1998,161,47,114
'4181025300,  소흘읍,'90,85+ ,1998,86,31,55
'4181031000,  군내면,'00,계,1998,7181,3777,3404
'4181031000,  군내면,'05,0 - 4세,1998,512,246,266
'4181031000,  군내면,'10,5 - 9세,1998,451,251,200
'4181031000,  군내면,'15,10 - 14세,1998,492,255,237
'4181031000,  군내면,'20,15 - 19세,1998,503,269,234
'4181031000,  군내면,'25,20 - 24세,1998,584,324,260
'4181031000,  군내면,'30,25 - 29세,1998,663,390,273
'4181031000,  군내면,'35,30 - 34세,1998,612,350,262
'4181031000,  군내면,'40,35 - 39세,1998,624,353,271
'4181031000,  군내면,'45,40 - 44세,1998,564,336,228
'4181031000,  군내면,'50,45 - 49세,1998,335,186,149
'4181031000,  군내면,'55,50 - 54세,1998,358,174,184
'4181031000,  군내면,'60,55 - 59세,1998,405,176,229
'4181031000,  군내면,'65,60 - 64세,1998,381,181,200
'4181031000,  군내면,'70,65 - 69세,1998,253,111,142
'4181031000,  군내면,'75,70 - 74세,1998,171,65,106
'4181031000,  군내면,'80,75 - 79세,1998,147,66,81
'4181031000,  군내면,'85,80 - 84세,1998,67,28,39
'4181031000,  군내면,'90,85+ ,1998,59,16,43
'4181032000,  내촌면,'00,계,1998,5447,2905,2542
'4181032000,  내촌면,'05,0 - 4세,1998,367,190,177
'4181032000,  내촌면,'10,5 - 9세,1998,403,222,181
'4181032000,  내촌면,'15,10 - 14세,1998,378,194,184
'4181032000,  내촌면,'20,15 - 19세,1998,378,191,187
'4181032000,  내촌면,'25,20 - 24세,1998,405,239,166
'4181032000,  내촌면,'30,25 - 29세,1998,478,278,200
'4181032000,  내촌면,'35,30 - 34세,1998,477,255,222
'4181032000,  내촌면,'40,35 - 39세,1998,542,320,222
'4181032000,  내촌면,'45,40 - 44세,1998,444,266,178
'4181032000,  내촌면,'50,45 - 49세,1998,265,154,111
'4181032000,  내촌면,'55,50 - 54세,1998,285,145,140
'4181032000,  내촌면,'60,55 - 59세,1998,275,126,149
'4181032000,  내촌면,'65,60 - 64세,1998,266,131,135
'4181032000,  내촌면,'70,65 - 69세,1998,202,80,122
'4181032000,  내촌면,'75,70 - 74세,1998,106,46,60
'4181032000,  내촌면,'80,75 - 79세,1998,89,36,53
'4181032000,  내촌면,'85,80 - 84세,1998,51,20,31
'4181032000,  내촌면,'90,85+ ,1998,36,12,24
'4181033000,  가산면,'00,계,1998,9436,5008,4428
'4181033000,  가산면,'05,0 - 4세,1998,690,373,317
'4181033000,  가산면,'10,5 - 9세,1998,761,387,374
'4181033000,  가산면,'15,10 - 14세,1998,655,349,306
'4181033000,  가산면,'20,15 - 19세,1998,667,354,313
'4181033000,  가산면,'25,20 - 24세,1998,715,358,357
'4181033000,  가산면,'30,25 - 29세,1998,827,455,372
'4181033000,  가산면,'35,30 - 34세,1998,913,503,410
'4181033000,  가산면,'40,35 - 39세,1998,993,579,414
'4181033000,  가산면,'45,40 - 44세,1998,710,436,274
'4181033000,  가산면,'50,45 - 49세,1998,461,273,188
'4181033000,  가산면,'55,50 - 54세,1998,400,214,186
'4181033000,  가산면,'60,55 - 59세,1998,459,225,234
'4181033000,  가산면,'65,60 - 64세,1998,430,202,228
'4181033000,  가산면,'70,65 - 69세,1998,307,133,174
'4181033000,  가산면,'75,70 - 74세,1998,172,70,102
'4181033000,  가산면,'80,75 - 79세,1998,148,59,89
'4181033000,  가산면,'85,80 - 84세,1998,74,27,47
'4181033000,  가산면,'90,85+ ,1998,54,11,43
'4181035000,  신북면,'00,계,1998,11089,5766,5323
'4181035000,  신북면,'05,0 - 4세,1998,875,479,396
'4181035000,  신북면,'10,5 - 9세,1998,907,478,429
'4181035000,  신북면,'15,10 - 14세,1998,682,355,327
'4181035000,  신북면,'20,15 - 19세,1998,820,420,400
'4181035000,  신북면,'25,20 - 24세,1998,803,425,378
'4181035000,  신북면,'30,25 - 29세,1998,968,492,476
'4181035000,  신북면,'35,30 - 34세,1998,1104,599,505
'4181035000,  신북면,'40,35 - 39세,1998,1103,641,462
'4181035000,  신북면,'45,40 - 44세,1998,896,536,360
'4181035000,  신북면,'50,45 - 49세,1998,466,239,227
'4181035000,  신북면,'55,50 - 54세,1998,515,244,271
'4181035000,  신북면,'60,55 - 59세,1998,500,234,266
'4181035000,  신북면,'65,60 - 64세,1998,532,254,278
'4181035000,  신북면,'70,65 - 69세,1998,354,159,195
'4181035000,  신북면,'75,70 - 74세,1998,230,92,138
'4181035000,  신북면,'80,75 - 79세,1998,179,67,112
'4181035000,  신북면,'85,80 - 84세,1998,94,35,59
'4181035000,  신북면,'90,85+ ,1998,61,17,44
'4181036000,  관인면,'00,계,1998,5098,2635,2463
'4181036000,  관인면,'05,0 - 4세,1998,275,147,128
'4181036000,  관인면,'10,5 - 9세,1998,293,141,152
'4181036000,  관인면,'15,10 - 14세,1998,278,140,138
'4181036000,  관인면,'20,15 - 19세,1998,440,227,213
'4181036000,  관인면,'25,20 - 24세,1998,447,251,196
'4181036000,  관인면,'30,25 - 29세,1998,389,224,165
'4181036000,  관인면,'35,30 - 34세,1998,347,195,152
'4181036000,  관인면,'40,35 - 39세,1998,405,240,165
'4181036000,  관인면,'45,40 - 44세,1998,350,196,154
'4181036000,  관인면,'50,45 - 49세,1998,259,118,141
'4181036000,  관인면,'55,50 - 54세,1998,311,150,161
'4181036000,  관인면,'60,55 - 59세,1998,369,196,173
'4181036000,  관인면,'65,60 - 64세,1998,325,151,174
'4181036000,  관인면,'70,65 - 69세,1998,203,89,114
'4181036000,  관인면,'75,70 - 74세,1998,152,58,94
'4181036000,  관인면,'80,75 - 79세,1998,127,50,77
'4181036000,  관인면,'85,80 - 84세,1998,83,35,48
'4181036000,  관인면,'90,85+ ,1998,45,27,18
'4181037000,  창수면,'00,계,1998,3351,1764,1587
'4181037000,  창수면,'05,0 - 4세,1998,219,126,93
'4181037000,  창수면,'10,5 - 9세,1998,191,103,88
'4181037000,  창수면,'15,10 - 14세,1998,191,104,87
'4181037000,  창수면,'20,15 - 19세,1998,258,133,125
'4181037000,  창수면,'25,20 - 24세,1998,292,146,146
'4181037000,  창수면,'30,25 - 29세,1998,305,193,112
'4181037000,  창수면,'35,30 - 34세,1998,225,132,93
'4181037000,  창수면,'40,35 - 39세,1998,269,146,123
'4181037000,  창수면,'45,40 - 44세,1998,246,147,99
'4181037000,  창수면,'50,45 - 49세,1998,156,86,70
'4181037000,  창수면,'55,50 - 54세,1998,180,84,96
'4181037000,  창수면,'60,55 - 59세,1998,254,111,143
'4181037000,  창수면,'65,60 - 64세,1998,192,92,100
'4181037000,  창수면,'70,65 - 69세,1998,137,64,73
'4181037000,  창수면,'75,70 - 74세,1998,86,33,53
'4181037000,  창수면,'80,75 - 79세,1998,86,41,45
'4181037000,  창수면,'85,80 - 84세,1998,41,15,26
'4181037000,  창수면,'90,85+ ,1998,23,8,15
'4181038000,  영중면,'00,계,1998,6543,3388,3155
'4181038000,  영중면,'05,0 - 4세,1998,412,222,190
'4181038000,  영중면,'10,5 - 9세,1998,415,207,208
'4181038000,  영중면,'15,10 - 14세,1998,359,194,165
'4181038000,  영중면,'20,15 - 19세,1998,513,270,243
'4181038000,  영중면,'25,20 - 24세,1998,564,302,262
'4181038000,  영중면,'30,25 - 29세,1998,591,315,276
'4181038000,  영중면,'35,30 - 34세,1998,535,312,223
'4181038000,  영중면,'40,35 - 39세,1998,522,311,211
'4181038000,  영중면,'45,40 - 44세,1998,490,269,221
'4181038000,  영중면,'50,45 - 49세,1998,327,174,153
'4181038000,  영중면,'55,50 - 54세,1998,350,162,188
'4181038000,  영중면,'60,55 - 59세,1998,435,203,232
'4181038000,  영중면,'65,60 - 64세,1998,366,168,198
'4181038000,  영중면,'70,65 - 69세,1998,250,117,133
'4181038000,  영중면,'75,70 - 74세,1998,180,70,110
'4181038000,  영중면,'80,75 - 79세,1998,110,46,64
'4181038000,  영중면,'85,80 - 84세,1998,84,34,50
'4181038000,  영중면,'90,85+ ,1998,40,12,28
'4181039000,  일동면,'00,계,1998,12133,6150,5983
'4181039000,  일동면,'05,0 - 4세,1998,846,456,390
'4181039000,  일동면,'10,5 - 9세,1998,901,455,446
'4181039000,  일동면,'15,10 - 14세,1998,797,384,413
'4181039000,  일동면,'20,15 - 19세,1998,946,510,436
'4181039000,  일동면,'25,20 - 24세,1998,943,473,470
'4181039000,  일동면,'30,25 - 29세,1998,1040,580,460
'4181039000,  일동면,'35,30 - 34세,1998,1025,515,510
'4181039000,  일동면,'40,35 - 39세,1998,1166,620,546
'4181039000,  일동면,'45,40 - 44세,1998,965,537,428
'4181039000,  일동면,'50,45 - 49세,1998,535,269,266
'4181039000,  일동면,'55,50 - 54세,1998,550,292,258
'4181039000,  일동면,'60,55 - 59세,1998,670,295,375
'4181039000,  일동면,'65,60 - 64세,1998,614,276,338
'4181039000,  일동면,'70,65 - 69세,1998,432,203,229
'4181039000,  일동면,'75,70 - 74세,1998,316,128,188
'4181039000,  일동면,'80,75 - 79세,1998,229,100,129
'4181039000,  일동면,'85,80 - 84세,1998,99,37,62
'4181039000,  일동면,'90,85+ ,1998,59,20,39
'4181040000,  이동면,'00,계,1998,8360,4215,4145
'4181040000,  이동면,'05,0 - 4세,1998,611,312,299
'4181040000,  이동면,'10,5 - 9세,1998,678,354,324
'4181040000,  이동면,'15,10 - 14세,1998,604,302,302
'4181040000,  이동면,'20,15 - 19세,1998,579,280,299
'4181040000,  이동면,'25,20 - 24세,1998,619,345,274
'4181040000,  이동면,'30,25 - 29세,1998,775,427,348
'4181040000,  이동면,'35,30 - 34세,1998,749,388,361
'4181040000,  이동면,'40,35 - 39세,1998,813,440,373
'4181040000,  이동면,'45,40 - 44세,1998,622,335,287
'4181040000,  이동면,'50,45 - 49세,1998,359,196,163
'4181040000,  이동면,'55,50 - 54세,1998,381,181,200
'4181040000,  이동면,'60,55 - 59세,1998,434,189,245
'4181040000,  이동면,'65,60 - 64세,1998,432,177,255
'4181040000,  이동면,'70,65 - 69세,1998,291,136,155
'4181040000,  이동면,'75,70 - 74세,1998,186,74,112
'4181040000,  이동면,'80,75 - 79세,1998,120,46,74
'4181040000,  이동면,'85,80 - 84세,1998,63,19,44
'4181040000,  이동면,'90,85+ ,1998,44,14,30
'4181041000,  영북면,'00,계,1998,12415,6347,6068
'4181041000,  영북면,'05,0 - 4세,1998,777,413,364
'4181041000,  영북면,'10,5 - 9세,1998,868,451,417
'4181041000,  영북면,'15,10 - 14세,1998,849,428,421
'4181041000,  영북면,'20,15 - 19세,1998,993,488,505
'4181041000,  영북면,'25,20 - 24세,1998,1027,571,456
'4181041000,  영북면,'30,25 - 29세,1998,1124,634,490
'4181041000,  영북면,'35,30 - 34세,1998,1069,592,477
'4181041000,  영북면,'40,35 - 39세,1998,1075,559,516
'4181041000,  영북면,'45,40 - 44세,1998,933,529,404
'4181041000,  영북면,'50,45 - 49세,1998,524,269,255
'4181041000,  영북면,'55,50 - 54세,1998,626,306,320
'4181041000,  영북면,'60,55 - 59세,1998,732,325,407
'4181041000,  영북면,'65,60 - 64세,1998,675,302,373
'4181041000,  영북면,'70,65 - 69세,1998,442,195,247
'4181041000,  영북면,'75,70 - 74세,1998,306,134,172
'4181041000,  영북면,'80,75 - 79세,1998,231,100,131
'4181041000,  영북면,'85,80 - 84세,1998,105,32,73
'4181041000,  영북면,'90,85+ ,1998,59,19,40
'4181042000,  화현면,'00,계,1998,2602,1317,1285
'4181042000,  화현면,'05,0 - 4세,1998,171,91,80
'4181042000,  화현면,'10,5 - 9세,1998,150,83,67
'4181042000,  화현면,'15,10 - 14세,1998,171,76,95
'4181042000,  화현면,'20,15 - 19세,1998,177,85,92
'4181042000,  화현면,'25,20 - 24세,1998,169,97,72
'4181042000,  화현면,'30,25 - 29세,1998,184,107,77
'4181042000,  화현면,'35,30 - 34세,1998,205,107,98
'4181042000,  화현면,'40,35 - 39세,1998,228,125,103
'4181042000,  화현면,'45,40 - 44세,1998,224,136,88
'4181042000,  화현면,'50,45 - 49세,1998,103,54,49
'4181042000,  화현면,'55,50 - 54세,1998,134,62,72
'4181042000,  화현면,'60,55 - 59세,1998,188,81,107
'4181042000,  화현면,'65,60 - 64세,1998,199,96,103
'4181042000,  화현면,'70,65 - 69세,1998,132,51,81
'4181042000,  화현면,'75,70 - 74세,1998,63,26,37
'4181042000,  화현면,'80,75 - 79세,1998,52,23,29
'4181042000,  화현면,'85,80 - 84세,1998,30,9,21
'4181042000,  화현면,'90,85+ ,1998,22,8,14
'41820, 가평군,'00,계,1998,56334,28694,27640
'41820, 가평군,'05,0 - 4세,1998,3556,1858,1698
'41820, 가평군,'10,5 - 9세,1998,3641,1868,1773
'41820, 가평군,'15,10 - 14세,1998,3433,1789,1644
'41820, 가평군,'20,15 - 19세,1998,4223,2109,2114
'41820, 가평군,'25,20 - 24세,1998,4411,2418,1993
'41820, 가평군,'30,25 - 29세,1998,4688,2661,2027
'41820, 가평군,'35,30 - 34세,1998,4485,2406,2079
'41820, 가평군,'40,35 - 39세,1998,4831,2586,2245
'41820, 가평군,'45,40 - 44세,1998,4329,2379,1950
'41820, 가평군,'50,45 - 49세,1998,2804,1455,1349
'41820, 가평군,'55,50 - 54세,1998,2918,1484,1434
'41820, 가평군,'60,55 - 59세,1998,3437,1610,1827
'41820, 가평군,'65,60 - 64세,1998,3254,1520,1734
'41820, 가평군,'70,65 - 69세,1998,2376,1009,1367
'41820, 가평군,'75,70 - 74세,1998,1739,680,1059
'41820, 가평군,'80,75 - 79세,1998,1249,512,737
'41820, 가평군,'85,80 - 84세,1998,593,220,373
'41820, 가평군,'90,85+ ,1998,367,130,237
'4182025000,  가평읍,'00,계,1998,19245,9703,9542
'4182025000,  가평읍,'05,0 - 4세,1998,1423,740,683
'4182025000,  가평읍,'10,5 - 9세,1998,1411,740,671
'4182025000,  가평읍,'15,10 - 14세,1998,1269,655,614
'4182025000,  가평읍,'20,15 - 19세,1998,1451,707,744
'4182025000,  가평읍,'25,20 - 24세,1998,1481,806,675
'4182025000,  가평읍,'30,25 - 29세,1998,1681,899,782
'4182025000,  가평읍,'35,30 - 34세,1998,1665,862,803
'4182025000,  가평읍,'40,35 - 39세,1998,1789,950,839
'4182025000,  가평읍,'45,40 - 44세,1998,1483,805,678
'4182025000,  가평읍,'50,45 - 49세,1998,900,478,422
'4182025000,  가평읍,'55,50 - 54세,1998,872,436,436
'4182025000,  가평읍,'60,55 - 59세,1998,998,478,520
'4182025000,  가평읍,'65,60 - 64세,1998,932,413,519
'4182025000,  가평읍,'70,65 - 69세,1998,704,288,416
'4182025000,  가평읍,'75,70 - 74세,1998,502,189,313
'4182025000,  가평읍,'80,75 - 79세,1998,405,164,241
'4182025000,  가평읍,'85,80 - 84세,1998,179,61,118
'4182025000,  가평읍,'90,85+ ,1998,100,32,68
'4182031000,  설악면,'00,계,1998,6442,3274,3168
'4182031000,  설악면,'05,0 - 4세,1998,287,150,137
'4182031000,  설악면,'10,5 - 9세,1998,319,170,149
'4182031000,  설악면,'15,10 - 14세,1998,409,212,197
'4182031000,  설악면,'20,15 - 19세,1998,512,260,252
'4182031000,  설악면,'25,20 - 24세,1998,495,288,207
'4182031000,  설악면,'30,25 - 29세,1998,392,244,148
'4182031000,  설악면,'35,30 - 34세,1998,419,215,204
'4182031000,  설악면,'40,35 - 39세,1998,482,274,208
'4182031000,  설악면,'45,40 - 44세,1998,468,244,224
'4182031000,  설악면,'50,45 - 49세,1998,340,179,161
'4182031000,  설악면,'55,50 - 54세,1998,370,187,183
'4182031000,  설악면,'60,55 - 59세,1998,450,220,230
'4182031000,  설악면,'65,60 - 64세,1998,477,217,260
'4182031000,  설악면,'70,65 - 69세,1998,369,148,221
'4182031000,  설악면,'75,70 - 74세,1998,300,119,181
'4182031000,  설악면,'80,75 - 79세,1998,190,75,115
'4182031000,  설악면,'85,80 - 84세,1998,105,47,58
'4182031000,  설악면,'90,85+ ,1998,58,25,33
'4182032000,  외서면,'00,계,1998,12145,6130,6015
'4182032000,  외서면,'05,0 - 4세,1998,815,426,389
'4182032000,  외서면,'10,5 - 9세,1998,832,414,418
'4182032000,  외서면,'15,10 - 14세,1998,691,371,320
'4182032000,  외서면,'20,15 - 19세,1998,884,437,447
'4182032000,  외서면,'25,20 - 24세,1998,919,458,461
'4182032000,  외서면,'30,25 - 29세,1998,1066,572,494
'4182032000,  외서면,'35,30 - 34세,1998,1058,573,485
'4182032000,  외서면,'40,35 - 39세,1998,1105,599,506
'4182032000,  외서면,'45,40 - 44세,1998,931,526,405
'4182032000,  외서면,'50,45 - 49세,1998,625,299,326
'4182032000,  외서면,'55,50 - 54세,1998,645,309,336
'4182032000,  외서면,'60,55 - 59세,1998,730,343,387
'4182032000,  외서면,'65,60 - 64세,1998,633,297,336
'4182032000,  외서면,'70,65 - 69세,1998,443,180,263
'4182032000,  외서면,'75,70 - 74세,1998,364,151,213
'4182032000,  외서면,'80,75 - 79세,1998,225,110,115
'4182032000,  외서면,'85,80 - 84세,1998,103,37,66
'4182032000,  외서면,'90,85+ ,1998,76,28,48
'4182033000,  상면,'00,계,1998,5537,2888,2649
'4182033000,  상면,'05,0 - 4세,1998,288,158,130
'4182033000,  상면,'10,5 - 9세,1998,301,151,150
'4182033000,  상면,'15,10 - 14세,1998,332,182,150
'4182033000,  상면,'20,15 - 19세,1998,416,219,197
'4182033000,  상면,'25,20 - 24세,1998,439,263,176
'4182033000,  상면,'30,25 - 29세,1998,453,276,177
'4182033000,  상면,'35,30 - 34세,1998,375,217,158
'4182033000,  상면,'40,35 - 39세,1998,396,207,189
'4182033000,  상면,'45,40 - 44세,1998,427,240,187
'4182033000,  상면,'50,45 - 49세,1998,285,147,138
'4182033000,  상면,'55,50 - 54세,1998,311,169,142
'4182033000,  상면,'60,55 - 59세,1998,403,168,235
'4182033000,  상면,'65,60 - 64세,1998,409,199,210
'4182033000,  상면,'70,65 - 69세,1998,279,133,146
'4182033000,  상면,'75,70 - 74세,1998,180,67,113
'4182033000,  상면,'80,75 - 79세,1998,133,52,81
'4182033000,  상면,'85,80 - 84세,1998,68,25,43
'4182033000,  상면,'90,85+ ,1998,42,15,27
'4182034000,  하면,'00,계,1998,8894,4598,4296
'4182034000,  하면,'05,0 - 4세,1998,584,300,284
'4182034000,  하면,'10,5 - 9세,1998,588,291,297
'4182034000,  하면,'15,10 - 14세,1998,539,264,275
'4182034000,  하면,'20,15 - 19세,1998,655,327,328
'4182034000,  하면,'25,20 - 24세,1998,716,395,321
'4182034000,  하면,'30,25 - 29세,1998,786,469,317
'4182034000,  하면,'35,30 - 34세,1998,734,394,340
'4182034000,  하면,'40,35 - 39세,1998,745,387,358
'4182034000,  하면,'45,40 - 44세,1998,726,413,313
'4182034000,  하면,'50,45 - 49세,1998,431,246,185
'4182034000,  하면,'55,50 - 54세,1998,482,262,220
'4182034000,  하면,'60,55 - 59세,1998,518,251,267
'4182034000,  하면,'65,60 - 64세,1998,477,242,235
'4182034000,  하면,'70,65 - 69세,1998,343,158,185
'4182034000,  하면,'75,70 - 74세,1998,223,82,141
'4182034000,  하면,'80,75 - 79세,1998,195,69,126
'4182034000,  하면,'85,80 - 84세,1998,88,26,62
'4182034000,  하면,'90,85+ ,1998,64,22,42
'4182035000,  북면,'00,계,1998,4071,2101,1970
'4182035000,  북면,'05,0 - 4세,1998,159,84,75
'4182035000,  북면,'10,5 - 9세,1998,190,102,88
'4182035000,  북면,'15,10 - 14세,1998,193,105,88
'4182035000,  북면,'20,15 - 19세,1998,305,159,146
'4182035000,  북면,'25,20 - 24세,1998,361,208,153
'4182035000,  북면,'30,25 - 29세,1998,310,201,109
'4182035000,  북면,'35,30 - 34세,1998,234,145,89
'4182035000,  북면,'40,35 - 39세,1998,314,169,145
'4182035000,  북면,'45,40 - 44세,1998,294,151,143
'4182035000,  북면,'50,45 - 49세,1998,223,106,117
'4182035000,  북면,'55,50 - 54세,1998,238,121,117
'4182035000,  북면,'60,55 - 59세,1998,338,150,188
'4182035000,  북면,'65,60 - 64세,1998,326,152,174
'4182035000,  북면,'70,65 - 69세,1998,238,102,136
'4182035000,  북면,'75,70 - 74세,1998,170,72,98
'4182035000,  북면,'80,75 - 79세,1998,101,42,59
'4182035000,  북면,'85,80 - 84세,1998,50,24,26
'4182035000,  북면,'90,85+ ,1998,27,8,19
'41830, 양평군,'00,계,1998,81200,40968,40232
'41830, 양평군,'05,0 - 4세,1998,4736,2536,2200
'41830, 양평군,'10,5 - 9세,1998,5023,2653,2370
'41830, 양평군,'15,10 - 14세,1998,5005,2539,2466
'41830, 양평군,'20,15 - 19세,1998,6443,3232,3211
'41830, 양평군,'25,20 - 24세,1998,6430,3569,2861
'41830, 양평군,'30,25 - 29세,1998,6141,3470,2671
'41830, 양평군,'35,30 - 34세,1998,5945,3161,2784
'41830, 양평군,'40,35 - 39세,1998,6927,3685,3242
'41830, 양평군,'45,40 - 44세,1998,5940,3178,2762
'41830, 양평군,'50,45 - 49세,1998,4145,2096,2049
'41830, 양평군,'55,50 - 54세,1998,4291,2070,2221
'41830, 양평군,'60,55 - 59세,1998,5127,2407,2720
'41830, 양평군,'65,60 - 64세,1998,5185,2392,2793
'41830, 양평군,'70,65 - 69세,1998,3667,1512,2155
'41830, 양평군,'75,70 - 74세,1998,2612,1064,1548
'41830, 양평군,'80,75 - 79세,1998,1954,810,1144
'41830, 양평군,'85,80 - 84세,1998,1043,402,641
'41830, 양평군,'90,85+ ,1998,586,192,394
'4183025000,  양평읍,'00,계,1998,21673,10796,10877
'4183025000,  양평읍,'05,0 - 4세,1998,1762,944,818
'4183025000,  양평읍,'10,5 - 9세,1998,1796,940,856
'4183025000,  양평읍,'15,10 - 14세,1998,1555,779,776
'4183025000,  양평읍,'20,15 - 19세,1998,1660,826,834
'4183025000,  양평읍,'25,20 - 24세,1998,1562,788,774
'4183025000,  양평읍,'30,25 - 29세,1998,1937,946,991
'4183025000,  양평읍,'35,30 - 34세,1998,2060,1044,1016
'4183025000,  양평읍,'40,35 - 39세,1998,2245,1165,1080
'4183025000,  양평읍,'45,40 - 44세,1998,1667,887,780
'4183025000,  양평읍,'50,45 - 49세,1998,1005,534,471
'4183025000,  양평읍,'55,50 - 54세,1998,907,440,467
'4183025000,  양평읍,'60,55 - 59세,1998,999,471,528
'4183025000,  양평읍,'65,60 - 64세,1998,894,389,505
'4183025000,  양평읍,'70,65 - 69세,1998,646,254,392
'4183025000,  양평읍,'75,70 - 74세,1998,406,176,230
'4183025000,  양평읍,'80,75 - 79세,1998,319,128,191
'4183025000,  양평읍,'85,80 - 84세,1998,150,55,95
'4183025000,  양평읍,'90,85+ ,1998,103,30,73
'4183031000,  강상면,'00,계,1998,3921,1986,1935
'4183031000,  강상면,'05,0 - 4세,1998,206,110,96
'4183031000,  강상면,'10,5 - 9세,1998,219,125,94
'4183031000,  강상면,'15,10 - 14세,1998,230,120,110
'4183031000,  강상면,'20,15 - 19세,1998,317,159,158
'4183031000,  강상면,'25,20 - 24세,1998,350,193,157
'4183031000,  강상면,'30,25 - 29세,1998,283,157,126
'4183031000,  강상면,'35,30 - 34세,1998,258,141,117
'4183031000,  강상면,'40,35 - 39세,1998,327,178,149
'4183031000,  강상면,'45,40 - 44세,1998,271,157,114
'4183031000,  강상면,'50,45 - 49세,1998,210,101,109
'4183031000,  강상면,'55,50 - 54세,1998,216,104,112
'4183031000,  강상면,'60,55 - 59세,1998,232,107,125
'4183031000,  강상면,'65,60 - 64세,1998,275,125,150
'4183031000,  강상면,'70,65 - 69세,1998,193,81,112
'4183031000,  강상면,'75,70 - 74세,1998,127,50,77
'4183031000,  강상면,'80,75 - 79세,1998,122,50,72
'4183031000,  강상면,'85,80 - 84세,1998,62,22,40
'4183031000,  강상면,'90,85+ ,1998,23,6,17
'4183032000,  강하면,'00,계,1998,3028,1538,1490
'4183032000,  강하면,'05,0 - 4세,1998,153,88,65
'4183032000,  강하면,'10,5 - 9세,1998,172,88,84
'4183032000,  강하면,'15,10 - 14세,1998,147,74,73
'4183032000,  강하면,'20,15 - 19세,1998,235,123,112
'4183032000,  강하면,'25,20 - 24세,1998,245,142,103
'4183032000,  강하면,'30,25 - 29세,1998,187,102,85
'4183032000,  강하면,'35,30 - 34세,1998,175,84,91
'4183032000,  강하면,'40,35 - 39세,1998,258,144,114
'4183032000,  강하면,'45,40 - 44세,1998,228,115,113
'4183032000,  강하면,'50,45 - 49세,1998,197,99,98
'4183032000,  강하면,'55,50 - 54세,1998,218,110,108
'4183032000,  강하면,'60,55 - 59세,1998,221,108,113
'4183032000,  강하면,'65,60 - 64세,1998,189,102,87
'4183032000,  강하면,'70,65 - 69세,1998,145,58,87
'4183032000,  강하면,'75,70 - 74세,1998,92,39,53
'4183032000,  강하면,'80,75 - 79세,1998,98,39,59
'4183032000,  강하면,'85,80 - 84세,1998,49,19,30
'4183032000,  강하면,'90,85+ ,1998,19,4,15
'4183033000,  양서면,'00,계,1998,7745,3955,3790
'4183033000,  양서면,'05,0 - 4세,1998,408,218,190
'4183033000,  양서면,'10,5 - 9세,1998,445,236,209
'4183033000,  양서면,'15,10 - 14세,1998,435,226,209
'4183033000,  양서면,'20,15 - 19세,1998,716,385,331
'4183033000,  양서면,'25,20 - 24세,1998,576,321,255
'4183033000,  양서면,'30,25 - 29세,1998,602,345,257
'4183033000,  양서면,'35,30 - 34세,1998,559,298,261
'4183033000,  양서면,'40,35 - 39세,1998,639,342,297
'4183033000,  양서면,'45,40 - 44세,1998,577,317,260
'4183033000,  양서면,'50,45 - 49세,1998,456,221,235
'4183033000,  양서면,'55,50 - 54세,1998,440,212,228
'4183033000,  양서면,'60,55 - 59세,1998,499,226,273
'4183033000,  양서면,'65,60 - 64세,1998,491,243,248
'4183033000,  양서면,'70,65 - 69세,1998,318,148,170
'4183033000,  양서면,'75,70 - 74세,1998,228,86,142
'4183033000,  양서면,'80,75 - 79세,1998,203,77,126
'4183033000,  양서면,'85,80 - 84세,1998,92,39,53
'4183033000,  양서면,'90,85+ ,1998,61,15,46
'4183034000,  옥천면,'00,계,1998,4806,2461,2345
'4183034000,  옥천면,'05,0 - 4세,1998,314,175,139
'4183034000,  옥천면,'10,5 - 9세,1998,301,146,155
'4183034000,  옥천면,'15,10 - 14세,1998,284,128,156
'4183034000,  옥천면,'20,15 - 19세,1998,330,173,157
'4183034000,  옥천면,'25,20 - 24세,1998,395,221,174
'4183034000,  옥천면,'30,25 - 29세,1998,429,266,163
'4183034000,  옥천면,'35,30 - 34세,1998,366,200,166
'4183034000,  옥천면,'40,35 - 39세,1998,405,227,178
'4183034000,  옥천면,'45,40 - 44세,1998,346,179,167
'4183034000,  옥천면,'50,45 - 49세,1998,244,112,132
'4183034000,  옥천면,'55,50 - 54세,1998,251,129,122
'4183034000,  옥천면,'60,55 - 59세,1998,297,133,164
'4183034000,  옥천면,'65,60 - 64세,1998,278,135,143
'4183034000,  옥천면,'70,65 - 69세,1998,215,91,124
'4183034000,  옥천면,'75,70 - 74세,1998,141,64,77
'4183034000,  옥천면,'80,75 - 79세,1998,102,40,62
'4183034000,  옥천면,'85,80 - 84세,1998,69,24,45
'4183034000,  옥천면,'90,85+ ,1998,39,18,21
'4183035000,  서종면,'00,계,1998,4312,2196,2116
'4183035000,  서종면,'05,0 - 4세,1998,202,112,90
'4183035000,  서종면,'10,5 - 9세,1998,244,131,113
'4183035000,  서종면,'15,10 - 14세,1998,262,133,129
'4183035000,  서종면,'20,15 - 19세,1998,253,125,128
'4183035000,  서종면,'25,20 - 24세,1998,288,156,132
'4183035000,  서종면,'30,25 - 29세,1998,274,155,119
'4183035000,  서종면,'35,30 - 34세,1998,280,152,128
'4183035000,  서종면,'40,35 - 39세,1998,370,186,184
'4183035000,  서종면,'45,40 - 44세,1998,351,196,155
'4183035000,  서종면,'50,45 - 49세,1998,260,133,127
'4183035000,  서종면,'55,50 - 54세,1998,305,149,156
'4183035000,  서종면,'60,55 - 59세,1998,296,155,141
'4183035000,  서종면,'65,60 - 64세,1998,299,139,160
'4183035000,  서종면,'70,65 - 69세,1998,216,90,126
'4183035000,  서종면,'75,70 - 74세,1998,185,85,100
'4183035000,  서종면,'80,75 - 79세,1998,129,58,71
'4183035000,  서종면,'85,80 - 84세,1998,55,22,33
'4183035000,  서종면,'90,85+ ,1998,43,19,24
'4183036000,  단월면,'00,계,1998,3256,1672,1584
'4183036000,  단월면,'05,0 - 4세,1998,128,68,60
'4183036000,  단월면,'10,5 - 9세,1998,123,68,55
'4183036000,  단월면,'15,10 - 14세,1998,192,93,99
'4183036000,  단월면,'20,15 - 19세,1998,295,148,147
'4183036000,  단월면,'25,20 - 24세,1998,259,157,102
'4183036000,  단월면,'30,25 - 29세,1998,201,148,53
'4183036000,  단월면,'35,30 - 34세,1998,142,74,68
'4183036000,  단월면,'40,35 - 39세,1998,203,104,99
'4183036000,  단월면,'45,40 - 44세,1998,238,132,106
'4183036000,  단월면,'50,45 - 49세,1998,170,89,81
'4183036000,  단월면,'55,50 - 54세,1998,187,81,106
'4183036000,  단월면,'60,55 - 59세,1998,291,134,157
'4183036000,  단월면,'65,60 - 64세,1998,297,143,154
'4183036000,  단월면,'70,65 - 69세,1998,177,83,94
'4183036000,  단월면,'75,70 - 74세,1998,155,61,94
'4183036000,  단월면,'80,75 - 79세,1998,102,44,58
'4183036000,  단월면,'85,80 - 84세,1998,69,32,37
'4183036000,  단월면,'90,85+ ,1998,27,13,14
'4183037000,  청운면,'00,계,1998,3980,2020,1960
'4183037000,  청운면,'05,0 - 4세,1998,145,79,66
'4183037000,  청운면,'10,5 - 9세,1998,157,84,73
'4183037000,  청운면,'15,10 - 14세,1998,224,114,110
'4183037000,  청운면,'20,15 - 19세,1998,317,157,160
'4183037000,  청운면,'25,20 - 24세,1998,346,205,141
'4183037000,  청운면,'30,25 - 29세,1998,272,179,93
'4183037000,  청운면,'35,30 - 34세,1998,232,137,95
'4183037000,  청운면,'40,35 - 39세,1998,271,146,125
'4183037000,  청운면,'45,40 - 44세,1998,282,146,136
'4183037000,  청운면,'50,45 - 49세,1998,199,107,92
'4183037000,  청운면,'55,50 - 54세,1998,246,114,132
'4183037000,  청운면,'60,55 - 59세,1998,312,141,171
'4183037000,  청운면,'65,60 - 64세,1998,333,155,178
'4183037000,  청운면,'70,65 - 69세,1998,239,92,147
'4183037000,  청운면,'75,70 - 74세,1998,172,70,102
'4183037000,  청운면,'80,75 - 79세,1998,121,57,64
'4183037000,  청운면,'85,80 - 84세,1998,77,26,51
'4183037000,  청운면,'90,85+ ,1998,35,11,24
'4183038000,  양동면,'00,계,1998,5627,2895,2732
'4183038000,  양동면,'05,0 - 4세,1998,214,112,102
'4183038000,  양동면,'10,5 - 9세,1998,250,130,120
'4183038000,  양동면,'15,10 - 14세,1998,334,178,156
'4183038000,  양동면,'20,15 - 19세,1998,478,253,225
'4183038000,  양동면,'25,20 - 24세,1998,501,307,194
'4183038000,  양동면,'30,25 - 29세,1998,341,203,138
'4183038000,  양동면,'35,30 - 34세,1998,318,188,130
'4183038000,  양동면,'40,35 - 39세,1998,379,215,164
'4183038000,  양동면,'45,40 - 44세,1998,400,211,189
'4183038000,  양동면,'50,45 - 49세,1998,307,149,158
'4183038000,  양동면,'55,50 - 54세,1998,298,143,155
'4183038000,  양동면,'60,55 - 59세,1998,424,205,219
'4183038000,  양동면,'65,60 - 64세,1998,467,216,251
'4183038000,  양동면,'70,65 - 69세,1998,332,138,194
'4183038000,  양동면,'75,70 - 74세,1998,257,105,152
'4183038000,  양동면,'80,75 - 79세,1998,178,83,95
'4183038000,  양동면,'85,80 - 84세,1998,98,43,55
'4183038000,  양동면,'90,85+ ,1998,51,16,35
'4183039000,  지제면,'00,계,1998,6675,3320,3355
'4183039000,  지제면,'05,0 - 4세,1998,352,185,167
'4183039000,  지제면,'10,5 - 9세,1998,364,202,162
'4183039000,  지제면,'15,10 - 14세,1998,338,169,169
'4183039000,  지제면,'20,15 - 19세,1998,469,214,255
'4183039000,  지제면,'25,20 - 24세,1998,544,307,237
'4183039000,  지제면,'30,25 - 29세,1998,462,295,167
'4183039000,  지제면,'35,30 - 34세,1998,434,232,202
'4183039000,  지제면,'40,35 - 39세,1998,491,273,218
'4183039000,  지제면,'45,40 - 44세,1998,398,211,187
'4183039000,  지제면,'50,45 - 49세,1998,281,142,139
'4183039000,  지제면,'55,50 - 54세,1998,344,150,194
'4183039000,  지제면,'60,55 - 59세,1998,533,242,291
'4183039000,  지제면,'65,60 - 64세,1998,595,273,322
'4183039000,  지제면,'70,65 - 69세,1998,397,169,228
'4183039000,  지제면,'75,70 - 74세,1998,298,106,192
'4183039000,  지제면,'80,75 - 79세,1998,204,93,111
'4183039000,  지제면,'85,80 - 84세,1998,106,35,71
'4183039000,  지제면,'90,85+ ,1998,65,22,43
'4183040000,  용문면,'00,계,1998,11935,5952,5983
'4183040000,  용문면,'05,0 - 4세,1998,657,343,314
'4183040000,  용문면,'10,5 - 9세,1998,727,384,343
'4183040000,  용문면,'15,10 - 14세,1998,760,390,370
'4183040000,  용문면,'20,15 - 19세,1998,990,480,510
'4183040000,  용문면,'25,20 - 24세,1998,979,539,440
'4183040000,  용문면,'30,25 - 29세,1998,825,479,346
'4183040000,  용문면,'35,30 - 34세,1998,855,457,398
'4183040000,  용문면,'40,35 - 39세,1998,1009,531,478
'4183040000,  용문면,'45,40 - 44세,1998,893,479,414
'4183040000,  용문면,'50,45 - 49세,1998,585,302,283
'4183040000,  용문면,'55,50 - 54세,1998,616,294,322
'4183040000,  용문면,'60,55 - 59세,1998,753,350,403
'4183040000,  용문면,'65,60 - 64세,1998,759,335,424
'4183040000,  용문면,'70,65 - 69세,1998,584,228,356
'4183040000,  용문면,'75,70 - 74세,1998,400,156,244
'4183040000,  용문면,'80,75 - 79세,1998,286,111,175
'4183040000,  용문면,'85,80 - 84세,1998,165,66,99
'4183040000,  용문면,'90,85+ ,1998,92,28,64
'4183041000,  개군면,'00,계,1998,4242,2177,2065
'4183041000,  개군면,'05,0 - 4세,1998,195,102,93
'4183041000,  개군면,'10,5 - 9세,1998,225,119,106
'4183041000,  개군면,'15,10 - 14세,1998,244,135,109
'4183041000,  개군면,'20,15 - 19세,1998,383,189,194
'4183041000,  개군면,'25,20 - 24세,1998,385,233,152
'4183041000,  개군면,'30,25 - 29세,1998,328,195,133
'4183041000,  개군면,'35,30 - 34세,1998,266,154,112
'4183041000,  개군면,'40,35 - 39세,1998,330,174,156
'4183041000,  개군면,'45,40 - 44세,1998,289,148,141
'4183041000,  개군면,'50,45 - 49세,1998,231,107,124
'4183041000,  개군면,'55,50 - 54세,1998,263,144,119
'4183041000,  개군면,'60,55 - 59세,1998,270,135,135
'4183041000,  개군면,'65,60 - 64세,1998,308,137,171
'4183041000,  개군면,'70,65 - 69세,1998,205,80,125
'4183041000,  개군면,'75,70 - 74세,1998,151,66,85
'4183041000,  개군면,'80,75 - 79세,1998,90,30,60
'4183041000,  개군면,'85,80 - 84세,1998,51,19,32
'4183041000,  개군면,'90,85+ ,1998,28,10,18
'42,강원도,'00,계,1998,1552667,781179,771488
'42,강원도,'05,0 - 4세,1998,101804,53467,48337
'42,강원도,'10,5 - 9세,1998,102842,53884,48958
'42,강원도,'15,10 - 14세,1998,103961,53159,50802
'42,강원도,'20,15 - 19세,1998,140107,71482,68625
'42,강원도,'25,20 - 24세,1998,135906,72683,63223
'42,강원도,'30,25 - 29세,1998,135282,73098,62184
'42,강원도,'35,30 - 34세,1998,125718,65614,60104
'42,강원도,'40,35 - 39세,1998,139897,71500,68397
'42,강원도,'45,40 - 44세,1998,122504,64130,58374
'42,강원도,'50,45 - 49세,1998,79177,39756,39421
'42,강원도,'55,50 - 54세,1998,75817,37502,38315
'42,강원도,'60,55 - 59세,1998,85391,40842,44549
'42,강원도,'65,60 - 64세,1998,72136,33933,38203
'42,강원도,'70,65 - 69세,1998,48280,19305,28975
'42,강원도,'75,70 - 74세,1998,35865,13427,22438
'42,강원도,'80,75 - 79세,1998,25458,9970,15488
'42,강원도,'85,80 - 84세,1998,14479,5012,9467
'42,강원도,'90,85+ ,1998,8043,2415,5628
'42110, 춘천시,'00,계,1998,244076,121095,122981
'42110, 춘천시,'05,0 - 4세,1998,16901,8702,8199
'42110, 춘천시,'10,5 - 9세,1998,16796,8728,8068
'42110, 춘천시,'15,10 - 14세,1998,16330,8376,7954
'42110, 춘천시,'20,15 - 19세,1998,20941,10678,10263
'42110, 춘천시,'25,20 - 24세,1998,20741,10657,10084
'42110, 춘천시,'30,25 - 29세,1998,23007,12033,10974
'42110, 춘천시,'35,30 - 34세,1998,21058,10836,10222
'42110, 춘천시,'40,35 - 39세,1998,22536,11297,11239
'42110, 춘천시,'45,40 - 44세,1998,20440,10341,10099
'42110, 춘천시,'50,45 - 49세,1998,11961,5887,6074
'42110, 춘천시,'55,50 - 54세,1998,11567,5569,5998
'42110, 춘천시,'60,55 - 59세,1998,12460,5849,6611
'42110, 춘천시,'65,60 - 64세,1998,10365,4760,5605
'42110, 춘천시,'70,65 - 69세,1998,6908,2842,4066
'42110, 춘천시,'75,70 - 74세,1998,5156,1974,3182
'42110, 춘천시,'80,75 - 79세,1998,3676,1489,2187
'42110, 춘천시,'85,80 - 84세,1998,2092,745,1347
'42110, 춘천시,'90,85+ ,1998,1141,332,809
'4211025000,  신북읍,'00,계,1998,9817,4947,4870
'4211025000,  신북읍,'05,0 - 4세,1998,612,320,292
'4211025000,  신북읍,'10,5 - 9세,1998,532,270,262
'4211025000,  신북읍,'15,10 - 14세,1998,465,226,239
'4211025000,  신북읍,'20,15 - 19세,1998,767,402,365
'4211025000,  신북읍,'25,20 - 24세,1998,891,465,426
'4211025000,  신북읍,'30,25 - 29세,1998,972,532,440
'4211025000,  신북읍,'35,30 - 34세,1998,782,446,336
'4211025000,  신북읍,'40,35 - 39세,1998,739,421,318
'4211025000,  신북읍,'45,40 - 44세,1998,669,354,315
'4211025000,  신북읍,'50,45 - 49세,1998,457,216,241
'4211025000,  신북읍,'55,50 - 54세,1998,504,252,252
'4211025000,  신북읍,'60,55 - 59세,1998,637,293,344
'4211025000,  신북읍,'65,60 - 64세,1998,636,284,352
'4211025000,  신북읍,'70,65 - 69세,1998,413,173,240
'4211025000,  신북읍,'75,70 - 74세,1998,287,117,170
'4211025000,  신북읍,'80,75 - 79세,1998,247,101,146
'4211025000,  신북읍,'85,80 - 84세,1998,144,57,87
'4211025000,  신북읍,'90,85+ ,1998,63,18,45
'4211031000,  동면,'00,계,1998,4617,2434,2183
'4211031000,  동면,'05,0 - 4세,1998,292,160,132
'4211031000,  동면,'10,5 - 9세,1998,204,116,88
'4211031000,  동면,'15,10 - 14세,1998,247,140,107
'4211031000,  동면,'20,15 - 19세,1998,431,241,190
'4211031000,  동면,'25,20 - 24세,1998,402,207,195
'4211031000,  동면,'30,25 - 29세,1998,386,217,169
'4211031000,  동면,'35,30 - 34세,1998,375,224,151
'4211031000,  동면,'40,35 - 39세,1998,400,228,172
'4211031000,  동면,'45,40 - 44세,1998,346,189,157
'4211031000,  동면,'50,45 - 49세,1998,204,102,102
'4211031000,  동면,'55,50 - 54세,1998,245,139,106
'4211031000,  동면,'60,55 - 59세,1998,287,128,159
'4211031000,  동면,'65,60 - 64세,1998,271,134,137
'4211031000,  동면,'70,65 - 69세,1998,199,77,122
'4211031000,  동면,'75,70 - 74세,1998,137,53,84
'4211031000,  동면,'80,75 - 79세,1998,100,47,53
'4211031000,  동면,'85,80 - 84세,1998,58,20,38
'4211031000,  동면,'90,85+ ,1998,33,12,21
'4211032000,  동산면,'00,계,1998,1992,1019,973
'4211032000,  동산면,'05,0 - 4세,1998,101,49,52
'4211032000,  동산면,'10,5 - 9세,1998,77,42,35
'4211032000,  동산면,'15,10 - 14세,1998,99,49,50
'4211032000,  동산면,'20,15 - 19세,1998,146,71,75
'4211032000,  동산면,'25,20 - 24세,1998,168,87,81
'4211032000,  동산면,'30,25 - 29세,1998,138,80,58
'4211032000,  동산면,'35,30 - 34세,1998,123,75,48
'4211032000,  동산면,'40,35 - 39세,1998,148,90,58
'4211032000,  동산면,'45,40 - 44세,1998,134,80,54
'4211032000,  동산면,'50,45 - 49세,1998,68,37,31
'4211032000,  동산면,'55,50 - 54세,1998,119,57,62
'4211032000,  동산면,'60,55 - 59세,1998,167,74,93
'4211032000,  동산면,'65,60 - 64세,1998,200,104,96
'4211032000,  동산면,'70,65 - 69세,1998,117,44,73
'4211032000,  동산면,'75,70 - 74세,1998,91,42,49
'4211032000,  동산면,'80,75 - 79세,1998,51,20,31
'4211032000,  동산면,'85,80 - 84세,1998,31,16,15
'4211032000,  동산면,'90,85+ ,1998,14,2,12
'4211033000,  신동면,'00,계,1998,3157,1543,1614
'4211033000,  신동면,'05,0 - 4세,1998,170,83,87
'4211033000,  신동면,'10,5 - 9세,1998,151,69,82
'4211033000,  신동면,'15,10 - 14세,1998,211,92,119
'4211033000,  신동면,'20,15 - 19세,1998,280,129,151
'4211033000,  신동면,'25,20 - 24세,1998,269,139,130
'4211033000,  신동면,'30,25 - 29세,1998,250,149,101
'4211033000,  신동면,'35,30 - 34세,1998,199,117,82
'4211033000,  신동면,'40,35 - 39세,1998,233,123,110
'4211033000,  신동면,'45,40 - 44세,1998,256,131,125
'4211033000,  신동면,'50,45 - 49세,1998,156,83,73
'4211033000,  신동면,'55,50 - 54세,1998,140,70,70
'4211033000,  신동면,'60,55 - 59세,1998,227,98,129
'4211033000,  신동면,'65,60 - 64세,1998,209,109,100
'4211033000,  신동면,'70,65 - 69세,1998,145,47,98
'4211033000,  신동면,'75,70 - 74세,1998,114,38,76
'4211033000,  신동면,'80,75 - 79세,1998,79,39,40
'4211033000,  신동면,'85,80 - 84세,1998,46,19,27
'4211033000,  신동면,'90,85+ ,1998,22,8,14
'4211034000,  남면,'00,계,1998,1456,763,693
'4211034000,  남면,'05,0 - 4세,1998,37,14,23
'4211034000,  남면,'10,5 - 9세,1998,45,25,20
'4211034000,  남면,'15,10 - 14세,1998,56,33,23
'4211034000,  남면,'20,15 - 19세,1998,128,54,74
'4211034000,  남면,'25,20 - 24세,1998,136,82,54
'4211034000,  남면,'30,25 - 29세,1998,94,70,24
'4211034000,  남면,'35,30 - 34세,1998,77,47,30
'4211034000,  남면,'40,35 - 39세,1998,91,55,36
'4211034000,  남면,'45,40 - 44세,1998,97,54,43
'4211034000,  남면,'50,45 - 49세,1998,62,35,27
'4211034000,  남면,'55,50 - 54세,1998,98,46,52
'4211034000,  남면,'60,55 - 59세,1998,119,54,65
'4211034000,  남면,'65,60 - 64세,1998,154,78,76
'4211034000,  남면,'70,65 - 69세,1998,81,34,47
'4211034000,  남면,'75,70 - 74세,1998,65,32,33
'4211034000,  남면,'80,75 - 79세,1998,61,30,31
'4211034000,  남면,'85,80 - 84세,1998,39,13,26
'4211034000,  남면,'90,85+ ,1998,16,7,9
'4211035000,  서면,'00,계,1998,5153,2602,2551
'4211035000,  서면,'05,0 - 4세,1998,225,115,110
'4211035000,  서면,'10,5 - 9세,1998,234,124,110
'4211035000,  서면,'15,10 - 14세,1998,232,129,103
'4211035000,  서면,'20,15 - 19세,1998,421,215,206
'4211035000,  서면,'25,20 - 24세,1998,471,248,223
'4211035000,  서면,'30,25 - 29세,1998,357,222,135
'4211035000,  서면,'35,30 - 34세,1998,296,182,114
'4211035000,  서면,'40,35 - 39세,1998,329,179,150
'4211035000,  서면,'45,40 - 44세,1998,340,175,165
'4211035000,  서면,'50,45 - 49세,1998,269,132,137
'4211035000,  서면,'55,50 - 54세,1998,277,140,137
'4211035000,  서면,'60,55 - 59세,1998,401,210,191
'4211035000,  서면,'65,60 - 64세,1998,393,164,229
'4211035000,  서면,'70,65 - 69세,1998,265,108,157
'4211035000,  서면,'75,70 - 74세,1998,259,109,150
'4211035000,  서면,'80,75 - 79세,1998,199,84,115
'4211035000,  서면,'85,80 - 84세,1998,118,47,71
'4211035000,  서면,'90,85+ ,1998,67,19,48
'4211036000,  사북면,'00,계,1998,3169,1595,1574
'4211036000,  사북면,'05,0 - 4세,1998,175,82,93
'4211036000,  사북면,'10,5 - 9세,1998,174,85,89
'4211036000,  사북면,'15,10 - 14세,1998,168,78,90
'4211036000,  사북면,'20,15 - 19세,1998,209,92,117
'4211036000,  사북면,'25,20 - 24세,1998,265,148,117
'4211036000,  사북면,'30,25 - 29세,1998,266,163,103
'4211036000,  사북면,'35,30 - 34세,1998,220,125,95
'4211036000,  사북면,'40,35 - 39세,1998,207,121,86
'4211036000,  사북면,'45,40 - 44세,1998,211,116,95
'4211036000,  사북면,'50,45 - 49세,1998,128,66,62
'4211036000,  사북면,'55,50 - 54세,1998,169,87,82
'4211036000,  사북면,'60,55 - 59세,1998,269,119,150
'4211036000,  사북면,'65,60 - 64세,1998,243,108,135
'4211036000,  사북면,'70,65 - 69세,1998,154,64,90
'4211036000,  사북면,'75,70 - 74세,1998,148,67,81
'4211036000,  사북면,'80,75 - 79세,1998,93,48,45
'4211036000,  사북면,'85,80 - 84세,1998,43,17,26
'4211036000,  사북면,'90,85+ ,1998,27,9,18
'4211038000,  북산면,'00,계,1998,888,484,404
'4211038000,  북산면,'05,0 - 4세,1998,27,14,13
'4211038000,  북산면,'10,5 - 9세,1998,32,17,15
'4211038000,  북산면,'15,10 - 14세,1998,28,10,18
'4211038000,  북산면,'20,15 - 19세,1998,68,41,27
'4211038000,  북산면,'25,20 - 24세,1998,55,26,29
'4211038000,  북산면,'30,25 - 29세,1998,53,35,18
'4211038000,  북산면,'35,30 - 34세,1998,39,28,11
'4211038000,  북산면,'40,35 - 39세,1998,59,41,18
'4211038000,  북산면,'45,40 - 44세,1998,63,43,20
'4211038000,  북산면,'50,45 - 49세,1998,44,24,20
'4211038000,  북산면,'55,50 - 54세,1998,58,26,32
'4211038000,  북산면,'60,55 - 59세,1998,105,50,55
'4211038000,  북산면,'65,60 - 64세,1998,91,52,39
'4211038000,  북산면,'70,65 - 69세,1998,65,26,39
'4211038000,  북산면,'75,70 - 74세,1998,50,27,23
'4211038000,  북산면,'80,75 - 79세,1998,29,13,16
'4211038000,  북산면,'85,80 - 84세,1998,15,9,6
'4211038000,  북산면,'90,85+ ,1998,7,2,5
'4211039000,  동내면,'00,계,1998,5686,2941,2745
'4211039000,  동내면,'05,0 - 4세,1998,320,179,141
'4211039000,  동내면,'10,5 - 9세,1998,289,160,129
'4211039000,  동내면,'15,10 - 14세,1998,325,165,160
'4211039000,  동내면,'20,15 - 19세,1998,494,239,255
'4211039000,  동내면,'25,20 - 24세,1998,515,289,226
'4211039000,  동내면,'30,25 - 29세,1998,512,296,216
'4211039000,  동내면,'35,30 - 34세,1998,428,247,181
'4211039000,  동내면,'40,35 - 39세,1998,475,267,208
'4211039000,  동내면,'45,40 - 44세,1998,419,216,203
'4211039000,  동내면,'50,45 - 49세,1998,279,142,137
'4211039000,  동내면,'55,50 - 54세,1998,299,160,139
'4211039000,  동내면,'60,55 - 59세,1998,369,165,204
'4211039000,  동내면,'65,60 - 64세,1998,338,171,167
'4211039000,  동내면,'70,65 - 69세,1998,204,92,112
'4211039000,  동내면,'75,70 - 74세,1998,179,65,114
'4211039000,  동내면,'80,75 - 79세,1998,121,44,77
'4211039000,  동내면,'85,80 - 84세,1998,80,31,49
'4211039000,  동내면,'90,85+ ,1998,40,13,27
'4211040000,  남산면,'00,계,1998,4419,2288,2131
'4211040000,  남산면,'05,0 - 4세,1998,230,113,117
'4211040000,  남산면,'10,5 - 9세,1998,241,130,111
'4211040000,  남산면,'15,10 - 14세,1998,258,131,127
'4211040000,  남산면,'20,15 - 19세,1998,382,212,170
'4211040000,  남산면,'25,20 - 24세,1998,352,198,154
'4211040000,  남산면,'30,25 - 29세,1998,313,194,119
'4211040000,  남산면,'35,30 - 34세,1998,305,173,132
'4211040000,  남산면,'40,35 - 39세,1998,335,174,161
'4211040000,  남산면,'45,40 - 44세,1998,350,201,149
'4211040000,  남산면,'50,45 - 49세,1998,213,117,96
'4211040000,  남산면,'55,50 - 54세,1998,219,106,113
'4211040000,  남산면,'60,55 - 59세,1998,301,158,143
'4211040000,  남산면,'65,60 - 64세,1998,285,136,149
'4211040000,  남산면,'70,65 - 69세,1998,212,72,140
'4211040000,  남산면,'75,70 - 74세,1998,160,61,99
'4211040000,  남산면,'80,75 - 79세,1998,144,59,85
'4211040000,  남산면,'85,80 - 84세,1998,78,40,38
'4211040000,  남산면,'90,85+ ,1998,41,13,28
'4211052000,  교동,'00,계,1998,5524,2701,2823
'4211052000,  교동,'05,0 - 4세,1998,295,151,144
'4211052000,  교동,'10,5 - 9세,1998,285,154,131
'4211052000,  교동,'15,10 - 14세,1998,291,141,150
'4211052000,  교동,'20,15 - 19세,1998,537,256,281
'4211052000,  교동,'25,20 - 24세,1998,654,333,321
'4211052000,  교동,'30,25 - 29세,1998,579,330,249
'4211052000,  교동,'35,30 - 34세,1998,399,213,186
'4211052000,  교동,'40,35 - 39세,1998,380,179,201
'4211052000,  교동,'45,40 - 44세,1998,408,191,217
'4211052000,  교동,'50,45 - 49세,1998,286,118,168
'4211052000,  교동,'55,50 - 54세,1998,312,149,163
'4211052000,  교동,'60,55 - 59세,1998,324,148,176
'4211052000,  교동,'65,60 - 64세,1998,299,142,157
'4211052000,  교동,'70,65 - 69세,1998,174,85,89
'4211052000,  교동,'75,70 - 74세,1998,137,52,85
'4211052000,  교동,'80,75 - 79세,1998,82,37,45
'4211052000,  교동,'85,80 - 84세,1998,53,15,38
'4211052000,  교동,'90,85+ ,1998,29,7,22
'4211053000,  조운동,'00,계,1998,4969,2446,2523
'4211053000,  조운동,'05,0 - 4세,1998,270,144,126
'4211053000,  조운동,'10,5 - 9세,1998,245,114,131
'4211053000,  조운동,'15,10 - 14세,1998,292,149,143
'4211053000,  조운동,'20,15 - 19세,1998,438,231,207
'4211053000,  조운동,'25,20 - 24세,1998,502,253,249
'4211053000,  조운동,'30,25 - 29세,1998,500,278,222
'4211053000,  조운동,'35,30 - 34세,1998,382,208,174
'4211053000,  조운동,'40,35 - 39세,1998,414,201,213
'4211053000,  조운동,'45,40 - 44세,1998,382,168,214
'4211053000,  조운동,'50,45 - 49세,1998,261,120,141
'4211053000,  조운동,'55,50 - 54세,1998,275,124,151
'4211053000,  조운동,'60,55 - 59세,1998,313,142,171
'4211053000,  조운동,'65,60 - 64세,1998,261,113,148
'4211053000,  조운동,'70,65 - 69세,1998,161,69,92
'4211053000,  조운동,'75,70 - 74세,1998,126,57,69
'4211053000,  조운동,'80,75 - 79세,1998,91,52,39
'4211053000,  조운동,'85,80 - 84세,1998,34,14,20
'4211053000,  조운동,'90,85+ ,1998,22,9,13
'4211054500,  약사명동,'00,계,1998,6803,3374,3429
'4211054500,  약사명동,'05,0 - 4세,1998,339,160,179
'4211054500,  약사명동,'10,5 - 9세,1998,411,218,193
'4211054500,  약사명동,'15,10 - 14세,1998,414,220,194
'4211054500,  약사명동,'20,15 - 19세,1998,566,296,270
'4211054500,  약사명동,'25,20 - 24세,1998,634,338,296
'4211054500,  약사명동,'30,25 - 29세,1998,649,359,290
'4211054500,  약사명동,'35,30 - 34세,1998,470,245,225
'4211054500,  약사명동,'40,35 - 39세,1998,527,255,272
'4211054500,  약사명동,'45,40 - 44세,1998,562,289,273
'4211054500,  약사명동,'50,45 - 49세,1998,352,164,188
'4211054500,  약사명동,'55,50 - 54세,1998,425,186,239
'4211054500,  약사명동,'60,55 - 59세,1998,458,226,232
'4211054500,  약사명동,'65,60 - 64세,1998,359,148,211
'4211054500,  약사명동,'70,65 - 69세,1998,226,99,127
'4211054500,  약사명동,'75,70 - 74세,1998,191,75,116
'4211054500,  약사명동,'80,75 - 79세,1998,112,49,63
'4211054500,  약사명동,'85,80 - 84세,1998,73,34,39
'4211054500,  약사명동,'90,85+ ,1998,35,13,22
'4211057000,  근화동,'00,계,1998,10565,5256,5309
'4211057000,  근화동,'05,0 - 4세,1998,754,392,362
'4211057000,  근화동,'10,5 - 9세,1998,647,346,301
'4211057000,  근화동,'15,10 - 14세,1998,576,287,289
'4211057000,  근화동,'20,15 - 19세,1998,821,433,388
'4211057000,  근화동,'25,20 - 24세,1998,924,503,421
'4211057000,  근화동,'30,25 - 29세,1998,1085,571,514
'4211057000,  근화동,'35,30 - 34세,1998,945,492,453
'4211057000,  근화동,'40,35 - 39세,1998,942,501,441
'4211057000,  근화동,'45,40 - 44세,1998,806,407,399
'4211057000,  근화동,'50,45 - 49세,1998,502,224,278
'4211057000,  근화동,'55,50 - 54세,1998,544,234,310
'4211057000,  근화동,'60,55 - 59세,1998,595,265,330
'4211057000,  근화동,'65,60 - 64세,1998,562,249,313
'4211057000,  근화동,'70,65 - 69세,1998,331,124,207
'4211057000,  근화동,'75,70 - 74세,1998,256,110,146
'4211057000,  근화동,'80,75 - 79세,1998,168,82,86
'4211057000,  근화동,'85,80 - 84세,1998,76,29,47
'4211057000,  근화동,'90,85+ ,1998,31,7,24
'4211058000,  소양동,'00,계,1998,9479,4605,4874
'4211058000,  소양동,'05,0 - 4세,1998,466,242,224
'4211058000,  소양동,'10,5 - 9세,1998,486,231,255
'4211058000,  소양동,'15,10 - 14세,1998,516,267,249
'4211058000,  소양동,'20,15 - 19세,1998,782,388,394
'4211058000,  소양동,'25,20 - 24세,1998,862,440,422
'4211058000,  소양동,'30,25 - 29세,1998,972,575,397
'4211058000,  소양동,'35,30 - 34세,1998,720,373,347
'4211058000,  소양동,'40,35 - 39세,1998,747,356,391
'4211058000,  소양동,'45,40 - 44세,1998,775,376,399
'4211058000,  소양동,'50,45 - 49세,1998,501,235,266
'4211058000,  소양동,'55,50 - 54세,1998,597,254,343
'4211058000,  소양동,'60,55 - 59세,1998,651,284,367
'4211058000,  소양동,'65,60 - 64세,1998,496,220,276
'4211058000,  소양동,'70,65 - 69세,1998,359,155,204
'4211058000,  소양동,'75,70 - 74세,1998,237,89,148
'4211058000,  소양동,'80,75 - 79세,1998,179,78,101
'4211058000,  소양동,'85,80 - 84세,1998,87,27,60
'4211058000,  소양동,'90,85+ ,1998,46,15,31
'4211060000,  후평1동,'00,계,1998,16761,8241,8520
'4211060000,  후평1동,'05,0 - 4세,1998,1153,571,582
'4211060000,  후평1동,'10,5 - 9세,1998,1040,542,498
'4211060000,  후평1동,'15,10 - 14세,1998,1078,575,503
'4211060000,  후평1동,'20,15 - 19세,1998,1610,815,795
'4211060000,  후평1동,'25,20 - 24세,1998,1656,838,818
'4211060000,  후평1동,'30,25 - 29세,1998,1756,880,876
'4211060000,  후평1동,'35,30 - 34세,1998,1464,752,712
'4211060000,  후평1동,'40,35 - 39세,1998,1410,659,751
'4211060000,  후평1동,'45,40 - 44세,1998,1453,712,741
'4211060000,  후평1동,'50,45 - 49세,1998,920,450,470
'4211060000,  후평1동,'55,50 - 54세,1998,819,375,444
'4211060000,  후평1동,'60,55 - 59세,1998,852,437,415
'4211060000,  후평1동,'65,60 - 64세,1998,567,266,301
'4211060000,  후평1동,'70,65 - 69세,1998,360,160,200
'4211060000,  후평1동,'75,70 - 74세,1998,258,95,163
'4211060000,  후평1동,'80,75 - 79세,1998,178,68,110
'4211060000,  후평1동,'85,80 - 84세,1998,121,34,87
'4211060000,  후평1동,'90,85+ ,1998,66,12,54
'4211061000,  후평2동,'00,계,1998,16998,8289,8709
'4211061000,  후평2동,'05,0 - 4세,1998,1352,704,648
'4211061000,  후평2동,'10,5 - 9세,1998,1231,645,586
'4211061000,  후평2동,'15,10 - 14세,1998,1267,643,624
'4211061000,  후평2동,'20,15 - 19세,1998,1538,796,742
'4211061000,  후평2동,'25,20 - 24세,1998,1463,717,746
'4211061000,  후평2동,'30,25 - 29세,1998,1713,846,867
'4211061000,  후평2동,'35,30 - 34세,1998,1567,779,788
'4211061000,  후평2동,'40,35 - 39세,1998,1685,803,882
'4211061000,  후평2동,'45,40 - 44세,1998,1534,732,802
'4211061000,  후평2동,'50,45 - 49세,1998,874,429,445
'4211061000,  후평2동,'55,50 - 54세,1998,728,352,376
'4211061000,  후평2동,'60,55 - 59세,1998,630,292,338
'4211061000,  후평2동,'65,60 - 64세,1998,490,205,285
'4211061000,  후평2동,'70,65 - 69세,1998,385,165,220
'4211061000,  후평2동,'75,70 - 74세,1998,230,75,155
'4211061000,  후평2동,'80,75 - 79세,1998,178,58,120
'4211061000,  후평2동,'85,80 - 84세,1998,81,33,48
'4211061000,  후평2동,'90,85+ ,1998,52,15,37
'4211061100,  후평3동,'00,계,1998,26578,12932,13646
'4211061100,  후평3동,'05,0 - 4세,1998,2126,1103,1023
'4211061100,  후평3동,'10,5 - 9세,1998,2277,1158,1119
'4211061100,  후평3동,'15,10 - 14세,1998,2113,1085,1028
'4211061100,  후평3동,'20,15 - 19세,1998,2498,1290,1208
'4211061100,  후평3동,'25,20 - 24세,1998,1897,966,931
'4211061100,  후평3동,'30,25 - 29세,1998,2298,1037,1261
'4211061100,  후평3동,'35,30 - 34세,1998,2550,1234,1316
'4211061100,  후평3동,'40,35 - 39세,1998,2797,1330,1467
'4211061100,  후평3동,'45,40 - 44세,1998,2527,1271,1256
'4211061100,  후평3동,'50,45 - 49세,1998,1354,687,667
'4211061100,  후평3동,'55,50 - 54세,1998,1068,529,539
'4211061100,  후평3동,'60,55 - 59세,1998,971,471,500
'4211061100,  후평3동,'65,60 - 64세,1998,673,289,384
'4211061100,  후평3동,'70,65 - 69세,1998,536,204,332
'4211061100,  후평3동,'75,70 - 74세,1998,374,125,249
'4211061100,  후평3동,'80,75 - 79세,1998,282,84,198
'4211061100,  후평3동,'85,80 - 84세,1998,146,44,102
'4211061100,  후평3동,'90,85+ ,1998,91,25,66
'4211062000,  효자1동,'00,계,1998,6804,3406,3398
'4211062000,  효자1동,'05,0 - 4세,1998,356,188,168
'4211062000,  효자1동,'10,5 - 9세,1998,403,202,201
'4211062000,  효자1동,'15,10 - 14세,1998,412,210,202
'4211062000,  효자1동,'20,15 - 19세,1998,647,357,290
'4211062000,  효자1동,'25,20 - 24세,1998,653,354,299
'4211062000,  효자1동,'30,25 - 29세,1998,642,346,296
'4211062000,  효자1동,'35,30 - 34세,1998,526,272,254
'4211062000,  효자1동,'40,35 - 39세,1998,509,251,258
'4211062000,  효자1동,'45,40 - 44세,1998,563,276,287
'4211062000,  효자1동,'50,45 - 49세,1998,387,172,215
'4211062000,  효자1동,'55,50 - 54세,1998,392,186,206
'4211062000,  효자1동,'60,55 - 59세,1998,377,179,198
'4211062000,  효자1동,'65,60 - 64세,1998,363,170,193
'4211062000,  효자1동,'70,65 - 69세,1998,221,95,126
'4211062000,  효자1동,'75,70 - 74세,1998,146,63,83
'4211062000,  효자1동,'80,75 - 79세,1998,111,51,60
'4211062000,  효자1동,'85,80 - 84세,1998,64,21,43
'4211062000,  효자1동,'90,85+ ,1998,32,13,19
'4211063000,  효자2동,'00,계,1998,15755,7858,7897
'4211063000,  효자2동,'05,0 - 4세,1998,804,390,414
'4211063000,  효자2동,'10,5 - 9세,1998,713,371,342
'4211063000,  효자2동,'15,10 - 14세,1998,768,410,358
'4211063000,  효자2동,'20,15 - 19세,1998,1436,723,713
'4211063000,  효자2동,'25,20 - 24세,1998,1984,1026,958
'4211063000,  효자2동,'30,25 - 29세,1998,1905,1124,781
'4211063000,  효자2동,'35,30 - 34세,1998,1110,641,469
'4211063000,  효자2동,'40,35 - 39세,1998,1020,542,478
'4211063000,  효자2동,'45,40 - 44세,1998,1075,486,589
'4211063000,  효자2동,'50,45 - 49세,1998,846,358,488
'4211063000,  효자2동,'55,50 - 54세,1998,963,417,546
'4211063000,  효자2동,'60,55 - 59세,1998,1050,507,543
'4211063000,  효자2동,'65,60 - 64세,1998,806,355,451
'4211063000,  효자2동,'70,65 - 69세,1998,462,208,254
'4211063000,  효자2동,'75,70 - 74세,1998,344,124,220
'4211063000,  효자2동,'80,75 - 79세,1998,245,97,148
'4211063000,  효자2동,'85,80 - 84세,1998,140,47,93
'4211063000,  효자2동,'90,85+ ,1998,84,32,52
'4211064000,  효자3동,'00,계,1998,6519,3242,3277
'4211064000,  효자3동,'05,0 - 4세,1998,360,189,171
'4211064000,  효자3동,'10,5 - 9세,1998,373,185,188
'4211064000,  효자3동,'15,10 - 14세,1998,369,187,182
'4211064000,  효자3동,'20,15 - 19세,1998,599,321,278
'4211064000,  효자3동,'25,20 - 24세,1998,745,374,371
'4211064000,  효자3동,'30,25 - 29세,1998,700,400,300
'4211064000,  효자3동,'35,30 - 34세,1998,479,251,228
'4211064000,  효자3동,'40,35 - 39세,1998,484,233,251
'4211064000,  효자3동,'45,40 - 44세,1998,497,236,261
'4211064000,  효자3동,'50,45 - 49세,1998,338,156,182
'4211064000,  효자3동,'55,50 - 54세,1998,348,152,196
'4211064000,  효자3동,'60,55 - 59세,1998,461,211,250
'4211064000,  효자3동,'65,60 - 64세,1998,302,157,145
'4211064000,  효자3동,'70,65 - 69세,1998,181,84,97
'4211064000,  효자3동,'75,70 - 74세,1998,121,57,64
'4211064000,  효자3동,'80,75 - 79세,1998,75,26,49
'4211064000,  효자3동,'85,80 - 84세,1998,54,17,37
'4211064000,  효자3동,'90,85+ ,1998,33,6,27
'4211065000,  석사동,'00,계,1998,23977,11851,12126
'4211065000,  석사동,'05,0 - 4세,1998,2458,1284,1174
'4211065000,  석사동,'10,5 - 9세,1998,2130,1134,996
'4211065000,  석사동,'15,10 - 14세,1998,1743,836,907
'4211065000,  석사동,'20,15 - 19세,1998,1668,812,856
'4211065000,  석사동,'25,20 - 24세,1998,1689,840,849
'4211065000,  석사동,'30,25 - 29세,1998,2567,1181,1386
'4211065000,  석사동,'35,30 - 34세,1998,2881,1430,1451
'4211065000,  석사동,'40,35 - 39세,1998,2715,1394,1321
'4211065000,  석사동,'45,40 - 44세,1998,1927,1000,927
'4211065000,  석사동,'50,45 - 49세,1998,950,500,450
'4211065000,  석사동,'55,50 - 54세,1998,850,411,439
'4211065000,  석사동,'60,55 - 59세,1998,772,384,388
'4211065000,  석사동,'65,60 - 64세,1998,553,271,282
'4211065000,  석사동,'70,65 - 69세,1998,352,153,199
'4211065000,  석사동,'75,70 - 74세,1998,278,85,193
'4211065000,  석사동,'80,75 - 79세,1998,215,71,144
'4211065000,  석사동,'85,80 - 84세,1998,138,43,95
'4211065000,  석사동,'90,85+ ,1998,91,22,69
'4211066000,  퇴계동,'00,계,1998,25004,12301,12703
'4211066000,  퇴계동,'05,0 - 4세,1998,1890,980,910
'4211066000,  퇴계동,'10,5 - 9세,1998,2507,1318,1189
'4211066000,  퇴계동,'15,10 - 14세,1998,2370,1192,1178
'4211066000,  퇴계동,'20,15 - 19세,1998,2069,1053,1016
'4211066000,  퇴계동,'25,20 - 24세,1998,1438,731,707
'4211066000,  퇴계동,'30,25 - 29세,1998,1755,828,927
'4211066000,  퇴계동,'35,30 - 34세,1998,2306,1050,1256
'4211066000,  퇴계동,'40,35 - 39세,1998,3110,1473,1637
'4211066000,  퇴계동,'45,40 - 44세,1998,2585,1377,1208
'4211066000,  퇴계동,'50,45 - 49세,1998,1196,645,551
'4211066000,  퇴계동,'55,50 - 54세,1998,893,478,415
'4211066000,  퇴계동,'60,55 - 59세,1998,819,374,445
'4211066000,  퇴계동,'65,60 - 64세,1998,745,324,421
'4211066000,  퇴계동,'70,65 - 69세,1998,510,190,320
'4211066000,  퇴계동,'75,70 - 74세,1998,356,136,220
'4211066000,  퇴계동,'80,75 - 79세,1998,231,92,139
'4211066000,  퇴계동,'85,80 - 84세,1998,147,36,111
'4211066000,  퇴계동,'90,85+ ,1998,77,24,53
'4211067500,  강남동,'00,계,1998,13218,6549,6669
'4211067500,  강남동,'05,0 - 4세,1998,970,504,466
'4211067500,  강남동,'10,5 - 9세,1998,978,506,472
'4211067500,  강남동,'15,10 - 14세,1998,1016,560,456
'4211067500,  강남동,'20,15 - 19세,1998,1225,606,619
'4211067500,  강남동,'25,20 - 24세,1998,952,477,475
'4211067500,  강남동,'30,25 - 29세,1998,1117,549,568
'4211067500,  강남동,'35,30 - 34세,1998,1085,539,546
'4211067500,  강남동,'40,35 - 39세,1998,1317,645,672
'4211067500,  강남동,'45,40 - 44세,1998,1324,668,656
'4211067500,  강남동,'50,45 - 49세,1998,683,356,327
'4211067500,  강남동,'55,50 - 54세,1998,572,313,259
'4211067500,  강남동,'60,55 - 59세,1998,567,255,312
'4211067500,  강남동,'65,60 - 64세,1998,483,242,241
'4211067500,  강남동,'70,65 - 69세,1998,323,125,198
'4211067500,  강남동,'75,70 - 74세,1998,271,88,183
'4211067500,  강남동,'80,75 - 79세,1998,181,67,114
'4211067500,  강남동,'85,80 - 84세,1998,103,39,64
'4211067500,  강남동,'90,85+ ,1998,51,10,41
'4211070500,  신사우동,'00,계,1998,14768,7428,7340
'4211070500,  신사우동,'05,0 - 4세,1998,1119,571,548
'4211070500,  신사우동,'10,5 - 9세,1998,1091,566,525
'4211070500,  신사우동,'15,10 - 14세,1998,1016,561,455
'4211070500,  신사우동,'20,15 - 19세,1998,1181,605,576
'4211070500,  신사우동,'25,20 - 24세,1998,1164,578,586
'4211070500,  신사우동,'30,25 - 29세,1998,1428,771,657
'4211070500,  신사우동,'35,30 - 34세,1998,1330,693,637
'4211070500,  신사우동,'40,35 - 39세,1998,1463,776,687
'4211070500,  신사우동,'45,40 - 44세,1998,1137,593,544
'4211070500,  신사우동,'50,45 - 49세,1998,631,319,312
'4211070500,  신사우동,'55,50 - 54세,1998,653,326,327
'4211070500,  신사우동,'60,55 - 59세,1998,738,325,413
'4211070500,  신사우동,'65,60 - 64세,1998,586,269,317
'4211070500,  신사우동,'70,65 - 69세,1998,472,189,283
'4211070500,  신사우동,'75,70 - 74세,1998,341,132,209
'4211070500,  신사우동,'80,75 - 79세,1998,224,92,132
'4211070500,  신사우동,'85,80 - 84세,1998,123,43,80
'4211070500,  신사우동,'90,85+ ,1998,71,19,52
'42130, 원주시,'00,계,1998,260355,130143,130212
'42130, 원주시,'05,0 - 4세,1998,19724,10414,9310
'42130, 원주시,'10,5 - 9세,1998,19909,10392,9517
'42130, 원주시,'15,10 - 14세,1998,18834,9693,9141
'42130, 원주시,'20,15 - 19세,1998,21666,11083,10583
'42130, 원주시,'25,20 - 24세,1998,20432,10421,10011
'42130, 원주시,'30,25 - 29세,1998,24426,12491,11935
'42130, 원주시,'35,30 - 34세,1998,24241,12411,11830
'42130, 원주시,'40,35 - 39세,1998,26391,13408,12983
'42130, 원주시,'45,40 - 44세,1998,21164,11147,10017
'42130, 원주시,'50,45 - 49세,1998,12283,6203,6080
'42130, 원주시,'55,50 - 54세,1998,10495,5156,5339
'42130, 원주시,'60,55 - 59세,1998,11846,5465,6381
'42130, 원주시,'65,60 - 64세,1998,10181,4696,5485
'42130, 원주시,'70,65 - 69세,1998,7182,2911,4271
'42130, 원주시,'75,70 - 74세,1998,5038,1964,3074
'42130, 원주시,'80,75 - 79세,1998,3435,1285,2150
'42130, 원주시,'85,80 - 84세,1998,1980,685,1295
'42130, 원주시,'90,85+ ,1998,1128,318,810
'4213025000,  문막읍,'00,계,1998,15726,7933,7793
'4213025000,  문막읍,'05,0 - 4세,1998,1725,898,827
'4213025000,  문막읍,'10,5 - 9세,1998,1395,713,682
'4213025000,  문막읍,'15,10 - 14세,1998,865,416,449
'4213025000,  문막읍,'20,15 - 19세,1998,970,482,488
'4213025000,  문막읍,'25,20 - 24세,1998,1090,534,556
'4213025000,  문막읍,'30,25 - 29세,1998,1828,867,961
'4213025000,  문막읍,'35,30 - 34세,1998,1853,1002,851
'4213025000,  문막읍,'40,35 - 39세,1998,1506,890,616
'4213025000,  문막읍,'45,40 - 44세,1998,882,500,382
'4213025000,  문막읍,'50,45 - 49세,1998,561,304,257
'4213025000,  문막읍,'55,50 - 54세,1998,538,268,270
'4213025000,  문막읍,'60,55 - 59세,1998,655,289,366
'4213025000,  문막읍,'65,60 - 64세,1998,651,308,343
'4213025000,  문막읍,'70,65 - 69세,1998,447,183,264
'4213025000,  문막읍,'75,70 - 74세,1998,304,114,190
'4213025000,  문막읍,'80,75 - 79세,1998,245,96,149
'4213025000,  문막읍,'85,80 - 84세,1998,139,48,91
'4213025000,  문막읍,'90,85+ ,1998,72,21,51
'4213031000,  소초면,'00,계,1998,11965,6070,5895
'4213031000,  소초면,'05,0 - 4세,1998,1034,529,505
'4213031000,  소초면,'10,5 - 9세,1998,782,420,362
'4213031000,  소초면,'15,10 - 14세,1998,813,393,420
'4213031000,  소초면,'20,15 - 19세,1998,906,440,466
'4213031000,  소초면,'25,20 - 24세,1998,908,498,410
'4213031000,  소초면,'30,25 - 29세,1998,1303,661,642
'4213031000,  소초면,'35,30 - 34세,1998,1207,684,523
'4213031000,  소초면,'40,35 - 39세,1998,1093,571,522
'4213031000,  소초면,'45,40 - 44세,1998,881,493,388
'4213031000,  소초면,'50,45 - 49세,1998,499,279,220
'4213031000,  소초면,'55,50 - 54세,1998,428,199,229
'4213031000,  소초면,'60,55 - 59세,1998,579,287,292
'4213031000,  소초면,'65,60 - 64세,1998,489,223,266
'4213031000,  소초면,'70,65 - 69세,1998,396,156,240
'4213031000,  소초면,'75,70 - 74세,1998,277,107,170
'4213031000,  소초면,'80,75 - 79세,1998,205,76,129
'4213031000,  소초면,'85,80 - 84세,1998,116,41,75
'4213031000,  소초면,'90,85+ ,1998,49,13,36
'4213032000,  호저면,'00,계,1998,5553,2839,2714
'4213032000,  호저면,'05,0 - 4세,1998,267,135,132
'4213032000,  호저면,'10,5 - 9세,1998,302,162,140
'4213032000,  호저면,'15,10 - 14세,1998,341,177,164
'4213032000,  호저면,'20,15 - 19세,1998,473,258,215
'4213032000,  호저면,'25,20 - 24세,1998,493,252,241
'4213032000,  호저면,'30,25 - 29세,1998,437,268,169
'4213032000,  호저면,'35,30 - 34세,1998,353,204,149
'4213032000,  호저면,'40,35 - 39세,1998,416,219,197
'4213032000,  호저면,'45,40 - 44세,1998,386,211,175
'4213032000,  호저면,'50,45 - 49세,1998,260,138,122
'4213032000,  호저면,'55,50 - 54세,1998,271,134,137
'4213032000,  호저면,'60,55 - 59세,1998,388,181,207
'4213032000,  호저면,'65,60 - 64세,1998,438,192,246
'4213032000,  호저면,'70,65 - 69세,1998,328,148,180
'4213032000,  호저면,'75,70 - 74세,1998,175,66,109
'4213032000,  호저면,'80,75 - 79세,1998,121,60,61
'4213032000,  호저면,'85,80 - 84세,1998,64,21,43
'4213032000,  호저면,'90,85+ ,1998,40,13,27
'4213033000,  지정면,'00,계,1998,3850,2005,1845
'4213033000,  지정면,'05,0 - 4세,1998,185,107,78
'4213033000,  지정면,'10,5 - 9세,1998,199,103,96
'4213033000,  지정면,'15,10 - 14세,1998,190,96,94
'4213033000,  지정면,'20,15 - 19세,1998,273,144,129
'4213033000,  지정면,'25,20 - 24세,1998,317,163,154
'4213033000,  지정면,'30,25 - 29세,1998,301,192,109
'4213033000,  지정면,'35,30 - 34세,1998,214,119,95
'4213033000,  지정면,'40,35 - 39세,1998,296,177,119
'4213033000,  지정면,'45,40 - 44세,1998,261,146,115
'4213033000,  지정면,'50,45 - 49세,1998,177,97,80
'4213033000,  지정면,'55,50 - 54세,1998,191,101,90
'4213033000,  지정면,'60,55 - 59세,1998,321,144,177
'4213033000,  지정면,'65,60 - 64세,1998,317,147,170
'4213033000,  지정면,'70,65 - 69세,1998,223,88,135
'4213033000,  지정면,'75,70 - 74세,1998,187,89,98
'4213033000,  지정면,'80,75 - 79세,1998,110,52,58
'4213033000,  지정면,'85,80 - 84세,1998,53,30,23
'4213033000,  지정면,'90,85+ ,1998,35,10,25
'4213035000,  부론면,'00,계,1998,3583,1806,1777
'4213035000,  부론면,'05,0 - 4세,1998,131,76,55
'4213035000,  부론면,'10,5 - 9세,1998,164,85,79
'4213035000,  부론면,'15,10 - 14세,1998,195,95,100
'4213035000,  부론면,'20,15 - 19세,1998,299,154,145
'4213035000,  부론면,'25,20 - 24세,1998,325,173,152
'4213035000,  부론면,'30,25 - 29세,1998,231,148,83
'4213035000,  부론면,'35,30 - 34세,1998,192,106,86
'4213035000,  부론면,'40,35 - 39세,1998,230,126,104
'4213035000,  부론면,'45,40 - 44세,1998,236,128,108
'4213035000,  부론면,'50,45 - 49세,1998,168,89,79
'4213035000,  부론면,'55,50 - 54세,1998,200,98,102
'4213035000,  부론면,'60,55 - 59세,1998,269,116,153
'4213035000,  부론면,'65,60 - 64세,1998,329,163,166
'4213035000,  부론면,'70,65 - 69세,1998,204,69,135
'4213035000,  부론면,'75,70 - 74세,1998,167,70,97
'4213035000,  부론면,'80,75 - 79세,1998,130,64,66
'4213035000,  부론면,'85,80 - 84세,1998,73,33,40
'4213035000,  부론면,'90,85+ ,1998,40,13,27
'4213036000,  귀래면,'00,계,1998,2560,1311,1249
'4213036000,  귀래면,'05,0 - 4세,1998,107,57,50
'4213036000,  귀래면,'10,5 - 9세,1998,130,68,62
'4213036000,  귀래면,'15,10 - 14세,1998,144,83,61
'4213036000,  귀래면,'20,15 - 19세,1998,195,99,96
'4213036000,  귀래면,'25,20 - 24세,1998,218,123,95
'4213036000,  귀래면,'30,25 - 29세,1998,164,101,63
'4213036000,  귀래면,'35,30 - 34세,1998,146,86,60
'4213036000,  귀래면,'40,35 - 39세,1998,192,109,83
'4213036000,  귀래면,'45,40 - 44세,1998,178,103,75
'4213036000,  귀래면,'50,45 - 49세,1998,122,65,57
'4213036000,  귀래면,'55,50 - 54세,1998,122,50,72
'4213036000,  귀래면,'60,55 - 59세,1998,208,100,108
'4213036000,  귀래면,'65,60 - 64세,1998,204,100,104
'4213036000,  귀래면,'70,65 - 69세,1998,144,58,86
'4213036000,  귀래면,'75,70 - 74세,1998,114,50,64
'4213036000,  귀래면,'80,75 - 79세,1998,88,32,56
'4213036000,  귀래면,'85,80 - 84세,1998,52,20,32
'4213036000,  귀래면,'90,85+ ,1998,32,7,25
'4213037000,  흥업면,'00,계,1998,5400,2817,2583
'4213037000,  흥업면,'05,0 - 4세,1998,352,184,168
'4213037000,  흥업면,'10,5 - 9세,1998,236,118,118
'4213037000,  흥업면,'15,10 - 14세,1998,272,138,134
'4213037000,  흥업면,'20,15 - 19세,1998,415,223,192
'4213037000,  흥업면,'25,20 - 24세,1998,544,326,218
'4213037000,  흥업면,'30,25 - 29세,1998,552,322,230
'4213037000,  흥업면,'35,30 - 34세,1998,394,230,164
'4213037000,  흥업면,'40,35 - 39세,1998,431,247,184
'4213037000,  흥업면,'45,40 - 44세,1998,409,226,183
'4213037000,  흥업면,'50,45 - 49세,1998,254,124,130
'4213037000,  흥업면,'55,50 - 54세,1998,214,104,110
'4213037000,  흥업면,'60,55 - 59세,1998,365,163,202
'4213037000,  흥업면,'65,60 - 64세,1998,319,155,164
'4213037000,  흥업면,'70,65 - 69세,1998,241,101,140
'4213037000,  흥업면,'75,70 - 74세,1998,164,65,99
'4213037000,  흥업면,'80,75 - 79세,1998,122,50,72
'4213037000,  흥업면,'85,80 - 84세,1998,71,28,43
'4213037000,  흥업면,'90,85+ ,1998,45,13,32
'4213038000,  판부면,'00,계,1998,3053,1609,1444
'4213038000,  판부면,'05,0 - 4세,1998,114,58,56
'4213038000,  판부면,'10,5 - 9세,1998,131,72,59
'4213038000,  판부면,'15,10 - 14세,1998,190,102,88
'4213038000,  판부면,'20,15 - 19세,1998,302,165,137
'4213038000,  판부면,'25,20 - 24세,1998,280,147,133
'4213038000,  판부면,'30,25 - 29세,1998,235,149,86
'4213038000,  판부면,'35,30 - 34세,1998,210,126,84
'4213038000,  판부면,'40,35 - 39세,1998,230,126,104
'4213038000,  판부면,'45,40 - 44세,1998,261,148,113
'4213038000,  판부면,'50,45 - 49세,1998,197,102,95
'4213038000,  판부면,'55,50 - 54세,1998,168,89,79
'4213038000,  판부면,'60,55 - 59세,1998,178,88,90
'4213038000,  판부면,'65,60 - 64세,1998,194,90,104
'4213038000,  판부면,'70,65 - 69세,1998,144,57,87
'4213038000,  판부면,'75,70 - 74세,1998,101,47,54
'4213038000,  판부면,'80,75 - 79세,1998,66,25,41
'4213038000,  판부면,'85,80 - 84세,1998,36,12,24
'4213038000,  판부면,'90,85+ ,1998,16,6,10
'4213039000,  신림면,'00,계,1998,4492,2313,2179
'4213039000,  신림면,'05,0 - 4세,1998,184,89,95
'4213039000,  신림면,'10,5 - 9세,1998,207,96,111
'4213039000,  신림면,'15,10 - 14세,1998,235,118,117
'4213039000,  신림면,'20,15 - 19세,1998,360,189,171
'4213039000,  신림면,'25,20 - 24세,1998,402,230,172
'4213039000,  신림면,'30,25 - 29세,1998,347,229,118
'4213039000,  신림면,'35,30 - 34세,1998,256,153,103
'4213039000,  신림면,'40,35 - 39세,1998,334,194,140
'4213039000,  신림면,'45,40 - 44세,1998,277,153,124
'4213039000,  신림면,'50,45 - 49세,1998,228,116,112
'4213039000,  신림면,'55,50 - 54세,1998,240,111,129
'4213039000,  신림면,'60,55 - 59세,1998,387,161,226
'4213039000,  신림면,'65,60 - 64세,1998,358,181,177
'4213039000,  신림면,'70,65 - 69세,1998,225,98,127
'4213039000,  신림면,'75,70 - 74세,1998,204,94,110
'4213039000,  신림면,'80,75 - 79세,1998,135,60,75
'4213039000,  신림면,'85,80 - 84세,1998,74,31,43
'4213039000,  신림면,'90,85+ ,1998,39,10,29
'4213051000,  중평동,'00,계,1998,2647,1335,1312
'4213051000,  중평동,'05,0 - 4세,1998,118,58,60
'4213051000,  중평동,'10,5 - 9세,1998,147,72,75
'4213051000,  중평동,'15,10 - 14세,1998,144,86,58
'4213051000,  중평동,'20,15 - 19세,1998,223,131,92
'4213051000,  중평동,'25,20 - 24세,1998,220,130,90
'4213051000,  중평동,'30,25 - 29세,1998,224,115,109
'4213051000,  중평동,'35,30 - 34세,1998,197,99,98
'4213051000,  중평동,'40,35 - 39세,1998,204,102,102
'4213051000,  중평동,'45,40 - 44세,1998,238,119,119
'4213051000,  중평동,'50,45 - 49세,1998,163,78,85
'4213051000,  중평동,'55,50 - 54세,1998,151,69,82
'4213051000,  중평동,'60,55 - 59세,1998,188,90,98
'4213051000,  중평동,'65,60 - 64세,1998,152,65,87
'4213051000,  중평동,'70,65 - 69세,1998,114,53,61
'4213051000,  중평동,'75,70 - 74세,1998,74,33,41
'4213051000,  중평동,'80,75 - 79세,1998,50,19,31
'4213051000,  중평동,'85,80 - 84세,1998,29,11,18
'4213051000,  중평동,'90,85+ ,1998,11,5,6
'4213052000,  원인동,'00,계,1998,9299,4577,4722
'4213052000,  원인동,'05,0 - 4세,1998,648,345,303
'4213052000,  원인동,'10,5 - 9세,1998,700,395,305
'4213052000,  원인동,'15,10 - 14세,1998,685,326,359
'4213052000,  원인동,'20,15 - 19세,1998,829,393,436
'4213052000,  원인동,'25,20 - 24세,1998,734,406,328
'4213052000,  원인동,'30,25 - 29세,1998,810,380,430
'4213052000,  원인동,'35,30 - 34세,1998,835,434,401
'4213052000,  원인동,'40,35 - 39세,1998,953,448,505
'4213052000,  원인동,'45,40 - 44세,1998,828,441,387
'4213052000,  원인동,'50,45 - 49세,1998,466,251,215
'4213052000,  원인동,'55,50 - 54세,1998,399,191,208
'4213052000,  원인동,'60,55 - 59세,1998,444,185,259
'4213052000,  원인동,'65,60 - 64세,1998,373,170,203
'4213052000,  원인동,'70,65 - 69세,1998,239,86,153
'4213052000,  원인동,'75,70 - 74세,1998,146,62,84
'4213052000,  원인동,'80,75 - 79세,1998,103,36,67
'4213052000,  원인동,'85,80 - 84세,1998,72,20,52
'4213052000,  원인동,'90,85+ ,1998,35,8,27
'4213053000,  개운동,'00,계,1998,14089,7021,7068
'4213053000,  개운동,'05,0 - 4세,1998,858,456,402
'4213053000,  개운동,'10,5 - 9세,1998,1099,598,501
'4213053000,  개운동,'15,10 - 14세,1998,984,519,465
'4213053000,  개운동,'20,15 - 19세,1998,1317,695,622
'4213053000,  개운동,'25,20 - 24세,1998,1339,681,658
'4213053000,  개운동,'30,25 - 29세,1998,1210,620,590
'4213053000,  개운동,'35,30 - 34세,1998,1215,606,609
'4213053000,  개운동,'40,35 - 39세,1998,1317,664,653
'4213053000,  개운동,'45,40 - 44세,1998,1151,557,594
'4213053000,  개운동,'50,45 - 49세,1998,770,350,420
'4213053000,  개운동,'55,50 - 54세,1998,656,324,332
'4213053000,  개운동,'60,55 - 59세,1998,746,350,396
'4213053000,  개운동,'65,60 - 64세,1998,543,265,278
'4213053000,  개운동,'70,65 - 69세,1998,360,149,211
'4213053000,  개운동,'75,70 - 74세,1998,227,84,143
'4213053000,  개운동,'80,75 - 79세,1998,180,65,115
'4213053000,  개운동,'85,80 - 84세,1998,74,22,52
'4213053000,  개운동,'90,85+ ,1998,43,16,27
'4213054100,  명륜1동,'00,계,1998,11568,5605,5963
'4213054100,  명륜1동,'05,0 - 4세,1998,640,343,297
'4213054100,  명륜1동,'10,5 - 9세,1998,837,438,399
'4213054100,  명륜1동,'15,10 - 14세,1998,1062,548,514
'4213054100,  명륜1동,'20,15 - 19세,1998,1243,576,667
'4213054100,  명륜1동,'25,20 - 24세,1998,927,468,459
'4213054100,  명륜1동,'30,25 - 29세,1998,833,426,407
'4213054100,  명륜1동,'35,30 - 34세,1998,757,365,392
'4213054100,  명륜1동,'40,35 - 39세,1998,1141,514,627
'4213054100,  명륜1동,'45,40 - 44세,1998,1199,613,586
'4213054100,  명륜1동,'50,45 - 49세,1998,693,327,366
'4213054100,  명륜1동,'55,50 - 54세,1998,538,268,270
'4213054100,  명륜1동,'60,55 - 59세,1998,536,267,269
'4213054100,  명륜1동,'65,60 - 64세,1998,371,178,193
'4213054100,  명륜1동,'70,65 - 69세,1998,315,121,194
'4213054100,  명륜1동,'75,70 - 74세,1998,207,65,142
'4213054100,  명륜1동,'80,75 - 79세,1998,134,48,86
'4213054100,  명륜1동,'85,80 - 84세,1998,83,25,58
'4213054100,  명륜1동,'90,85+ ,1998,52,15,37
'4213054200,  명륜2동,'00,계,1998,16479,8024,8455
'4213054200,  명륜2동,'05,0 - 4세,1998,1230,641,589
'4213054200,  명륜2동,'10,5 - 9세,1998,1498,781,717
'4213054200,  명륜2동,'15,10 - 14세,1998,1418,728,690
'4213054200,  명륜2동,'20,15 - 19세,1998,1548,789,759
'4213054200,  명륜2동,'25,20 - 24세,1998,1247,626,621
'4213054200,  명륜2동,'30,25 - 29세,1998,1290,640,650
'4213054200,  명륜2동,'35,30 - 34세,1998,1522,683,839
'4213054200,  명륜2동,'40,35 - 39세,1998,1921,914,1007
'4213054200,  명륜2동,'45,40 - 44세,1998,1650,849,801
'4213054200,  명륜2동,'50,45 - 49세,1998,763,381,382
'4213054200,  명륜2동,'55,50 - 54세,1998,570,282,288
'4213054200,  명륜2동,'60,55 - 59세,1998,519,239,280
'4213054200,  명륜2동,'65,60 - 64세,1998,432,169,263
'4213054200,  명륜2동,'70,65 - 69세,1998,319,119,200
'4213054200,  명륜2동,'75,70 - 74세,1998,247,74,173
'4213054200,  명륜2동,'80,75 - 79세,1998,150,52,98
'4213054200,  명륜2동,'85,80 - 84세,1998,98,36,62
'4213054200,  명륜2동,'90,85+ ,1998,57,21,36
'4213055000,  단구동,'00,계,1998,26893,13406,13487
'4213055000,  단구동,'05,0 - 4세,1998,2677,1481,1196
'4213055000,  단구동,'10,5 - 9세,1998,2334,1186,1148
'4213055000,  단구동,'15,10 - 14세,1998,1997,1015,982
'4213055000,  단구동,'20,15 - 19세,1998,2052,1061,991
'4213055000,  단구동,'25,20 - 24세,1998,1923,909,1014
'4213055000,  단구동,'30,25 - 29세,1998,2852,1312,1540
'4213055000,  단구동,'35,30 - 34세,1998,3160,1615,1545
'4213055000,  단구동,'40,35 - 39세,1998,2924,1458,1466
'4213055000,  단구동,'45,40 - 44세,1998,2151,1167,984
'4213055000,  단구동,'50,45 - 49세,1998,1147,578,569
'4213055000,  단구동,'55,50 - 54세,1998,908,452,456
'4213055000,  단구동,'60,55 - 59세,1998,812,394,418
'4213055000,  단구동,'65,60 - 64세,1998,704,308,396
'4213055000,  단구동,'70,65 - 69세,1998,494,205,289
'4213055000,  단구동,'75,70 - 74세,1998,363,144,219
'4213055000,  단구동,'80,75 - 79세,1998,207,67,140
'4213055000,  단구동,'85,80 - 84세,1998,123,36,87
'4213055000,  단구동,'90,85+ ,1998,65,18,47
'4213056000,  일산동,'00,계,1998,10876,5315,5561
'4213056000,  일산동,'05,0 - 4세,1998,691,369,322
'4213056000,  일산동,'10,5 - 9세,1998,782,398,384
'4213056000,  일산동,'15,10 - 14세,1998,777,418,359
'4213056000,  일산동,'20,15 - 19세,1998,936,494,442
'4213056000,  일산동,'25,20 - 24세,1998,969,484,485
'4213056000,  일산동,'30,25 - 29세,1998,1069,556,513
'4213056000,  일산동,'35,30 - 34세,1998,884,424,460
'4213056000,  일산동,'40,35 - 39세,1998,1003,464,539
'4213056000,  일산동,'45,40 - 44세,1998,926,445,481
'4213056000,  일산동,'50,45 - 49세,1998,620,275,345
'4213056000,  일산동,'55,50 - 54세,1998,526,266,260
'4213056000,  일산동,'60,55 - 59세,1998,526,251,275
'4213056000,  일산동,'65,60 - 64세,1998,401,191,210
'4213056000,  일산동,'70,65 - 69세,1998,300,124,176
'4213056000,  일산동,'75,70 - 74세,1998,208,76,132
'4213056000,  일산동,'80,75 - 79세,1998,134,42,92
'4213056000,  일산동,'85,80 - 84세,1998,78,29,49
'4213056000,  일산동,'90,85+ ,1998,46,9,37
'4213057000,  학성1동,'00,계,1998,8940,4430,4510
'4213057000,  학성1동,'05,0 - 4세,1998,532,285,247
'4213057000,  학성1동,'10,5 - 9세,1998,727,341,386
'4213057000,  학성1동,'15,10 - 14세,1998,686,367,319
'4213057000,  학성1동,'20,15 - 19세,1998,789,416,373
'4213057000,  학성1동,'25,20 - 24세,1998,663,334,329
'4213057000,  학성1동,'30,25 - 29세,1998,757,407,350
'4213057000,  학성1동,'35,30 - 34세,1998,725,363,362
'4213057000,  학성1동,'40,35 - 39세,1998,988,478,510
'4213057000,  학성1동,'45,40 - 44세,1998,808,414,394
'4213057000,  학성1동,'50,45 - 49세,1998,427,207,220
'4213057000,  학성1동,'55,50 - 54세,1998,401,199,202
'4213057000,  학성1동,'60,55 - 59세,1998,460,210,250
'4213057000,  학성1동,'65,60 - 64세,1998,380,185,195
'4213057000,  학성1동,'70,65 - 69세,1998,248,111,137
'4213057000,  학성1동,'75,70 - 74세,1998,158,60,98
'4213057000,  학성1동,'80,75 - 79세,1998,102,32,70
'4213057000,  학성1동,'85,80 - 84세,1998,60,15,45
'4213057000,  학성1동,'90,85+ ,1998,29,6,23
'4213058000,  학성2동,'00,계,1998,2724,1370,1354
'4213058000,  학성2동,'05,0 - 4세,1998,123,62,61
'4213058000,  학성2동,'10,5 - 9세,1998,132,81,51
'4213058000,  학성2동,'15,10 - 14세,1998,173,94,79
'4213058000,  학성2동,'20,15 - 19세,1998,224,121,103
'4213058000,  학성2동,'25,20 - 24세,1998,238,131,107
'4213058000,  학성2동,'30,25 - 29세,1998,251,135,116
'4213058000,  학성2동,'35,30 - 34세,1998,211,114,97
'4213058000,  학성2동,'40,35 - 39세,1998,214,117,97
'4213058000,  학성2동,'45,40 - 44세,1998,215,110,105
'4213058000,  학성2동,'50,45 - 49세,1998,162,70,92
'4213058000,  학성2동,'55,50 - 54세,1998,150,71,79
'4213058000,  학성2동,'60,55 - 59세,1998,191,80,111
'4213058000,  학성2동,'65,60 - 64세,1998,164,74,90
'4213058000,  학성2동,'70,65 - 69세,1998,109,48,61
'4213058000,  학성2동,'75,70 - 74세,1998,85,34,51
'4213058000,  학성2동,'80,75 - 79세,1998,41,15,26
'4213058000,  학성2동,'85,80 - 84세,1998,33,8,25
'4213058000,  학성2동,'90,85+ ,1998,8,5,3
'4213059000,  단계동,'00,계,1998,29572,14532,15040
'4213059000,  단계동,'05,0 - 4세,1998,2455,1312,1143
'4213059000,  단계동,'10,5 - 9세,1998,2855,1510,1345
'4213059000,  단계동,'15,10 - 14세,1998,2736,1413,1323
'4213059000,  단계동,'20,15 - 19세,1998,2422,1210,1212
'4213059000,  단계동,'25,20 - 24세,1998,1913,899,1014
'4213059000,  단계동,'30,25 - 29세,1998,2542,1208,1334
'4213059000,  단계동,'35,30 - 34세,1998,2933,1335,1598
'4213059000,  단계동,'40,35 - 39세,1998,3740,1819,1921
'4213059000,  단계동,'45,40 - 44세,1998,2850,1492,1358
'4213059000,  단계동,'50,45 - 49세,1998,1311,681,630
'4213059000,  단계동,'55,50 - 54세,1998,906,459,447
'4213059000,  단계동,'60,55 - 59세,1998,902,435,467
'4213059000,  단계동,'65,60 - 64세,1998,665,295,370
'4213059000,  단계동,'70,65 - 69세,1998,487,179,308
'4213059000,  단계동,'75,70 - 74세,1998,352,131,221
'4213059000,  단계동,'80,75 - 79세,1998,260,92,168
'4213059000,  단계동,'85,80 - 84세,1998,142,43,99
'4213059000,  단계동,'90,85+ ,1998,101,19,82
'4213060000,  우산동,'00,계,1998,14080,7116,6964
'4213060000,  우산동,'05,0 - 4세,1998,815,422,393
'4213060000,  우산동,'10,5 - 9세,1998,905,477,428
'4213060000,  우산동,'15,10 - 14세,1998,981,511,470
'4213060000,  우산동,'20,15 - 19세,1998,1277,679,598
'4213060000,  우산동,'25,20 - 24세,1998,1459,764,695
'4213060000,  우산동,'30,25 - 29세,1998,1450,829,621
'4213060000,  우산동,'35,30 - 34세,1998,1157,596,561
'4213060000,  우산동,'40,35 - 39세,1998,1317,643,674
'4213060000,  우산동,'45,40 - 44세,1998,1127,551,576
'4213060000,  우산동,'50,45 - 49세,1998,758,375,383
'4213060000,  우산동,'55,50 - 54세,1998,726,363,363
'4213060000,  우산동,'60,55 - 59세,1998,684,338,346
'4213060000,  우산동,'65,60 - 64세,1998,565,250,315
'4213060000,  우산동,'70,65 - 69세,1998,371,149,222
'4213060000,  우산동,'75,70 - 74세,1998,209,79,130
'4213060000,  우산동,'80,75 - 79세,1998,135,51,84
'4213060000,  우산동,'85,80 - 84세,1998,89,22,67
'4213060000,  우산동,'90,85+ ,1998,55,17,38
'4213061000,  태장1동,'00,계,1998,9199,4662,4537
'4213061000,  태장1동,'05,0 - 4세,1998,1003,525,478
'4213061000,  태장1동,'10,5 - 9세,1998,695,374,321
'4213061000,  태장1동,'15,10 - 14세,1998,557,295,262
'4213061000,  태장1동,'20,15 - 19세,1998,654,334,320
'4213061000,  태장1동,'25,20 - 24세,1998,706,336,370
'4213061000,  태장1동,'30,25 - 29세,1998,1150,569,581
'4213061000,  태장1동,'35,30 - 34세,1998,1147,630,517
'4213061000,  태장1동,'40,35 - 39세,1998,848,473,375
'4213061000,  태장1동,'45,40 - 44세,1998,587,312,275
'4213061000,  태장1동,'50,45 - 49세,1998,353,171,182
'4213061000,  태장1동,'55,50 - 54세,1998,310,135,175
'4213061000,  태장1동,'60,55 - 59세,1998,389,173,216
'4213061000,  태장1동,'65,60 - 64세,1998,288,149,139
'4213061000,  태장1동,'70,65 - 69세,1998,217,88,129
'4213061000,  태장1동,'75,70 - 74세,1998,123,46,77
'4213061000,  태장1동,'80,75 - 79세,1998,101,34,67
'4213061000,  태장1동,'85,80 - 84세,1998,37,7,30
'4213061000,  태장1동,'90,85+ ,1998,34,11,23
'4213062000,  태장2동,'00,계,1998,23047,11625,11422
'4213062000,  태장2동,'05,0 - 4세,1998,2030,1079,951
'4213062000,  태장2동,'10,5 - 9세,1998,1992,1049,943
'4213062000,  태장2동,'15,10 - 14세,1998,1730,887,843
'4213062000,  태장2동,'20,15 - 19세,1998,1842,930,912
'4213062000,  태장2동,'25,20 - 24세,1998,1629,811,818
'4213062000,  태장2동,'30,25 - 29세,1998,2342,1168,1174
'4213062000,  태장2동,'35,30 - 34세,1998,2424,1239,1185
'4213062000,  태장2동,'40,35 - 39세,1998,2628,1369,1259
'4213062000,  태장2동,'45,40 - 44세,1998,1813,994,819
'4213062000,  태장2동,'50,45 - 49세,1998,970,494,476
'4213062000,  태장2동,'55,50 - 54세,1998,838,402,436
'4213062000,  태장2동,'60,55 - 59세,1998,890,388,502
'4213062000,  태장2동,'65,60 - 64세,1998,734,349,385
'4213062000,  태장2동,'70,65 - 69세,1998,459,203,256
'4213062000,  태장2동,'75,70 - 74세,1998,321,122,199
'4213062000,  태장2동,'80,75 - 79세,1998,215,71,144
'4213062000,  태장2동,'85,80 - 84세,1998,120,52,68
'4213062000,  태장2동,'90,85+ ,1998,70,18,52
'4213063000,  봉산1동,'00,계,1998,2650,1345,1305
'4213063000,  봉산1동,'05,0 - 4세,1998,139,70,69
'4213063000,  봉산1동,'10,5 - 9세,1998,152,73,79
'4213063000,  봉산1동,'15,10 - 14세,1998,176,103,73
'4213063000,  봉산1동,'20,15 - 19세,1998,233,115,118
'4213063000,  봉산1동,'25,20 - 24세,1998,209,109,100
'4213063000,  봉산1동,'30,25 - 29세,1998,261,157,104
'4213063000,  봉산1동,'35,30 - 34세,1998,204,111,93
'4213063000,  봉산1동,'40,35 - 39세,1998,216,121,95
'4213063000,  봉산1동,'45,40 - 44세,1998,204,112,92
'4213063000,  봉산1동,'50,45 - 49세,1998,135,74,61
'4213063000,  봉산1동,'55,50 - 54세,1998,145,67,78
'4213063000,  봉산1동,'60,55 - 59세,1998,166,65,101
'4213063000,  봉산1동,'65,60 - 64세,1998,144,59,85
'4213063000,  봉산1동,'70,65 - 69세,1998,123,48,75
'4213063000,  봉산1동,'75,70 - 74세,1998,71,27,44
'4213063000,  봉산1동,'80,75 - 79세,1998,35,16,19
'4213063000,  봉산1동,'85,80 - 84세,1998,28,15,13
'4213063000,  봉산1동,'90,85+ ,1998,9,3,6
'4213064000,  봉산2동,'00,계,1998,10404,5171,5233
'4213064000,  봉산2동,'05,0 - 4세,1998,840,420,420
'4213064000,  봉산2동,'10,5 - 9세,1998,806,415,391
'4213064000,  봉산2동,'15,10 - 14세,1998,743,395,348
'4213064000,  봉산2동,'20,15 - 19세,1998,888,457,431
'4213064000,  봉산2동,'25,20 - 24세,1998,791,411,380
'4213064000,  봉산2동,'30,25 - 29세,1998,927,468,459
'4213064000,  봉산2동,'35,30 - 34세,1998,1016,525,491
'4213064000,  봉산2동,'40,35 - 39세,1998,1161,587,574
'4213064000,  봉산2동,'45,40 - 44세,1998,765,411,354
'4213064000,  봉산2동,'50,45 - 49세,1998,513,262,251
'4213064000,  봉산2동,'55,50 - 54세,1998,386,188,198
'4213064000,  봉산2동,'60,55 - 59세,1998,445,204,241
'4213064000,  봉산2동,'65,60 - 64세,1998,383,164,219
'4213064000,  봉산2동,'70,65 - 69세,1998,262,103,159
'4213064000,  봉산2동,'75,70 - 74세,1998,222,82,140
'4213064000,  봉산2동,'80,75 - 79세,1998,126,41,85
'4213064000,  봉산2동,'85,80 - 84세,1998,86,28,58
'4213064000,  봉산2동,'90,85+ ,1998,44,10,34
'4213065000,  행구동,'00,계,1998,5227,2617,2610
'4213065000,  행구동,'05,0 - 4세,1998,516,261,255
'4213065000,  행구동,'10,5 - 9세,1998,357,192,165
'4213065000,  행구동,'15,10 - 14세,1998,298,145,153
'4213065000,  행구동,'20,15 - 19세,1998,375,213,162
'4213065000,  행구동,'25,20 - 24세,1998,321,170,151
'4213065000,  행구동,'30,25 - 29세,1998,532,242,290
'4213065000,  행구동,'35,30 - 34세,1998,592,320,272
'4213065000,  행구동,'40,35 - 39세,1998,551,295,256
'4213065000,  행구동,'45,40 - 44세,1998,373,191,182
'4213065000,  행구동,'50,45 - 49세,1998,214,119,95
'4213065000,  행구동,'55,50 - 54세,1998,186,96,90
'4213065000,  행구동,'60,55 - 59세,1998,215,96,119
'4213065000,  행구동,'65,60 - 64세,1998,223,104,119
'4213065000,  행구동,'70,65 - 69세,1998,141,55,86
'4213065000,  행구동,'75,70 - 74세,1998,104,47,57
'4213065000,  행구동,'80,75 - 79세,1998,96,33,63
'4213065000,  행구동,'85,80 - 84세,1998,75,23,52
'4213065000,  행구동,'90,85+ ,1998,58,15,43
'4213066000,  무실동,'00,계,1998,1523,767,756
'4213066000,  무실동,'05,0 - 4세,1998,70,31,39
'4213066000,  무실동,'10,5 - 9세,1998,64,32,32
'4213066000,  무실동,'15,10 - 14세,1998,106,68,38
'4213066000,  무실동,'20,15 - 19세,1998,139,60,79
'4213066000,  무실동,'25,20 - 24세,1998,143,87,56
'4213066000,  무실동,'30,25 - 29세,1998,112,64,48
'4213066000,  무실동,'35,30 - 34세,1998,91,51,40
'4213066000,  무실동,'40,35 - 39세,1998,129,65,64
'4213066000,  무실동,'45,40 - 44세,1998,125,60,65
'4213066000,  무실동,'50,45 - 49세,1998,91,52,39
'4213066000,  무실동,'55,50 - 54세,1998,80,40,40
'4213066000,  무실동,'60,55 - 59세,1998,73,39,34
'4213066000,  무실동,'65,60 - 64세,1998,73,28,45
'4213066000,  무실동,'70,65 - 69세,1998,76,28,48
'4213066000,  무실동,'75,70 - 74세,1998,64,25,39
'4213066000,  무실동,'80,75 - 79세,1998,42,18,24
'4213066000,  무실동,'85,80 - 84세,1998,28,14,14
'4213066000,  무실동,'90,85+ ,1998,17,5,12
'4213067000,  관설동,'00,계,1998,2606,1322,1284
'4213067000,  관설동,'05,0 - 4세,1998,145,80,65
'4213067000,  관설동,'10,5 - 9세,1998,144,67,77
'4213067000,  관설동,'15,10 - 14세,1998,177,84,93
'4213067000,  관설동,'20,15 - 19세,1998,263,139,124
'4213067000,  관설동,'25,20 - 24세,1998,230,117,113
'4213067000,  관설동,'30,25 - 29세,1998,229,141,88
'4213067000,  관설동,'35,30 - 34세,1998,184,101,83
'4213067000,  관설동,'40,35 - 39세,1998,209,106,103
'4213067000,  관설동,'45,40 - 44세,1998,193,103,90
'4213067000,  관설동,'50,45 - 49세,1998,144,74,70
'4213067000,  관설동,'55,50 - 54세,1998,124,66,58
'4213067000,  관설동,'60,55 - 59세,1998,169,73,96
'4213067000,  관설동,'65,60 - 64세,1998,148,67,81
'4213067000,  관설동,'70,65 - 69세,1998,95,41,54
'4213067000,  관설동,'75,70 - 74세,1998,72,32,40
'4213067000,  관설동,'80,75 - 79세,1998,50,20,30
'4213067000,  관설동,'85,80 - 84세,1998,17,5,12
'4213067000,  관설동,'90,85+ ,1998,13,6,7
'4213068000,  반곡동,'00,계,1998,2350,1200,1150
'4213068000,  반곡동,'05,0 - 4세,1998,95,41,54
'4213068000,  반곡동,'10,5 - 9세,1998,137,76,61
'4213068000,  반곡동,'15,10 - 14세,1998,159,73,86
'4213068000,  반곡동,'20,15 - 19세,1998,219,116,103
'4213068000,  반곡동,'25,20 - 24세,1998,194,102,92
'4213068000,  반곡동,'30,25 - 29세,1998,187,117,70
'4213068000,  반곡동,'35,30 - 34세,1998,162,90,72
'4213068000,  반곡동,'40,35 - 39세,1998,199,112,87
'4213068000,  반곡동,'45,40 - 44세,1998,190,98,92
'4213068000,  반곡동,'50,45 - 49세,1998,117,70,47
'4213068000,  반곡동,'55,50 - 54세,1998,123,64,59
'4213068000,  반곡동,'60,55 - 59세,1998,141,59,82
'4213068000,  반곡동,'65,60 - 64세,1998,139,67,72
'4213068000,  반곡동,'70,65 - 69세,1998,101,43,58
'4213068000,  반곡동,'75,70 - 74세,1998,92,39,53
'4213068000,  반곡동,'80,75 - 79세,1998,52,18,34
'4213068000,  반곡동,'85,80 - 84세,1998,30,10,20
'4213068000,  반곡동,'90,85+ ,1998,13,5,8
'42150, 강릉시,'00,계,1998,229449,114544,114905
'42150, 강릉시,'05,0 - 4세,1998,14754,7837,6917
'42150, 강릉시,'10,5 - 9세,1998,14781,7811,6970
'42150, 강릉시,'15,10 - 14세,1998,15451,8044,7407
'42150, 강릉시,'20,15 - 19세,1998,21902,11292,10610
'42150, 강릉시,'25,20 - 24세,1998,21375,11252,10123
'42150, 강릉시,'30,25 - 29세,1998,20426,10922,9504
'42150, 강릉시,'35,30 - 34세,1998,18051,9301,8750
'42150, 강릉시,'40,35 - 39세,1998,20283,10006,10277
'42150, 강릉시,'45,40 - 44세,1998,18422,9192,9230
'42150, 강릉시,'50,45 - 49세,1998,12803,6191,6612
'42150, 강릉시,'55,50 - 54세,1998,11636,5811,5825
'42150, 강릉시,'60,55 - 59세,1998,11627,5659,5968
'42150, 강릉시,'65,60 - 64세,1998,9624,4602,5022
'42150, 강릉시,'70,65 - 69세,1998,6424,2627,3797
'42150, 강릉시,'75,70 - 74세,1998,4962,1833,3129
'42150, 강릉시,'80,75 - 79세,1998,3619,1263,2356
'42150, 강릉시,'85,80 - 84세,1998,2143,636,1507
'42150, 강릉시,'90,85+ ,1998,1166,265,901
'4215025000,  주문진읍,'00,계,1998,26738,13372,13366
'4215025000,  주문진읍,'05,0 - 4세,1998,1498,795,703
'4215025000,  주문진읍,'10,5 - 9세,1998,1512,826,686
'4215025000,  주문진읍,'15,10 - 14세,1998,1492,724,768
'4215025000,  주문진읍,'20,15 - 19세,1998,2677,1388,1289
'4215025000,  주문진읍,'25,20 - 24세,1998,2651,1433,1218
'4215025000,  주문진읍,'30,25 - 29세,1998,2272,1260,1012
'4215025000,  주문진읍,'35,30 - 34세,1998,1961,1042,919
'4215025000,  주문진읍,'40,35 - 39세,1998,2154,1103,1051
'4215025000,  주문진읍,'45,40 - 44세,1998,2024,1022,1002
'4215025000,  주문진읍,'50,45 - 49세,1998,1559,742,817
'4215025000,  주문진읍,'55,50 - 54세,1998,1505,746,759
'4215025000,  주문진읍,'60,55 - 59세,1998,1636,766,870
'4215025000,  주문진읍,'65,60 - 64세,1998,1349,621,728
'4215025000,  주문진읍,'70,65 - 69세,1998,886,379,507
'4215025000,  주문진읍,'75,70 - 74세,1998,723,245,478
'4215025000,  주문진읍,'80,75 - 79세,1998,461,166,295
'4215025000,  주문진읍,'85,80 - 84세,1998,240,72,168
'4215025000,  주문진읍,'90,85+ ,1998,138,42,96
'4215031000,  성산면,'00,계,1998,4085,2100,1985
'4215031000,  성산면,'05,0 - 4세,1998,182,97,85
'4215031000,  성산면,'10,5 - 9세,1998,155,97,58
'4215031000,  성산면,'15,10 - 14세,1998,222,114,108
'4215031000,  성산면,'20,15 - 19세,1998,369,179,190
'4215031000,  성산면,'25,20 - 24세,1998,391,221,170
'4215031000,  성산면,'30,25 - 29세,1998,360,229,131
'4215031000,  성산면,'35,30 - 34세,1998,237,151,86
'4215031000,  성산면,'40,35 - 39세,1998,239,122,117
'4215031000,  성산면,'45,40 - 44세,1998,263,148,115
'4215031000,  성산면,'50,45 - 49세,1998,197,104,93
'4215031000,  성산면,'55,50 - 54세,1998,238,103,135
'4215031000,  성산면,'60,55 - 59세,1998,305,157,148
'4215031000,  성산면,'65,60 - 64세,1998,316,134,182
'4215031000,  성산면,'70,65 - 69세,1998,193,88,105
'4215031000,  성산면,'75,70 - 74세,1998,161,66,95
'4215031000,  성산면,'80,75 - 79세,1998,121,50,71
'4215031000,  성산면,'85,80 - 84세,1998,87,29,58
'4215031000,  성산면,'90,85+ ,1998,49,11,38
'4215032000,  왕산면,'00,계,1998,2131,1156,975
'4215032000,  왕산면,'05,0 - 4세,1998,65,35,30
'4215032000,  왕산면,'10,5 - 9세,1998,45,21,24
'4215032000,  왕산면,'15,10 - 14세,1998,107,52,55
'4215032000,  왕산면,'20,15 - 19세,1998,195,103,92
'4215032000,  왕산면,'25,20 - 24세,1998,228,126,102
'4215032000,  왕산면,'30,25 - 29세,1998,134,90,44
'4215032000,  왕산면,'35,30 - 34세,1998,108,74,34
'4215032000,  왕산면,'40,35 - 39세,1998,135,83,52
'4215032000,  왕산면,'45,40 - 44세,1998,156,96,60
'4215032000,  왕산면,'50,45 - 49세,1998,139,67,72
'4215032000,  왕산면,'55,50 - 54세,1998,140,74,66
'4215032000,  왕산면,'60,55 - 59세,1998,194,110,84
'4215032000,  왕산면,'65,60 - 64세,1998,200,103,97
'4215032000,  왕산면,'70,65 - 69세,1998,99,42,57
'4215032000,  왕산면,'75,70 - 74세,1998,87,39,48
'4215032000,  왕산면,'80,75 - 79세,1998,60,26,34
'4215032000,  왕산면,'85,80 - 84세,1998,25,9,16
'4215032000,  왕산면,'90,85+ ,1998,14,6,8
'4215033000,  구정면,'00,계,1998,4692,2447,2245
'4215033000,  구정면,'05,0 - 4세,1998,182,105,77
'4215033000,  구정면,'10,5 - 9세,1998,182,93,89
'4215033000,  구정면,'15,10 - 14세,1998,268,132,136
'4215033000,  구정면,'20,15 - 19세,1998,483,262,221
'4215033000,  구정면,'25,20 - 24세,1998,515,299,216
'4215033000,  구정면,'30,25 - 29세,1998,361,216,145
'4215033000,  구정면,'35,30 - 34세,1998,234,141,93
'4215033000,  구정면,'40,35 - 39세,1998,334,182,152
'4215033000,  구정면,'45,40 - 44세,1998,340,181,159
'4215033000,  구정면,'50,45 - 49세,1998,258,137,121
'4215033000,  구정면,'55,50 - 54세,1998,250,123,127
'4215033000,  구정면,'60,55 - 59세,1998,296,147,149
'4215033000,  구정면,'65,60 - 64세,1998,306,143,163
'4215033000,  구정면,'70,65 - 69세,1998,213,82,131
'4215033000,  구정면,'75,70 - 74세,1998,204,87,117
'4215033000,  구정면,'80,75 - 79세,1998,144,61,83
'4215033000,  구정면,'85,80 - 84세,1998,75,42,33
'4215033000,  구정면,'90,85+ ,1998,47,14,33
'4215034000,  강동면,'00,계,1998,7585,3854,3731
'4215034000,  강동면,'05,0 - 4세,1998,399,221,178
'4215034000,  강동면,'10,5 - 9세,1998,317,162,155
'4215034000,  강동면,'15,10 - 14세,1998,436,219,217
'4215034000,  강동면,'20,15 - 19세,1998,780,394,386
'4215034000,  강동면,'25,20 - 24세,1998,789,406,383
'4215034000,  강동면,'30,25 - 29세,1998,672,403,269
'4215034000,  강동면,'35,30 - 34세,1998,497,294,203
'4215034000,  강동면,'40,35 - 39세,1998,496,274,222
'4215034000,  강동면,'45,40 - 44세,1998,483,264,219
'4215034000,  강동면,'50,45 - 49세,1998,405,187,218
'4215034000,  강동면,'55,50 - 54세,1998,422,217,205
'4215034000,  강동면,'60,55 - 59세,1998,548,275,273
'4215034000,  강동면,'65,60 - 64세,1998,462,226,236
'4215034000,  강동면,'70,65 - 69세,1998,328,129,199
'4215034000,  강동면,'75,70 - 74세,1998,220,90,130
'4215034000,  강동면,'80,75 - 79세,1998,173,56,117
'4215034000,  강동면,'85,80 - 84세,1998,107,30,77
'4215034000,  강동면,'90,85+ ,1998,51,7,44
'4215035000,  옥계면,'00,계,1998,7077,3531,3546
'4215035000,  옥계면,'05,0 - 4세,1998,436,243,193
'4215035000,  옥계면,'10,5 - 9세,1998,460,239,221
'4215035000,  옥계면,'15,10 - 14세,1998,413,213,200
'4215035000,  옥계면,'20,15 - 19세,1998,631,289,342
'4215035000,  옥계면,'25,20 - 24세,1998,660,370,290
'4215035000,  옥계면,'30,25 - 29세,1998,505,285,220
'4215035000,  옥계면,'35,30 - 34세,1998,535,277,258
'4215035000,  옥계면,'40,35 - 39세,1998,579,318,261
'4215035000,  옥계면,'45,40 - 44세,1998,485,261,224
'4215035000,  옥계면,'50,45 - 49세,1998,369,196,173
'4215035000,  옥계면,'55,50 - 54세,1998,354,176,178
'4215035000,  옥계면,'60,55 - 59세,1998,428,181,247
'4215035000,  옥계면,'65,60 - 64세,1998,414,195,219
'4215035000,  옥계면,'70,65 - 69세,1998,316,127,189
'4215035000,  옥계면,'75,70 - 74세,1998,211,79,132
'4215035000,  옥계면,'80,75 - 79세,1998,147,46,101
'4215035000,  옥계면,'85,80 - 84세,1998,89,27,62
'4215035000,  옥계면,'90,85+ ,1998,45,9,36
'4215036000,  사천면,'00,계,1998,5275,2676,2599
'4215036000,  사천면,'05,0 - 4세,1998,269,136,133
'4215036000,  사천면,'10,5 - 9세,1998,253,114,139
'4215036000,  사천면,'15,10 - 14세,1998,246,134,112
'4215036000,  사천면,'20,15 - 19세,1998,464,243,221
'4215036000,  사천면,'25,20 - 24세,1998,544,311,233
'4215036000,  사천면,'30,25 - 29세,1998,472,284,188
'4215036000,  사천면,'35,30 - 34세,1998,359,201,158
'4215036000,  사천면,'40,35 - 39세,1998,359,187,172
'4215036000,  사천면,'45,40 - 44세,1998,324,172,152
'4215036000,  사천면,'50,45 - 49세,1998,288,145,143
'4215036000,  사천면,'55,50 - 54세,1998,268,124,144
'4215036000,  사천면,'60,55 - 59세,1998,352,161,191
'4215036000,  사천면,'65,60 - 64세,1998,336,177,159
'4215036000,  사천면,'70,65 - 69세,1998,243,112,131
'4215036000,  사천면,'75,70 - 74세,1998,178,63,115
'4215036000,  사천면,'80,75 - 79세,1998,181,67,114
'4215036000,  사천면,'85,80 - 84세,1998,95,35,60
'4215036000,  사천면,'90,85+ ,1998,44,10,34
'4215037000,  연곡면,'00,계,1998,5702,2914,2788
'4215037000,  연곡면,'05,0 - 4세,1998,306,162,144
'4215037000,  연곡면,'10,5 - 9세,1998,229,114,115
'4215037000,  연곡면,'15,10 - 14세,1998,285,163,122
'4215037000,  연곡면,'20,15 - 19세,1998,534,275,259
'4215037000,  연곡면,'25,20 - 24세,1998,541,293,248
'4215037000,  연곡면,'30,25 - 29세,1998,524,309,215
'4215037000,  연곡면,'35,30 - 34세,1998,382,207,175
'4215037000,  연곡면,'40,35 - 39세,1998,393,212,181
'4215037000,  연곡면,'45,40 - 44세,1998,437,228,209
'4215037000,  연곡면,'50,45 - 49세,1998,316,156,160
'4215037000,  연곡면,'55,50 - 54세,1998,308,161,147
'4215037000,  연곡면,'60,55 - 59세,1998,362,173,189
'4215037000,  연곡면,'65,60 - 64세,1998,355,177,178
'4215037000,  연곡면,'70,65 - 69세,1998,249,108,141
'4215037000,  연곡면,'75,70 - 74세,1998,191,72,119
'4215037000,  연곡면,'80,75 - 79세,1998,153,58,95
'4215037000,  연곡면,'85,80 - 84세,1998,92,35,57
'4215037000,  연곡면,'90,85+ ,1998,45,11,34
'4215051000,  홍제동,'00,계,1998,9176,4526,4650
'4215051000,  홍제동,'05,0 - 4세,1998,588,320,268
'4215051000,  홍제동,'10,5 - 9세,1998,665,364,301
'4215051000,  홍제동,'15,10 - 14세,1998,559,293,266
'4215051000,  홍제동,'20,15 - 19세,1998,832,407,425
'4215051000,  홍제동,'25,20 - 24세,1998,910,491,419
'4215051000,  홍제동,'30,25 - 29세,1998,861,458,403
'4215051000,  홍제동,'35,30 - 34세,1998,697,366,331
'4215051000,  홍제동,'40,35 - 39세,1998,738,395,343
'4215051000,  홍제동,'45,40 - 44세,1998,662,296,366
'4215051000,  홍제동,'50,45 - 49세,1998,484,216,268
'4215051000,  홍제동,'55,50 - 54세,1998,469,210,259
'4215051000,  홍제동,'60,55 - 59세,1998,498,235,263
'4215051000,  홍제동,'65,60 - 64세,1998,411,174,237
'4215051000,  홍제동,'70,65 - 69세,1998,291,122,169
'4215051000,  홍제동,'75,70 - 74세,1998,207,87,120
'4215051000,  홍제동,'80,75 - 79세,1998,152,54,98
'4215051000,  홍제동,'85,80 - 84세,1998,93,31,62
'4215051000,  홍제동,'90,85+ ,1998,59,7,52
'4215052000,  중앙동,'00,계,1998,9420,4517,4903
'4215052000,  중앙동,'05,0 - 4세,1998,392,203,189
'4215052000,  중앙동,'10,5 - 9세,1998,614,320,294
'4215052000,  중앙동,'15,10 - 14세,1998,629,317,312
'4215052000,  중앙동,'20,15 - 19세,1998,924,469,455
'4215052000,  중앙동,'25,20 - 24세,1998,895,471,424
'4215052000,  중앙동,'30,25 - 29세,1998,711,402,309
'4215052000,  중앙동,'35,30 - 34세,1998,551,272,279
'4215052000,  중앙동,'40,35 - 39세,1998,728,300,428
'4215052000,  중앙동,'45,40 - 44세,1998,852,384,468
'4215052000,  중앙동,'50,45 - 49세,1998,607,285,322
'4215052000,  중앙동,'55,50 - 54세,1998,590,292,298
'4215052000,  중앙동,'60,55 - 59세,1998,590,278,312
'4215052000,  중앙동,'65,60 - 64세,1998,447,198,249
'4215052000,  중앙동,'70,65 - 69세,1998,305,121,184
'4215052000,  중앙동,'75,70 - 74세,1998,261,105,156
'4215052000,  중앙동,'80,75 - 79세,1998,170,56,114
'4215052000,  중앙동,'85,80 - 84세,1998,107,34,73
'4215052000,  중앙동,'90,85+ ,1998,47,10,37
'4215054000,  옥천동,'00,계,1998,6641,3209,3432
'4215054000,  옥천동,'05,0 - 4세,1998,270,139,131
'4215054000,  옥천동,'10,5 - 9세,1998,358,189,169
'4215054000,  옥천동,'15,10 - 14세,1998,383,198,185
'4215054000,  옥천동,'20,15 - 19세,1998,630,313,317
'4215054000,  옥천동,'25,20 - 24세,1998,759,378,381
'4215054000,  옥천동,'30,25 - 29세,1998,656,382,274
'4215054000,  옥천동,'35,30 - 34세,1998,451,211,240
'4215054000,  옥천동,'40,35 - 39세,1998,497,226,271
'4215054000,  옥천동,'45,40 - 44세,1998,491,214,277
'4215054000,  옥천동,'50,45 - 49세,1998,436,183,253
'4215054000,  옥천동,'55,50 - 54세,1998,446,205,241
'4215054000,  옥천동,'60,55 - 59세,1998,440,205,235
'4215054000,  옥천동,'65,60 - 64세,1998,342,184,158
'4215054000,  옥천동,'70,65 - 69세,1998,166,73,93
'4215054000,  옥천동,'75,70 - 74세,1998,120,41,79
'4215054000,  옥천동,'80,75 - 79세,1998,100,42,58
'4215054000,  옥천동,'85,80 - 84세,1998,55,14,41
'4215054000,  옥천동,'90,85+ ,1998,41,12,29
'4215055000,  교1동,'00,계,1998,11110,5552,5558
'4215055000,  교1동,'05,0 - 4세,1998,557,292,265
'4215055000,  교1동,'10,5 - 9세,1998,618,336,282
'4215055000,  교1동,'15,10 - 14세,1998,755,390,365
'4215055000,  교1동,'20,15 - 19세,1998,1171,610,561
'4215055000,  교1동,'25,20 - 24세,1998,1285,685,600
'4215055000,  교1동,'30,25 - 29세,1998,997,566,431
'4215055000,  교1동,'35,30 - 34세,1998,697,358,339
'4215055000,  교1동,'40,35 - 39세,1998,775,360,415
'4215055000,  교1동,'45,40 - 44세,1998,886,405,481
'4215055000,  교1동,'50,45 - 49세,1998,738,318,420
'4215055000,  교1동,'55,50 - 54세,1998,729,368,361
'4215055000,  교1동,'60,55 - 59세,1998,651,329,322
'4215055000,  교1동,'65,60 - 64세,1998,477,247,230
'4215055000,  교1동,'70,65 - 69세,1998,282,135,147
'4215055000,  교1동,'75,70 - 74세,1998,190,74,116
'4215055000,  교1동,'80,75 - 79세,1998,142,42,100
'4215055000,  교1동,'85,80 - 84세,1998,104,26,78
'4215055000,  교1동,'90,85+ ,1998,56,11,45
'4215056000,  교2동,'00,계,1998,11185,5592,5593
'4215056000,  교2동,'05,0 - 4세,1998,689,364,325
'4215056000,  교2동,'10,5 - 9세,1998,682,353,329
'4215056000,  교2동,'15,10 - 14세,1998,866,476,390
'4215056000,  교2동,'20,15 - 19세,1998,1134,621,513
'4215056000,  교2동,'25,20 - 24세,1998,1026,530,496
'4215056000,  교2동,'30,25 - 29세,1998,929,472,457
'4215056000,  교2동,'35,30 - 34세,1998,812,410,402
'4215056000,  교2동,'40,35 - 39세,1998,997,459,538
'4215056000,  교2동,'45,40 - 44세,1998,1054,512,542
'4215056000,  교2동,'50,45 - 49세,1998,678,316,362
'4215056000,  교2동,'55,50 - 54세,1998,593,329,264
'4215056000,  교2동,'60,55 - 59세,1998,571,277,294
'4215056000,  교2동,'65,60 - 64세,1998,408,211,197
'4215056000,  교2동,'70,65 - 69세,1998,248,110,138
'4215056000,  교2동,'75,70 - 74세,1998,204,60,144
'4215056000,  교2동,'80,75 - 79세,1998,154,45,109
'4215056000,  교2동,'85,80 - 84세,1998,94,37,57
'4215056000,  교2동,'90,85+ ,1998,46,10,36
'4215057100,  포남1동,'00,계,1998,15972,7799,8173
'4215057100,  포남1동,'05,0 - 4세,1998,933,496,437
'4215057100,  포남1동,'10,5 - 9세,1998,1043,557,486
'4215057100,  포남1동,'15,10 - 14세,1998,1175,597,578
'4215057100,  포남1동,'20,15 - 19세,1998,1799,916,883
'4215057100,  포남1동,'25,20 - 24세,1998,1548,804,744
'4215057100,  포남1동,'30,25 - 29세,1998,1390,720,670
'4215057100,  포남1동,'35,30 - 34세,1998,1151,567,584
'4215057100,  포남1동,'40,35 - 39세,1998,1358,583,775
'4215057100,  포남1동,'45,40 - 44세,1998,1491,678,813
'4215057100,  포남1동,'50,45 - 49세,1998,1073,517,556
'4215057100,  포남1동,'55,50 - 54세,1998,912,449,463
'4215057100,  포남1동,'60,55 - 59세,1998,720,362,358
'4215057100,  포남1동,'65,60 - 64세,1998,506,265,241
'4215057100,  포남1동,'70,65 - 69세,1998,295,117,178
'4215057100,  포남1동,'75,70 - 74세,1998,235,77,158
'4215057100,  포남1동,'80,75 - 79세,1998,166,51,115
'4215057100,  포남1동,'85,80 - 84세,1998,111,27,84
'4215057100,  포남1동,'90,85+ ,1998,66,16,50
'4215057200,  포남2동,'00,계,1998,21277,10508,10769
'4215057200,  포남2동,'05,0 - 4세,1998,1792,958,834
'4215057200,  포남2동,'10,5 - 9세,1998,1970,1047,923
'4215057200,  포남2동,'15,10 - 14세,1998,1717,920,797
'4215057200,  포남2동,'20,15 - 19세,1998,2011,1047,964
'4215057200,  포남2동,'25,20 - 24세,1998,1520,756,764
'4215057200,  포남2동,'30,25 - 29세,1998,1769,826,943
'4215057200,  포남2동,'35,30 - 34세,1998,2017,924,1093
'4215057200,  포남2동,'40,35 - 39세,1998,2553,1211,1342
'4215057200,  포남2동,'45,40 - 44세,1998,1950,998,952
'4215057200,  포남2동,'50,45 - 49세,1998,1106,574,532
'4215057200,  포남2동,'55,50 - 54세,1998,843,448,395
'4215057200,  포남2동,'60,55 - 59세,1998,592,288,304
'4215057200,  포남2동,'65,60 - 64세,1998,490,218,272
'4215057200,  포남2동,'70,65 - 69세,1998,340,117,223
'4215057200,  포남2동,'75,70 - 74세,1998,263,94,169
'4215057200,  포남2동,'80,75 - 79세,1998,179,50,129
'4215057200,  포남2동,'85,80 - 84세,1998,100,21,79
'4215057200,  포남2동,'90,85+ ,1998,65,11,54
'4215058000,  초당동,'00,계,1998,6462,3204,3258
'4215058000,  초당동,'05,0 - 4세,1998,639,321,318
'4215058000,  초당동,'10,5 - 9세,1998,641,347,294
'4215058000,  초당동,'15,10 - 14세,1998,481,269,212
'4215058000,  초당동,'20,15 - 19세,1998,461,237,224
'4215058000,  초당동,'25,20 - 24세,1998,379,192,187
'4215058000,  초당동,'30,25 - 29세,1998,529,231,298
'4215058000,  초당동,'35,30 - 34세,1998,729,351,378
'4215058000,  초당동,'40,35 - 39세,1998,798,416,382
'4215058000,  초당동,'45,40 - 44세,1998,576,301,275
'4215058000,  초당동,'50,45 - 49세,1998,278,126,152
'4215058000,  초당동,'55,50 - 54세,1998,232,123,109
'4215058000,  초당동,'60,55 - 59세,1998,180,86,94
'4215058000,  초당동,'65,60 - 64세,1998,158,65,93
'4215058000,  초당동,'70,65 - 69세,1998,141,61,80
'4215058000,  초당동,'75,70 - 74세,1998,89,33,56
'4215058000,  초당동,'80,75 - 79세,1998,80,24,56
'4215058000,  초당동,'85,80 - 84세,1998,44,13,31
'4215058000,  초당동,'90,85+ ,1998,27,8,19
'4215059000,  송정동,'00,계,1998,6311,3140,3171
'4215059000,  송정동,'05,0 - 4세,1998,481,251,230
'4215059000,  송정동,'10,5 - 9세,1998,484,233,251
'4215059000,  송정동,'15,10 - 14세,1998,520,273,247
'4215059000,  송정동,'20,15 - 19세,1998,585,298,287
'4215059000,  송정동,'25,20 - 24세,1998,465,253,212
'4215059000,  송정동,'30,25 - 29세,1998,459,231,228
'4215059000,  송정동,'35,30 - 34세,1998,556,273,283
'4215059000,  송정동,'40,35 - 39세,1998,659,311,348
'4215059000,  송정동,'45,40 - 44세,1998,642,331,311
'4215059000,  송정동,'50,45 - 49세,1998,376,187,189
'4215059000,  송정동,'55,50 - 54세,1998,263,144,119
'4215059000,  송정동,'60,55 - 59세,1998,231,127,104
'4215059000,  송정동,'65,60 - 64세,1998,193,85,108
'4215059000,  송정동,'70,65 - 69세,1998,146,58,88
'4215059000,  송정동,'75,70 - 74세,1998,103,43,60
'4215059000,  송정동,'80,75 - 79세,1998,83,26,57
'4215059000,  송정동,'85,80 - 84세,1998,46,13,33
'4215059000,  송정동,'90,85+ ,1998,19,3,16
'4215060000,  내곡동,'00,계,1998,12226,6044,6182
'4215060000,  내곡동,'05,0 - 4세,1998,1042,561,481
'4215060000,  내곡동,'10,5 - 9세,1998,896,476,420
'4215060000,  내곡동,'15,10 - 14세,1998,908,437,471
'4215060000,  내곡동,'20,15 - 19세,1998,1039,527,512
'4215060000,  내곡동,'25,20 - 24세,1998,1008,487,521
'4215060000,  내곡동,'30,25 - 29세,1998,1143,554,589
'4215060000,  내곡동,'35,30 - 34세,1998,1210,606,604
'4215060000,  내곡동,'40,35 - 39세,1998,1321,665,656
'4215060000,  내곡동,'45,40 - 44세,1998,1018,547,471
'4215060000,  내곡동,'50,45 - 49세,1998,576,302,274
'4215060000,  내곡동,'55,50 - 54세,1998,492,245,247
'4215060000,  내곡동,'60,55 - 59세,1998,464,221,243
'4215060000,  내곡동,'65,60 - 64세,1998,377,181,196
'4215060000,  내곡동,'70,65 - 69세,1998,262,104,158
'4215060000,  내곡동,'75,70 - 74세,1998,190,56,134
'4215060000,  내곡동,'80,75 - 79세,1998,150,47,103
'4215060000,  내곡동,'85,80 - 84세,1998,88,20,68
'4215060000,  내곡동,'90,85+ ,1998,42,8,34
'4215061500,  강남동,'00,계,1998,25136,12630,12506
'4215061500,  강남동,'05,0 - 4세,1998,1645,854,791
'4215061500,  강남동,'10,5 - 9세,1998,1593,827,766
'4215061500,  강남동,'15,10 - 14세,1998,1676,883,793
'4215061500,  강남동,'20,15 - 19세,1998,2308,1240,1068
'4215061500,  강남동,'25,20 - 24세,1998,2478,1308,1170
'4215061500,  강남동,'30,25 - 29세,1998,2454,1312,1142
'4215061500,  강남동,'35,30 - 34세,1998,2022,1067,955
'4215061500,  강남동,'40,35 - 39세,1998,2176,1064,1112
'4215061500,  강남동,'45,40 - 44세,1998,1855,926,929
'4215061500,  강남동,'50,45 - 49세,1998,1349,667,682
'4215061500,  강남동,'55,50 - 54세,1998,1301,615,686
'4215061500,  강남동,'60,55 - 59세,1998,1334,674,660
'4215061500,  강남동,'65,60 - 64세,1998,1021,511,510
'4215061500,  강남동,'70,65 - 69세,1998,644,248,396
'4215061500,  강남동,'75,70 - 74세,1998,520,199,321
'4215061500,  강남동,'80,75 - 79세,1998,379,142,237
'4215061500,  강남동,'85,80 - 84세,1998,238,57,181
'4215061500,  강남동,'90,85+ ,1998,143,36,107
'4215064500,  성덕동,'00,계,1998,25024,12575,12449
'4215064500,  성덕동,'05,0 - 4세,1998,2005,1066,939
'4215064500,  성덕동,'10,5 - 9세,1998,1761,932,829
'4215064500,  성덕동,'15,10 - 14세,1998,2024,1094,930
'4215064500,  성덕동,'20,15 - 19세,1998,2403,1235,1168
'4215064500,  성덕동,'25,20 - 24세,1998,2078,1039,1039
'4215064500,  성덕동,'30,25 - 29세,1998,2503,1288,1215
'4215064500,  성덕동,'35,30 - 34세,1998,2380,1238,1142
'4215064500,  성덕동,'40,35 - 39세,1998,2554,1292,1262
'4215064500,  성덕동,'45,40 - 44세,1998,2036,1040,996
'4215064500,  성덕동,'50,45 - 49세,1998,1264,632,632
'4215064500,  성덕동,'55,50 - 54세,1998,923,487,436
'4215064500,  성덕동,'60,55 - 59세,1998,855,411,444
'4215064500,  성덕동,'65,60 - 64세,1998,730,319,411
'4215064500,  성덕동,'70,65 - 69세,1998,529,192,337
'4215064500,  성덕동,'75,70 - 74세,1998,432,153,279
'4215064500,  성덕동,'80,75 - 79세,1998,300,108,192
'4215064500,  성덕동,'85,80 - 84세,1998,173,39,134
'4215064500,  성덕동,'90,85+ ,1998,74,10,64
'4215066500,  경포동,'00,계,1998,6224,3198,3026
'4215066500,  경포동,'05,0 - 4세,1998,384,218,166
'4215066500,  경포동,'10,5 - 9세,1998,303,164,139
'4215066500,  경포동,'15,10 - 14세,1998,289,146,143
'4215066500,  경포동,'20,15 - 19세,1998,472,239,233
'4215066500,  경포동,'25,20 - 24세,1998,705,399,306
'4215066500,  경포동,'30,25 - 29세,1998,725,404,321
'4215066500,  경포동,'35,30 - 34세,1998,465,271,194
'4215066500,  경포동,'40,35 - 39세,1998,440,243,197
'4215066500,  경포동,'45,40 - 44세,1998,397,188,209
'4215066500,  경포동,'50,45 - 49세,1998,307,134,173
'4215066500,  경포동,'55,50 - 54세,1998,358,172,186
'4215066500,  경포동,'60,55 - 59세,1998,380,196,184
'4215066500,  경포동,'65,60 - 64세,1998,326,168,158
'4215066500,  경포동,'70,65 - 69세,1998,248,102,146
'4215066500,  경포동,'75,70 - 74세,1998,173,70,103
'4215066500,  경포동,'80,75 - 79세,1998,124,46,78
'4215066500,  경포동,'85,80 - 84세,1998,80,25,55
'4215066500,  경포동,'90,85+ ,1998,48,13,35
'42170, 동해시,'00,계,1998,103474,52230,51244
'42170, 동해시,'05,0 - 4세,1998,7193,3849,3344
'42170, 동해시,'10,5 - 9세,1998,6901,3637,3264
'42170, 동해시,'15,10 - 14세,1998,6975,3538,3437
'42170, 동해시,'20,15 - 19세,1998,10028,5106,4922
'42170, 동해시,'25,20 - 24세,1998,9293,4978,4315
'42170, 동해시,'30,25 - 29세,1998,9478,5109,4369
'42170, 동해시,'35,30 - 34세,1998,8622,4483,4139
'42170, 동해시,'40,35 - 39세,1998,9459,4751,4708
'42170, 동해시,'45,40 - 44세,1998,8376,4266,4110
'42170, 동해시,'50,45 - 49세,1998,5743,2986,2757
'42170, 동해시,'55,50 - 54세,1998,5030,2551,2479
'42170, 동해시,'60,55 - 59세,1998,5046,2484,2562
'42170, 동해시,'65,60 - 64세,1998,4027,1930,2097
'42170, 동해시,'70,65 - 69세,1998,2800,1072,1728
'42170, 동해시,'75,70 - 74세,1998,2022,701,1321
'42170, 동해시,'80,75 - 79세,1998,1357,468,889
'42170, 동해시,'85,80 - 84세,1998,749,214,535
'42170, 동해시,'90,85+ ,1998,375,107,268
'4217051000,  천곡동,'00,계,1998,28039,14033,14006
'4217051000,  천곡동,'05,0 - 4세,1998,2440,1310,1130
'4217051000,  천곡동,'10,5 - 9세,1998,2524,1315,1209
'4217051000,  천곡동,'15,10 - 14세,1998,2189,1126,1063
'4217051000,  천곡동,'20,15 - 19세,1998,2634,1365,1269
'4217051000,  천곡동,'25,20 - 24세,1998,2092,1051,1041
'4217051000,  천곡동,'30,25 - 29세,1998,2553,1241,1312
'4217051000,  천곡동,'35,30 - 34세,1998,2707,1267,1440
'4217051000,  천곡동,'40,35 - 39세,1998,3168,1518,1650
'4217051000,  천곡동,'45,40 - 44세,1998,2660,1395,1265
'4217051000,  천곡동,'50,45 - 49세,1998,1493,845,648
'4217051000,  천곡동,'55,50 - 54세,1998,996,536,460
'4217051000,  천곡동,'60,55 - 59세,1998,796,409,387
'4217051000,  천곡동,'65,60 - 64세,1998,600,268,332
'4217051000,  천곡동,'70,65 - 69세,1998,432,154,278
'4217051000,  천곡동,'75,70 - 74세,1998,314,103,211
'4217051000,  천곡동,'80,75 - 79세,1998,232,76,156
'4217051000,  천곡동,'85,80 - 84세,1998,138,29,109
'4217051000,  천곡동,'90,85+ ,1998,71,25,46
'4217052000,  송정동,'00,계,1998,6696,3421,3275
'4217052000,  송정동,'05,0 - 4세,1998,386,214,172
'4217052000,  송정동,'10,5 - 9세,1998,403,216,187
'4217052000,  송정동,'15,10 - 14세,1998,407,210,197
'4217052000,  송정동,'20,15 - 19세,1998,635,330,305
'4217052000,  송정동,'25,20 - 24세,1998,640,359,281
'4217052000,  송정동,'30,25 - 29세,1998,580,326,254
'4217052000,  송정동,'35,30 - 34세,1998,516,286,230
'4217052000,  송정동,'40,35 - 39세,1998,552,289,263
'4217052000,  송정동,'45,40 - 44세,1998,495,235,260
'4217052000,  송정동,'50,45 - 49세,1998,389,194,195
'4217052000,  송정동,'55,50 - 54세,1998,383,196,187
'4217052000,  송정동,'60,55 - 59세,1998,380,179,201
'4217052000,  송정동,'65,60 - 64세,1998,315,164,151
'4217052000,  송정동,'70,65 - 69세,1998,241,87,154
'4217052000,  송정동,'75,70 - 74세,1998,160,69,91
'4217052000,  송정동,'80,75 - 79세,1998,110,37,73
'4217052000,  송정동,'85,80 - 84세,1998,66,20,46
'4217052000,  송정동,'90,85+ ,1998,38,10,28
'4217053000,  북삼동,'00,계,1998,14406,7391,7015
'4217053000,  북삼동,'05,0 - 4세,1998,1229,660,569
'4217053000,  북삼동,'10,5 - 9세,1998,1035,554,481
'4217053000,  북삼동,'15,10 - 14세,1998,1027,533,494
'4217053000,  북삼동,'20,15 - 19세,1998,1365,725,640
'4217053000,  북삼동,'25,20 - 24세,1998,1218,669,549
'4217053000,  북삼동,'30,25 - 29세,1998,1437,708,729
'4217053000,  북삼동,'35,30 - 34세,1998,1411,748,663
'4217053000,  북삼동,'40,35 - 39세,1998,1363,717,646
'4217053000,  북삼동,'45,40 - 44세,1998,1145,595,550
'4217053000,  북삼동,'50,45 - 49세,1998,751,384,367
'4217053000,  북삼동,'55,50 - 54세,1998,579,312,267
'4217053000,  북삼동,'60,55 - 59세,1998,591,314,277
'4217053000,  북삼동,'65,60 - 64세,1998,434,208,226
'4217053000,  북삼동,'70,65 - 69세,1998,300,114,186
'4217053000,  북삼동,'75,70 - 74세,1998,223,71,152
'4217053000,  북삼동,'80,75 - 79세,1998,156,50,106
'4217053000,  북삼동,'85,80 - 84세,1998,96,22,74
'4217053000,  북삼동,'90,85+ ,1998,46,7,39
'4217054000,  부곡동,'00,계,1998,9323,4713,4610
'4217054000,  부곡동,'05,0 - 4세,1998,661,358,303
'4217054000,  부곡동,'10,5 - 9세,1998,587,307,280
'4217054000,  부곡동,'15,10 - 14세,1998,594,308,286
'4217054000,  부곡동,'20,15 - 19세,1998,922,455,467
'4217054000,  부곡동,'25,20 - 24세,1998,932,515,417
'4217054000,  부곡동,'30,25 - 29세,1998,828,456,372
'4217054000,  부곡동,'35,30 - 34세,1998,818,413,405
'4217054000,  부곡동,'40,35 - 39세,1998,810,414,396
'4217054000,  부곡동,'45,40 - 44세,1998,778,369,409
'4217054000,  부곡동,'50,45 - 49세,1998,544,269,275
'4217054000,  부곡동,'55,50 - 54세,1998,518,271,247
'4217054000,  부곡동,'60,55 - 59세,1998,465,233,232
'4217054000,  부곡동,'65,60 - 64세,1998,350,170,180
'4217054000,  부곡동,'70,65 - 69세,1998,205,84,121
'4217054000,  부곡동,'75,70 - 74세,1998,137,43,94
'4217054000,  부곡동,'80,75 - 79세,1998,95,27,68
'4217054000,  부곡동,'85,80 - 84세,1998,56,13,43
'4217054000,  부곡동,'90,85+ ,1998,23,8,15
'4217055000,  동호동,'00,계,1998,7579,3865,3714
'4217055000,  동호동,'05,0 - 4세,1998,450,226,224
'4217055000,  동호동,'10,5 - 9세,1998,443,236,207
'4217055000,  동호동,'15,10 - 14세,1998,496,278,218
'4217055000,  동호동,'20,15 - 19세,1998,768,415,353
'4217055000,  동호동,'25,20 - 24세,1998,774,407,367
'4217055000,  동호동,'30,25 - 29세,1998,734,418,316
'4217055000,  동호동,'35,30 - 34세,1998,567,299,268
'4217055000,  동호동,'40,35 - 39세,1998,684,336,348
'4217055000,  동호동,'45,40 - 44세,1998,610,296,314
'4217055000,  동호동,'50,45 - 49세,1998,456,217,239
'4217055000,  동호동,'55,50 - 54세,1998,404,210,194
'4217055000,  동호동,'60,55 - 59세,1998,412,208,204
'4217055000,  동호동,'65,60 - 64세,1998,301,151,150
'4217055000,  동호동,'70,65 - 69세,1998,187,68,119
'4217055000,  동호동,'75,70 - 74세,1998,131,43,88
'4217055000,  동호동,'80,75 - 79세,1998,95,34,61
'4217055000,  동호동,'85,80 - 84세,1998,45,15,30
'4217055000,  동호동,'90,85+ ,1998,22,8,14
'4217057000,  발한동,'00,계,1998,7748,3844,3904
'4217057000,  발한동,'05,0 - 4세,1998,370,200,170
'4217057000,  발한동,'10,5 - 9세,1998,391,203,188
'4217057000,  발한동,'15,10 - 14세,1998,457,208,249
'4217057000,  발한동,'20,15 - 19세,1998,719,382,337
'4217057000,  발한동,'25,20 - 24세,1998,770,419,351
'4217057000,  발한동,'30,25 - 29세,1998,665,394,271
'4217057000,  발한동,'35,30 - 34세,1998,472,251,221
'4217057000,  발한동,'40,35 - 39세,1998,613,290,323
'4217057000,  발한동,'45,40 - 44세,1998,572,293,279
'4217057000,  발한동,'50,45 - 49세,1998,460,221,239
'4217057000,  발한동,'55,50 - 54세,1998,496,239,257
'4217057000,  발한동,'60,55 - 59세,1998,546,269,277
'4217057000,  발한동,'65,60 - 64세,1998,421,197,224
'4217057000,  발한동,'70,65 - 69세,1998,304,110,194
'4217057000,  발한동,'75,70 - 74세,1998,222,73,149
'4217057000,  발한동,'80,75 - 79세,1998,155,48,107
'4217057000,  발한동,'85,80 - 84세,1998,76,32,44
'4217057000,  발한동,'90,85+ ,1998,39,15,24
'4217059000,  묵호동,'00,계,1998,7025,3531,3494
'4217059000,  묵호동,'05,0 - 4세,1998,235,123,112
'4217059000,  묵호동,'10,5 - 9세,1998,239,114,125
'4217059000,  묵호동,'15,10 - 14세,1998,315,146,169
'4217059000,  묵호동,'20,15 - 19세,1998,709,347,362
'4217059000,  묵호동,'25,20 - 24세,1998,797,445,352
'4217059000,  묵호동,'30,25 - 29세,1998,612,389,223
'4217059000,  묵호동,'35,30 - 34세,1998,388,246,142
'4217059000,  묵호동,'40,35 - 39세,1998,414,227,187
'4217059000,  묵호동,'45,40 - 44세,1998,501,236,265
'4217059000,  묵호동,'50,45 - 49세,1998,465,216,249
'4217059000,  묵호동,'55,50 - 54세,1998,509,230,279
'4217059000,  묵호동,'60,55 - 59세,1998,577,255,322
'4217059000,  묵호동,'65,60 - 64세,1998,514,249,265
'4217059000,  묵호동,'70,65 - 69세,1998,302,137,165
'4217059000,  묵호동,'75,70 - 74세,1998,235,90,145
'4217059000,  묵호동,'80,75 - 79세,1998,126,58,68
'4217059000,  묵호동,'85,80 - 84세,1998,57,13,44
'4217059000,  묵호동,'90,85+ ,1998,30,10,20
'4217060000,  북평동,'00,계,1998,10633,5326,5307
'4217060000,  북평동,'05,0 - 4세,1998,816,442,374
'4217060000,  북평동,'10,5 - 9세,1998,678,376,302
'4217060000,  북평동,'15,10 - 14세,1998,734,348,386
'4217060000,  북평동,'20,15 - 19세,1998,1024,490,534
'4217060000,  북평동,'25,20 - 24세,1998,859,452,407
'4217060000,  북평동,'30,25 - 29세,1998,992,533,459
'4217060000,  북평동,'35,30 - 34세,1998,917,488,429
'4217060000,  북평동,'40,35 - 39세,1998,958,483,475
'4217060000,  북평동,'45,40 - 44세,1998,824,441,383
'4217060000,  북평동,'50,45 - 49세,1998,508,276,232
'4217060000,  북평동,'55,50 - 54세,1998,461,231,230
'4217060000,  북평동,'60,55 - 59세,1998,472,235,237
'4217060000,  북평동,'65,60 - 64세,1998,414,189,225
'4217060000,  북평동,'70,65 - 69세,1998,385,139,246
'4217060000,  북평동,'75,70 - 74세,1998,241,87,154
'4217060000,  북평동,'80,75 - 79세,1998,200,72,128
'4217060000,  북평동,'85,80 - 84세,1998,102,31,71
'4217060000,  북평동,'90,85+ ,1998,48,13,35
'4217063000,  망상동,'00,계,1998,5833,2947,2886
'4217063000,  망상동,'05,0 - 4세,1998,290,147,143
'4217063000,  망상동,'10,5 - 9세,1998,295,155,140
'4217063000,  망상동,'15,10 - 14세,1998,356,178,178
'4217063000,  망상동,'20,15 - 19세,1998,568,274,294
'4217063000,  망상동,'25,20 - 24세,1998,539,295,244
'4217063000,  망상동,'30,25 - 29세,1998,520,310,210
'4217063000,  망상동,'35,30 - 34세,1998,389,219,170
'4217063000,  망상동,'40,35 - 39세,1998,443,240,203
'4217063000,  망상동,'45,40 - 44세,1998,374,199,175
'4217063000,  망상동,'50,45 - 49세,1998,320,171,149
'4217063000,  망상동,'55,50 - 54세,1998,347,169,178
'4217063000,  망상동,'60,55 - 59세,1998,435,208,227
'4217063000,  망상동,'65,60 - 64세,1998,349,167,182
'4217063000,  망상동,'70,65 - 69세,1998,234,96,138
'4217063000,  망상동,'75,70 - 74세,1998,185,59,126
'4217063000,  망상동,'80,75 - 79세,1998,107,37,70
'4217063000,  망상동,'85,80 - 84세,1998,51,18,33
'4217063000,  망상동,'90,85+ ,1998,31,5,26
'4217065000,  삼화동,'00,계,1998,6192,3159,3033
'4217065000,  삼화동,'05,0 - 4세,1998,316,169,147
'4217065000,  삼화동,'10,5 - 9세,1998,306,161,145
'4217065000,  삼화동,'15,10 - 14세,1998,400,203,197
'4217065000,  삼화동,'20,15 - 19세,1998,684,323,361
'4217065000,  삼화동,'25,20 - 24세,1998,672,366,306
'4217065000,  삼화동,'30,25 - 29세,1998,557,334,223
'4217065000,  삼화동,'35,30 - 34세,1998,437,266,171
'4217065000,  삼화동,'40,35 - 39세,1998,454,237,217
'4217065000,  삼화동,'45,40 - 44세,1998,417,207,210
'4217065000,  삼화동,'50,45 - 49세,1998,357,193,164
'4217065000,  삼화동,'55,50 - 54세,1998,337,157,180
'4217065000,  삼화동,'60,55 - 59세,1998,372,174,198
'4217065000,  삼화동,'65,60 - 64세,1998,329,167,162
'4217065000,  삼화동,'70,65 - 69세,1998,210,83,127
'4217065000,  삼화동,'75,70 - 74세,1998,174,63,111
'4217065000,  삼화동,'80,75 - 79세,1998,81,29,52
'4217065000,  삼화동,'85,80 - 84세,1998,62,21,41
'4217065000,  삼화동,'90,85+ ,1998,27,6,21
'42190, 태백시,'00,계,1998,59896,30549,29347
'42190, 태백시,'05,0 - 4세,1998,3197,1679,1518
'42190, 태백시,'10,5 - 9세,1998,3406,1828,1578
'42190, 태백시,'15,10 - 14세,1998,4070,2109,1961
'42190, 태백시,'20,15 - 19세,1998,6809,3468,3341
'42190, 태백시,'25,20 - 24세,1998,5938,3204,2734
'42190, 태백시,'30,25 - 29세,1998,4538,2454,2084
'42190, 태백시,'35,30 - 34세,1998,4207,2169,2038
'42190, 태백시,'40,35 - 39세,1998,5151,2631,2520
'42190, 태백시,'45,40 - 44세,1998,4958,2579,2379
'42190, 태백시,'50,45 - 49세,1998,3970,2008,1962
'42190, 태백시,'55,50 - 54세,1998,3475,1758,1717
'42190, 태백시,'60,55 - 59세,1998,3680,1861,1819
'42190, 태백시,'65,60 - 64세,1998,2770,1357,1413
'42190, 태백시,'70,65 - 69세,1998,1576,696,880
'42190, 태백시,'75,70 - 74세,1998,978,378,600
'42190, 태백시,'80,75 - 79세,1998,678,232,446
'42190, 태백시,'85,80 - 84세,1998,324,99,225
'42190, 태백시,'90,85+ ,1998,171,39,132
'4219051500,  황지동,'00,계,1998,8849,4473,4376
'4219051500,  황지동,'05,0 - 4세,1998,590,304,286
'4219051500,  황지동,'10,5 - 9세,1998,683,376,307
'4219051500,  황지동,'15,10 - 14세,1998,563,300,263
'4219051500,  황지동,'20,15 - 19세,1998,791,399,392
'4219051500,  황지동,'25,20 - 24세,1998,783,431,352
'4219051500,  황지동,'30,25 - 29세,1998,756,394,362
'4219051500,  황지동,'35,30 - 34세,1998,782,376,406
'4219051500,  황지동,'40,35 - 39세,1998,818,428,390
'4219051500,  황지동,'45,40 - 44세,1998,693,352,341
'4219051500,  황지동,'50,45 - 49세,1998,521,254,267
'4219051500,  황지동,'55,50 - 54세,1998,456,223,233
'4219051500,  황지동,'60,55 - 59세,1998,520,249,271
'4219051500,  황지동,'65,60 - 64세,1998,365,176,189
'4219051500,  황지동,'70,65 - 69세,1998,220,100,120
'4219051500,  황지동,'75,70 - 74세,1998,129,51,78
'4219051500,  황지동,'80,75 - 79세,1998,107,44,63
'4219051500,  황지동,'85,80 - 84세,1998,36,10,26
'4219051500,  황지동,'90,85+ ,1998,36,6,30
'4219052500,  황연동,'00,계,1998,8569,4436,4133
'4219052500,  황연동,'05,0 - 4세,1998,396,219,177
'4219052500,  황연동,'10,5 - 9세,1998,430,236,194
'4219052500,  황연동,'15,10 - 14세,1998,632,313,319
'4219052500,  황연동,'20,15 - 19세,1998,1160,602,558
'4219052500,  황연동,'25,20 - 24세,1998,882,480,402
'4219052500,  황연동,'30,25 - 29세,1998,587,321,266
'4219052500,  황연동,'35,30 - 34세,1998,508,261,247
'4219052500,  황연동,'40,35 - 39세,1998,742,372,370
'4219052500,  황연동,'45,40 - 44세,1998,818,432,386
'4219052500,  황연동,'50,45 - 49세,1998,659,371,288
'4219052500,  황연동,'55,50 - 54세,1998,470,249,221
'4219052500,  황연동,'60,55 - 59세,1998,468,228,240
'4219052500,  황연동,'65,60 - 64세,1998,343,160,183
'4219052500,  황연동,'70,65 - 69세,1998,215,94,121
'4219052500,  황연동,'75,70 - 74세,1998,122,50,72
'4219052500,  황연동,'80,75 - 79세,1998,78,30,48
'4219052500,  황연동,'85,80 - 84세,1998,43,13,30
'4219052500,  황연동,'90,85+ ,1998,16,5,11
'4219053500,  삼수동,'00,계,1998,8318,4279,4039
'4219053500,  삼수동,'05,0 - 4세,1998,334,172,162
'4219053500,  삼수동,'10,5 - 9세,1998,327,166,161
'4219053500,  삼수동,'15,10 - 14세,1998,481,260,221
'4219053500,  삼수동,'20,15 - 19세,1998,990,510,480
'4219053500,  삼수동,'25,20 - 24세,1998,995,547,448
'4219053500,  삼수동,'30,25 - 29세,1998,613,361,252
'4219053500,  삼수동,'35,30 - 34세,1998,496,290,206
'4219053500,  삼수동,'40,35 - 39세,1998,595,313,282
'4219053500,  삼수동,'45,40 - 44세,1998,612,294,318
'4219053500,  삼수동,'50,45 - 49세,1998,559,266,293
'4219053500,  삼수동,'55,50 - 54세,1998,575,267,308
'4219053500,  삼수동,'60,55 - 59세,1998,611,304,307
'4219053500,  삼수동,'65,60 - 64세,1998,549,281,268
'4219053500,  삼수동,'70,65 - 69세,1998,267,123,144
'4219053500,  삼수동,'75,70 - 74세,1998,156,62,94
'4219053500,  삼수동,'80,75 - 79세,1998,99,41,58
'4219053500,  삼수동,'85,80 - 84세,1998,41,17,24
'4219053500,  삼수동,'90,85+ ,1998,18,5,13
'4219054000,  상장동,'00,계,1998,10867,5512,5355
'4219054000,  상장동,'05,0 - 4세,1998,811,424,387
'4219054000,  상장동,'10,5 - 9세,1998,783,414,369
'4219054000,  상장동,'15,10 - 14세,1998,815,418,397
'4219054000,  상장동,'20,15 - 19세,1998,1132,572,560
'4219054000,  상장동,'25,20 - 24세,1998,947,502,445
'4219054000,  상장동,'30,25 - 29세,1998,930,452,478
'4219054000,  상장동,'35,30 - 34세,1998,963,509,454
'4219054000,  상장동,'40,35 - 39세,1998,1068,544,524
'4219054000,  상장동,'45,40 - 44세,1998,910,484,426
'4219054000,  상장동,'50,45 - 49세,1998,650,338,312
'4219054000,  상장동,'55,50 - 54세,1998,496,247,249
'4219054000,  상장동,'60,55 - 59세,1998,528,285,243
'4219054000,  상장동,'65,60 - 64세,1998,339,157,182
'4219054000,  상장동,'70,65 - 69세,1998,202,79,123
'4219054000,  상장동,'75,70 - 74세,1998,132,51,81
'4219054000,  상장동,'80,75 - 79세,1998,101,23,78
'4219054000,  상장동,'85,80 - 84세,1998,42,10,32
'4219054000,  상장동,'90,85+ ,1998,18,3,15
'4219058500,  문곡소도동,'00,계,1998,5210,2643,2567
'4219058500,  문곡소도동,'05,0 - 4세,1998,263,135,128
'4219058500,  문곡소도동,'10,5 - 9세,1998,251,130,121
'4219058500,  문곡소도동,'15,10 - 14세,1998,335,165,170
'4219058500,  문곡소도동,'20,15 - 19세,1998,628,321,307
'4219058500,  문곡소도동,'25,20 - 24세,1998,554,292,262
'4219058500,  문곡소도동,'30,25 - 29세,1998,405,227,178
'4219058500,  문곡소도동,'35,30 - 34세,1998,370,190,180
'4219058500,  문곡소도동,'40,35 - 39세,1998,404,202,202
'4219058500,  문곡소도동,'45,40 - 44세,1998,463,238,225
'4219058500,  문곡소도동,'50,45 - 49세,1998,382,197,185
'4219058500,  문곡소도동,'55,50 - 54세,1998,305,160,145
'4219058500,  문곡소도동,'60,55 - 59세,1998,324,158,166
'4219058500,  문곡소도동,'65,60 - 64세,1998,241,127,114
'4219058500,  문곡소도동,'70,65 - 69세,1998,114,51,63
'4219058500,  문곡소도동,'75,70 - 74세,1998,73,24,49
'4219058500,  문곡소도동,'80,75 - 79세,1998,42,12,30
'4219058500,  문곡소도동,'85,80 - 84세,1998,36,11,25
'4219058500,  문곡소도동,'90,85+ ,1998,20,3,17
'4219059500,  장성동,'00,계,1998,7140,3614,3526
'4219059500,  장성동,'05,0 - 4세,1998,301,158,143
'4219059500,  장성동,'10,5 - 9세,1998,421,235,186
'4219059500,  장성동,'15,10 - 14세,1998,559,275,284
'4219059500,  장성동,'20,15 - 19세,1998,837,427,410
'4219059500,  장성동,'25,20 - 24세,1998,668,366,302
'4219059500,  장성동,'30,25 - 29세,1998,427,229,198
'4219059500,  장성동,'35,30 - 34세,1998,450,213,237
'4219059500,  장성동,'40,35 - 39세,1998,669,332,337
'4219059500,  장성동,'45,40 - 44세,1998,594,322,272
'4219059500,  장성동,'50,45 - 49세,1998,499,245,254
'4219059500,  장성동,'55,50 - 54세,1998,449,248,201
'4219059500,  장성동,'60,55 - 59세,1998,424,216,208
'4219059500,  장성동,'65,60 - 64세,1998,321,156,165
'4219059500,  장성동,'70,65 - 69세,1998,209,90,119
'4219059500,  장성동,'75,70 - 74세,1998,131,44,87
'4219059500,  장성동,'80,75 - 79세,1998,98,34,64
'4219059500,  장성동,'85,80 - 84세,1998,54,16,38
'4219059500,  장성동,'90,85+ ,1998,29,8,21
'4219060500,  구문소동,'00,계,1998,5713,2909,2804
'4219060500,  구문소동,'05,0 - 4세,1998,304,152,152
'4219060500,  구문소동,'10,5 - 9세,1998,263,137,126
'4219060500,  구문소동,'15,10 - 14세,1998,360,198,162
'4219060500,  구문소동,'20,15 - 19세,1998,603,302,301
'4219060500,  구문소동,'25,20 - 24세,1998,579,301,278
'4219060500,  구문소동,'30,25 - 29세,1998,466,280,186
'4219060500,  구문소동,'35,30 - 34세,1998,337,168,169
'4219060500,  구문소동,'40,35 - 39세,1998,459,239,220
'4219060500,  구문소동,'45,40 - 44세,1998,424,219,205
'4219060500,  구문소동,'50,45 - 49세,1998,356,173,183
'4219060500,  구문소동,'55,50 - 54세,1998,372,178,194
'4219060500,  구문소동,'60,55 - 59세,1998,449,238,211
'4219060500,  구문소동,'65,60 - 64세,1998,327,165,162
'4219060500,  구문소동,'70,65 - 69세,1998,159,72,87
'4219060500,  구문소동,'75,70 - 74세,1998,126,45,81
'4219060500,  구문소동,'80,75 - 79세,1998,75,25,50
'4219060500,  구문소동,'85,80 - 84세,1998,34,9,25
'4219060500,  구문소동,'90,85+ ,1998,20,8,12
'4219061500,  철암동,'00,계,1998,5230,2683,2547
'4219061500,  철암동,'05,0 - 4세,1998,198,115,83
'4219061500,  철암동,'10,5 - 9세,1998,248,134,114
'4219061500,  철암동,'15,10 - 14세,1998,325,180,145
'4219061500,  철암동,'20,15 - 19세,1998,668,335,333
'4219061500,  철암동,'25,20 - 24세,1998,530,285,245
'4219061500,  철암동,'30,25 - 29세,1998,354,190,164
'4219061500,  철암동,'35,30 - 34세,1998,301,162,139
'4219061500,  철암동,'40,35 - 39세,1998,396,201,195
'4219061500,  철암동,'45,40 - 44세,1998,444,238,206
'4219061500,  철암동,'50,45 - 49세,1998,344,164,180
'4219061500,  철암동,'55,50 - 54세,1998,352,186,166
'4219061500,  철암동,'60,55 - 59세,1998,356,183,173
'4219061500,  철암동,'65,60 - 64세,1998,285,135,150
'4219061500,  철암동,'70,65 - 69세,1998,190,87,103
'4219061500,  철암동,'75,70 - 74세,1998,109,51,58
'4219061500,  철암동,'80,75 - 79세,1998,78,23,55
'4219061500,  철암동,'85,80 - 84세,1998,38,13,25
'4219061500,  철암동,'90,85+ ,1998,14,1,13
'42210, 속초시,'00,계,1998,86923,43167,43756
'42210, 속초시,'05,0 - 4세,1998,6466,3412,3054
'42210, 속초시,'10,5 - 9세,1998,6657,3521,3136
'42210, 속초시,'15,10 - 14세,1998,6108,3190,2918
'42210, 속초시,'20,15 - 19세,1998,7273,3680,3593
'42210, 속초시,'25,20 - 24세,1998,6425,3312,3113
'42210, 속초시,'30,25 - 29세,1998,7629,3814,3815
'42210, 속초시,'35,30 - 34세,1998,8191,4098,4093
'42210, 속초시,'40,35 - 39세,1998,9184,4566,4618
'42210, 속초시,'45,40 - 44세,1998,7524,3999,3525
'42210, 속초시,'50,45 - 49세,1998,4386,2233,2153
'42210, 속초시,'55,50 - 54세,1998,3976,1916,2060
'42210, 속초시,'60,55 - 59세,1998,3972,1864,2108
'42210, 속초시,'65,60 - 64세,1998,3158,1380,1778
'42210, 속초시,'70,65 - 69세,1998,2085,727,1358
'42210, 속초시,'75,70 - 74세,1998,1757,574,1183
'42210, 속초시,'80,75 - 79세,1998,1241,557,684
'42210, 속초시,'85,80 - 84세,1998,572,210,362
'42210, 속초시,'90,85+ ,1998,319,114,205
'4221051000,  영랑동,'00,계,1998,7639,3861,3778
'4221051000,  영랑동,'05,0 - 4세,1998,449,231,218
'4221051000,  영랑동,'10,5 - 9세,1998,585,318,267
'4221051000,  영랑동,'15,10 - 14세,1998,538,277,261
'4221051000,  영랑동,'20,15 - 19세,1998,697,368,329
'4221051000,  영랑동,'25,20 - 24세,1998,665,383,282
'4221051000,  영랑동,'30,25 - 29세,1998,617,340,277
'4221051000,  영랑동,'35,30 - 34세,1998,576,281,295
'4221051000,  영랑동,'40,35 - 39세,1998,774,375,399
'4221051000,  영랑동,'45,40 - 44세,1998,680,368,312
'4221051000,  영랑동,'50,45 - 49세,1998,446,226,220
'4221051000,  영랑동,'55,50 - 54세,1998,372,194,178
'4221051000,  영랑동,'60,55 - 59세,1998,350,167,183
'4221051000,  영랑동,'65,60 - 64세,1998,312,134,178
'4221051000,  영랑동,'70,65 - 69세,1998,186,71,115
'4221051000,  영랑동,'75,70 - 74세,1998,166,51,115
'4221051000,  영랑동,'80,75 - 79세,1998,130,46,84
'4221051000,  영랑동,'85,80 - 84세,1998,68,24,44
'4221051000,  영랑동,'90,85+ ,1998,28,7,21
'4221052000,  동명동,'00,계,1998,5899,2928,2971
'4221052000,  동명동,'05,0 - 4세,1998,360,196,164
'4221052000,  동명동,'10,5 - 9세,1998,400,202,198
'4221052000,  동명동,'15,10 - 14세,1998,343,167,176
'4221052000,  동명동,'20,15 - 19세,1998,476,250,226
'4221052000,  동명동,'25,20 - 24세,1998,530,260,270
'4221052000,  동명동,'30,25 - 29세,1998,507,290,217
'4221052000,  동명동,'35,30 - 34세,1998,468,243,225
'4221052000,  동명동,'40,35 - 39세,1998,527,268,259
'4221052000,  동명동,'45,40 - 44세,1998,493,253,240
'4221052000,  동명동,'50,45 - 49세,1998,360,165,195
'4221052000,  동명동,'55,50 - 54세,1998,333,152,181
'4221052000,  동명동,'60,55 - 59세,1998,335,161,174
'4221052000,  동명동,'65,60 - 64세,1998,274,118,156
'4221052000,  동명동,'70,65 - 69세,1998,173,71,102
'4221052000,  동명동,'75,70 - 74세,1998,158,61,97
'4221052000,  동명동,'80,75 - 79세,1998,93,49,44
'4221052000,  동명동,'85,80 - 84세,1998,45,14,31
'4221052000,  동명동,'90,85+ ,1998,24,8,16
'4221054000,  금호동,'00,계,1998,10171,5011,5160
'4221054000,  금호동,'05,0 - 4세,1998,547,289,258
'4221054000,  금호동,'10,5 - 9세,1998,591,308,283
'4221054000,  금호동,'15,10 - 14세,1998,682,361,321
'4221054000,  금호동,'20,15 - 19세,1998,975,495,480
'4221054000,  금호동,'25,20 - 24세,1998,793,421,372
'4221054000,  금호동,'30,25 - 29세,1998,762,415,347
'4221054000,  금호동,'35,30 - 34세,1998,731,370,361
'4221054000,  금호동,'40,35 - 39세,1998,969,496,473
'4221054000,  금호동,'45,40 - 44세,1998,945,474,471
'4221054000,  금호동,'50,45 - 49세,1998,567,288,279
'4221054000,  금호동,'55,50 - 54세,1998,567,258,309
'4221054000,  금호동,'60,55 - 59세,1998,624,294,330
'4221054000,  금호동,'65,60 - 64세,1998,491,215,276
'4221054000,  금호동,'70,65 - 69세,1998,318,95,223
'4221054000,  금호동,'75,70 - 74세,1998,282,85,197
'4221054000,  금호동,'80,75 - 79세,1998,196,98,98
'4221054000,  금호동,'85,80 - 84세,1998,76,28,48
'4221054000,  금호동,'90,85+ ,1998,55,21,34
'4221056000,  교동,'00,계,1998,15655,7774,7881
'4221056000,  교동,'05,0 - 4세,1998,1111,560,551
'4221056000,  교동,'10,5 - 9세,1998,1292,673,619
'4221056000,  교동,'15,10 - 14세,1998,1273,688,585
'4221056000,  교동,'20,15 - 19세,1998,1313,660,653
'4221056000,  교동,'25,20 - 24세,1998,1089,532,557
'4221056000,  교동,'30,25 - 29세,1998,1295,665,630
'4221056000,  교동,'35,30 - 34세,1998,1489,728,761
'4221056000,  교동,'40,35 - 39세,1998,1785,838,947
'4221056000,  교동,'45,40 - 44세,1998,1445,798,647
'4221056000,  교동,'50,45 - 49세,1998,788,418,370
'4221056000,  교동,'55,50 - 54세,1998,649,307,342
'4221056000,  교동,'60,55 - 59세,1998,654,306,348
'4221056000,  교동,'65,60 - 64세,1998,520,233,287
'4221056000,  교동,'70,65 - 69세,1998,335,118,217
'4221056000,  교동,'75,70 - 74세,1998,293,101,192
'4221056000,  교동,'80,75 - 79세,1998,206,101,105
'4221056000,  교동,'85,80 - 84세,1998,75,28,47
'4221056000,  교동,'90,85+ ,1998,43,20,23
'4221057000,  노학동,'00,계,1998,20502,10117,10385
'4221057000,  노학동,'05,0 - 4세,1998,1590,848,742
'4221057000,  노학동,'10,5 - 9세,1998,1726,930,796
'4221057000,  노학동,'15,10 - 14세,1998,1598,825,773
'4221057000,  노학동,'20,15 - 19세,1998,1775,879,896
'4221057000,  노학동,'25,20 - 24세,1998,1441,746,695
'4221057000,  노학동,'30,25 - 29세,1998,1788,857,931
'4221057000,  노학동,'35,30 - 34세,1998,1975,933,1042
'4221057000,  노학동,'40,35 - 39세,1998,2329,1088,1241
'4221057000,  노학동,'45,40 - 44세,1998,1874,992,882
'4221057000,  노학동,'50,45 - 49세,1998,1015,522,493
'4221057000,  노학동,'55,50 - 54세,1998,852,443,409
'4221057000,  노학동,'60,55 - 59세,1998,790,380,410
'4221057000,  노학동,'65,60 - 64세,1998,574,249,325
'4221057000,  노학동,'70,65 - 69세,1998,393,125,268
'4221057000,  노학동,'75,70 - 74세,1998,346,119,227
'4221057000,  노학동,'80,75 - 79세,1998,237,112,125
'4221057000,  노학동,'85,80 - 84세,1998,126,46,80
'4221057000,  노학동,'90,85+ ,1998,73,23,50
'4221058000,  조양동,'00,계,1998,15596,7745,7851
'4221058000,  조양동,'05,0 - 4세,1998,1839,979,860
'4221058000,  조양동,'10,5 - 9세,1998,1404,742,662
'4221058000,  조양동,'15,10 - 14세,1998,981,520,461
'4221058000,  조양동,'20,15 - 19세,1998,973,491,482
'4221058000,  조양동,'25,20 - 24세,1998,944,449,495
'4221058000,  조양동,'30,25 - 29세,1998,1753,753,1000
'4221058000,  조양동,'35,30 - 34세,1998,2127,1094,1033
'4221058000,  조양동,'40,35 - 39세,1998,1787,964,823
'4221058000,  조양동,'45,40 - 44세,1998,1113,593,520
'4221058000,  조양동,'50,45 - 49세,1998,553,278,275
'4221058000,  조양동,'55,50 - 54세,1998,522,244,278
'4221058000,  조양동,'60,55 - 59세,1998,507,222,285
'4221058000,  조양동,'65,60 - 64세,1998,411,176,235
'4221058000,  조양동,'70,65 - 69세,1998,264,97,167
'4221058000,  조양동,'75,70 - 74세,1998,176,54,122
'4221058000,  조양동,'80,75 - 79세,1998,134,49,85
'4221058000,  조양동,'85,80 - 84세,1998,72,25,47
'4221058000,  조양동,'90,85+ ,1998,36,15,21
'4221059000,  청호동,'00,계,1998,6075,3055,3020
'4221059000,  청호동,'05,0 - 4세,1998,299,163,136
'4221059000,  청호동,'10,5 - 9세,1998,356,191,165
'4221059000,  청호동,'15,10 - 14세,1998,340,176,164
'4221059000,  청호동,'20,15 - 19세,1998,558,299,259
'4221059000,  청호동,'25,20 - 24세,1998,472,255,217
'4221059000,  청호동,'30,25 - 29세,1998,526,280,246
'4221059000,  청호동,'35,30 - 34세,1998,457,255,202
'4221059000,  청호동,'40,35 - 39세,1998,540,293,247
'4221059000,  청호동,'45,40 - 44세,1998,508,282,226
'4221059000,  청호동,'50,45 - 49세,1998,312,165,147
'4221059000,  청호동,'55,50 - 54세,1998,317,144,173
'4221059000,  청호동,'60,55 - 59세,1998,402,178,224
'4221059000,  청호동,'65,60 - 64세,1998,313,118,195
'4221059000,  청호동,'70,65 - 69세,1998,248,87,161
'4221059000,  청호동,'75,70 - 74세,1998,199,58,141
'4221059000,  청호동,'80,75 - 79세,1998,131,64,67
'4221059000,  청호동,'85,80 - 84세,1998,63,34,29
'4221059000,  청호동,'90,85+ ,1998,34,13,21
'4221060000,  대포동,'00,계,1998,5386,2676,2710
'4221060000,  대포동,'05,0 - 4세,1998,271,146,125
'4221060000,  대포동,'10,5 - 9세,1998,303,157,146
'4221060000,  대포동,'15,10 - 14세,1998,353,176,177
'4221060000,  대포동,'20,15 - 19세,1998,506,238,268
'4221060000,  대포동,'25,20 - 24세,1998,491,266,225
'4221060000,  대포동,'30,25 - 29세,1998,381,214,167
'4221060000,  대포동,'35,30 - 34세,1998,368,194,174
'4221060000,  대포동,'40,35 - 39세,1998,473,244,229
'4221060000,  대포동,'45,40 - 44세,1998,466,239,227
'4221060000,  대포동,'50,45 - 49세,1998,345,171,174
'4221060000,  대포동,'55,50 - 54세,1998,364,174,190
'4221060000,  대포동,'60,55 - 59세,1998,310,156,154
'4221060000,  대포동,'65,60 - 64세,1998,263,137,126
'4221060000,  대포동,'70,65 - 69세,1998,168,63,105
'4221060000,  대포동,'75,70 - 74세,1998,137,45,92
'4221060000,  대포동,'80,75 - 79세,1998,114,38,76
'4221060000,  대포동,'85,80 - 84세,1998,47,11,36
'4221060000,  대포동,'90,85+ ,1998,26,7,19
'42230, 삼척시,'00,계,1998,85846,43465,42381
'42230, 삼척시,'05,0 - 4세,1998,4598,2369,2229
'42230, 삼척시,'10,5 - 9세,1998,4664,2432,2232
'42230, 삼척시,'15,10 - 14세,1998,5621,2841,2780
'42230, 삼척시,'20,15 - 19세,1998,8703,4387,4316
'42230, 삼척시,'25,20 - 24세,1998,8797,5018,3779
'42230, 삼척시,'30,25 - 29세,1998,6960,4145,2815
'42230, 삼척시,'35,30 - 34세,1998,5836,3196,2640
'42230, 삼척시,'40,35 - 39세,1998,6859,3522,3337
'42230, 삼척시,'45,40 - 44세,1998,6204,3192,3012
'42230, 삼척시,'50,45 - 49세,1998,4775,2455,2320
'42230, 삼척시,'55,50 - 54세,1998,4674,2374,2300
'42230, 삼척시,'60,55 - 59세,1998,5169,2365,2804
'42230, 삼척시,'65,60 - 64세,1998,4628,2162,2466
'42230, 삼척시,'70,65 - 69세,1998,3209,1268,1941
'42230, 삼척시,'75,70 - 74세,1998,2353,839,1514
'42230, 삼척시,'80,75 - 79세,1998,1476,535,941
'42230, 삼척시,'85,80 - 84세,1998,886,266,620
'42230, 삼척시,'90,85+ ,1998,434,99,335
'4223025000,  도계읍,'00,계,1998,18306,9441,8865
'4223025000,  도계읍,'05,0 - 4세,1998,748,398,350
'4223025000,  도계읍,'10,5 - 9세,1998,964,494,470
'4223025000,  도계읍,'15,10 - 14세,1998,1402,727,675
'4223025000,  도계읍,'20,15 - 19세,1998,2280,1109,1171
'4223025000,  도계읍,'25,20 - 24세,1998,2004,1172,832
'4223025000,  도계읍,'30,25 - 29세,1998,1266,768,498
'4223025000,  도계읍,'35,30 - 34세,1998,1102,574,528
'4223025000,  도계읍,'40,35 - 39세,1998,1474,748,726
'4223025000,  도계읍,'45,40 - 44세,1998,1498,810,688
'4223025000,  도계읍,'50,45 - 49세,1998,1152,582,570
'4223025000,  도계읍,'55,50 - 54세,1998,1113,606,507
'4223025000,  도계읍,'60,55 - 59세,1998,1147,547,600
'4223025000,  도계읍,'65,60 - 64세,1998,890,416,474
'4223025000,  도계읍,'70,65 - 69세,1998,564,241,323
'4223025000,  도계읍,'75,70 - 74세,1998,348,129,219
'4223025000,  도계읍,'80,75 - 79세,1998,192,69,123
'4223025000,  도계읍,'85,80 - 84세,1998,98,37,61
'4223025000,  도계읍,'90,85+ ,1998,64,14,50
'4223025300,  원덕읍,'00,계,1998,7893,3907,3986
'4223025300,  원덕읍,'05,0 - 4세,1998,301,156,145
'4223025300,  원덕읍,'10,5 - 9세,1998,351,185,166
'4223025300,  원덕읍,'15,10 - 14세,1998,439,217,222
'4223025300,  원덕읍,'20,15 - 19세,1998,737,371,366
'4223025300,  원덕읍,'25,20 - 24세,1998,781,494,287
'4223025300,  원덕읍,'30,25 - 29세,1998,495,320,175
'4223025300,  원덕읍,'35,30 - 34세,1998,401,220,181
'4223025300,  원덕읍,'40,35 - 39세,1998,533,276,257
'4223025300,  원덕읍,'45,40 - 44세,1998,469,235,234
'4223025300,  원덕읍,'50,45 - 49세,1998,448,231,217
'4223025300,  원덕읍,'55,50 - 54세,1998,501,212,289
'4223025300,  원덕읍,'60,55 - 59세,1998,656,305,351
'4223025300,  원덕읍,'65,60 - 64세,1998,594,264,330
'4223025300,  원덕읍,'70,65 - 69세,1998,431,163,268
'4223025300,  원덕읍,'75,70 - 74세,1998,339,124,215
'4223025300,  원덕읍,'80,75 - 79세,1998,222,83,139
'4223025300,  원덕읍,'85,80 - 84세,1998,132,35,97
'4223025300,  원덕읍,'90,85+ ,1998,63,16,47
'4223031000,  근덕면,'00,계,1998,8049,4022,4027
'4223031000,  근덕면,'05,0 - 4세,1998,283,148,135
'4223031000,  근덕면,'10,5 - 9세,1998,344,189,155
'4223031000,  근덕면,'15,10 - 14세,1998,398,197,201
'4223031000,  근덕면,'20,15 - 19세,1998,722,371,351
'4223031000,  근덕면,'25,20 - 24세,1998,816,468,348
'4223031000,  근덕면,'30,25 - 29세,1998,606,393,213
'4223031000,  근덕면,'35,30 - 34세,1998,396,247,149
'4223031000,  근덕면,'40,35 - 39세,1998,478,263,215
'4223031000,  근덕면,'45,40 - 44세,1998,485,257,228
'4223031000,  근덕면,'50,45 - 49세,1998,374,194,180
'4223031000,  근덕면,'55,50 - 54세,1998,456,216,240
'4223031000,  근덕면,'60,55 - 59세,1998,652,292,360
'4223031000,  근덕면,'65,60 - 64세,1998,683,332,351
'4223031000,  근덕면,'70,65 - 69세,1998,513,201,312
'4223031000,  근덕면,'75,70 - 74세,1998,379,122,257
'4223031000,  근덕면,'80,75 - 79세,1998,226,87,139
'4223031000,  근덕면,'85,80 - 84세,1998,149,34,115
'4223031000,  근덕면,'90,85+ ,1998,89,11,78
'4223032000,  하장면,'00,계,1998,2290,1179,1111
'4223032000,  하장면,'05,0 - 4세,1998,100,39,61
'4223032000,  하장면,'10,5 - 9세,1998,80,38,42
'4223032000,  하장면,'15,10 - 14세,1998,171,77,94
'4223032000,  하장면,'20,15 - 19세,1998,265,126,139
'4223032000,  하장면,'25,20 - 24세,1998,285,168,117
'4223032000,  하장면,'30,25 - 29세,1998,139,94,45
'4223032000,  하장면,'35,30 - 34세,1998,116,64,52
'4223032000,  하장면,'40,35 - 39세,1998,164,93,71
'4223032000,  하장면,'45,40 - 44세,1998,131,70,61
'4223032000,  하장면,'50,45 - 49세,1998,114,64,50
'4223032000,  하장면,'55,50 - 54세,1998,115,61,54
'4223032000,  하장면,'60,55 - 59세,1998,157,70,87
'4223032000,  하장면,'65,60 - 64세,1998,183,88,95
'4223032000,  하장면,'70,65 - 69세,1998,122,58,64
'4223032000,  하장면,'75,70 - 74세,1998,66,30,36
'4223032000,  하장면,'80,75 - 79세,1998,39,16,23
'4223032000,  하장면,'85,80 - 84세,1998,33,19,14
'4223032000,  하장면,'90,85+ ,1998,10,4,6
'4223033000,  노곡면,'00,계,1998,1214,660,554
'4223033000,  노곡면,'05,0 - 4세,1998,33,17,16
'4223033000,  노곡면,'10,5 - 9세,1998,21,10,11
'4223033000,  노곡면,'15,10 - 14세,1998,34,18,16
'4223033000,  노곡면,'20,15 - 19세,1998,112,57,55
'4223033000,  노곡면,'25,20 - 24세,1998,162,112,50
'4223033000,  노곡면,'30,25 - 29세,1998,98,74,24
'4223033000,  노곡면,'35,30 - 34세,1998,57,47,10
'4223033000,  노곡면,'40,35 - 39세,1998,53,28,25
'4223033000,  노곡면,'45,40 - 44세,1998,63,39,24
'4223033000,  노곡면,'50,45 - 49세,1998,47,26,21
'4223033000,  노곡면,'55,50 - 54세,1998,73,35,38
'4223033000,  노곡면,'60,55 - 59세,1998,111,47,64
'4223033000,  노곡면,'65,60 - 64세,1998,115,54,61
'4223033000,  노곡면,'70,65 - 69세,1998,95,46,49
'4223033000,  노곡면,'75,70 - 74세,1998,64,22,42
'4223033000,  노곡면,'80,75 - 79세,1998,45,17,28
'4223033000,  노곡면,'85,80 - 84세,1998,19,7,12
'4223033000,  노곡면,'90,85+ ,1998,12,4,8
'4223034000,  미로면,'00,계,1998,3064,1594,1470
'4223034000,  미로면,'05,0 - 4세,1998,123,61,62
'4223034000,  미로면,'10,5 - 9세,1998,86,48,38
'4223034000,  미로면,'15,10 - 14세,1998,126,66,60
'4223034000,  미로면,'20,15 - 19세,1998,318,157,161
'4223034000,  미로면,'25,20 - 24세,1998,429,252,177
'4223034000,  미로면,'30,25 - 29세,1998,268,193,75
'4223034000,  미로면,'35,30 - 34세,1998,161,110,51
'4223034000,  미로면,'40,35 - 39세,1998,151,79,72
'4223034000,  미로면,'45,40 - 44세,1998,138,80,58
'4223034000,  미로면,'50,45 - 49세,1998,147,62,85
'4223034000,  미로면,'55,50 - 54세,1998,176,88,88
'4223034000,  미로면,'60,55 - 59세,1998,237,108,129
'4223034000,  미로면,'65,60 - 64세,1998,248,113,135
'4223034000,  미로면,'70,65 - 69세,1998,190,74,116
'4223034000,  미로면,'75,70 - 74세,1998,123,52,71
'4223034000,  미로면,'80,75 - 79세,1998,87,33,54
'4223034000,  미로면,'85,80 - 84세,1998,45,15,30
'4223034000,  미로면,'90,85+ ,1998,11,3,8
'4223035000,  가곡면,'00,계,1998,1159,575,584
'4223035000,  가곡면,'05,0 - 4세,1998,29,14,15
'4223035000,  가곡면,'10,5 - 9세,1998,38,20,18
'4223035000,  가곡면,'15,10 - 14세,1998,53,23,30
'4223035000,  가곡면,'20,15 - 19세,1998,142,70,72
'4223035000,  가곡면,'25,20 - 24세,1998,120,73,47
'4223035000,  가곡면,'30,25 - 29세,1998,71,52,19
'4223035000,  가곡면,'35,30 - 34세,1998,46,23,23
'4223035000,  가곡면,'40,35 - 39세,1998,73,43,30
'4223035000,  가곡면,'45,40 - 44세,1998,56,30,26
'4223035000,  가곡면,'50,45 - 49세,1998,87,46,41
'4223035000,  가곡면,'55,50 - 54세,1998,67,32,35
'4223035000,  가곡면,'60,55 - 59세,1998,86,34,52
'4223035000,  가곡면,'65,60 - 64세,1998,95,43,52
'4223035000,  가곡면,'70,65 - 69세,1998,76,28,48
'4223035000,  가곡면,'75,70 - 74세,1998,62,22,40
'4223035000,  가곡면,'80,75 - 79세,1998,31,12,19
'4223035000,  가곡면,'85,80 - 84세,1998,19,6,13
'4223035000,  가곡면,'90,85+ ,1998,8,4,4
'4223036000,  신기면,'00,계,1998,1211,662,549
'4223036000,  신기면,'05,0 - 4세,1998,45,26,19
'4223036000,  신기면,'10,5 - 9세,1998,37,19,18
'4223036000,  신기면,'15,10 - 14세,1998,50,22,28
'4223036000,  신기면,'20,15 - 19세,1998,125,53,72
'4223036000,  신기면,'25,20 - 24세,1998,146,105,41
'4223036000,  신기면,'30,25 - 29세,1998,113,85,28
'4223036000,  신기면,'35,30 - 34세,1998,67,46,21
'4223036000,  신기면,'40,35 - 39세,1998,70,41,29
'4223036000,  신기면,'45,40 - 44세,1998,52,31,21
'4223036000,  신기면,'50,45 - 49세,1998,56,30,26
'4223036000,  신기면,'55,50 - 54세,1998,85,43,42
'4223036000,  신기면,'60,55 - 59세,1998,99,49,50
'4223036000,  신기면,'65,60 - 64세,1998,104,40,64
'4223036000,  신기면,'70,65 - 69세,1998,60,25,35
'4223036000,  신기면,'75,70 - 74세,1998,42,22,20
'4223036000,  신기면,'80,75 - 79세,1998,34,16,18
'4223036000,  신기면,'85,80 - 84세,1998,19,7,12
'4223036000,  신기면,'90,85+ ,1998,7,2,5
'4223051000,  남양동,'00,계,1998,14401,7138,7263
'4223051000,  남양동,'05,0 - 4세,1998,777,379,398
'4223051000,  남양동,'10,5 - 9세,1998,891,486,405
'4223051000,  남양동,'15,10 - 14세,1998,1142,588,554
'4223051000,  남양동,'20,15 - 19세,1998,1514,779,735
'4223051000,  남양동,'25,20 - 24세,1998,1355,730,625
'4223051000,  남양동,'30,25 - 29세,1998,1085,598,487
'4223051000,  남양동,'35,30 - 34세,1998,991,510,481
'4223051000,  남양동,'40,35 - 39세,1998,1320,616,704
'4223051000,  남양동,'45,40 - 44세,1998,1261,595,666
'4223051000,  남양동,'50,45 - 49세,1998,932,490,442
'4223051000,  남양동,'55,50 - 54세,1998,772,385,387
'4223051000,  남양동,'60,55 - 59세,1998,696,336,360
'4223051000,  남양동,'65,60 - 64세,1998,595,300,295
'4223051000,  남양동,'70,65 - 69세,1998,378,121,257
'4223051000,  남양동,'75,70 - 74세,1998,304,117,187
'4223051000,  남양동,'80,75 - 79세,1998,209,69,140
'4223051000,  남양동,'85,80 - 84세,1998,117,26,91
'4223051000,  남양동,'90,85+ ,1998,62,13,49
'4223053000,  교동,'00,계,1998,6315,3175,3140
'4223053000,  교동,'05,0 - 4세,1998,622,316,306
'4223053000,  교동,'10,5 - 9세,1998,536,276,260
'4223053000,  교동,'15,10 - 14세,1998,373,169,204
'4223053000,  교동,'20,15 - 19세,1998,455,213,242
'4223053000,  교동,'25,20 - 24세,1998,542,311,231
'4223053000,  교동,'30,25 - 29세,1998,690,369,321
'4223053000,  교동,'35,30 - 34세,1998,660,339,321
'4223053000,  교동,'40,35 - 39세,1998,630,339,291
'4223053000,  교동,'45,40 - 44세,1998,395,218,177
'4223053000,  교동,'50,45 - 49세,1998,269,138,131
'4223053000,  교동,'55,50 - 54세,1998,250,133,117
'4223053000,  교동,'60,55 - 59세,1998,250,108,142
'4223053000,  교동,'65,60 - 64세,1998,214,100,114
'4223053000,  교동,'70,65 - 69세,1998,139,59,80
'4223053000,  교동,'75,70 - 74세,1998,135,41,94
'4223053000,  교동,'80,75 - 79세,1998,72,28,44
'4223053000,  교동,'85,80 - 84세,1998,50,13,37
'4223053000,  교동,'90,85+ ,1998,33,5,28
'4223054000,  정라동,'00,계,1998,11235,5753,5482
'4223054000,  정라동,'05,0 - 4세,1998,931,493,438
'4223054000,  정라동,'10,5 - 9세,1998,655,329,326
'4223054000,  정라동,'15,10 - 14세,1998,671,350,321
'4223054000,  정라동,'20,15 - 19세,1998,950,514,436
'4223054000,  정라동,'25,20 - 24세,1998,1074,553,521
'4223054000,  정라동,'30,25 - 29세,1998,1244,698,546
'4223054000,  정라동,'35,30 - 34세,1998,1045,593,452
'4223054000,  정라동,'40,35 - 39세,1998,1004,556,448
'4223054000,  정라동,'45,40 - 44세,1998,789,406,383
'4223054000,  정라동,'50,45 - 49세,1998,562,299,263
'4223054000,  정라동,'55,50 - 54세,1998,513,268,245
'4223054000,  정라동,'60,55 - 59세,1998,537,234,303
'4223054000,  정라동,'65,60 - 64세,1998,425,179,246
'4223054000,  정라동,'70,65 - 69세,1998,331,122,209
'4223054000,  정라동,'75,70 - 74세,1998,232,69,163
'4223054000,  정라동,'80,75 - 79세,1998,142,47,95
'4223054000,  정라동,'85,80 - 84세,1998,99,31,68
'4223054000,  정라동,'90,85+ ,1998,31,12,19
'4223057000,  성내동,'00,계,1998,10709,5359,5350
'4223057000,  성내동,'05,0 - 4세,1998,606,322,284
'4223057000,  성내동,'10,5 - 9세,1998,661,338,323
'4223057000,  성내동,'15,10 - 14세,1998,762,387,375
'4223057000,  성내동,'20,15 - 19세,1998,1083,567,516
'4223057000,  성내동,'25,20 - 24세,1998,1083,580,503
'4223057000,  성내동,'30,25 - 29세,1998,885,501,384
'4223057000,  성내동,'35,30 - 34세,1998,794,423,371
'4223057000,  성내동,'40,35 - 39세,1998,909,440,469
'4223057000,  성내동,'45,40 - 44세,1998,867,421,446
'4223057000,  성내동,'50,45 - 49세,1998,587,293,294
'4223057000,  성내동,'55,50 - 54세,1998,553,295,258
'4223057000,  성내동,'60,55 - 59세,1998,541,235,306
'4223057000,  성내동,'65,60 - 64세,1998,482,233,249
'4223057000,  성내동,'70,65 - 69세,1998,310,130,180
'4223057000,  성내동,'75,70 - 74세,1998,259,89,170
'4223057000,  성내동,'80,75 - 79세,1998,177,58,119
'4223057000,  성내동,'85,80 - 84세,1998,106,36,70
'4223057000,  성내동,'90,85+ ,1998,44,11,33
'42720, 홍천군,'00,계,1998,75251,38263,36988
'42720, 홍천군,'05,0 - 4세,1998,4693,2441,2252
'42720, 홍천군,'10,5 - 9세,1998,4856,2515,2341
'42720, 홍천군,'15,10 - 14세,1998,4940,2444,2496
'42720, 홍천군,'20,15 - 19세,1998,6455,3301,3154
'42720, 홍천군,'25,20 - 24세,1998,6414,3518,2896
'42720, 홍천군,'30,25 - 29세,1998,6047,3411,2636
'42720, 홍천군,'35,30 - 34세,1998,5789,3153,2636
'42720, 홍천군,'40,35 - 39세,1998,6446,3455,2991
'42720, 홍천군,'45,40 - 44세,1998,5642,3084,2558
'42720, 홍천군,'50,45 - 49세,1998,3305,1750,1555
'42720, 홍천군,'55,50 - 54세,1998,3409,1653,1756
'42720, 홍천군,'60,55 - 59세,1998,4541,2141,2400
'42720, 홍천군,'65,60 - 64세,1998,4633,2220,2413
'42720, 홍천군,'70,65 - 69세,1998,3011,1171,1840
'42720, 홍천군,'75,70 - 74세,1998,2081,822,1259
'42720, 홍천군,'80,75 - 79세,1998,1498,636,862
'42720, 홍천군,'85,80 - 84세,1998,951,372,579
'42720, 홍천군,'90,85+ ,1998,540,176,364
'4272025000,  홍천읍,'00,계,1998,32643,16443,16200
'4272025000,  홍천읍,'05,0 - 4세,1998,2433,1266,1167
'4272025000,  홍천읍,'10,5 - 9세,1998,2556,1340,1216
'4272025000,  홍천읍,'15,10 - 14세,1998,2410,1229,1181
'4272025000,  홍천읍,'20,15 - 19세,1998,2878,1513,1365
'4272025000,  홍천읍,'25,20 - 24세,1998,2663,1389,1274
'4272025000,  홍천읍,'30,25 - 29세,1998,2900,1487,1413
'4272025000,  홍천읍,'35,30 - 34세,1998,2950,1511,1439
'4272025000,  홍천읍,'40,35 - 39세,1998,3223,1633,1590
'4272025000,  홍천읍,'45,40 - 44세,1998,2682,1434,1248
'4272025000,  홍천읍,'50,45 - 49세,1998,1446,758,688
'4272025000,  홍천읍,'55,50 - 54세,1998,1339,633,706
'4272025000,  홍천읍,'60,55 - 59세,1998,1555,742,813
'4272025000,  홍천읍,'65,60 - 64세,1998,1316,621,695
'4272025000,  홍천읍,'70,65 - 69세,1998,870,350,520
'4272025000,  홍천읍,'75,70 - 74세,1998,616,238,378
'4272025000,  홍천읍,'80,75 - 79세,1998,403,160,243
'4272025000,  홍천읍,'85,80 - 84세,1998,256,87,169
'4272025000,  홍천읍,'90,85+ ,1998,147,52,95
'4272031000,  화촌면,'00,계,1998,5980,3087,2893
'4272031000,  화촌면,'05,0 - 4세,1998,310,156,154
'4272031000,  화촌면,'10,5 - 9세,1998,326,173,153
'4272031000,  화촌면,'15,10 - 14세,1998,303,138,165
'4272031000,  화촌면,'20,15 - 19세,1998,521,272,249
'4272031000,  화촌면,'25,20 - 24세,1998,567,324,243
'4272031000,  화촌면,'30,25 - 29세,1998,462,289,173
'4272031000,  화촌면,'35,30 - 34세,1998,361,217,144
'4272031000,  화촌면,'40,35 - 39세,1998,475,273,202
'4272031000,  화촌면,'45,40 - 44세,1998,428,231,197
'4272031000,  화촌면,'50,45 - 49세,1998,266,150,116
'4272031000,  화촌면,'55,50 - 54세,1998,297,144,153
'4272031000,  화촌면,'60,55 - 59세,1998,386,175,211
'4272031000,  화촌면,'65,60 - 64세,1998,465,221,244
'4272031000,  화촌면,'70,65 - 69세,1998,312,125,187
'4272031000,  화촌면,'75,70 - 74세,1998,203,70,133
'4272031000,  화촌면,'80,75 - 79세,1998,138,58,80
'4272031000,  화촌면,'85,80 - 84세,1998,106,55,51
'4272031000,  화촌면,'90,85+ ,1998,54,16,38
'4272032000,  두촌면,'00,계,1998,3196,1624,1572
'4272032000,  두촌면,'05,0 - 4세,1998,134,73,61
'4272032000,  두촌면,'10,5 - 9세,1998,151,81,70
'4272032000,  두촌면,'15,10 - 14세,1998,164,79,85
'4272032000,  두촌면,'20,15 - 19세,1998,237,126,111
'4272032000,  두촌면,'25,20 - 24세,1998,281,161,120
'4272032000,  두촌면,'30,25 - 29세,1998,223,143,80
'4272032000,  두촌면,'35,30 - 34세,1998,176,108,68
'4272032000,  두촌면,'40,35 - 39세,1998,234,123,111
'4272032000,  두촌면,'45,40 - 44세,1998,222,123,99
'4272032000,  두촌면,'50,45 - 49세,1998,133,63,70
'4272032000,  두촌면,'55,50 - 54세,1998,169,80,89
'4272032000,  두촌면,'60,55 - 59세,1998,258,124,134
'4272032000,  두촌면,'65,60 - 64세,1998,280,135,145
'4272032000,  두촌면,'70,65 - 69세,1998,194,78,116
'4272032000,  두촌면,'75,70 - 74세,1998,139,56,83
'4272032000,  두촌면,'80,75 - 79세,1998,105,39,66
'4272032000,  두촌면,'85,80 - 84세,1998,64,25,39
'4272032000,  두촌면,'90,85+ ,1998,32,7,25
'4272033000,  내촌면,'00,계,1998,2908,1460,1448
'4272033000,  내촌면,'05,0 - 4세,1998,116,70,46
'4272033000,  내촌면,'10,5 - 9세,1998,140,72,68
'4272033000,  내촌면,'15,10 - 14세,1998,176,87,89
'4272033000,  내촌면,'20,15 - 19세,1998,261,120,141
'4272033000,  내촌면,'25,20 - 24세,1998,232,134,98
'4272033000,  내촌면,'30,25 - 29세,1998,161,96,65
'4272033000,  내촌면,'35,30 - 34세,1998,157,90,67
'4272033000,  내촌면,'40,35 - 39세,1998,210,120,90
'4272033000,  내촌면,'45,40 - 44세,1998,192,103,89
'4272033000,  내촌면,'50,45 - 49세,1998,126,64,62
'4272033000,  내촌면,'55,50 - 54세,1998,143,73,70
'4272033000,  내촌면,'60,55 - 59세,1998,248,118,130
'4272033000,  내촌면,'65,60 - 64세,1998,276,139,137
'4272033000,  내촌면,'70,65 - 69세,1998,191,69,122
'4272033000,  내촌면,'75,70 - 74세,1998,116,48,68
'4272033000,  내촌면,'80,75 - 79세,1998,84,31,53
'4272033000,  내촌면,'85,80 - 84세,1998,53,17,36
'4272033000,  내촌면,'90,85+ ,1998,26,9,17
'4272034000,  서석면,'00,계,1998,4870,2425,2445
'4272034000,  서석면,'05,0 - 4세,1998,252,131,121
'4272034000,  서석면,'10,5 - 9세,1998,319,153,166
'4272034000,  서석면,'15,10 - 14세,1998,326,164,162
'4272034000,  서석면,'20,15 - 19세,1998,461,195,266
'4272034000,  서석면,'25,20 - 24세,1998,392,229,163
'4272034000,  서석면,'30,25 - 29세,1998,318,190,128
'4272034000,  서석면,'35,30 - 34세,1998,337,182,155
'4272034000,  서석면,'40,35 - 39세,1998,356,204,152
'4272034000,  서석면,'45,40 - 44세,1998,332,183,149
'4272034000,  서석면,'50,45 - 49세,1998,223,122,101
'4272034000,  서석면,'55,50 - 54세,1998,216,98,118
'4272034000,  서석면,'60,55 - 59세,1998,341,169,172
'4272034000,  서석면,'65,60 - 64세,1998,352,156,196
'4272034000,  서석면,'70,65 - 69세,1998,223,70,153
'4272034000,  서석면,'75,70 - 74세,1998,155,62,93
'4272034000,  서석면,'80,75 - 79세,1998,134,58,76
'4272034000,  서석면,'85,80 - 84세,1998,89,40,49
'4272034000,  서석면,'90,85+ ,1998,44,19,25
'4272035000,  동면,'00,계,1998,4649,2361,2288
'4272035000,  동면,'05,0 - 4세,1998,202,97,105
'4272035000,  동면,'10,5 - 9세,1998,183,82,101
'4272035000,  동면,'15,10 - 14세,1998,278,139,139
'4272035000,  동면,'20,15 - 19세,1998,421,213,208
'4272035000,  동면,'25,20 - 24세,1998,440,229,211
'4272035000,  동면,'30,25 - 29세,1998,334,217,117
'4272035000,  동면,'35,30 - 34세,1998,263,167,96
'4272035000,  동면,'40,35 - 39세,1998,309,180,129
'4272035000,  동면,'45,40 - 44세,1998,321,174,147
'4272035000,  동면,'50,45 - 49세,1998,205,102,103
'4272035000,  동면,'55,50 - 54세,1998,252,125,127
'4272035000,  동면,'60,55 - 59세,1998,337,165,172
'4272035000,  동면,'65,60 - 64세,1998,412,207,205
'4272035000,  동면,'70,65 - 69세,1998,260,95,165
'4272035000,  동면,'75,70 - 74세,1998,170,67,103
'4272035000,  동면,'80,75 - 79세,1998,137,58,79
'4272035000,  동면,'85,80 - 84세,1998,77,29,48
'4272035000,  동면,'90,85+ ,1998,48,15,33
'4272036000,  남면,'00,계,1998,7947,4118,3829
'4272036000,  남면,'05,0 - 4세,1998,645,344,301
'4272036000,  남면,'10,5 - 9세,1998,546,282,264
'4272036000,  남면,'15,10 - 14세,1998,438,217,221
'4272036000,  남면,'20,15 - 19세,1998,532,273,259
'4272036000,  남면,'25,20 - 24세,1998,730,415,315
'4272036000,  남면,'30,25 - 29세,1998,781,450,331
'4272036000,  남면,'35,30 - 34세,1998,703,402,301
'4272036000,  남면,'40,35 - 39세,1998,622,341,281
'4272036000,  남면,'45,40 - 44세,1998,518,294,224
'4272036000,  남면,'50,45 - 49세,1998,298,172,126
'4272036000,  남면,'55,50 - 54세,1998,295,146,149
'4272036000,  남면,'60,55 - 59세,1998,428,180,248
'4272036000,  남면,'65,60 - 64세,1998,538,259,279
'4272036000,  남면,'70,65 - 69세,1998,318,123,195
'4272036000,  남면,'75,70 - 74세,1998,233,99,134
'4272036000,  남면,'80,75 - 79세,1998,155,64,91
'4272036000,  남면,'85,80 - 84세,1998,105,36,69
'4272036000,  남면,'90,85+ ,1998,62,21,41
'4272037000,  서면,'00,계,1998,3808,1982,1826
'4272037000,  서면,'05,0 - 4세,1998,145,78,67
'4272037000,  서면,'10,5 - 9세,1998,157,85,72
'4272037000,  서면,'15,10 - 14세,1998,222,103,119
'4272037000,  서면,'20,15 - 19세,1998,297,160,137
'4272037000,  서면,'25,20 - 24세,1998,309,181,128
'4272037000,  서면,'30,25 - 29세,1998,219,134,85
'4272037000,  서면,'35,30 - 34세,1998,204,124,80
'4272037000,  서면,'40,35 - 39세,1998,258,152,106
'4272037000,  서면,'45,40 - 44세,1998,264,154,110
'4272037000,  서면,'50,45 - 49세,1998,191,98,93
'4272037000,  서면,'55,50 - 54세,1998,212,97,115
'4272037000,  서면,'60,55 - 59세,1998,339,166,173
'4272037000,  서면,'65,60 - 64세,1998,330,163,167
'4272037000,  서면,'70,65 - 69세,1998,259,104,155
'4272037000,  서면,'75,70 - 74세,1998,167,74,93
'4272037000,  서면,'80,75 - 79세,1998,122,63,59
'4272037000,  서면,'85,80 - 84세,1998,72,35,37
'4272037000,  서면,'90,85+ ,1998,41,11,30
'4272038000,  북방면,'00,계,1998,4903,2511,2392
'4272038000,  북방면,'05,0 - 4세,1998,261,135,126
'4272038000,  북방면,'10,5 - 9세,1998,243,126,117
'4272038000,  북방면,'15,10 - 14세,1998,303,145,158
'4272038000,  북방면,'20,15 - 19세,1998,367,179,188
'4272038000,  북방면,'25,20 - 24세,1998,413,233,180
'4272038000,  북방면,'30,25 - 29세,1998,400,253,147
'4272038000,  북방면,'35,30 - 34세,1998,327,192,135
'4272038000,  북방면,'40,35 - 39세,1998,376,214,162
'4272038000,  북방면,'45,40 - 44세,1998,336,182,154
'4272038000,  북방면,'50,45 - 49세,1998,196,104,92
'4272038000,  북방면,'55,50 - 54세,1998,267,144,123
'4272038000,  북방면,'60,55 - 59세,1998,367,160,207
'4272038000,  북방면,'65,60 - 64세,1998,397,190,207
'4272038000,  북방면,'70,65 - 69세,1998,241,100,141
'4272038000,  북방면,'75,70 - 74세,1998,150,55,95
'4272038000,  북방면,'80,75 - 79세,1998,124,55,69
'4272038000,  북방면,'85,80 - 84세,1998,79,26,53
'4272038000,  북방면,'90,85+ ,1998,56,18,38
'4272039000,  내면,'00,계,1998,4347,2252,2095
'4272039000,  내면,'05,0 - 4세,1998,195,91,104
'4272039000,  내면,'10,5 - 9세,1998,235,121,114
'4272039000,  내면,'15,10 - 14세,1998,320,143,177
'4272039000,  내면,'20,15 - 19세,1998,480,250,230
'4272039000,  내면,'25,20 - 24세,1998,387,223,164
'4272039000,  내면,'30,25 - 29세,1998,249,152,97
'4272039000,  내면,'35,30 - 34세,1998,311,160,151
'4272039000,  내면,'40,35 - 39세,1998,383,215,168
'4272039000,  내면,'45,40 - 44세,1998,347,206,141
'4272039000,  내면,'50,45 - 49세,1998,221,117,104
'4272039000,  내면,'55,50 - 54세,1998,219,113,106
'4272039000,  내면,'60,55 - 59세,1998,282,142,140
'4272039000,  내면,'65,60 - 64세,1998,267,129,138
'4272039000,  내면,'70,65 - 69세,1998,143,57,86
'4272039000,  내면,'75,70 - 74세,1998,132,53,79
'4272039000,  내면,'80,75 - 79세,1998,96,50,46
'4272039000,  내면,'85,80 - 84세,1998,50,22,28
'4272039000,  내면,'90,85+ ,1998,30,8,22
'42730, 횡성군,'00,계,1998,47362,24213,23149
'42730, 횡성군,'05,0 - 4세,1998,2654,1422,1232
'42730, 횡성군,'10,5 - 9세,1998,2647,1423,1224
'42730, 횡성군,'15,10 - 14세,1998,2867,1536,1331
'42730, 횡성군,'20,15 - 19세,1998,4112,2042,2070
'42730, 횡성군,'25,20 - 24세,1998,4127,2289,1838
'42730, 횡성군,'30,25 - 29세,1998,3620,2109,1511
'42730, 횡성군,'35,30 - 34세,1998,3259,1786,1473
'42730, 횡성군,'40,35 - 39세,1998,3872,2105,1767
'42730, 횡성군,'45,40 - 44세,1998,3385,1846,1539
'42730, 횡성군,'50,45 - 49세,1998,2162,1139,1023
'42730, 횡성군,'55,50 - 54세,1998,2311,1118,1193
'42730, 횡성군,'60,55 - 59세,1998,3161,1531,1630
'42730, 횡성군,'65,60 - 64세,1998,3225,1546,1679
'42730, 횡성군,'70,65 - 69세,1998,2136,810,1326
'42730, 횡성군,'75,70 - 74세,1998,1594,636,958
'42730, 횡성군,'80,75 - 79세,1998,1126,481,645
'42730, 횡성군,'85,80 - 84세,1998,690,256,434
'42730, 횡성군,'90,85+ ,1998,414,138,276
'4273025000,  횡성읍,'00,계,1998,19648,9925,9723
'4273025000,  횡성읍,'05,0 - 4세,1998,1381,708,673
'4273025000,  횡성읍,'10,5 - 9세,1998,1386,743,643
'4273025000,  횡성읍,'15,10 - 14세,1998,1337,712,625
'4273025000,  횡성읍,'20,15 - 19세,1998,1701,856,845
'4273025000,  횡성읍,'25,20 - 24세,1998,1662,879,783
'4273025000,  횡성읍,'30,25 - 29세,1998,1708,921,787
'4273025000,  횡성읍,'35,30 - 34세,1998,1627,852,775
'4273025000,  횡성읍,'40,35 - 39세,1998,1810,945,865
'4273025000,  횡성읍,'45,40 - 44세,1998,1491,788,703
'4273025000,  횡성읍,'50,45 - 49세,1998,878,462,416
'4273025000,  횡성읍,'55,50 - 54세,1998,823,394,429
'4273025000,  횡성읍,'60,55 - 59세,1998,1073,523,550
'4273025000,  횡성읍,'65,60 - 64세,1998,903,441,462
'4273025000,  횡성읍,'70,65 - 69세,1998,668,240,428
'4273025000,  횡성읍,'75,70 - 74세,1998,508,207,301
'4273025000,  횡성읍,'80,75 - 79세,1998,364,148,216
'4273025000,  횡성읍,'85,80 - 84세,1998,207,65,142
'4273025000,  횡성읍,'90,85+ ,1998,121,41,80
'4273031000,  우천면,'00,계,1998,5419,2782,2637
'4273031000,  우천면,'05,0 - 4세,1998,309,186,123
'4273031000,  우천면,'10,5 - 9세,1998,255,140,115
'4273031000,  우천면,'15,10 - 14세,1998,276,144,132
'4273031000,  우천면,'20,15 - 19세,1998,480,231,249
'4273031000,  우천면,'25,20 - 24세,1998,474,268,206
'4273031000,  우천면,'30,25 - 29세,1998,432,241,191
'4273031000,  우천면,'35,30 - 34세,1998,354,217,137
'4273031000,  우천면,'40,35 - 39세,1998,406,227,179
'4273031000,  우천면,'45,40 - 44세,1998,361,192,169
'4273031000,  우천면,'50,45 - 49세,1998,250,134,116
'4273031000,  우천면,'55,50 - 54세,1998,271,137,134
'4273031000,  우천면,'60,55 - 59세,1998,349,167,182
'4273031000,  우천면,'65,60 - 64세,1998,413,190,223
'4273031000,  우천면,'70,65 - 69세,1998,283,103,180
'4273031000,  우천면,'75,70 - 74세,1998,220,86,134
'4273031000,  우천면,'80,75 - 79세,1998,130,57,73
'4273031000,  우천면,'85,80 - 84세,1998,86,39,47
'4273031000,  우천면,'90,85+ ,1998,70,23,47
'4273032000,  안흥면,'00,계,1998,2935,1528,1407
'4273032000,  안흥면,'05,0 - 4세,1998,117,63,54
'4273032000,  안흥면,'10,5 - 9세,1998,105,58,47
'4273032000,  안흥면,'15,10 - 14세,1998,188,93,95
'4273032000,  안흥면,'20,15 - 19세,1998,271,119,152
'4273032000,  안흥면,'25,20 - 24세,1998,259,166,93
'4273032000,  안흥면,'30,25 - 29세,1998,190,125,65
'4273032000,  안흥면,'35,30 - 34세,1998,166,100,66
'4273032000,  안흥면,'40,35 - 39세,1998,236,126,110
'4273032000,  안흥면,'45,40 - 44세,1998,205,126,79
'4273032000,  안흥면,'50,45 - 49세,1998,140,71,69
'4273032000,  안흥면,'55,50 - 54세,1998,168,82,86
'4273032000,  안흥면,'60,55 - 59세,1998,226,115,111
'4273032000,  안흥면,'65,60 - 64세,1998,252,122,130
'4273032000,  안흥면,'70,65 - 69세,1998,147,55,92
'4273032000,  안흥면,'75,70 - 74세,1998,120,56,64
'4273032000,  안흥면,'80,75 - 79세,1998,60,26,34
'4273032000,  안흥면,'85,80 - 84세,1998,62,19,43
'4273032000,  안흥면,'90,85+ ,1998,23,6,17
'4273033000,  둔내면,'00,계,1998,5616,2909,2707
'4273033000,  둔내면,'05,0 - 4세,1998,268,142,126
'4273033000,  둔내면,'10,5 - 9세,1998,331,181,150
'4273033000,  둔내면,'15,10 - 14세,1998,353,186,167
'4273033000,  둔내면,'20,15 - 19세,1998,501,252,249
'4273033000,  둔내면,'25,20 - 24세,1998,483,259,224
'4273033000,  둔내면,'30,25 - 29세,1998,427,267,160
'4273033000,  둔내면,'35,30 - 34세,1998,392,214,178
'4273033000,  둔내면,'40,35 - 39세,1998,447,240,207
'4273033000,  둔내면,'45,40 - 44세,1998,399,226,173
'4273033000,  둔내면,'50,45 - 49세,1998,277,143,134
'4273033000,  둔내면,'55,50 - 54세,1998,317,154,163
'4273033000,  둔내면,'60,55 - 59세,1998,407,203,204
'4273033000,  둔내면,'65,60 - 64세,1998,381,186,195
'4273033000,  둔내면,'70,65 - 69세,1998,239,82,157
'4273033000,  둔내면,'75,70 - 74세,1998,159,70,89
'4273033000,  둔내면,'80,75 - 79세,1998,117,47,70
'4273033000,  둔내면,'85,80 - 84세,1998,72,33,39
'4273033000,  둔내면,'90,85+ ,1998,46,24,22
'4273034000,  갑천면,'00,계,1998,2361,1211,1150
'4273034000,  갑천면,'05,0 - 4세,1998,103,52,51
'4273034000,  갑천면,'10,5 - 9세,1998,74,33,41
'4273034000,  갑천면,'15,10 - 14세,1998,104,59,45
'4273034000,  갑천면,'20,15 - 19세,1998,193,96,97
'4273034000,  갑천면,'25,20 - 24세,1998,225,129,96
'4273034000,  갑천면,'30,25 - 29세,1998,159,102,57
'4273034000,  갑천면,'35,30 - 34세,1998,104,61,43
'4273034000,  갑천면,'40,35 - 39세,1998,161,102,59
'4273034000,  갑천면,'45,40 - 44세,1998,160,87,73
'4273034000,  갑천면,'50,45 - 49세,1998,92,46,46
'4273034000,  갑천면,'55,50 - 54세,1998,137,65,72
'4273034000,  갑천면,'60,55 - 59세,1998,204,97,107
'4273034000,  갑천면,'65,60 - 64세,1998,233,109,124
'4273034000,  갑천면,'70,65 - 69세,1998,141,62,79
'4273034000,  갑천면,'75,70 - 74세,1998,107,38,69
'4273034000,  갑천면,'80,75 - 79세,1998,81,41,40
'4273034000,  갑천면,'85,80 - 84세,1998,47,21,26
'4273034000,  갑천면,'90,85+ ,1998,36,11,25
'4273035000,  청일면,'00,계,1998,2892,1479,1413
'4273035000,  청일면,'05,0 - 4세,1998,143,75,68
'4273035000,  청일면,'10,5 - 9세,1998,137,72,65
'4273035000,  청일면,'15,10 - 14세,1998,150,83,67
'4273035000,  청일면,'20,15 - 19세,1998,210,105,105
'4273035000,  청일면,'25,20 - 24세,1998,261,161,100
'4273035000,  청일면,'30,25 - 29세,1998,179,117,62
'4273035000,  청일면,'35,30 - 34세,1998,179,98,81
'4273035000,  청일면,'40,35 - 39세,1998,206,117,89
'4273035000,  청일면,'45,40 - 44세,1998,169,93,76
'4273035000,  청일면,'50,45 - 49세,1998,115,68,47
'4273035000,  청일면,'55,50 - 54세,1998,159,79,80
'4273035000,  청일면,'60,55 - 59세,1998,235,109,126
'4273035000,  청일면,'65,60 - 64세,1998,260,114,146
'4273035000,  청일면,'70,65 - 69세,1998,165,67,98
'4273035000,  청일면,'75,70 - 74세,1998,135,49,86
'4273035000,  청일면,'80,75 - 79세,1998,100,44,56
'4273035000,  청일면,'85,80 - 84세,1998,63,18,45
'4273035000,  청일면,'90,85+ ,1998,26,10,16
'4273036000,  공근면,'00,계,1998,4388,2249,2139
'4273036000,  공근면,'05,0 - 4세,1998,173,94,79
'4273036000,  공근면,'10,5 - 9세,1998,164,93,71
'4273036000,  공근면,'15,10 - 14세,1998,247,143,104
'4273036000,  공근면,'20,15 - 19세,1998,380,188,192
'4273036000,  공근면,'25,20 - 24세,1998,416,220,196
'4273036000,  공근면,'30,25 - 29세,1998,294,196,98
'4273036000,  공근면,'35,30 - 34세,1998,222,125,97
'4273036000,  공근면,'40,35 - 39세,1998,300,169,131
'4273036000,  공근면,'45,40 - 44세,1998,308,169,139
'4273036000,  공근면,'50,45 - 49세,1998,191,96,95
'4273036000,  공근면,'55,50 - 54세,1998,220,108,112
'4273036000,  공근면,'60,55 - 59세,1998,358,178,180
'4273036000,  공근면,'65,60 - 64세,1998,397,195,202
'4273036000,  공근면,'70,65 - 69세,1998,276,107,169
'4273036000,  공근면,'75,70 - 74세,1998,170,65,105
'4273036000,  공근면,'80,75 - 79세,1998,146,63,83
'4273036000,  공근면,'85,80 - 84세,1998,80,29,51
'4273036000,  공근면,'90,85+ ,1998,46,11,35
'4273037000,  서원면,'00,계,1998,2543,1322,1221
'4273037000,  서원면,'05,0 - 4세,1998,99,61,38
'4273037000,  서원면,'10,5 - 9세,1998,135,71,64
'4273037000,  서원면,'15,10 - 14세,1998,127,65,62
'4273037000,  서원면,'20,15 - 19세,1998,230,122,108
'4273037000,  서원면,'25,20 - 24세,1998,209,127,82
'4273037000,  서원면,'30,25 - 29세,1998,136,86,50
'4273037000,  서원면,'35,30 - 34세,1998,132,72,60
'4273037000,  서원면,'40,35 - 39세,1998,206,119,87
'4273037000,  서원면,'45,40 - 44세,1998,194,112,82
'4273037000,  서원면,'50,45 - 49세,1998,141,81,60
'4273037000,  서원면,'55,50 - 54세,1998,120,61,59
'4273037000,  서원면,'60,55 - 59세,1998,175,74,101
'4273037000,  서원면,'65,60 - 64세,1998,239,116,123
'4273037000,  서원면,'70,65 - 69세,1998,132,52,80
'4273037000,  서원면,'75,70 - 74세,1998,114,40,74
'4273037000,  서원면,'80,75 - 79세,1998,82,37,45
'4273037000,  서원면,'85,80 - 84세,1998,49,20,29
'4273037000,  서원면,'90,85+ ,1998,23,6,17
'4273038000,  강림면,'00,계,1998,1560,808,752
'4273038000,  강림면,'05,0 - 4세,1998,61,41,20
'4273038000,  강림면,'10,5 - 9세,1998,60,32,28
'4273038000,  강림면,'15,10 - 14세,1998,85,51,34
'4273038000,  강림면,'20,15 - 19세,1998,146,73,73
'4273038000,  강림면,'25,20 - 24세,1998,138,80,58
'4273038000,  강림면,'30,25 - 29세,1998,95,54,41
'4273038000,  강림면,'35,30 - 34세,1998,83,47,36
'4273038000,  강림면,'40,35 - 39세,1998,100,60,40
'4273038000,  강림면,'45,40 - 44세,1998,98,53,45
'4273038000,  강림면,'50,45 - 49세,1998,78,38,40
'4273038000,  강림면,'55,50 - 54세,1998,96,38,58
'4273038000,  강림면,'60,55 - 59세,1998,134,65,69
'4273038000,  강림면,'65,60 - 64세,1998,147,73,74
'4273038000,  강림면,'70,65 - 69세,1998,85,42,43
'4273038000,  강림면,'75,70 - 74세,1998,61,25,36
'4273038000,  강림면,'80,75 - 79세,1998,46,18,28
'4273038000,  강림면,'85,80 - 84세,1998,24,12,12
'4273038000,  강림면,'90,85+ ,1998,23,6,17
'42750, 영월군,'00,계,1998,50287,25494,24793
'42750, 영월군,'05,0 - 4세,1998,2676,1402,1274
'42750, 영월군,'10,5 - 9세,1998,2785,1461,1324
'42750, 영월군,'15,10 - 14세,1998,3064,1538,1526
'42750, 영월군,'20,15 - 19세,1998,4736,2392,2344
'42750, 영월군,'25,20 - 24세,1998,4687,2661,2026
'42750, 영월군,'30,25 - 29세,1998,3749,2165,1584
'42750, 영월군,'35,30 - 34세,1998,3471,1867,1604
'42750, 영월군,'40,35 - 39세,1998,3828,2046,1782
'42750, 영월군,'45,40 - 44세,1998,3551,1925,1626
'42750, 영월군,'50,45 - 49세,1998,2638,1324,1314
'42750, 영월군,'55,50 - 54세,1998,2639,1286,1353
'42750, 영월군,'60,55 - 59세,1998,3523,1690,1833
'42750, 영월군,'65,60 - 64세,1998,3186,1497,1689
'42750, 영월군,'70,65 - 69세,1998,2161,840,1321
'42750, 영월군,'75,70 - 74세,1998,1569,623,946
'42750, 영월군,'80,75 - 79세,1998,1113,438,675
'42750, 영월군,'85,80 - 84세,1998,600,237,363
'42750, 영월군,'90,85+ ,1998,311,102,209
'4275025000,  영월읍,'00,계,1998,25875,13058,12817
'4275025000,  영월읍,'05,0 - 4세,1998,1720,876,844
'4275025000,  영월읍,'10,5 - 9세,1998,1756,919,837
'4275025000,  영월읍,'15,10 - 14세,1998,1713,856,857
'4275025000,  영월읍,'20,15 - 19세,1998,2362,1186,1176
'4275025000,  영월읍,'25,20 - 24세,1998,2310,1272,1038
'4275025000,  영월읍,'30,25 - 29세,1998,2139,1147,992
'4275025000,  영월읍,'35,30 - 34세,1998,2141,1132,1009
'4275025000,  영월읍,'40,35 - 39세,1998,2284,1198,1086
'4275025000,  영월읍,'45,40 - 44세,1998,1960,1042,918
'4275025000,  영월읍,'50,45 - 49세,1998,1324,654,670
'4275025000,  영월읍,'55,50 - 54세,1998,1236,628,608
'4275025000,  영월읍,'60,55 - 59세,1998,1476,707,769
'4275025000,  영월읍,'65,60 - 64세,1998,1255,588,667
'4275025000,  영월읍,'70,65 - 69세,1998,830,310,520
'4275025000,  영월읍,'75,70 - 74세,1998,636,260,376
'4275025000,  영월읍,'80,75 - 79세,1998,404,167,237
'4275025000,  영월읍,'85,80 - 84세,1998,213,78,135
'4275025000,  영월읍,'90,85+ ,1998,116,38,78
'4275025300,  상동읍,'00,계,1998,2022,1030,992
'4275025300,  상동읍,'05,0 - 4세,1998,74,47,27
'4275025300,  상동읍,'10,5 - 9세,1998,71,40,31
'4275025300,  상동읍,'15,10 - 14세,1998,126,61,65
'4275025300,  상동읍,'20,15 - 19세,1998,216,111,105
'4275025300,  상동읍,'25,20 - 24세,1998,194,115,79
'4275025300,  상동읍,'30,25 - 29세,1998,137,84,53
'4275025300,  상동읍,'35,30 - 34세,1998,116,60,56
'4275025300,  상동읍,'40,35 - 39세,1998,129,72,57
'4275025300,  상동읍,'45,40 - 44세,1998,123,63,60
'4275025300,  상동읍,'50,45 - 49세,1998,116,62,54
'4275025300,  상동읍,'55,50 - 54세,1998,133,63,70
'4275025300,  상동읍,'60,55 - 59세,1998,185,74,111
'4275025300,  상동읍,'65,60 - 64세,1998,155,87,68
'4275025300,  상동읍,'70,65 - 69세,1998,105,37,68
'4275025300,  상동읍,'75,70 - 74세,1998,62,22,40
'4275025300,  상동읍,'80,75 - 79세,1998,47,21,26
'4275025300,  상동읍,'85,80 - 84세,1998,23,9,14
'4275025300,  상동읍,'90,85+ ,1998,10,2,8
'4275031000,  중동면,'00,계,1998,2308,1176,1132
'4275031000,  중동면,'05,0 - 4세,1998,68,39,29
'4275031000,  중동면,'10,5 - 9세,1998,91,50,41
'4275031000,  중동면,'15,10 - 14세,1998,133,67,66
'4275031000,  중동면,'20,15 - 19세,1998,273,144,129
'4275031000,  중동면,'25,20 - 24세,1998,255,143,112
'4275031000,  중동면,'30,25 - 29세,1998,120,74,46
'4275031000,  중동면,'35,30 - 34세,1998,115,66,49
'4275031000,  중동면,'40,35 - 39세,1998,131,71,60
'4275031000,  중동면,'45,40 - 44세,1998,149,85,64
'4275031000,  중동면,'50,45 - 49세,1998,113,61,52
'4275031000,  중동면,'55,50 - 54세,1998,128,53,75
'4275031000,  중동면,'60,55 - 59세,1998,225,112,113
'4275031000,  중동면,'65,60 - 64세,1998,181,80,101
'4275031000,  중동면,'70,65 - 69세,1998,130,61,69
'4275031000,  중동면,'75,70 - 74세,1998,86,25,61
'4275031000,  중동면,'80,75 - 79세,1998,65,25,40
'4275031000,  중동면,'85,80 - 84세,1998,28,13,15
'4275031000,  중동면,'90,85+ ,1998,17,7,10
'4275032000,  하동면,'00,계,1998,2166,1095,1071
'4275032000,  하동면,'05,0 - 4세,1998,76,38,38
'4275032000,  하동면,'10,5 - 9세,1998,68,33,35
'4275032000,  하동면,'15,10 - 14세,1998,122,68,54
'4275032000,  하동면,'20,15 - 19세,1998,228,122,106
'4275032000,  하동면,'25,20 - 24세,1998,237,140,97
'4275032000,  하동면,'30,25 - 29세,1998,142,90,52
'4275032000,  하동면,'35,30 - 34세,1998,96,57,39
'4275032000,  하동면,'40,35 - 39세,1998,113,63,50
'4275032000,  하동면,'45,40 - 44세,1998,129,74,55
'4275032000,  하동면,'50,45 - 49세,1998,107,58,49
'4275032000,  하동면,'55,50 - 54세,1998,141,66,75
'4275032000,  하동면,'60,55 - 59세,1998,173,78,95
'4275032000,  하동면,'65,60 - 64세,1998,176,84,92
'4275032000,  하동면,'70,65 - 69세,1998,129,51,78
'4275032000,  하동면,'75,70 - 74세,1998,97,29,68
'4275032000,  하동면,'80,75 - 79세,1998,74,22,52
'4275032000,  하동면,'85,80 - 84세,1998,41,19,22
'4275032000,  하동면,'90,85+ ,1998,17,3,14
'4275033000,  북면,'00,계,1998,3255,1682,1573
'4275033000,  북면,'05,0 - 4세,1998,100,62,38
'4275033000,  북면,'10,5 - 9세,1998,121,67,54
'4275033000,  북면,'15,10 - 14세,1998,161,82,79
'4275033000,  북면,'20,15 - 19세,1998,337,165,172
'4275033000,  북면,'25,20 - 24세,1998,313,191,122
'4275033000,  북면,'30,25 - 29세,1998,201,127,74
'4275033000,  북면,'35,30 - 34세,1998,168,94,74
'4275033000,  북면,'40,35 - 39세,1998,201,121,80
'4275033000,  북면,'45,40 - 44세,1998,216,120,96
'4275033000,  북면,'50,45 - 49세,1998,178,96,82
'4275033000,  북면,'55,50 - 54세,1998,197,98,99
'4275033000,  북면,'60,55 - 59세,1998,270,124,146
'4275033000,  북면,'65,60 - 64세,1998,277,127,150
'4275033000,  북면,'70,65 - 69세,1998,199,85,114
'4275033000,  북면,'75,70 - 74세,1998,134,49,85
'4275033000,  북면,'80,75 - 79세,1998,111,45,66
'4275033000,  북면,'85,80 - 84세,1998,44,20,24
'4275033000,  북면,'90,85+ ,1998,27,9,18
'4275034000,  남면,'00,계,1998,3134,1602,1532
'4275034000,  남면,'05,0 - 4세,1998,120,59,61
'4275034000,  남면,'10,5 - 9세,1998,122,69,53
'4275034000,  남면,'15,10 - 14세,1998,159,90,69
'4275034000,  남면,'20,15 - 19세,1998,335,166,169
'4275034000,  남면,'25,20 - 24세,1998,288,173,115
'4275034000,  남면,'30,25 - 29세,1998,209,144,65
'4275034000,  남면,'35,30 - 34세,1998,146,78,68
'4275034000,  남면,'40,35 - 39세,1998,192,101,91
'4275034000,  남면,'45,40 - 44세,1998,235,127,108
'4275034000,  남면,'50,45 - 49세,1998,167,94,73
'4275034000,  남면,'55,50 - 54세,1998,157,69,88
'4275034000,  남면,'60,55 - 59세,1998,263,125,138
'4275034000,  남면,'65,60 - 64세,1998,246,112,134
'4275034000,  남면,'70,65 - 69세,1998,189,71,118
'4275034000,  남면,'75,70 - 74세,1998,132,64,68
'4275034000,  남면,'80,75 - 79세,1998,87,27,60
'4275034000,  남면,'85,80 - 84세,1998,60,26,34
'4275034000,  남면,'90,85+ ,1998,27,7,20
'4275035000,  서면,'00,계,1998,4920,2505,2415
'4275035000,  서면,'05,0 - 4세,1998,259,138,121
'4275035000,  서면,'10,5 - 9세,1998,279,142,137
'4275035000,  서면,'15,10 - 14세,1998,290,133,157
'4275035000,  서면,'20,15 - 19세,1998,417,208,209
'4275035000,  서면,'25,20 - 24세,1998,492,288,204
'4275035000,  서면,'30,25 - 29세,1998,367,214,153
'4275035000,  서면,'35,30 - 34세,1998,350,189,161
'4275035000,  서면,'40,35 - 39세,1998,381,202,179
'4275035000,  서면,'45,40 - 44세,1998,309,180,129
'4275035000,  서면,'50,45 - 49세,1998,277,125,152
'4275035000,  서면,'55,50 - 54세,1998,274,138,136
'4275035000,  서면,'60,55 - 59세,1998,379,196,183
'4275035000,  서면,'65,60 - 64세,1998,322,158,164
'4275035000,  서면,'70,65 - 69세,1998,203,76,127
'4275035000,  서면,'75,70 - 74세,1998,129,51,78
'4275035000,  서면,'80,75 - 79세,1998,102,31,71
'4275035000,  서면,'85,80 - 84세,1998,65,22,43
'4275035000,  서면,'90,85+ ,1998,25,14,11
'4275036000,  주천면,'00,계,1998,5013,2532,2481
'4275036000,  주천면,'05,0 - 4세,1998,195,106,89
'4275036000,  주천면,'10,5 - 9세,1998,240,126,114
'4275036000,  주천면,'15,10 - 14세,1998,288,151,137
'4275036000,  주천면,'20,15 - 19세,1998,432,229,203
'4275036000,  주천면,'25,20 - 24세,1998,475,269,206
'4275036000,  주천면,'30,25 - 29세,1998,333,213,120
'4275036000,  주천면,'35,30 - 34세,1998,260,144,116
'4275036000,  주천면,'40,35 - 39세,1998,317,171,146
'4275036000,  주천면,'45,40 - 44세,1998,324,172,152
'4275036000,  주천면,'50,45 - 49세,1998,252,119,133
'4275036000,  주천면,'55,50 - 54세,1998,273,125,148
'4275036000,  주천면,'60,55 - 59세,1998,394,195,199
'4275036000,  주천면,'65,60 - 64세,1998,428,188,240
'4275036000,  주천면,'70,65 - 69세,1998,265,103,162
'4275036000,  주천면,'75,70 - 74세,1998,215,93,122
'4275036000,  주천면,'80,75 - 79세,1998,178,79,99
'4275036000,  주천면,'85,80 - 84세,1998,89,32,57
'4275036000,  주천면,'90,85+ ,1998,55,17,38
'4275037000,  수주면,'00,계,1998,1594,814,780
'4275037000,  수주면,'05,0 - 4세,1998,64,37,27
'4275037000,  수주면,'10,5 - 9세,1998,37,15,22
'4275037000,  수주면,'15,10 - 14세,1998,72,30,42
'4275037000,  수주면,'20,15 - 19세,1998,136,61,75
'4275037000,  수주면,'25,20 - 24세,1998,123,70,53
'4275037000,  수주면,'30,25 - 29세,1998,101,72,29
'4275037000,  수주면,'35,30 - 34세,1998,79,47,32
'4275037000,  수주면,'40,35 - 39세,1998,80,47,33
'4275037000,  수주면,'45,40 - 44세,1998,106,62,44
'4275037000,  수주면,'50,45 - 49세,1998,104,55,49
'4275037000,  수주면,'55,50 - 54세,1998,100,46,54
'4275037000,  수주면,'60,55 - 59세,1998,158,79,79
'4275037000,  수주면,'65,60 - 64세,1998,146,73,73
'4275037000,  수주면,'70,65 - 69세,1998,111,46,65
'4275037000,  수주면,'75,70 - 74세,1998,78,30,48
'4275037000,  수주면,'80,75 - 79세,1998,45,21,24
'4275037000,  수주면,'85,80 - 84세,1998,37,18,19
'4275037000,  수주면,'90,85+ ,1998,17,5,12
'42760, 평창군,'00,계,1998,48746,24752,23994
'42760, 평창군,'05,0 - 4세,1998,2758,1457,1301
'42760, 평창군,'10,5 - 9세,1998,2808,1475,1333
'42760, 평창군,'15,10 - 14세,1998,3017,1478,1539
'42760, 평창군,'20,15 - 19세,1998,4464,2215,2249
'42760, 평창군,'25,20 - 24세,1998,4567,2434,2133
'42760, 평창군,'30,25 - 29세,1998,3906,2246,1660
'42760, 평창군,'35,30 - 34세,1998,3489,1909,1580
'42760, 평창군,'40,35 - 39세,1998,3985,2155,1830
'42760, 평창군,'45,40 - 44세,1998,3527,1968,1559
'42760, 평창군,'50,45 - 49세,1998,2358,1190,1168
'42760, 평창군,'55,50 - 54세,1998,2540,1261,1279
'42760, 평창군,'60,55 - 59세,1998,3319,1661,1658
'42760, 평창군,'65,60 - 64세,1998,2823,1328,1495
'42760, 평창군,'70,65 - 69세,1998,1879,711,1168
'42760, 평창군,'75,70 - 74세,1998,1350,516,834
'42760, 평창군,'80,75 - 79세,1998,1015,420,595
'42760, 평창군,'85,80 - 84세,1998,592,210,382
'42760, 평창군,'90,85+ ,1998,349,118,231
'4276025000,  평창읍,'00,계,1998,10326,5186,5140
'4276025000,  평창읍,'05,0 - 4세,1998,638,352,286
'4276025000,  평창읍,'10,5 - 9세,1998,682,364,318
'4276025000,  평창읍,'15,10 - 14세,1998,697,339,358
'4276025000,  평창읍,'20,15 - 19세,1998,854,412,442
'4276025000,  평창읍,'25,20 - 24세,1998,866,460,406
'4276025000,  평창읍,'30,25 - 29세,1998,773,413,360
'4276025000,  평창읍,'35,30 - 34세,1998,805,435,370
'4276025000,  평창읍,'40,35 - 39세,1998,887,471,416
'4276025000,  평창읍,'45,40 - 44세,1998,762,439,323
'4276025000,  평창읍,'50,45 - 49세,1998,485,243,242
'4276025000,  평창읍,'55,50 - 54세,1998,496,253,243
'4276025000,  평창읍,'60,55 - 59세,1998,603,305,298
'4276025000,  평창읍,'65,60 - 64세,1998,587,266,321
'4276025000,  평창읍,'70,65 - 69세,1998,440,165,275
'4276025000,  평창읍,'75,70 - 74세,1998,317,121,196
'4276025000,  평창읍,'80,75 - 79세,1998,236,89,147
'4276025000,  평창읍,'85,80 - 84세,1998,126,44,82
'4276025000,  평창읍,'90,85+ ,1998,72,15,57
'4276031000,  미탄면,'00,계,1998,2400,1224,1176
'4276031000,  미탄면,'05,0 - 4세,1998,98,45,53
'4276031000,  미탄면,'10,5 - 9세,1998,88,47,41
'4276031000,  미탄면,'15,10 - 14세,1998,139,73,66
'4276031000,  미탄면,'20,15 - 19세,1998,261,134,127
'4276031000,  미탄면,'25,20 - 24세,1998,263,164,99
'4276031000,  미탄면,'30,25 - 29세,1998,151,89,62
'4276031000,  미탄면,'35,30 - 34세,1998,126,73,53
'4276031000,  미탄면,'40,35 - 39세,1998,176,98,78
'4276031000,  미탄면,'45,40 - 44세,1998,186,99,87
'4276031000,  미탄면,'50,45 - 49세,1998,143,75,68
'4276031000,  미탄면,'55,50 - 54세,1998,136,59,77
'4276031000,  미탄면,'60,55 - 59세,1998,180,90,90
'4276031000,  미탄면,'65,60 - 64세,1998,152,70,82
'4276031000,  미탄면,'70,65 - 69세,1998,112,40,72
'4276031000,  미탄면,'75,70 - 74세,1998,95,37,58
'4276031000,  미탄면,'80,75 - 79세,1998,60,22,38
'4276031000,  미탄면,'85,80 - 84세,1998,23,6,17
'4276031000,  미탄면,'90,85+ ,1998,11,3,8
'4276032000,  방림면,'00,계,1998,2911,1471,1440
'4276032000,  방림면,'05,0 - 4세,1998,98,56,42
'4276032000,  방림면,'10,5 - 9세,1998,129,65,64
'4276032000,  방림면,'15,10 - 14세,1998,187,88,99
'4276032000,  방림면,'20,15 - 19세,1998,273,154,119
'4276032000,  방림면,'25,20 - 24세,1998,259,140,119
'4276032000,  방림면,'30,25 - 29세,1998,185,116,69
'4276032000,  방림면,'35,30 - 34세,1998,163,91,72
'4276032000,  방림면,'40,35 - 39세,1998,236,129,107
'4276032000,  방림면,'45,40 - 44세,1998,236,145,91
'4276032000,  방림면,'50,45 - 49세,1998,123,48,75
'4276032000,  방림면,'55,50 - 54세,1998,151,78,73
'4276032000,  방림면,'60,55 - 59세,1998,230,102,128
'4276032000,  방림면,'65,60 - 64세,1998,220,111,109
'4276032000,  방림면,'70,65 - 69세,1998,140,40,100
'4276032000,  방림면,'75,70 - 74세,1998,109,41,68
'4276032000,  방림면,'80,75 - 79세,1998,90,39,51
'4276032000,  방림면,'85,80 - 84세,1998,53,16,37
'4276032000,  방림면,'90,85+ ,1998,29,12,17
'4276033000,  대화면,'00,계,1998,6988,3500,3488
'4276033000,  대화면,'05,0 - 4세,1998,339,181,158
'4276033000,  대화면,'10,5 - 9세,1998,397,214,183
'4276033000,  대화면,'15,10 - 14세,1998,426,196,230
'4276033000,  대화면,'20,15 - 19세,1998,697,333,364
'4276033000,  대화면,'25,20 - 24세,1998,649,364,285
'4276033000,  대화면,'30,25 - 29세,1998,512,294,218
'4276033000,  대화면,'35,30 - 34세,1998,440,236,204
'4276033000,  대화면,'40,35 - 39세,1998,528,284,244
'4276033000,  대화면,'45,40 - 44세,1998,483,260,223
'4276033000,  대화면,'50,45 - 49세,1998,312,165,147
'4276033000,  대화면,'55,50 - 54세,1998,348,165,183
'4276033000,  대화면,'60,55 - 59세,1998,513,260,253
'4276033000,  대화면,'65,60 - 64세,1998,498,218,280
'4276033000,  대화면,'70,65 - 69세,1998,352,133,219
'4276033000,  대화면,'75,70 - 74세,1998,205,79,126
'4276033000,  대화면,'80,75 - 79세,1998,149,68,81
'4276033000,  대화면,'85,80 - 84세,1998,90,35,55
'4276033000,  대화면,'90,85+ ,1998,50,15,35
'4276034000,  봉평면,'00,계,1998,4846,2465,2381
'4276034000,  봉평면,'05,0 - 4세,1998,294,152,142
'4276034000,  봉평면,'10,5 - 9세,1998,265,133,132
'4276034000,  봉평면,'15,10 - 14세,1998,320,157,163
'4276034000,  봉평면,'20,15 - 19세,1998,405,192,213
'4276034000,  봉평면,'25,20 - 24세,1998,469,232,237
'4276034000,  봉평면,'30,25 - 29세,1998,418,268,150
'4276034000,  봉평면,'35,30 - 34세,1998,335,183,152
'4276034000,  봉평면,'40,35 - 39세,1998,383,198,185
'4276034000,  봉평면,'45,40 - 44세,1998,326,189,137
'4276034000,  봉평면,'50,45 - 49세,1998,231,119,112
'4276034000,  봉평면,'55,50 - 54세,1998,251,127,124
'4276034000,  봉평면,'60,55 - 59세,1998,340,168,172
'4276034000,  봉평면,'65,60 - 64세,1998,289,136,153
'4276034000,  봉평면,'70,65 - 69세,1998,182,77,105
'4276034000,  봉평면,'75,70 - 74세,1998,157,65,92
'4276034000,  봉평면,'80,75 - 79세,1998,82,35,47
'4276034000,  봉평면,'85,80 - 84세,1998,70,24,46
'4276034000,  봉평면,'90,85+ ,1998,29,10,19
'4276035000,  용평면,'00,계,1998,3273,1685,1588
'4276035000,  용평면,'05,0 - 4세,1998,160,82,78
'4276035000,  용평면,'10,5 - 9세,1998,136,75,61
'4276035000,  용평면,'15,10 - 14세,1998,190,98,92
'4276035000,  용평면,'20,15 - 19세,1998,293,136,157
'4276035000,  용평면,'25,20 - 24세,1998,327,177,150
'4276035000,  용평면,'30,25 - 29세,1998,258,156,102
'4276035000,  용평면,'35,30 - 34세,1998,201,115,86
'4276035000,  용평면,'40,35 - 39세,1998,250,140,110
'4276035000,  용평면,'45,40 - 44세,1998,249,141,108
'4276035000,  용평면,'50,45 - 49세,1998,152,81,71
'4276035000,  용평면,'55,50 - 54세,1998,179,87,92
'4276035000,  용평면,'60,55 - 59세,1998,262,130,132
'4276035000,  용평면,'65,60 - 64세,1998,240,115,125
'4276035000,  용평면,'70,65 - 69세,1998,130,56,74
'4276035000,  용평면,'75,70 - 74세,1998,82,29,53
'4276035000,  용평면,'80,75 - 79세,1998,85,37,48
'4276035000,  용평면,'85,80 - 84세,1998,52,19,33
'4276035000,  용평면,'90,85+ ,1998,27,11,16
'4276036000,  진부면,'00,계,1998,11229,5662,5567
'4276036000,  진부면,'05,0 - 4세,1998,687,355,332
'4276036000,  진부면,'10,5 - 9세,1998,723,369,354
'4276036000,  진부면,'15,10 - 14세,1998,668,326,342
'4276036000,  진부면,'20,15 - 19세,1998,1099,555,544
'4276036000,  진부면,'25,20 - 24세,1998,1102,570,532
'4276036000,  진부면,'30,25 - 29세,1998,923,530,393
'4276036000,  진부면,'35,30 - 34세,1998,834,453,381
'4276036000,  진부면,'40,35 - 39세,1998,935,491,444
'4276036000,  진부면,'45,40 - 44세,1998,824,438,386
'4276036000,  진부면,'50,45 - 49세,1998,550,269,281
'4276036000,  진부면,'55,50 - 54세,1998,628,320,308
'4276036000,  진부면,'60,55 - 59세,1998,746,375,371
'4276036000,  진부면,'65,60 - 64세,1998,510,246,264
'4276036000,  진부면,'70,65 - 69세,1998,324,121,203
'4276036000,  진부면,'75,70 - 74세,1998,259,89,170
'4276036000,  진부면,'80,75 - 79세,1998,201,77,124
'4276036000,  진부면,'85,80 - 84세,1998,124,43,81
'4276036000,  진부면,'90,85+ ,1998,92,35,57
'4276037000,  도암면,'00,계,1998,6773,3559,3214
'4276037000,  도암면,'05,0 - 4세,1998,444,234,210
'4276037000,  도암면,'10,5 - 9세,1998,388,208,180
'4276037000,  도암면,'15,10 - 14세,1998,390,201,189
'4276037000,  도암면,'20,15 - 19세,1998,582,299,283
'4276037000,  도암면,'25,20 - 24세,1998,632,327,305
'4276037000,  도암면,'30,25 - 29세,1998,686,380,306
'4276037000,  도암면,'35,30 - 34세,1998,585,323,262
'4276037000,  도암면,'40,35 - 39세,1998,590,344,246
'4276037000,  도암면,'45,40 - 44세,1998,461,257,204
'4276037000,  도암면,'50,45 - 49세,1998,362,190,172
'4276037000,  도암면,'55,50 - 54세,1998,351,172,179
'4276037000,  도암면,'60,55 - 59세,1998,445,231,214
'4276037000,  도암면,'65,60 - 64세,1998,327,166,161
'4276037000,  도암면,'70,65 - 69세,1998,199,79,120
'4276037000,  도암면,'75,70 - 74세,1998,126,55,71
'4276037000,  도암면,'80,75 - 79세,1998,112,53,59
'4276037000,  도암면,'85,80 - 84세,1998,54,23,31
'4276037000,  도암면,'90,85+ ,1998,39,17,22
'42770, 정선군,'00,계,1998,53849,27814,26035
'42770, 정선군,'05,0 - 4세,1998,2460,1305,1155
'42770, 정선군,'10,5 - 9세,1998,2782,1450,1332
'42770, 정선군,'15,10 - 14세,1998,3666,1850,1816
'42770, 정선군,'20,15 - 19세,1998,6053,3124,2929
'42770, 정선군,'25,20 - 24세,1998,5651,3216,2435
'42770, 정선군,'30,25 - 29세,1998,3712,2162,1550
'42770, 정선군,'35,30 - 34세,1998,3227,1741,1486
'42770, 정선군,'40,35 - 39세,1998,4139,2165,1974
'42770, 정선군,'45,40 - 44세,1998,4037,2211,1826
'42770, 정선군,'50,45 - 49세,1998,3222,1655,1567
'42770, 정선군,'55,50 - 54세,1998,3206,1688,1518
'42770, 정선군,'60,55 - 59세,1998,3717,1868,1849
'42770, 정선군,'65,60 - 64세,1998,2846,1356,1490
'42770, 정선군,'70,65 - 69세,1998,2002,800,1202
'42770, 정선군,'75,70 - 74세,1998,1423,551,872
'42770, 정선군,'80,75 - 79세,1998,938,379,559
'42770, 정선군,'85,80 - 84세,1998,514,206,308
'42770, 정선군,'90,85+ ,1998,254,87,167
'4277025000,  정선읍,'00,계,1998,13520,6888,6632
'4277025000,  정선읍,'05,0 - 4세,1998,837,451,386
'4277025000,  정선읍,'10,5 - 9세,1998,795,413,382
'4277025000,  정선읍,'15,10 - 14세,1998,955,464,491
'4277025000,  정선읍,'20,15 - 19세,1998,1337,690,647
'4277025000,  정선읍,'25,20 - 24세,1998,1364,744,620
'4277025000,  정선읍,'30,25 - 29세,1998,1075,578,497
'4277025000,  정선읍,'35,30 - 34세,1998,926,489,437
'4277025000,  정선읍,'40,35 - 39세,1998,1122,591,531
'4277025000,  정선읍,'45,40 - 44세,1998,1000,555,445
'4277025000,  정선읍,'50,45 - 49세,1998,694,354,340
'4277025000,  정선읍,'55,50 - 54세,1998,706,373,333
'4277025000,  정선읍,'60,55 - 59세,1998,776,389,387
'4277025000,  정선읍,'65,60 - 64세,1998,613,281,332
'4277025000,  정선읍,'70,65 - 69세,1998,442,175,267
'4277025000,  정선읍,'75,70 - 74세,1998,370,135,235
'4277025000,  정선읍,'80,75 - 79세,1998,270,118,152
'4277025000,  정선읍,'85,80 - 84세,1998,164,60,104
'4277025000,  정선읍,'90,85+ ,1998,74,28,46
'4277025300,  고한읍,'00,계,1998,7590,3936,3654
'4277025300,  고한읍,'05,0 - 4세,1998,278,156,122
'4277025300,  고한읍,'10,5 - 9세,1998,391,205,186
'4277025300,  고한읍,'15,10 - 14세,1998,525,255,270
'4277025300,  고한읍,'20,15 - 19세,1998,981,488,493
'4277025300,  고한읍,'25,20 - 24세,1998,872,478,394
'4277025300,  고한읍,'30,25 - 29세,1998,485,296,189
'4277025300,  고한읍,'35,30 - 34세,1998,391,204,187
'4277025300,  고한읍,'40,35 - 39세,1998,556,283,273
'4277025300,  고한읍,'45,40 - 44세,1998,643,324,319
'4277025300,  고한읍,'50,45 - 49세,1998,593,292,301
'4277025300,  고한읍,'55,50 - 54세,1998,568,308,260
'4277025300,  고한읍,'60,55 - 59세,1998,536,277,259
'4277025300,  고한읍,'65,60 - 64세,1998,342,189,153
'4277025300,  고한읍,'70,65 - 69세,1998,194,91,103
'4277025300,  고한읍,'75,70 - 74세,1998,117,50,67
'4277025300,  고한읍,'80,75 - 79세,1998,62,22,40
'4277025300,  고한읍,'85,80 - 84세,1998,36,10,26
'4277025300,  고한읍,'90,85+ ,1998,20,8,12
'4277025600,  사북읍,'00,계,1998,8432,4409,4023
'4277025600,  사북읍,'05,0 - 4세,1998,376,204,172
'4277025600,  사북읍,'10,5 - 9세,1998,488,240,248
'4277025600,  사북읍,'15,10 - 14세,1998,654,326,328
'4277025600,  사북읍,'20,15 - 19세,1998,1067,544,523
'4277025600,  사북읍,'25,20 - 24세,1998,891,500,391
'4277025600,  사북읍,'30,25 - 29세,1998,505,293,212
'4277025600,  사북읍,'35,30 - 34세,1998,532,259,273
'4277025600,  사북읍,'40,35 - 39세,1998,777,405,372
'4277025600,  사북읍,'45,40 - 44세,1998,785,415,370
'4277025600,  사북읍,'50,45 - 49세,1998,603,329,274
'4277025600,  사북읍,'55,50 - 54세,1998,540,314,226
'4277025600,  사북읍,'60,55 - 59세,1998,499,267,232
'4277025600,  사북읍,'65,60 - 64세,1998,300,163,137
'4277025600,  사북읍,'70,65 - 69세,1998,195,79,116
'4277025600,  사북읍,'75,70 - 74세,1998,105,36,69
'4277025600,  사북읍,'80,75 - 79세,1998,65,17,48
'4277025600,  사북읍,'85,80 - 84세,1998,36,14,22
'4277025600,  사북읍,'90,85+ ,1998,14,4,10
'4277025900,  신동읍,'00,계,1998,5817,2999,2818
'4277025900,  신동읍,'05,0 - 4세,1998,209,113,96
'4277025900,  신동읍,'10,5 - 9세,1998,266,147,119
'4277025900,  신동읍,'15,10 - 14세,1998,348,192,156
'4277025900,  신동읍,'20,15 - 19세,1998,636,345,291
'4277025900,  신동읍,'25,20 - 24세,1998,628,372,256
'4277025900,  신동읍,'30,25 - 29세,1998,370,211,159
'4277025900,  신동읍,'35,30 - 34세,1998,341,199,142
'4277025900,  신동읍,'40,35 - 39세,1998,374,196,178
'4277025900,  신동읍,'45,40 - 44세,1998,368,212,156
'4277025900,  신동읍,'50,45 - 49세,1998,318,146,172
'4277025900,  신동읍,'55,50 - 54세,1998,365,170,195
'4277025900,  신동읍,'60,55 - 59세,1998,486,235,251
'4277025900,  신동읍,'65,60 - 64세,1998,389,161,228
'4277025900,  신동읍,'70,65 - 69세,1998,281,107,174
'4277025900,  신동읍,'75,70 - 74세,1998,196,83,113
'4277025900,  신동읍,'80,75 - 79세,1998,141,66,75
'4277025900,  신동읍,'85,80 - 84세,1998,71,37,34
'4277025900,  신동읍,'90,85+ ,1998,30,7,23
'4277031000,  동면,'00,계,1998,2282,1181,1101
'4277031000,  동면,'05,0 - 4세,1998,103,56,47
'4277031000,  동면,'10,5 - 9세,1998,112,57,55
'4277031000,  동면,'15,10 - 14세,1998,134,64,70
'4277031000,  동면,'20,15 - 19세,1998,227,121,106
'4277031000,  동면,'25,20 - 24세,1998,216,123,93
'4277031000,  동면,'30,25 - 29세,1998,171,99,72
'4277031000,  동면,'35,30 - 34세,1998,159,101,58
'4277031000,  동면,'40,35 - 39세,1998,130,81,49
'4277031000,  동면,'45,40 - 44세,1998,135,80,55
'4277031000,  동면,'50,45 - 49세,1998,109,55,54
'4277031000,  동면,'55,50 - 54세,1998,113,47,66
'4277031000,  동면,'60,55 - 59세,1998,200,93,107
'4277031000,  동면,'65,60 - 64세,1998,175,94,81
'4277031000,  동면,'70,65 - 69세,1998,131,51,80
'4277031000,  동면,'75,70 - 74세,1998,79,24,55
'4277031000,  동면,'80,75 - 79세,1998,54,18,36
'4277031000,  동면,'85,80 - 84세,1998,21,12,9
'4277031000,  동면,'90,85+ ,1998,13,5,8
'4277032000,  남면,'00,계,1998,4683,2473,2210
'4277032000,  남면,'05,0 - 4세,1998,236,107,129
'4277032000,  남면,'10,5 - 9세,1998,243,133,110
'4277032000,  남면,'15,10 - 14세,1998,357,193,164
'4277032000,  남면,'20,15 - 19세,1998,526,272,254
'4277032000,  남면,'25,20 - 24세,1998,447,274,173
'4277032000,  남면,'30,25 - 29세,1998,379,229,150
'4277032000,  남면,'35,30 - 34세,1998,297,167,130
'4277032000,  남면,'40,35 - 39세,1998,374,187,187
'4277032000,  남면,'45,40 - 44세,1998,371,215,156
'4277032000,  남면,'50,45 - 49세,1998,293,157,136
'4277032000,  남면,'55,50 - 54세,1998,213,126,87
'4277032000,  남면,'60,55 - 59세,1998,281,138,143
'4277032000,  남면,'65,60 - 64세,1998,212,97,115
'4277032000,  남면,'70,65 - 69세,1998,167,63,104
'4277032000,  남면,'75,70 - 74세,1998,111,43,68
'4277032000,  남면,'80,75 - 79세,1998,95,44,51
'4277032000,  남면,'85,80 - 84세,1998,55,21,34
'4277032000,  남면,'90,85+ ,1998,26,7,19
'4277033000,  북면,'00,계,1998,3107,1614,1493
'4277033000,  북면,'05,0 - 4세,1998,110,57,53
'4277033000,  북면,'10,5 - 9세,1998,135,66,69
'4277033000,  북면,'15,10 - 14세,1998,220,117,103
'4277033000,  북면,'20,15 - 19세,1998,348,182,166
'4277033000,  북면,'25,20 - 24세,1998,332,186,146
'4277033000,  북면,'30,25 - 29세,1998,204,130,74
'4277033000,  북면,'35,30 - 34세,1998,148,82,66
'4277033000,  북면,'40,35 - 39세,1998,234,123,111
'4277033000,  북면,'45,40 - 44세,1998,189,106,83
'4277033000,  북면,'50,45 - 49세,1998,172,86,86
'4277033000,  북면,'55,50 - 54세,1998,205,110,95
'4277033000,  북면,'60,55 - 59세,1998,249,134,115
'4277033000,  북면,'65,60 - 64세,1998,196,84,112
'4277033000,  북면,'70,65 - 69세,1998,157,61,96
'4277033000,  북면,'75,70 - 74세,1998,99,44,55
'4277033000,  북면,'80,75 - 79세,1998,63,30,33
'4277033000,  북면,'85,80 - 84세,1998,32,11,21
'4277033000,  북면,'90,85+ ,1998,14,5,9
'4277034000,  북평면,'00,계,1998,3235,1661,1574
'4277034000,  북평면,'05,0 - 4세,1998,132,72,60
'4277034000,  북평면,'10,5 - 9세,1998,138,75,63
'4277034000,  북평면,'15,10 - 14세,1998,181,83,98
'4277034000,  북평면,'20,15 - 19세,1998,393,214,179
'4277034000,  북평면,'25,20 - 24세,1998,340,200,140
'4277034000,  북평면,'30,25 - 29세,1998,211,129,82
'4277034000,  북평면,'35,30 - 34세,1998,186,113,73
'4277034000,  북평면,'40,35 - 39세,1998,218,112,106
'4277034000,  북평면,'45,40 - 44세,1998,204,111,93
'4277034000,  북평면,'50,45 - 49세,1998,162,93,69
'4277034000,  북평면,'55,50 - 54세,1998,179,84,95
'4277034000,  북평면,'60,55 - 59세,1998,263,128,135
'4277034000,  북평면,'65,60 - 64세,1998,204,92,112
'4277034000,  북평면,'70,65 - 69세,1998,161,61,100
'4277034000,  북평면,'75,70 - 74세,1998,118,43,75
'4277034000,  북평면,'80,75 - 79세,1998,78,26,52
'4277034000,  북평면,'85,80 - 84세,1998,35,15,20
'4277034000,  북평면,'90,85+ ,1998,32,10,22
'4277035000,  임계면,'00,계,1998,5183,2653,2530
'4277035000,  임계면,'05,0 - 4세,1998,179,89,90
'4277035000,  임계면,'10,5 - 9세,1998,214,114,100
'4277035000,  임계면,'15,10 - 14세,1998,292,156,136
'4277035000,  임계면,'20,15 - 19세,1998,538,268,270
'4277035000,  임계면,'25,20 - 24세,1998,561,339,222
'4277035000,  임계면,'30,25 - 29세,1998,312,197,115
'4277035000,  임계면,'35,30 - 34세,1998,247,127,120
'4277035000,  임계면,'40,35 - 39세,1998,354,187,167
'4277035000,  임계면,'45,40 - 44세,1998,342,193,149
'4277035000,  임계면,'50,45 - 49세,1998,278,143,135
'4277035000,  임계면,'55,50 - 54세,1998,317,156,161
'4277035000,  임계면,'60,55 - 59세,1998,427,207,220
'4277035000,  임계면,'65,60 - 64세,1998,415,195,220
'4277035000,  임계면,'70,65 - 69세,1998,274,112,162
'4277035000,  임계면,'75,70 - 74세,1998,228,93,135
'4277035000,  임계면,'80,75 - 79세,1998,110,38,72
'4277035000,  임계면,'85,80 - 84세,1998,64,26,38
'4277035000,  임계면,'90,85+ ,1998,31,13,18
'42780, 철원군,'00,계,1998,54500,27816,26684
'42780, 철원군,'05,0 - 4세,1998,3697,1921,1776
'42780, 철원군,'10,5 - 9세,1998,3887,2020,1867
'42780, 철원군,'15,10 - 14세,1998,3556,1782,1774
'42780, 철원군,'20,15 - 19세,1998,4607,2385,2222
'42780, 철원군,'25,20 - 24세,1998,4563,2535,2028
'42780, 철원군,'30,25 - 29세,1998,4705,2677,2028
'42780, 철원군,'35,30 - 34세,1998,4446,2371,2075
'42780, 철원군,'40,35 - 39세,1998,4823,2507,2316
'42780, 철원군,'45,40 - 44세,1998,4136,2191,1945
'42780, 철원군,'50,45 - 49세,1998,2552,1243,1309
'42780, 철원군,'55,50 - 54세,1998,2899,1452,1447
'42780, 철원군,'60,55 - 59세,1998,3346,1596,1750
'42780, 철원군,'65,60 - 64세,1998,2438,1154,1284
'42780, 철원군,'70,65 - 69세,1998,1684,745,939
'42780, 철원군,'75,70 - 74세,1998,1276,445,831
'42780, 철원군,'80,75 - 79세,1998,1016,449,567
'42780, 철원군,'85,80 - 84세,1998,527,206,321
'42780, 철원군,'90,85+ ,1998,342,137,205
'4278025000,  철원읍,'00,계,1998,6182,3201,2981
'4278025000,  철원읍,'05,0 - 4세,1998,362,178,184
'4278025000,  철원읍,'10,5 - 9세,1998,427,214,213
'4278025000,  철원읍,'15,10 - 14세,1998,394,203,191
'4278025000,  철원읍,'20,15 - 19세,1998,532,284,248
'4278025000,  철원읍,'25,20 - 24세,1998,549,321,228
'4278025000,  철원읍,'30,25 - 29세,1998,498,298,200
'4278025000,  철원읍,'35,30 - 34세,1998,419,222,197
'4278025000,  철원읍,'40,35 - 39세,1998,517,282,235
'4278025000,  철원읍,'45,40 - 44세,1998,460,238,222
'4278025000,  철원읍,'50,45 - 49세,1998,303,146,157
'4278025000,  철원읍,'55,50 - 54세,1998,373,184,189
'4278025000,  철원읍,'60,55 - 59세,1998,435,221,214
'4278025000,  철원읍,'65,60 - 64세,1998,328,148,180
'4278025000,  철원읍,'70,65 - 69세,1998,207,99,108
'4278025000,  철원읍,'75,70 - 74세,1998,152,61,91
'4278025000,  철원읍,'80,75 - 79세,1998,122,63,59
'4278025000,  철원읍,'85,80 - 84세,1998,66,24,42
'4278025000,  철원읍,'90,85+ ,1998,38,15,23
'4278025300,  김화읍,'00,계,1998,4248,2190,2058
'4278025300,  김화읍,'05,0 - 4세,1998,276,149,127
'4278025300,  김화읍,'10,5 - 9세,1998,299,150,149
'4278025300,  김화읍,'15,10 - 14세,1998,242,118,124
'4278025300,  김화읍,'20,15 - 19세,1998,318,166,152
'4278025300,  김화읍,'25,20 - 24세,1998,358,213,145
'4278025300,  김화읍,'30,25 - 29세,1998,387,231,156
'4278025300,  김화읍,'35,30 - 34세,1998,326,185,141
'4278025300,  김화읍,'40,35 - 39세,1998,305,167,138
'4278025300,  김화읍,'45,40 - 44세,1998,295,158,137
'4278025300,  김화읍,'50,45 - 49세,1998,165,78,87
'4278025300,  김화읍,'55,50 - 54세,1998,247,111,136
'4278025300,  김화읍,'60,55 - 59세,1998,329,164,165
'4278025300,  김화읍,'65,60 - 64세,1998,240,113,127
'4278025300,  김화읍,'70,65 - 69세,1998,148,63,85
'4278025300,  김화읍,'75,70 - 74세,1998,118,42,76
'4278025300,  김화읍,'80,75 - 79세,1998,97,40,57
'4278025300,  김화읍,'85,80 - 84세,1998,61,27,34
'4278025300,  김화읍,'90,85+ ,1998,37,15,22
'4278025600,  갈말읍,'00,계,1998,15116,7712,7404
'4278025600,  갈말읍,'05,0 - 4세,1998,1155,593,562
'4278025600,  갈말읍,'10,5 - 9세,1998,1091,585,506
'4278025600,  갈말읍,'15,10 - 14세,1998,1012,504,508
'4278025600,  갈말읍,'20,15 - 19세,1998,1243,634,609
'4278025600,  갈말읍,'25,20 - 24세,1998,1181,642,539
'4278025600,  갈말읍,'30,25 - 29세,1998,1369,748,621
'4278025600,  갈말읍,'35,30 - 34세,1998,1351,726,625
'4278025600,  갈말읍,'40,35 - 39세,1998,1402,721,681
'4278025600,  갈말읍,'45,40 - 44세,1998,1181,633,548
'4278025600,  갈말읍,'50,45 - 49세,1998,732,375,357
'4278025600,  갈말읍,'55,50 - 54세,1998,746,380,366
'4278025600,  갈말읍,'60,55 - 59세,1998,808,370,438
'4278025600,  갈말읍,'65,60 - 64세,1998,637,308,329
'4278025600,  갈말읍,'70,65 - 69세,1998,428,188,240
'4278025600,  갈말읍,'75,70 - 74세,1998,307,111,196
'4278025600,  갈말읍,'80,75 - 79세,1998,261,112,149
'4278025600,  갈말읍,'85,80 - 84세,1998,125,49,76
'4278025600,  갈말읍,'90,85+ ,1998,87,33,54
'4278025900,  동송읍,'00,계,1998,18825,9562,9263
'4278025900,  동송읍,'05,0 - 4세,1998,1244,652,592
'4278025900,  동송읍,'10,5 - 9세,1998,1345,699,646
'4278025900,  동송읍,'15,10 - 14세,1998,1278,640,638
'4278025900,  동송읍,'20,15 - 19세,1998,1655,877,778
'4278025900,  동송읍,'25,20 - 24세,1998,1589,877,712
'4278025900,  동송읍,'30,25 - 29세,1998,1577,885,692
'4278025900,  동송읍,'35,30 - 34세,1998,1522,789,733
'4278025900,  동송읍,'40,35 - 39세,1998,1721,888,833
'4278025900,  동송읍,'45,40 - 44세,1998,1473,775,698
'4278025900,  동송읍,'50,45 - 49세,1998,880,411,469
'4278025900,  동송읍,'55,50 - 54세,1998,996,509,487
'4278025900,  동송읍,'60,55 - 59세,1998,1136,547,589
'4278025900,  동송읍,'65,60 - 64세,1998,772,364,408
'4278025900,  동송읍,'70,65 - 69세,1998,559,247,312
'4278025900,  동송읍,'75,70 - 74세,1998,426,134,292
'4278025900,  동송읍,'80,75 - 79세,1998,342,150,192
'4278025900,  동송읍,'85,80 - 84세,1998,192,66,126
'4278025900,  동송읍,'90,85+ ,1998,118,52,66
'4278031000,  서면,'00,계,1998,7282,3702,3580
'4278031000,  서면,'05,0 - 4세,1998,515,274,241
'4278031000,  서면,'10,5 - 9세,1998,548,277,271
'4278031000,  서면,'15,10 - 14세,1998,462,239,223
'4278031000,  서면,'20,15 - 19세,1998,600,300,300
'4278031000,  서면,'25,20 - 24세,1998,607,322,285
'4278031000,  서면,'30,25 - 29세,1998,625,358,267
'4278031000,  서면,'35,30 - 34세,1998,647,352,295
'4278031000,  서면,'40,35 - 39세,1998,643,324,319
'4278031000,  서면,'45,40 - 44세,1998,525,284,241
'4278031000,  서면,'50,45 - 49세,1998,335,158,177
'4278031000,  서면,'55,50 - 54세,1998,365,189,176
'4278031000,  서면,'60,55 - 59세,1998,455,210,245
'4278031000,  서면,'65,60 - 64세,1998,316,151,165
'4278031000,  서면,'70,65 - 69세,1998,232,103,129
'4278031000,  서면,'75,70 - 74세,1998,180,66,114
'4278031000,  서면,'80,75 - 79세,1998,135,58,77
'4278031000,  서면,'85,80 - 84세,1998,55,27,28
'4278031000,  서면,'90,85+ ,1998,37,10,27
'4278032000,  근남면,'00,계,1998,2847,1449,1398
'4278032000,  근남면,'05,0 - 4세,1998,145,75,70
'4278032000,  근남면,'10,5 - 9세,1998,177,95,82
'4278032000,  근남면,'15,10 - 14세,1998,168,78,90
'4278032000,  근남면,'20,15 - 19세,1998,259,124,135
'4278032000,  근남면,'25,20 - 24세,1998,279,160,119
'4278032000,  근남면,'30,25 - 29세,1998,249,157,92
'4278032000,  근남면,'35,30 - 34세,1998,181,97,84
'4278032000,  근남면,'40,35 - 39세,1998,235,125,110
'4278032000,  근남면,'45,40 - 44세,1998,202,103,99
'4278032000,  근남면,'50,45 - 49세,1998,137,75,62
'4278032000,  근남면,'55,50 - 54세,1998,172,79,93
'4278032000,  근남면,'60,55 - 59세,1998,183,84,99
'4278032000,  근남면,'65,60 - 64세,1998,145,70,75
'4278032000,  근남면,'70,65 - 69세,1998,110,45,65
'4278032000,  근남면,'75,70 - 74세,1998,93,31,62
'4278032000,  근남면,'80,75 - 79세,1998,59,26,33
'4278032000,  근남면,'85,80 - 84세,1998,28,13,15
'4278032000,  근남면,'90,85+ ,1998,25,12,13
'42790, 화천군,'00,계,1998,25916,13344,12572
'42790, 화천군,'05,0 - 4세,1998,2011,1036,975
'42790, 화천군,'10,5 - 9세,1998,1805,963,842
'42790, 화천군,'15,10 - 14세,1998,1549,765,784
'42790, 화천군,'20,15 - 19세,1998,1773,902,871
'42790, 화천군,'25,20 - 24세,1998,1957,1106,851
'42790, 화천군,'30,25 - 29세,1998,2482,1413,1069
'42790, 화천군,'35,30 - 34세,1998,2317,1246,1071
'42790, 화천군,'40,35 - 39세,1998,2189,1197,992
'42790, 화천군,'45,40 - 44세,1998,1784,1022,762
'42790, 화천군,'50,45 - 49세,1998,1028,506,522
'42790, 화천군,'55,50 - 54세,1998,1214,601,613
'42790, 화천군,'60,55 - 59세,1998,1781,829,952
'42790, 화천군,'65,60 - 64세,1998,1386,640,746
'42790, 화천군,'70,65 - 69세,1998,937,413,524
'42790, 화천군,'75,70 - 74세,1998,668,274,394
'42790, 화천군,'80,75 - 79세,1998,533,231,302
'42790, 화천군,'85,80 - 84세,1998,281,110,171
'42790, 화천군,'90,85+ ,1998,221,90,131
'4279025000,  화천읍,'00,계,1998,9167,4633,4534
'4279025000,  화천읍,'05,0 - 4세,1998,701,347,354
'4279025000,  화천읍,'10,5 - 9세,1998,706,356,350
'4279025000,  화천읍,'15,10 - 14세,1998,575,282,293
'4279025000,  화천읍,'20,15 - 19세,1998,616,310,306
'4279025000,  화천읍,'25,20 - 24세,1998,693,368,325
'4279025000,  화천읍,'30,25 - 29세,1998,842,473,369
'4279025000,  화천읍,'35,30 - 34세,1998,855,444,411
'4279025000,  화천읍,'40,35 - 39세,1998,860,471,389
'4279025000,  화천읍,'45,40 - 44세,1998,653,377,276
'4279025000,  화천읍,'50,45 - 49세,1998,363,170,193
'4279025000,  화천읍,'55,50 - 54세,1998,420,210,210
'4279025000,  화천읍,'60,55 - 59세,1998,634,285,349
'4279025000,  화천읍,'65,60 - 64세,1998,438,204,234
'4279025000,  화천읍,'70,65 - 69세,1998,289,124,165
'4279025000,  화천읍,'75,70 - 74세,1998,190,77,113
'4279025000,  화천읍,'80,75 - 79세,1998,172,80,92
'4279025000,  화천읍,'85,80 - 84세,1998,88,27,61
'4279025000,  화천읍,'90,85+ ,1998,72,28,44
'4279031000,  간동면,'00,계,1998,2860,1526,1334
'4279031000,  간동면,'05,0 - 4세,1998,150,91,59
'4279031000,  간동면,'10,5 - 9세,1998,139,82,57
'4279031000,  간동면,'15,10 - 14세,1998,120,57,63
'4279031000,  간동면,'20,15 - 19세,1998,177,87,90
'4279031000,  간동면,'25,20 - 24세,1998,202,116,86
'4279031000,  간동면,'30,25 - 29세,1998,223,141,82
'4279031000,  간동면,'35,30 - 34세,1998,225,141,84
'4279031000,  간동면,'40,35 - 39세,1998,202,121,81
'4279031000,  간동면,'45,40 - 44세,1998,172,103,69
'4279031000,  간동면,'50,45 - 49세,1998,107,49,58
'4279031000,  간동면,'55,50 - 54세,1998,179,78,101
'4279031000,  간동면,'60,55 - 59세,1998,271,137,134
'4279031000,  간동면,'65,60 - 64세,1998,244,110,134
'4279031000,  간동면,'70,65 - 69세,1998,182,85,97
'4279031000,  간동면,'75,70 - 74세,1998,104,51,53
'4279031000,  간동면,'80,75 - 79세,1998,82,35,47
'4279031000,  간동면,'85,80 - 84세,1998,53,28,25
'4279031000,  간동면,'90,85+ ,1998,28,14,14
'4279032000,  하남면,'00,계,1998,2324,1184,1140
'4279032000,  하남면,'05,0 - 4세,1998,117,47,70
'4279032000,  하남면,'10,5 - 9세,1998,110,63,47
'4279032000,  하남면,'15,10 - 14세,1998,158,90,68
'4279032000,  하남면,'20,15 - 19세,1998,219,121,98
'4279032000,  하남면,'25,20 - 24세,1998,195,108,87
'4279032000,  하남면,'30,25 - 29세,1998,153,87,66
'4279032000,  하남면,'35,30 - 34세,1998,121,65,56
'4279032000,  하남면,'40,35 - 39세,1998,173,102,71
'4279032000,  하남면,'45,40 - 44세,1998,175,94,81
'4279032000,  하남면,'50,45 - 49세,1998,116,61,55
'4279032000,  하남면,'55,50 - 54세,1998,124,64,60
'4279032000,  하남면,'60,55 - 59세,1998,213,111,102
'4279032000,  하남면,'65,60 - 64세,1998,146,60,86
'4279032000,  하남면,'70,65 - 69세,1998,87,30,57
'4279032000,  하남면,'75,70 - 74세,1998,66,21,45
'4279032000,  하남면,'80,75 - 79세,1998,73,29,44
'4279032000,  하남면,'85,80 - 84세,1998,43,18,25
'4279032000,  하남면,'90,85+ ,1998,35,13,22
'4279033000,  상서면,'00,계,1998,5182,2683,2499
'4279033000,  상서면,'05,0 - 4세,1998,464,240,224
'4279033000,  상서면,'10,5 - 9세,1998,386,216,170
'4279033000,  상서면,'15,10 - 14세,1998,282,144,138
'4279033000,  상서면,'20,15 - 19세,1998,302,154,148
'4279033000,  상서면,'25,20 - 24세,1998,422,245,177
'4279033000,  상서면,'30,25 - 29세,1998,627,347,280
'4279033000,  상서면,'35,30 - 34세,1998,508,274,234
'4279033000,  상서면,'40,35 - 39세,1998,383,218,165
'4279033000,  상서면,'45,40 - 44세,1998,305,167,138
'4279033000,  상서면,'50,45 - 49세,1998,188,94,94
'4279033000,  상서면,'55,50 - 54세,1998,224,113,111
'4279033000,  상서면,'60,55 - 59세,1998,321,135,186
'4279033000,  상서면,'65,60 - 64세,1998,250,119,131
'4279033000,  상서면,'70,65 - 69세,1998,190,86,104
'4279033000,  상서면,'75,70 - 74세,1998,135,55,80
'4279033000,  상서면,'80,75 - 79세,1998,99,39,60
'4279033000,  상서면,'85,80 - 84세,1998,51,17,34
'4279033000,  상서면,'90,85+ ,1998,45,20,25
'4279034000,  사내면,'00,계,1998,6383,3318,3065
'4279034000,  사내면,'05,0 - 4세,1998,579,311,268
'4279034000,  사내면,'10,5 - 9세,1998,464,246,218
'4279034000,  사내면,'15,10 - 14세,1998,414,192,222
'4279034000,  사내면,'20,15 - 19세,1998,459,230,229
'4279034000,  사내면,'25,20 - 24세,1998,445,269,176
'4279034000,  사내면,'30,25 - 29세,1998,637,365,272
'4279034000,  사내면,'35,30 - 34세,1998,608,322,286
'4279034000,  사내면,'40,35 - 39세,1998,571,285,286
'4279034000,  사내면,'45,40 - 44세,1998,479,281,198
'4279034000,  사내면,'50,45 - 49세,1998,254,132,122
'4279034000,  사내면,'55,50 - 54세,1998,267,136,131
'4279034000,  사내면,'60,55 - 59세,1998,342,161,181
'4279034000,  사내면,'65,60 - 64세,1998,308,147,161
'4279034000,  사내면,'70,65 - 69세,1998,189,88,101
'4279034000,  사내면,'75,70 - 74세,1998,173,70,103
'4279034000,  사내면,'80,75 - 79세,1998,107,48,59
'4279034000,  사내면,'85,80 - 84세,1998,46,20,26
'4279034000,  사내면,'90,85+ ,1998,41,15,26
'42800, 양구군,'00,계,1998,24027,12303,11724
'42800, 양구군,'05,0 - 4세,1998,1802,1000,802
'42800, 양구군,'10,5 - 9세,1998,1739,898,841
'42800, 양구군,'15,10 - 14세,1998,1563,749,814
'42800, 양구군,'20,15 - 19세,1998,1814,912,902
'42800, 양구군,'25,20 - 24세,1998,1908,1096,812
'42800, 양구군,'30,25 - 29세,1998,2123,1144,979
'42800, 양구군,'35,30 - 34세,1998,1934,1016,918
'42800, 양구군,'40,35 - 39세,1998,2219,1188,1031
'42800, 양구군,'45,40 - 44세,1998,1784,1041,743
'42800, 양구군,'50,45 - 49세,1998,969,499,470
'42800, 양구군,'55,50 - 54세,1998,1130,555,575
'42800, 양구군,'60,55 - 59세,1998,1484,695,789
'42800, 양구군,'65,60 - 64세,1998,1202,580,622
'42800, 양구군,'70,65 - 69세,1998,793,300,493
'42800, 양구군,'75,70 - 74세,1998,636,253,383
'42800, 양구군,'80,75 - 79세,1998,483,208,275
'42800, 양구군,'85,80 - 84세,1998,278,115,163
'42800, 양구군,'90,85+ ,1998,166,54,112
'4280025000,  양구읍,'00,계,1998,13027,6675,6352
'4280025000,  양구읍,'05,0 - 4세,1998,1074,599,475
'4280025000,  양구읍,'10,5 - 9세,1998,984,508,476
'4280025000,  양구읍,'15,10 - 14세,1998,841,404,437
'4280025000,  양구읍,'20,15 - 19세,1998,989,510,479
'4280025000,  양구읍,'25,20 - 24세,1998,1014,568,446
'4280025000,  양구읍,'30,25 - 29세,1998,1210,633,577
'4280025000,  양구읍,'35,30 - 34세,1998,1153,600,553
'4280025000,  양구읍,'40,35 - 39세,1998,1315,676,639
'4280025000,  양구읍,'45,40 - 44세,1998,1000,598,402
'4280025000,  양구읍,'50,45 - 49세,1998,537,289,248
'4280025000,  양구읍,'55,50 - 54세,1998,556,272,284
'4280025000,  양구읍,'60,55 - 59세,1998,701,335,366
'4280025000,  양구읍,'65,60 - 64세,1998,551,255,296
'4280025000,  양구읍,'70,65 - 69세,1998,383,138,245
'4280025000,  양구읍,'75,70 - 74세,1998,282,114,168
'4280025000,  양구읍,'80,75 - 79세,1998,236,102,134
'4280025000,  양구읍,'85,80 - 84세,1998,125,47,78
'4280025000,  양구읍,'90,85+ ,1998,76,27,49
'4280031000,  남면,'00,계,1998,4657,2348,2309
'4280031000,  남면,'05,0 - 4세,1998,270,155,115
'4280031000,  남면,'10,5 - 9세,1998,287,147,140
'4280031000,  남면,'15,10 - 14세,1998,307,153,154
'4280031000,  남면,'20,15 - 19세,1998,390,179,211
'4280031000,  남면,'25,20 - 24세,1998,364,207,157
'4280031000,  남면,'30,25 - 29세,1998,379,211,168
'4280031000,  남면,'35,30 - 34세,1998,293,156,137
'4280031000,  남면,'40,35 - 39세,1998,377,209,168
'4280031000,  남면,'45,40 - 44세,1998,351,199,152
'4280031000,  남면,'50,45 - 49세,1998,189,93,96
'4280031000,  남면,'55,50 - 54세,1998,254,122,132
'4280031000,  남면,'60,55 - 59세,1998,343,156,187
'4280031000,  남면,'65,60 - 64세,1998,291,145,146
'4280031000,  남면,'70,65 - 69세,1998,186,68,118
'4280031000,  남면,'75,70 - 74세,1998,147,49,98
'4280031000,  남면,'80,75 - 79세,1998,119,55,64
'4280031000,  남면,'85,80 - 84세,1998,67,35,32
'4280031000,  남면,'90,85+ ,1998,43,9,34
'4280032000,  동면,'00,계,1998,2809,1435,1374
'4280032000,  동면,'05,0 - 4세,1998,214,106,108
'4280032000,  동면,'10,5 - 9세,1998,193,102,91
'4280032000,  동면,'15,10 - 14세,1998,174,79,95
'4280032000,  동면,'20,15 - 19세,1998,191,92,99
'4280032000,  동면,'25,20 - 24세,1998,253,148,105
'4280032000,  동면,'30,25 - 29세,1998,254,151,103
'4280032000,  동면,'35,30 - 34세,1998,213,113,100
'4280032000,  동면,'40,35 - 39세,1998,226,120,106
'4280032000,  동면,'45,40 - 44세,1998,184,101,83
'4280032000,  동면,'50,45 - 49세,1998,99,50,49
'4280032000,  동면,'55,50 - 54세,1998,133,67,66
'4280032000,  동면,'60,55 - 59세,1998,222,100,122
'4280032000,  동면,'65,60 - 64세,1998,154,81,73
'4280032000,  동면,'70,65 - 69세,1998,94,41,53
'4280032000,  동면,'75,70 - 74세,1998,95,40,55
'4280032000,  동면,'80,75 - 79세,1998,57,27,30
'4280032000,  동면,'85,80 - 84세,1998,32,10,22
'4280032000,  동면,'90,85+ ,1998,21,7,14
'4280033000,  방산면,'00,계,1998,1931,989,942
'4280033000,  방산면,'05,0 - 4세,1998,145,83,62
'4280033000,  방산면,'10,5 - 9세,1998,153,72,81
'4280033000,  방산면,'15,10 - 14세,1998,139,61,78
'4280033000,  방산면,'20,15 - 19세,1998,125,68,57
'4280033000,  방산면,'25,20 - 24세,1998,150,93,57
'4280033000,  방산면,'30,25 - 29세,1998,159,81,78
'4280033000,  방산면,'35,30 - 34세,1998,175,94,81
'4280033000,  방산면,'40,35 - 39세,1998,162,98,64
'4280033000,  방산면,'45,40 - 44세,1998,133,71,62
'4280033000,  방산면,'50,45 - 49세,1998,69,33,36
'4280033000,  방산면,'55,50 - 54세,1998,87,42,45
'4280033000,  방산면,'60,55 - 59세,1998,108,51,57
'4280033000,  방산면,'65,60 - 64세,1998,109,52,57
'4280033000,  방산면,'70,65 - 69세,1998,71,28,43
'4280033000,  방산면,'75,70 - 74세,1998,64,31,33
'4280033000,  방산면,'80,75 - 79세,1998,40,15,25
'4280033000,  방산면,'85,80 - 84세,1998,28,11,17
'4280033000,  방산면,'90,85+ ,1998,14,5,9
'4280034000,  해안면,'00,계,1998,1603,856,747
'4280034000,  해안면,'05,0 - 4세,1998,99,57,42
'4280034000,  해안면,'10,5 - 9세,1998,122,69,53
'4280034000,  해안면,'15,10 - 14세,1998,102,52,50
'4280034000,  해안면,'20,15 - 19세,1998,119,63,56
'4280034000,  해안면,'25,20 - 24세,1998,127,80,47
'4280034000,  해안면,'30,25 - 29세,1998,121,68,53
'4280034000,  해안면,'35,30 - 34세,1998,100,53,47
'4280034000,  해안면,'40,35 - 39세,1998,139,85,54
'4280034000,  해안면,'45,40 - 44세,1998,116,72,44
'4280034000,  해안면,'50,45 - 49세,1998,75,34,41
'4280034000,  해안면,'55,50 - 54세,1998,100,52,48
'4280034000,  해안면,'60,55 - 59세,1998,110,53,57
'4280034000,  해안면,'65,60 - 64세,1998,97,47,50
'4280034000,  해안면,'70,65 - 69세,1998,59,25,34
'4280034000,  해안면,'75,70 - 74세,1998,48,19,29
'4280034000,  해안면,'80,75 - 79세,1998,31,9,22
'4280034000,  해안면,'85,80 - 84세,1998,26,12,14
'4280034000,  해안면,'90,85+ ,1998,12,6,6
'42810, 인제군,'00,계,1998,34288,17600,16688
'42810, 인제군,'05,0 - 4세,1998,2563,1318,1245
'42810, 인제군,'10,5 - 9세,1998,2499,1302,1197
'42810, 인제군,'15,10 - 14세,1998,2258,1146,1112
'42810, 인제군,'20,15 - 19세,1998,2713,1357,1356
'42810, 인제군,'25,20 - 24세,1998,2847,1568,1279
'42810, 인제군,'30,25 - 29세,1998,3039,1723,1316
'42810, 인제군,'35,30 - 34세,1998,2874,1525,1349
'42810, 인제군,'40,35 - 39세,1998,3136,1637,1499
'42810, 인제군,'45,40 - 44세,1998,2528,1437,1091
'42810, 인제군,'50,45 - 49세,1998,1415,718,697
'42810, 인제군,'55,50 - 54세,1998,1562,805,757
'42810, 인제군,'60,55 - 59세,1998,1959,943,1016
'42810, 인제군,'65,60 - 64세,1998,1719,824,895
'42810, 인제군,'70,65 - 69세,1998,1098,434,664
'42810, 인제군,'75,70 - 74세,1998,864,337,527
'42810, 인제군,'80,75 - 79세,1998,648,286,362
'42810, 인제군,'85,80 - 84세,1998,360,143,217
'42810, 인제군,'90,85+ ,1998,206,97,109
'4281025000,  인제읍,'00,계,1998,9695,5030,4665
'4281025000,  인제읍,'05,0 - 4세,1998,735,378,357
'4281025000,  인제읍,'10,5 - 9세,1998,752,390,362
'4281025000,  인제읍,'15,10 - 14세,1998,634,330,304
'4281025000,  인제읍,'20,15 - 19세,1998,781,390,391
'4281025000,  인제읍,'25,20 - 24세,1998,753,406,347
'4281025000,  인제읍,'30,25 - 29세,1998,895,523,372
'4281025000,  인제읍,'35,30 - 34세,1998,849,445,404
'4281025000,  인제읍,'40,35 - 39세,1998,937,493,444
'4281025000,  인제읍,'45,40 - 44세,1998,703,404,299
'4281025000,  인제읍,'50,45 - 49세,1998,426,232,194
'4281025000,  인제읍,'55,50 - 54세,1998,461,238,223
'4281025000,  인제읍,'60,55 - 59세,1998,512,241,271
'4281025000,  인제읍,'65,60 - 64세,1998,418,211,207
'4281025000,  인제읍,'70,65 - 69세,1998,269,115,154
'4281025000,  인제읍,'75,70 - 74세,1998,233,81,152
'4281025000,  인제읍,'80,75 - 79세,1998,160,77,83
'4281025000,  인제읍,'85,80 - 84세,1998,110,48,62
'4281025000,  인제읍,'90,85+ ,1998,67,28,39
'4281031000,  남면,'00,계,1998,3999,2065,1934
'4281031000,  남면,'05,0 - 4세,1998,279,148,131
'4281031000,  남면,'10,5 - 9세,1998,236,122,114
'4281031000,  남면,'15,10 - 14세,1998,251,128,123
'4281031000,  남면,'20,15 - 19세,1998,320,158,162
'4281031000,  남면,'25,20 - 24세,1998,308,179,129
'4281031000,  남면,'30,25 - 29세,1998,376,214,162
'4281031000,  남면,'35,30 - 34세,1998,290,165,125
'4281031000,  남면,'40,35 - 39세,1998,321,172,149
'4281031000,  남면,'45,40 - 44세,1998,302,167,135
'4281031000,  남면,'50,45 - 49세,1998,178,86,92
'4281031000,  남면,'55,50 - 54세,1998,171,92,79
'4281031000,  남면,'60,55 - 59세,1998,241,120,121
'4281031000,  남면,'65,60 - 64세,1998,268,117,151
'4281031000,  남면,'70,65 - 69세,1998,170,73,97
'4281031000,  남면,'75,70 - 74세,1998,123,54,69
'4281031000,  남면,'80,75 - 79세,1998,101,42,59
'4281031000,  남면,'85,80 - 84세,1998,40,16,24
'4281031000,  남면,'90,85+ ,1998,24,12,12
'4281032000,  북면,'00,계,1998,9019,4579,4440
'4281032000,  북면,'05,0 - 4세,1998,682,341,341
'4281032000,  북면,'10,5 - 9세,1998,657,349,308
'4281032000,  북면,'15,10 - 14세,1998,607,296,311
'4281032000,  북면,'20,15 - 19세,1998,666,348,318
'4281032000,  북면,'25,20 - 24세,1998,745,411,334
'4281032000,  북면,'30,25 - 29세,1998,780,424,356
'4281032000,  북면,'35,30 - 34세,1998,770,391,379
'4281032000,  북면,'40,35 - 39세,1998,853,441,412
'4281032000,  북면,'45,40 - 44세,1998,680,384,296
'4281032000,  북면,'50,45 - 49세,1998,386,201,185
'4281032000,  북면,'55,50 - 54세,1998,421,211,210
'4281032000,  북면,'60,55 - 59세,1998,548,258,290
'4281032000,  북면,'65,60 - 64세,1998,440,209,231
'4281032000,  북면,'70,65 - 69세,1998,264,105,159
'4281032000,  북면,'75,70 - 74세,1998,229,92,137
'4281032000,  북면,'80,75 - 79세,1998,172,69,103
'4281032000,  북면,'85,80 - 84세,1998,76,26,50
'4281032000,  북면,'90,85+ ,1998,43,23,20
'4281033000,  기린면,'00,계,1998,5505,2855,2650
'4281033000,  기린면,'05,0 - 4세,1998,404,220,184
'4281033000,  기린면,'10,5 - 9세,1998,409,221,188
'4281033000,  기린면,'15,10 - 14세,1998,372,192,180
'4281033000,  기린면,'20,15 - 19세,1998,459,229,230
'4281033000,  기린면,'25,20 - 24세,1998,485,279,206
'4281033000,  기린면,'30,25 - 29세,1998,438,241,197
'4281033000,  기린면,'35,30 - 34세,1998,486,266,220
'4281033000,  기린면,'40,35 - 39세,1998,496,259,237
'4281033000,  기린면,'45,40 - 44세,1998,391,220,171
'4281033000,  기린면,'50,45 - 49세,1998,213,105,108
'4281033000,  기린면,'55,50 - 54세,1998,225,112,113
'4281033000,  기린면,'60,55 - 59세,1998,328,172,156
'4281033000,  기린면,'65,60 - 64세,1998,286,131,155
'4281033000,  기린면,'70,65 - 69세,1998,188,69,119
'4281033000,  기린면,'75,70 - 74세,1998,141,59,82
'4281033000,  기린면,'80,75 - 79세,1998,95,48,47
'4281033000,  기린면,'85,80 - 84세,1998,62,20,42
'4281033000,  기린면,'90,85+ ,1998,27,12,15
'4281034000,  서화면,'00,계,1998,3794,1919,1875
'4281034000,  서화면,'05,0 - 4세,1998,331,166,165
'4281034000,  서화면,'10,5 - 9세,1998,304,153,151
'4281034000,  서화면,'15,10 - 14세,1998,234,111,123
'4281034000,  서화면,'20,15 - 19세,1998,307,143,164
'4281034000,  서화면,'25,20 - 24세,1998,358,182,176
'4281034000,  서화면,'30,25 - 29세,1998,380,221,159
'4281034000,  서화면,'35,30 - 34세,1998,319,176,143
'4281034000,  서화면,'40,35 - 39세,1998,334,167,167
'4281034000,  서화면,'45,40 - 44세,1998,288,161,127
'4281034000,  서화면,'50,45 - 49세,1998,122,54,68
'4281034000,  서화면,'55,50 - 54세,1998,168,93,75
'4281034000,  서화면,'60,55 - 59세,1998,182,84,98
'4281034000,  서화면,'65,60 - 64세,1998,157,78,79
'4281034000,  서화면,'70,65 - 69세,1998,112,48,64
'4281034000,  서화면,'75,70 - 74세,1998,72,23,49
'4281034000,  서화면,'80,75 - 79세,1998,64,30,34
'4281034000,  서화면,'85,80 - 84세,1998,35,14,21
'4281034000,  서화면,'90,85+ ,1998,27,15,12
'4281035000,  상남면,'00,계,1998,2276,1152,1124
'4281035000,  상남면,'05,0 - 4세,1998,132,65,67
'4281035000,  상남면,'10,5 - 9세,1998,141,67,74
'4281035000,  상남면,'15,10 - 14세,1998,160,89,71
'4281035000,  상남면,'20,15 - 19세,1998,180,89,91
'4281035000,  상남면,'25,20 - 24세,1998,198,111,87
'4281035000,  상남면,'30,25 - 29세,1998,170,100,70
'4281035000,  상남면,'35,30 - 34세,1998,160,82,78
'4281035000,  상남면,'40,35 - 39세,1998,195,105,90
'4281035000,  상남면,'45,40 - 44세,1998,164,101,63
'4281035000,  상남면,'50,45 - 49세,1998,90,40,50
'4281035000,  상남면,'55,50 - 54세,1998,116,59,57
'4281035000,  상남면,'60,55 - 59세,1998,148,68,80
'4281035000,  상남면,'65,60 - 64세,1998,150,78,72
'4281035000,  상남면,'70,65 - 69세,1998,95,24,71
'4281035000,  상남면,'75,70 - 74세,1998,66,28,38
'4281035000,  상남면,'80,75 - 79세,1998,56,20,36
'4281035000,  상남면,'85,80 - 84세,1998,37,19,18
'4281035000,  상남면,'90,85+ ,1998,18,7,11
'42820, 고성군,'00,계,1998,37319,18780,18539
'42820, 고성군,'05,0 - 4세,1998,2043,1071,972
'42820, 고성군,'10,5 - 9세,1998,2155,1114,1041
'42820, 고성군,'15,10 - 14세,1998,2276,1158,1118
'42820, 고성군,'20,15 - 19세,1998,3290,1741,1549
'42820, 고성군,'25,20 - 24세,1998,3323,1854,1469
'42820, 고성군,'30,25 - 29세,1998,2989,1706,1283
'42820, 고성군,'35,30 - 34세,1998,2602,1378,1224
'42820, 고성군,'40,35 - 39세,1998,3071,1642,1429
'42820, 고성군,'45,40 - 44세,1998,2794,1521,1273
'42820, 고성군,'50,45 - 49세,1998,1953,959,994
'42820, 고성군,'55,50 - 54세,1998,2170,1025,1145
'42820, 고성군,'60,55 - 59세,1998,2521,1240,1281
'42820, 고성군,'65,60 - 64세,1998,2037,929,1108
'42820, 고성군,'70,65 - 69세,1998,1284,485,799
'42820, 고성군,'75,70 - 74세,1998,1189,373,816
'42820, 고성군,'80,75 - 79세,1998,886,344,542
'42820, 고성군,'85,80 - 84세,1998,481,172,309
'42820, 고성군,'90,85+ ,1998,255,68,187
'4282025000,  간성읍,'00,계,1998,7929,4021,3908
'4282025000,  간성읍,'05,0 - 4세,1998,580,317,263
'4282025000,  간성읍,'10,5 - 9세,1998,573,309,264
'4282025000,  간성읍,'15,10 - 14세,1998,483,245,238
'4282025000,  간성읍,'20,15 - 19세,1998,593,310,283
'4282025000,  간성읍,'25,20 - 24세,1998,737,404,333
'4282025000,  간성읍,'30,25 - 29세,1998,760,427,333
'4282025000,  간성읍,'35,30 - 34세,1998,687,344,343
'4282025000,  간성읍,'40,35 - 39세,1998,671,348,323
'4282025000,  간성읍,'45,40 - 44세,1998,554,297,257
'4282025000,  간성읍,'50,45 - 49세,1998,354,157,197
'4282025000,  간성읍,'55,50 - 54세,1998,393,198,195
'4282025000,  간성읍,'60,55 - 59세,1998,455,233,222
'4282025000,  간성읍,'65,60 - 64세,1998,361,163,198
'4282025000,  간성읍,'70,65 - 69세,1998,211,82,129
'4282025000,  간성읍,'75,70 - 74세,1998,207,72,135
'4282025000,  간성읍,'80,75 - 79세,1998,159,64,95
'4282025000,  간성읍,'85,80 - 84세,1998,86,37,49
'4282025000,  간성읍,'90,85+ ,1998,65,14,51
'4282025300,  거진읍,'00,계,1998,11013,5499,5514
'4282025300,  거진읍,'05,0 - 4세,1998,537,284,253
'4282025300,  거진읍,'10,5 - 9세,1998,596,304,292
'4282025300,  거진읍,'15,10 - 14세,1998,678,341,337
'4282025300,  거진읍,'20,15 - 19세,1998,1001,517,484
'4282025300,  거진읍,'25,20 - 24세,1998,932,530,402
'4282025300,  거진읍,'30,25 - 29세,1998,799,456,343
'4282025300,  거진읍,'35,30 - 34세,1998,697,360,337
'4282025300,  거진읍,'40,35 - 39세,1998,911,493,418
'4282025300,  거진읍,'45,40 - 44세,1998,877,469,408
'4282025300,  거진읍,'50,45 - 49세,1998,614,304,310
'4282025300,  거진읍,'55,50 - 54세,1998,695,313,382
'4282025300,  거진읍,'60,55 - 59세,1998,778,387,391
'4282025300,  거진읍,'65,60 - 64세,1998,665,291,374
'4282025300,  거진읍,'70,65 - 69세,1998,408,165,243
'4282025300,  거진읍,'75,70 - 74세,1998,364,119,245
'4282025300,  거진읍,'80,75 - 79세,1998,247,96,151
'4282025300,  거진읍,'85,80 - 84세,1998,141,55,86
'4282025300,  거진읍,'90,85+ ,1998,73,15,58
'4282031000,  현내면,'00,계,1998,4382,2170,2212
'4282031000,  현내면,'05,0 - 4세,1998,173,93,80
'4282031000,  현내면,'10,5 - 9세,1998,223,104,119
'4282031000,  현내면,'15,10 - 14세,1998,261,119,142
'4282031000,  현내면,'20,15 - 19세,1998,451,236,215
'4282031000,  현내면,'25,20 - 24세,1998,392,231,161
'4282031000,  현내면,'30,25 - 29세,1998,280,169,111
'4282031000,  현내면,'35,30 - 34세,1998,228,123,105
'4282031000,  현내면,'40,35 - 39세,1998,335,169,166
'4282031000,  현내면,'45,40 - 44세,1998,354,193,161
'4282031000,  현내면,'50,45 - 49세,1998,258,130,128
'4282031000,  현내면,'55,50 - 54세,1998,276,133,143
'4282031000,  현내면,'60,55 - 59세,1998,341,167,174
'4282031000,  현내면,'65,60 - 64세,1998,247,106,141
'4282031000,  현내면,'70,65 - 69세,1998,186,67,119
'4282031000,  현내면,'75,70 - 74세,1998,165,53,112
'4282031000,  현내면,'80,75 - 79세,1998,132,46,86
'4282031000,  현내면,'85,80 - 84세,1998,57,24,33
'4282031000,  현내면,'90,85+ ,1998,23,7,16
'4282032000,  죽왕면,'00,계,1998,5400,2734,2666
'4282032000,  죽왕면,'05,0 - 4세,1998,313,159,154
'4282032000,  죽왕면,'10,5 - 9세,1998,299,163,136
'4282032000,  죽왕면,'15,10 - 14세,1998,327,166,161
'4282032000,  죽왕면,'20,15 - 19세,1998,459,258,201
'4282032000,  죽왕면,'25,20 - 24세,1998,489,264,225
'4282032000,  죽왕면,'30,25 - 29세,1998,468,266,202
'4282032000,  죽왕면,'35,30 - 34세,1998,378,206,172
'4282032000,  죽왕면,'40,35 - 39세,1998,418,227,191
'4282032000,  죽왕면,'45,40 - 44세,1998,394,220,174
'4282032000,  죽왕면,'50,45 - 49세,1998,227,121,106
'4282032000,  죽왕면,'55,50 - 54세,1998,290,142,148
'4282032000,  죽왕면,'60,55 - 59세,1998,386,174,212
'4282032000,  죽왕면,'65,60 - 64세,1998,306,137,169
'4282032000,  죽왕면,'70,65 - 69세,1998,221,90,131
'4282032000,  죽왕면,'75,70 - 74세,1998,177,50,127
'4282032000,  죽왕면,'80,75 - 79세,1998,148,63,85
'4282032000,  죽왕면,'85,80 - 84세,1998,61,20,41
'4282032000,  죽왕면,'90,85+ ,1998,39,8,31
'4282033000,  토성면,'00,계,1998,8595,4356,4239
'4282033000,  토성면,'05,0 - 4세,1998,440,218,222
'4282033000,  토성면,'10,5 - 9세,1998,464,234,230
'4282033000,  토성면,'15,10 - 14세,1998,527,287,240
'4282033000,  토성면,'20,15 - 19세,1998,786,420,366
'4282033000,  토성면,'25,20 - 24세,1998,773,425,348
'4282033000,  토성면,'30,25 - 29세,1998,682,388,294
'4282033000,  토성면,'35,30 - 34세,1998,612,345,267
'4282033000,  토성면,'40,35 - 39세,1998,736,405,331
'4282033000,  토성면,'45,40 - 44세,1998,615,342,273
'4282033000,  토성면,'50,45 - 49세,1998,500,247,253
'4282033000,  토성면,'55,50 - 54세,1998,516,239,277
'4282033000,  토성면,'60,55 - 59세,1998,561,279,282
'4282033000,  토성면,'65,60 - 64세,1998,458,232,226
'4282033000,  토성면,'70,65 - 69세,1998,258,81,177
'4282033000,  토성면,'75,70 - 74세,1998,276,79,197
'4282033000,  토성면,'80,75 - 79세,1998,200,75,125
'4282033000,  토성면,'85,80 - 84세,1998,136,36,100
'4282033000,  토성면,'90,85+ ,1998,55,24,31
'42830, 양양군,'00,계,1998,31103,15607,15496
'42830, 양양군,'05,0 - 4세,1998,1614,832,782
'42830, 양양군,'10,5 - 9세,1998,1765,914,851
'42830, 양양군,'15,10 - 14세,1998,1816,922,894
'42830, 양양군,'20,15 - 19세,1998,2768,1417,1351
'42830, 양양군,'25,20 - 24세,1998,2861,1564,1297
'42830, 양양군,'30,25 - 29세,1998,2446,1374,1072
'42830, 양양군,'35,30 - 34세,1998,2104,1128,976
'42830, 양양군,'40,35 - 39세,1998,2326,1222,1104
'42830, 양양군,'45,40 - 44세,1998,2248,1168,1080
'42830, 양양군,'50,45 - 49세,1998,1654,810,844
'42830, 양양군,'55,50 - 54세,1998,1884,923,961
'42830, 양양군,'60,55 - 59세,1998,2239,1101,1138
'42830, 양양군,'65,60 - 64세,1998,1888,972,916
'42830, 양양군,'70,65 - 69세,1998,1111,453,658
'42830, 양양군,'75,70 - 74세,1998,949,334,615
'42830, 양양군,'80,75 - 79세,1998,720,269,451
'42830, 양양군,'85,80 - 84세,1998,459,130,329
'42830, 양양군,'90,85+ ,1998,251,74,177
'4283025000,  양양읍,'00,계,1998,12072,6038,6034
'4283025000,  양양읍,'05,0 - 4세,1998,859,456,403
'4283025000,  양양읍,'10,5 - 9세,1998,907,467,440
'4283025000,  양양읍,'15,10 - 14세,1998,777,401,376
'4283025000,  양양읍,'20,15 - 19세,1998,996,496,500
'4283025000,  양양읍,'25,20 - 24세,1998,986,515,471
'4283025000,  양양읍,'30,25 - 29세,1998,1086,564,522
'4283025000,  양양읍,'35,30 - 34세,1998,1079,550,529
'4283025000,  양양읍,'40,35 - 39세,1998,1049,543,506
'4283025000,  양양읍,'45,40 - 44세,1998,882,464,418
'4283025000,  양양읍,'50,45 - 49세,1998,590,286,304
'4283025000,  양양읍,'55,50 - 54세,1998,623,300,323
'4283025000,  양양읍,'60,55 - 59세,1998,696,356,340
'4283025000,  양양읍,'65,60 - 64세,1998,538,279,259
'4283025000,  양양읍,'70,65 - 69세,1998,320,135,185
'4283025000,  양양읍,'75,70 - 74세,1998,261,89,172
'4283025000,  양양읍,'80,75 - 79세,1998,207,74,133
'4283025000,  양양읍,'85,80 - 84세,1998,137,41,96
'4283025000,  양양읍,'90,85+ ,1998,79,22,57
'4283031000,  서면,'00,계,1998,3880,1996,1884
'4283031000,  서면,'05,0 - 4세,1998,149,80,69
'4283031000,  서면,'10,5 - 9세,1998,142,71,71
'4283031000,  서면,'15,10 - 14세,1998,192,95,97
'4283031000,  서면,'20,15 - 19세,1998,380,201,179
'4283031000,  서면,'25,20 - 24세,1998,416,231,185
'4283031000,  서면,'30,25 - 29세,1998,270,174,96
'4283031000,  서면,'35,30 - 34세,1998,221,134,87
'4283031000,  서면,'40,35 - 39세,1998,250,140,110
'4283031000,  서면,'45,40 - 44세,1998,267,135,132
'4283031000,  서면,'50,45 - 49세,1998,223,99,124
'4283031000,  서면,'55,50 - 54세,1998,286,130,156
'4283031000,  서면,'60,55 - 59세,1998,337,177,160
'4283031000,  서면,'65,60 - 64세,1998,278,149,129
'4283031000,  서면,'70,65 - 69세,1998,150,60,90
'4283031000,  서면,'75,70 - 74세,1998,124,52,72
'4283031000,  서면,'80,75 - 79세,1998,108,43,65
'4283031000,  서면,'85,80 - 84세,1998,59,18,41
'4283031000,  서면,'90,85+ ,1998,28,7,21
'4283032000,  손양면,'00,계,1998,2846,1429,1417
'4283032000,  손양면,'05,0 - 4세,1998,103,55,48
'4283032000,  손양면,'10,5 - 9세,1998,124,66,58
'4283032000,  손양면,'15,10 - 14세,1998,133,57,76
'4283032000,  손양면,'20,15 - 19세,1998,268,143,125
'4283032000,  손양면,'25,20 - 24세,1998,293,159,134
'4283032000,  손양면,'30,25 - 29세,1998,227,132,95
'4283032000,  손양면,'35,30 - 34세,1998,126,78,48
'4283032000,  손양면,'40,35 - 39세,1998,178,91,87
'4283032000,  손양면,'45,40 - 44세,1998,193,101,92
'4283032000,  손양면,'50,45 - 49세,1998,143,70,73
'4283032000,  손양면,'55,50 - 54세,1998,187,91,96
'4283032000,  손양면,'60,55 - 59세,1998,271,118,153
'4283032000,  손양면,'65,60 - 64세,1998,247,131,116
'4283032000,  손양면,'70,65 - 69세,1998,106,47,59
'4283032000,  손양면,'75,70 - 74세,1998,92,34,58
'4283032000,  손양면,'80,75 - 79세,1998,77,29,48
'4283032000,  손양면,'85,80 - 84세,1998,51,16,35
'4283032000,  손양면,'90,85+ ,1998,27,11,16
'4283033000,  현북면,'00,계,1998,3198,1633,1565
'4283033000,  현북면,'05,0 - 4세,1998,124,58,66
'4283033000,  현북면,'10,5 - 9세,1998,171,87,84
'4283033000,  현북면,'15,10 - 14세,1998,204,114,90
'4283033000,  현북면,'20,15 - 19세,1998,302,163,139
'4283033000,  현북면,'25,20 - 24세,1998,289,167,122
'4283033000,  현북면,'30,25 - 29세,1998,228,131,97
'4283033000,  현북면,'35,30 - 34세,1998,185,90,95
'4283033000,  현북면,'40,35 - 39세,1998,224,114,110
'4283033000,  현북면,'45,40 - 44세,1998,242,124,118
'4283033000,  현북면,'50,45 - 49세,1998,181,107,74
'4283033000,  현북면,'55,50 - 54세,1998,199,103,96
'4283033000,  현북면,'60,55 - 59세,1998,245,118,127
'4283033000,  현북면,'65,60 - 64세,1998,209,105,104
'4283033000,  현북면,'70,65 - 69세,1998,142,58,84
'4283033000,  현북면,'75,70 - 74세,1998,111,48,63
'4283033000,  현북면,'80,75 - 79세,1998,68,28,40
'4283033000,  현북면,'85,80 - 84세,1998,49,11,38
'4283033000,  현북면,'90,85+ ,1998,25,7,18
'4283034000,  현남면,'00,계,1998,4317,2140,2177
'4283034000,  현남면,'05,0 - 4세,1998,135,72,63
'4283034000,  현남면,'10,5 - 9세,1998,159,79,80
'4283034000,  현남면,'15,10 - 14세,1998,246,127,119
'4283034000,  현남면,'20,15 - 19세,1998,382,196,186
'4283034000,  현남면,'25,20 - 24세,1998,419,233,186
'4283034000,  현남면,'30,25 - 29세,1998,268,161,107
'4283034000,  현남면,'35,30 - 34세,1998,202,117,85
'4283034000,  현남면,'40,35 - 39세,1998,280,152,128
'4283034000,  현남면,'45,40 - 44세,1998,321,175,146
'4283034000,  현남면,'50,45 - 49세,1998,248,121,127
'4283034000,  현남면,'55,50 - 54세,1998,286,152,134
'4283034000,  현남면,'60,55 - 59세,1998,313,143,170
'4283034000,  현남면,'65,60 - 64세,1998,331,164,167
'4283034000,  현남면,'70,65 - 69세,1998,231,89,142
'4283034000,  현남면,'75,70 - 74세,1998,218,63,155
'4283034000,  현남면,'80,75 - 79세,1998,155,61,94
'4283034000,  현남면,'85,80 - 84세,1998,84,23,61
'4283034000,  현남면,'90,85+ ,1998,39,12,27
'4283035000,  강현면,'00,계,1998,4790,2371,2419
'4283035000,  강현면,'05,0 - 4세,1998,244,111,133
'4283035000,  강현면,'10,5 - 9세,1998,262,144,118
'4283035000,  강현면,'15,10 - 14세,1998,264,128,136
'4283035000,  강현면,'20,15 - 19세,1998,440,218,222
'4283035000,  강현면,'25,20 - 24세,1998,458,259,199
'4283035000,  강현면,'30,25 - 29세,1998,367,212,155
'4283035000,  강현면,'35,30 - 34세,1998,291,159,132
'4283035000,  강현면,'40,35 - 39세,1998,345,182,163
'4283035000,  강현면,'45,40 - 44세,1998,343,169,174
'4283035000,  강현면,'50,45 - 49세,1998,269,127,142
'4283035000,  강현면,'55,50 - 54세,1998,303,147,156
'4283035000,  강현면,'60,55 - 59세,1998,377,189,188
'4283035000,  강현면,'65,60 - 64세,1998,285,144,141
'4283035000,  강현면,'70,65 - 69세,1998,162,64,98
'4283035000,  강현면,'75,70 - 74세,1998,143,48,95
'4283035000,  강현면,'80,75 - 79세,1998,105,34,71
'4283035000,  강현면,'85,80 - 84세,1998,79,21,58
'4283035000,  강현면,'90,85+ ,1998,53,15,38
'43,충청북도,'00,계,1998,1484466,746355,738111
'43,충청북도,'05,0 - 4세,1998,105987,55783,50204
'43,충청북도,'10,5 - 9세,1998,105935,56365,49570
'43,충청북도,'15,10 - 14세,1998,102908,53537,49371
'43,충청북도,'20,15 - 19세,1998,131883,67138,64745
'43,충청북도,'25,20 - 24세,1998,130499,68183,62316
'43,충청북도,'30,25 - 29세,1998,135212,71442,63770
'43,충청북도,'35,30 - 34세,1998,126938,65449,61489
'43,충청북도,'40,35 - 39세,1998,130588,67713,62875
'43,충청북도,'45,40 - 44세,1998,110987,57955,53032
'43,충청북도,'50,45 - 49세,1998,74959,38526,36433
'43,충청북도,'55,50 - 54세,1998,63937,31640,32297
'43,충청북도,'60,55 - 59세,1998,74049,34968,39081
'43,충청북도,'65,60 - 64세,1998,67062,30518,36544
'43,충청북도,'70,65 - 69세,1998,47242,18865,28377
'43,충청북도,'75,70 - 74세,1998,32794,13064,19730
'43,충청북도,'80,75 - 79세,1998,23172,8843,14329
'43,충청북도,'85,80 - 84세,1998,12790,4333,8457
'43,충청북도,'90,85+ ,1998,7524,2033,5491
'43110, 청주시,'00,계,1998,557405,277384,280021
'43110, 청주시,'05,0 - 4세,1998,45795,23933,21862
'43110, 청주시,'10,5 - 9세,1998,46531,24835,21696
'43110, 청주시,'15,10 - 14세,1998,43173,22748,20425
'43110, 청주시,'20,15 - 19세,1998,50886,25835,25051
'43110, 청주시,'25,20 - 24세,1998,49322,23856,25466
'43110, 청주시,'30,25 - 29세,1998,55984,27750,28234
'43110, 청주시,'35,30 - 34세,1998,54083,26615,27468
'43110, 청주시,'40,35 - 39세,1998,55376,27935,27441
'43110, 청주시,'45,40 - 44세,1998,45258,23116,22142
'43110, 청주시,'50,45 - 49세,1998,27741,14302,13439
'43110, 청주시,'55,50 - 54세,1998,21423,10731,10692
'43110, 청주시,'60,55 - 59세,1998,19624,9534,10090
'43110, 청주시,'65,60 - 64세,1998,15284,6978,8306
'43110, 청주시,'70,65 - 69세,1998,10291,3850,6441
'43110, 청주시,'75,70 - 74세,1998,6935,2469,4466
'43110, 청주시,'80,75 - 79세,1998,5066,1683,3383
'43110, 청주시,'85,80 - 84세,1998,2891,840,2051
'43110, 청주시,'90,85+ ,1998,1742,374,1368
'43111, 상당구,'00,계,1998,234924,116786,118138
'43111, 상당구,'05,0 - 4세,1998,17813,9395,8418
'43111, 상당구,'10,5 - 9세,1998,19178,10249,8929
'43111, 상당구,'15,10 - 14세,1998,18413,9622,8791
'43111, 상당구,'20,15 - 19세,1998,22071,11187,10884
'43111, 상당구,'25,20 - 24세,1998,20334,10149,10185
'43111, 상당구,'30,25 - 29세,1998,21767,10850,10917
'43111, 상당구,'35,30 - 34세,1998,21634,10533,11101
'43111, 상당구,'40,35 - 39세,1998,23188,11574,11614
'43111, 상당구,'45,40 - 44세,1998,19405,9796,9609
'43111, 상당구,'50,45 - 49세,1998,12164,6335,5829
'43111, 상당구,'55,50 - 54세,1998,9678,4763,4915
'43111, 상당구,'60,55 - 59세,1998,9290,4535,4755
'43111, 상당구,'65,60 - 64세,1998,7392,3396,3996
'43111, 상당구,'70,65 - 69세,1998,4862,1868,2994
'43111, 상당구,'75,70 - 74세,1998,3197,1177,2020
'43111, 상당구,'80,75 - 79세,1998,2325,784,1541
'43111, 상당구,'85,80 - 84세,1998,1360,386,974
'43111, 상당구,'90,85+ ,1998,853,187,666
'4311152500,  중앙동,'00,계,1998,10695,5462,5233
'4311152500,  중앙동,'05,0 - 4세,1998,478,253,225
'4311152500,  중앙동,'10,5 - 9세,1998,561,302,259
'4311152500,  중앙동,'15,10 - 14세,1998,724,410,314
'4311152500,  중앙동,'20,15 - 19세,1998,1091,579,512
'4311152500,  중앙동,'25,20 - 24세,1998,1074,610,464
'4311152500,  중앙동,'30,25 - 29세,1998,957,527,430
'4311152500,  중앙동,'35,30 - 34세,1998,694,366,328
'4311152500,  중앙동,'40,35 - 39세,1998,819,413,406
'4311152500,  중앙동,'45,40 - 44세,1998,856,409,447
'4311152500,  중앙동,'50,45 - 49세,1998,697,359,338
'4311152500,  중앙동,'55,50 - 54세,1998,665,329,336
'4311152500,  중앙동,'60,55 - 59세,1998,678,312,366
'4311152500,  중앙동,'65,60 - 64세,1998,533,262,271
'4311152500,  중앙동,'70,65 - 69세,1998,334,135,199
'4311152500,  중앙동,'75,70 - 74세,1998,241,96,145
'4311152500,  중앙동,'80,75 - 79세,1998,148,59,89
'4311152500,  중앙동,'85,80 - 84세,1998,89,27,62
'4311152500,  중앙동,'90,85+ ,1998,56,14,42
'4311154500,  성안동,'00,계,1998,11853,5911,5942
'4311154500,  성안동,'05,0 - 4세,1998,479,261,218
'4311154500,  성안동,'10,5 - 9세,1998,658,368,290
'4311154500,  성안동,'15,10 - 14세,1998,762,392,370
'4311154500,  성안동,'20,15 - 19세,1998,1173,609,564
'4311154500,  성안동,'25,20 - 24세,1998,1222,636,586
'4311154500,  성안동,'30,25 - 29세,1998,1034,597,437
'4311154500,  성안동,'35,30 - 34세,1998,744,370,374
'4311154500,  성안동,'40,35 - 39세,1998,896,442,454
'4311154500,  성안동,'45,40 - 44세,1998,993,458,535
'4311154500,  성안동,'50,45 - 49세,1998,790,384,406
'4311154500,  성안동,'55,50 - 54세,1998,712,348,364
'4311154500,  성안동,'60,55 - 59세,1998,743,354,389
'4311154500,  성안동,'65,60 - 64세,1998,618,302,316
'4311154500,  성안동,'70,65 - 69세,1998,429,163,266
'4311154500,  성안동,'75,70 - 74세,1998,255,115,140
'4311154500,  성안동,'80,75 - 79세,1998,171,59,112
'4311154500,  성안동,'85,80 - 84세,1998,108,37,71
'4311154500,  성안동,'90,85+ ,1998,66,16,50
'4311158000,  우암동,'00,계,1998,18490,9209,9281
'4311158000,  우암동,'05,0 - 4세,1998,1036,556,480
'4311158000,  우암동,'10,5 - 9세,1998,1115,578,537
'4311158000,  우암동,'15,10 - 14세,1998,1267,665,602
'4311158000,  우암동,'20,15 - 19세,1998,1770,901,869
'4311158000,  우암동,'25,20 - 24세,1998,2123,1106,1017
'4311158000,  우암동,'30,25 - 29세,1998,1857,1047,810
'4311158000,  우암동,'35,30 - 34세,1998,1325,667,658
'4311158000,  우암동,'40,35 - 39세,1998,1388,659,729
'4311158000,  우암동,'45,40 - 44세,1998,1398,692,706
'4311158000,  우암동,'50,45 - 49세,1998,1106,522,584
'4311158000,  우암동,'55,50 - 54세,1998,1009,452,557
'4311158000,  우암동,'60,55 - 59세,1998,1069,517,552
'4311158000,  우암동,'65,60 - 64세,1998,846,411,435
'4311158000,  우암동,'70,65 - 69세,1998,489,207,282
'4311158000,  우암동,'75,70 - 74세,1998,294,114,180
'4311158000,  우암동,'80,75 - 79세,1998,192,61,131
'4311158000,  우암동,'85,80 - 84세,1998,123,39,84
'4311158000,  우암동,'90,85+ ,1998,83,15,68
'4311159000,  내덕1동,'00,계,1998,15632,7800,7832
'4311159000,  내덕1동,'05,0 - 4세,1998,857,443,414
'4311159000,  내덕1동,'10,5 - 9세,1998,966,531,435
'4311159000,  내덕1동,'15,10 - 14세,1998,1081,568,513
'4311159000,  내덕1동,'20,15 - 19세,1998,1711,860,851
'4311159000,  내덕1동,'25,20 - 24세,1998,1738,900,838
'4311159000,  내덕1동,'30,25 - 29세,1998,1471,794,677
'4311159000,  내덕1동,'35,30 - 34세,1998,1071,557,514
'4311159000,  내덕1동,'40,35 - 39세,1998,1238,589,649
'4311159000,  내덕1동,'45,40 - 44세,1998,1266,612,654
'4311159000,  내덕1동,'50,45 - 49세,1998,1013,517,496
'4311159000,  내덕1동,'55,50 - 54세,1998,881,412,469
'4311159000,  내덕1동,'60,55 - 59세,1998,824,414,410
'4311159000,  내덕1동,'65,60 - 64세,1998,606,301,305
'4311159000,  내덕1동,'70,65 - 69세,1998,342,142,200
'4311159000,  내덕1동,'75,70 - 74세,1998,230,68,162
'4311159000,  내덕1동,'80,75 - 79세,1998,173,59,114
'4311159000,  내덕1동,'85,80 - 84세,1998,102,25,77
'4311159000,  내덕1동,'90,85+ ,1998,62,8,54
'4311160000,  내덕2동,'00,계,1998,16102,8042,8060
'4311160000,  내덕2동,'05,0 - 4세,1998,1007,528,479
'4311160000,  내덕2동,'10,5 - 9세,1998,944,520,424
'4311160000,  내덕2동,'15,10 - 14세,1998,1027,518,509
'4311160000,  내덕2동,'20,15 - 19세,1998,1640,784,856
'4311160000,  내덕2동,'25,20 - 24세,1998,2034,1041,993
'4311160000,  내덕2동,'30,25 - 29세,1998,1777,1017,760
'4311160000,  내덕2동,'35,30 - 34세,1998,1207,611,596
'4311160000,  내덕2동,'40,35 - 39세,1998,1221,620,601
'4311160000,  내덕2동,'45,40 - 44세,1998,1200,540,660
'4311160000,  내덕2동,'50,45 - 49세,1998,881,433,448
'4311160000,  내덕2동,'55,50 - 54세,1998,813,402,411
'4311160000,  내덕2동,'60,55 - 59세,1998,781,386,395
'4311160000,  내덕2동,'65,60 - 64세,1998,637,286,351
'4311160000,  내덕2동,'70,65 - 69세,1998,371,161,210
'4311160000,  내덕2동,'75,70 - 74세,1998,213,83,130
'4311160000,  내덕2동,'80,75 - 79세,1998,173,54,119
'4311160000,  내덕2동,'85,80 - 84세,1998,100,36,64
'4311160000,  내덕2동,'90,85+ ,1998,76,22,54
'4311161000,  율량·사천동,'00,계,1998,45801,22389,23412
'4311161000,  율량·사천동,'05,0 - 4세,1998,3986,2097,1889
'4311161000,  율량·사천동,'10,5 - 9세,1998,4636,2469,2167
'4311161000,  율량·사천동,'15,10 - 14세,1998,4341,2229,2112
'4311161000,  율량·사천동,'20,15 - 19세,1998,4145,1998,2147
'4311161000,  율량·사천동,'25,20 - 24세,1998,3059,1395,1664
'4311161000,  율량·사천동,'30,25 - 29세,1998,3965,1768,2197
'4311161000,  율량·사천동,'35,30 - 34세,1998,4743,2231,2512
'4311161000,  율량·사천동,'40,35 - 39세,1998,5418,2637,2781
'4311161000,  율량·사천동,'45,40 - 44세,1998,4223,2161,2062
'4311161000,  율량·사천동,'50,45 - 49세,1998,2068,1157,911
'4311161000,  율량·사천동,'55,50 - 54세,1998,1326,680,646
'4311161000,  율량·사천동,'60,55 - 59세,1998,1142,574,568
'4311161000,  율량·사천동,'65,60 - 64세,1998,928,413,515
'4311161000,  율량·사천동,'70,65 - 69세,1998,685,229,456
'4311161000,  율량·사천동,'75,70 - 74세,1998,455,155,300
'4311161000,  율량·사천동,'80,75 - 79세,1998,344,111,233
'4311161000,  율량·사천동,'85,80 - 84세,1998,202,55,147
'4311161000,  율량·사천동,'90,85+ ,1998,135,30,105
'4311162000,  탑·대성동,'00,계,1998,15339,7579,7760
'4311162000,  탑·대성동,'05,0 - 4세,1998,899,492,407
'4311162000,  탑·대성동,'10,5 - 9세,1998,939,519,420
'4311162000,  탑·대성동,'15,10 - 14세,1998,1122,600,522
'4311162000,  탑·대성동,'20,15 - 19세,1998,1514,751,763
'4311162000,  탑·대성동,'25,20 - 24세,1998,1510,720,790
'4311162000,  탑·대성동,'30,25 - 29세,1998,1455,784,671
'4311162000,  탑·대성동,'35,30 - 34세,1998,1065,544,521
'4311162000,  탑·대성동,'40,35 - 39세,1998,1303,642,661
'4311162000,  탑·대성동,'45,40 - 44세,1998,1285,604,681
'4311162000,  탑·대성동,'50,45 - 49세,1998,959,465,494
'4311162000,  탑·대성동,'55,50 - 54세,1998,811,395,416
'4311162000,  탑·대성동,'60,55 - 59세,1998,787,397,390
'4311162000,  탑·대성동,'65,60 - 64세,1998,613,291,322
'4311162000,  탑·대성동,'70,65 - 69세,1998,394,156,238
'4311162000,  탑·대성동,'75,70 - 74세,1998,294,110,184
'4311162000,  탑·대성동,'80,75 - 79세,1998,203,69,134
'4311162000,  탑·대성동,'85,80 - 84세,1998,110,25,85
'4311162000,  탑·대성동,'90,85+ ,1998,76,15,61
'4311167000,  영운동,'00,계,1998,15355,7640,7715
'4311167000,  영운동,'05,0 - 4세,1998,1190,617,573
'4311167000,  영운동,'10,5 - 9세,1998,1053,555,498
'4311167000,  영운동,'15,10 - 14세,1998,1080,560,520
'4311167000,  영운동,'20,15 - 19세,1998,1542,816,726
'4311167000,  영운동,'25,20 - 24세,1998,1496,726,770
'4311167000,  영운동,'30,25 - 29세,1998,1648,815,833
'4311167000,  영운동,'35,30 - 34세,1998,1427,739,688
'4311167000,  영운동,'40,35 - 39세,1998,1399,676,723
'4311167000,  영운동,'45,40 - 44세,1998,1189,601,588
'4311167000,  영운동,'50,45 - 49세,1998,814,417,397
'4311167000,  영운동,'55,50 - 54세,1998,668,325,343
'4311167000,  영운동,'60,55 - 59세,1998,610,285,325
'4311167000,  영운동,'65,60 - 64세,1998,477,231,246
'4311167000,  영운동,'70,65 - 69세,1998,294,113,181
'4311167000,  영운동,'75,70 - 74세,1998,186,77,109
'4311167000,  영운동,'80,75 - 79세,1998,146,50,96
'4311167000,  영운동,'85,80 - 84세,1998,84,25,59
'4311167000,  영운동,'90,85+ ,1998,52,12,40
'4311168000,  금천동,'00,계,1998,25068,12543,12525
'4311168000,  금천동,'05,0 - 4세,1998,1772,922,850
'4311168000,  금천동,'10,5 - 9세,1998,2117,1167,950
'4311168000,  금천동,'15,10 - 14세,1998,2081,1100,981
'4311168000,  금천동,'20,15 - 19세,1998,2519,1300,1219
'4311168000,  금천동,'25,20 - 24세,1998,2267,1136,1131
'4311168000,  금천동,'30,25 - 29세,1998,2268,1140,1128
'4311168000,  금천동,'35,30 - 34세,1998,2181,1015,1166
'4311168000,  금천동,'40,35 - 39세,1998,2545,1233,1312
'4311168000,  금천동,'45,40 - 44세,1998,2254,1151,1103
'4311168000,  금천동,'50,45 - 49세,1998,1403,739,664
'4311168000,  금천동,'55,50 - 54세,1998,1033,527,506
'4311168000,  금천동,'60,55 - 59세,1998,856,448,408
'4311168000,  금천동,'65,60 - 64세,1998,617,268,349
'4311168000,  금천동,'70,65 - 69세,1998,426,165,261
'4311168000,  금천동,'75,70 - 74세,1998,295,102,193
'4311168000,  금천동,'80,75 - 79세,1998,232,84,148
'4311168000,  금천동,'85,80 - 84세,1998,132,26,106
'4311168000,  금천동,'90,85+ ,1998,70,20,50
'4311169000,  용담·명암·산성동,'00,계,1998,5458,2757,2701
'4311169000,  용담·명암·산성동,'05,0 - 4세,1998,385,200,185
'4311169000,  용담·명암·산성동,'10,5 - 9세,1998,395,210,185
'4311169000,  용담·명암·산성동,'15,10 - 14세,1998,369,192,177
'4311169000,  용담·명암·산성동,'20,15 - 19세,1998,516,257,259
'4311169000,  용담·명암·산성동,'25,20 - 24세,1998,501,273,228
'4311169000,  용담·명암·산성동,'30,25 - 29세,1998,527,285,242
'4311169000,  용담·명암·산성동,'35,30 - 34세,1998,487,237,250
'4311169000,  용담·명암·산성동,'40,35 - 39세,1998,457,242,215
'4311169000,  용담·명암·산성동,'45,40 - 44세,1998,422,218,204
'4311169000,  용담·명암·산성동,'50,45 - 49세,1998,290,157,133
'4311169000,  용담·명암·산성동,'55,50 - 54세,1998,258,129,129
'4311169000,  용담·명암·산성동,'60,55 - 59세,1998,236,111,125
'4311169000,  용담·명암·산성동,'65,60 - 64세,1998,221,98,123
'4311169000,  용담·명암·산성동,'70,65 - 69세,1998,168,74,94
'4311169000,  용담·명암·산성동,'75,70 - 74세,1998,102,39,63
'4311169000,  용담·명암·산성동,'80,75 - 79세,1998,63,26,37
'4311169000,  용담·명암·산성동,'85,80 - 84세,1998,38,7,31
'4311169000,  용담·명암·산성동,'90,85+ ,1998,23,2,21
'4311171000,  용암·용정·방서동,'00,계,1998,50167,24940,25227
'4311171000,  용암·용정·방서동,'05,0 - 4세,1998,5482,2903,2579
'4311171000,  용암·용정·방서동,'10,5 - 9세,1998,5589,2922,2667
'4311171000,  용암·용정·방서동,'15,10 - 14세,1998,4239,2215,2024
'4311171000,  용암·용정·방서동,'20,15 - 19세,1998,3973,2089,1884
'4311171000,  용암·용정·방서동,'25,20 - 24세,1998,2777,1336,1441
'4311171000,  용암·용정·방서동,'30,25 - 29세,1998,4361,1820,2541
'4311171000,  용암·용정·방서동,'35,30 - 34세,1998,6372,3014,3358
'4311171000,  용암·용정·방서동,'40,35 - 39세,1998,6179,3239,2940
'4311171000,  용암·용정·방서동,'45,40 - 44세,1998,3968,2167,1801
'4311171000,  용암·용정·방서동,'50,45 - 49세,1998,1894,1059,835
'4311171000,  용암·용정·방서동,'55,50 - 54세,1998,1248,641,607
'4311171000,  용암·용정·방서동,'60,55 - 59세,1998,1219,566,653
'4311171000,  용암·용정·방서동,'65,60 - 64세,1998,959,374,585
'4311171000,  용암·용정·방서동,'70,65 - 69세,1998,708,245,463
'4311171000,  용암·용정·방서동,'75,70 - 74세,1998,510,162,348
'4311171000,  용암·용정·방서동,'80,75 - 79세,1998,364,102,262
'4311171000,  용암·용정·방서동,'85,80 - 84세,1998,213,61,152
'4311171000,  용암·용정·방서동,'90,85+ ,1998,112,25,87
'4311179000,  오근장동,'00,계,1998,4964,2514,2450
'4311179000,  오근장동,'05,0 - 4세,1998,242,123,119
'4311179000,  오근장동,'10,5 - 9세,1998,205,108,97
'4311179000,  오근장동,'15,10 - 14세,1998,320,173,147
'4311179000,  오근장동,'20,15 - 19세,1998,477,243,234
'4311179000,  오근장동,'25,20 - 24세,1998,533,270,263
'4311179000,  오근장동,'30,25 - 29세,1998,447,256,191
'4311179000,  오근장동,'35,30 - 34세,1998,318,182,136
'4311179000,  오근장동,'40,35 - 39세,1998,325,182,143
'4311179000,  오근장동,'45,40 - 44세,1998,351,183,168
'4311179000,  오근장동,'50,45 - 49세,1998,249,126,123
'4311179000,  오근장동,'55,50 - 54세,1998,254,123,131
'4311179000,  오근장동,'60,55 - 59세,1998,345,171,174
'4311179000,  오근장동,'65,60 - 64세,1998,337,159,178
'4311179000,  오근장동,'70,65 - 69세,1998,222,78,144
'4311179000,  오근장동,'75,70 - 74세,1998,122,56,66
'4311179000,  오근장동,'80,75 - 79세,1998,116,50,66
'4311179000,  오근장동,'85,80 - 84세,1998,59,23,36
'4311179000,  오근장동,'90,85+ ,1998,42,8,34
'43113, 흥덕구,'00,계,1998,322481,160598,161883
'43113, 흥덕구,'05,0 - 4세,1998,27982,14538,13444
'43113, 흥덕구,'10,5 - 9세,1998,27353,14586,12767
'43113, 흥덕구,'15,10 - 14세,1998,24760,13126,11634
'43113, 흥덕구,'20,15 - 19세,1998,28815,14648,14167
'43113, 흥덕구,'25,20 - 24세,1998,28988,13707,15281
'43113, 흥덕구,'30,25 - 29세,1998,34217,16900,17317
'43113, 흥덕구,'35,30 - 34세,1998,32449,16082,16367
'43113, 흥덕구,'40,35 - 39세,1998,32188,16361,15827
'43113, 흥덕구,'45,40 - 44세,1998,25853,13320,12533
'43113, 흥덕구,'50,45 - 49세,1998,15577,7967,7610
'43113, 흥덕구,'55,50 - 54세,1998,11745,5968,5777
'43113, 흥덕구,'60,55 - 59세,1998,10334,4999,5335
'43113, 흥덕구,'65,60 - 64세,1998,7892,3582,4310
'43113, 흥덕구,'70,65 - 69세,1998,5429,1982,3447
'43113, 흥덕구,'75,70 - 74세,1998,3738,1292,2446
'43113, 흥덕구,'80,75 - 79세,1998,2741,899,1842
'43113, 흥덕구,'85,80 - 84세,1998,1531,454,1077
'43113, 흥덕구,'90,85+ ,1998,889,187,702
'4311363000,  사직1동,'00,계,1998,12371,6226,6145
'4311363000,  사직1동,'05,0 - 4세,1998,709,358,351
'4311363000,  사직1동,'10,5 - 9세,1998,678,348,330
'4311363000,  사직1동,'15,10 - 14세,1998,725,400,325
'4311363000,  사직1동,'20,15 - 19세,1998,1227,647,580
'4311363000,  사직1동,'25,20 - 24세,1998,1442,774,668
'4311363000,  사직1동,'30,25 - 29세,1998,1293,731,562
'4311363000,  사직1동,'35,30 - 34세,1998,871,467,404
'4311363000,  사직1동,'40,35 - 39세,1998,887,437,450
'4311363000,  사직1동,'45,40 - 44세,1998,932,433,499
'4311363000,  사직1동,'50,45 - 49세,1998,793,367,426
'4311363000,  사직1동,'55,50 - 54세,1998,731,334,397
'4311363000,  사직1동,'60,55 - 59세,1998,707,356,351
'4311363000,  사직1동,'65,60 - 64세,1998,537,268,269
'4311363000,  사직1동,'70,65 - 69세,1998,332,140,192
'4311363000,  사직1동,'75,70 - 74세,1998,206,83,123
'4311363000,  사직1동,'80,75 - 79세,1998,160,47,113
'4311363000,  사직1동,'85,80 - 84세,1998,91,21,70
'4311363000,  사직1동,'90,85+ ,1998,50,15,35
'4311364000,  사직2동,'00,계,1998,16164,8027,8137
'4311364000,  사직2동,'05,0 - 4세,1998,1289,671,618
'4311364000,  사직2동,'10,5 - 9세,1998,1241,653,588
'4311364000,  사직2동,'15,10 - 14세,1998,1131,615,516
'4311364000,  사직2동,'20,15 - 19세,1998,1468,767,701
'4311364000,  사직2동,'25,20 - 24세,1998,1540,746,794
'4311364000,  사직2동,'30,25 - 29세,1998,1809,942,867
'4311364000,  사직2동,'35,30 - 34세,1998,1519,758,761
'4311364000,  사직2동,'40,35 - 39세,1998,1472,740,732
'4311364000,  사직2동,'45,40 - 44세,1998,1286,613,673
'4311364000,  사직2동,'50,45 - 49세,1998,813,410,403
'4311364000,  사직2동,'55,50 - 54세,1998,664,333,331
'4311364000,  사직2동,'60,55 - 59세,1998,658,292,366
'4311364000,  사직2동,'65,60 - 64세,1998,467,209,258
'4311364000,  사직2동,'70,65 - 69세,1998,297,104,193
'4311364000,  사직2동,'75,70 - 74세,1998,224,69,155
'4311364000,  사직2동,'80,75 - 79세,1998,152,59,93
'4311364000,  사직2동,'85,80 - 84세,1998,81,33,48
'4311364000,  사직2동,'90,85+ ,1998,53,13,40
'4311365000,  사창동,'00,계,1998,19360,9519,9841
'4311365000,  사창동,'05,0 - 4세,1998,1164,603,561
'4311365000,  사창동,'10,5 - 9세,1998,1149,623,526
'4311365000,  사창동,'15,10 - 14세,1998,1252,647,605
'4311365000,  사창동,'20,15 - 19세,1998,1975,1028,947
'4311365000,  사창동,'25,20 - 24세,1998,2512,1218,1294
'4311365000,  사창동,'30,25 - 29세,1998,2128,1124,1004
'4311365000,  사창동,'35,30 - 34세,1998,1458,740,718
'4311365000,  사창동,'40,35 - 39세,1998,1442,683,759
'4311365000,  사창동,'45,40 - 44세,1998,1407,647,760
'4311365000,  사창동,'50,45 - 49세,1998,1181,554,627
'4311365000,  사창동,'55,50 - 54세,1998,1072,499,573
'4311365000,  사창동,'60,55 - 59세,1998,938,459,479
'4311365000,  사창동,'65,60 - 64세,1998,685,325,360
'4311365000,  사창동,'70,65 - 69세,1998,377,165,212
'4311365000,  사창동,'75,70 - 74세,1998,243,91,152
'4311365000,  사창동,'80,75 - 79세,1998,187,59,128
'4311365000,  사창동,'85,80 - 84세,1998,121,39,82
'4311365000,  사창동,'90,85+ ,1998,69,15,54
'4311366000,  모충동,'00,계,1998,24778,12339,12439
'4311366000,  모충동,'05,0 - 4세,1998,1739,939,800
'4311366000,  모충동,'10,5 - 9세,1998,1712,892,820
'4311366000,  모충동,'15,10 - 14세,1998,1822,951,871
'4311366000,  모충동,'20,15 - 19세,1998,2463,1278,1185
'4311366000,  모충동,'25,20 - 24세,1998,2499,1273,1226
'4311366000,  모충동,'30,25 - 29세,1998,2333,1197,1136
'4311366000,  모충동,'35,30 - 34세,1998,2040,1016,1024
'4311366000,  모충동,'40,35 - 39세,1998,2249,1080,1169
'4311366000,  모충동,'45,40 - 44세,1998,2166,1101,1065
'4311366000,  모충동,'50,45 - 49세,1998,1387,689,698
'4311366000,  모충동,'55,50 - 54세,1998,1179,575,604
'4311366000,  모충동,'60,55 - 59세,1998,1055,520,535
'4311366000,  모충동,'65,60 - 64세,1998,768,368,400
'4311366000,  모충동,'70,65 - 69세,1998,524,186,338
'4311366000,  모충동,'75,70 - 74세,1998,346,131,215
'4311366000,  모충동,'80,75 - 79세,1998,282,84,198
'4311366000,  모충동,'85,80 - 84세,1998,132,36,96
'4311366000,  모충동,'90,85+ ,1998,82,23,59
'4311370000,  운천·신봉동,'00,계,1998,25878,13027,12851
'4311370000,  운천·신봉동,'05,0 - 4세,1998,2509,1303,1206
'4311370000,  운천·신봉동,'10,5 - 9세,1998,2488,1374,1114
'4311370000,  운천·신봉동,'15,10 - 14세,1998,2147,1166,981
'4311370000,  운천·신봉동,'20,15 - 19세,1998,2100,1147,953
'4311370000,  운천·신봉동,'25,20 - 24세,1998,1884,926,958
'4311370000,  운천·신봉동,'30,25 - 29세,1998,2602,1176,1426
'4311370000,  운천·신봉동,'35,30 - 34세,1998,2902,1373,1529
'4311370000,  운천·신봉동,'40,35 - 39세,1998,2930,1521,1409
'4311370000,  운천·신봉동,'45,40 - 44세,1998,2079,1107,972
'4311370000,  운천·신봉동,'50,45 - 49세,1998,1133,591,542
'4311370000,  운천·신봉동,'55,50 - 54세,1998,857,457,400
'4311370000,  운천·신봉동,'60,55 - 59세,1998,668,303,365
'4311370000,  운천·신봉동,'65,60 - 64세,1998,546,256,290
'4311370000,  운천·신봉동,'70,65 - 69세,1998,416,149,267
'4311370000,  운천·신봉동,'75,70 - 74세,1998,256,75,181
'4311370000,  운천·신봉동,'80,75 - 79세,1998,199,66,133
'4311370000,  운천·신봉동,'85,80 - 84세,1998,102,29,73
'4311370000,  운천·신봉동,'90,85+ ,1998,60,8,52
'4311372100,  산·미·분·장동,'00,계,1998,28306,14194,14112
'4311372100,  산·미·분·장동,'05,0 - 4세,1998,3212,1700,1512
'4311372100,  산·미·분·장동,'10,5 - 9세,1998,2825,1471,1354
'4311372100,  산·미·분·장동,'15,10 - 14세,1998,2136,1115,1021
'4311372100,  산·미·분·장동,'20,15 - 19세,1998,2024,1034,990
'4311372100,  산·미·분·장동,'25,20 - 24세,1998,1872,907,965
'4311372100,  산·미·분·장동,'30,25 - 29세,1998,3243,1462,1781
'4311372100,  산·미·분·장동,'35,30 - 34세,1998,3659,1858,1801
'4311372100,  산·미·분·장동,'40,35 - 39세,1998,3005,1620,1385
'4311372100,  산·미·분·장동,'45,40 - 44세,1998,2116,1133,983
'4311372100,  산·미·분·장동,'50,45 - 49세,1998,1120,580,540
'4311372100,  산·미·분·장동,'55,50 - 54세,1998,784,414,370
'4311372100,  산·미·분·장동,'60,55 - 59세,1998,651,308,343
'4311372100,  산·미·분·장동,'65,60 - 64세,1998,531,222,309
'4311372100,  산·미·분·장동,'70,65 - 69세,1998,418,138,280
'4311372100,  산·미·분·장동,'75,70 - 74세,1998,314,99,215
'4311372100,  산·미·분·장동,'80,75 - 79세,1998,206,72,134
'4311372100,  산·미·분·장동,'85,80 - 84세,1998,123,40,83
'4311372100,  산·미·분·장동,'90,85+ ,1998,67,21,46
'4311372700,  수곡1동,'00,계,1998,22371,11144,11227
'4311372700,  수곡1동,'05,0 - 4세,1998,1409,722,687
'4311372700,  수곡1동,'10,5 - 9세,1998,1534,798,736
'4311372700,  수곡1동,'15,10 - 14세,1998,1791,959,832
'4311372700,  수곡1동,'20,15 - 19세,1998,2357,1224,1133
'4311372700,  수곡1동,'25,20 - 24세,1998,2279,1110,1169
'4311372700,  수곡1동,'30,25 - 29세,1998,2192,1167,1025
'4311372700,  수곡1동,'35,30 - 34세,1998,1743,851,892
'4311372700,  수곡1동,'40,35 - 39세,1998,2039,971,1068
'4311372700,  수곡1동,'45,40 - 44세,1998,1969,976,993
'4311372700,  수곡1동,'50,45 - 49세,1998,1325,669,656
'4311372700,  수곡1동,'55,50 - 54세,1998,1039,541,498
'4311372700,  수곡1동,'60,55 - 59세,1998,918,458,460
'4311372700,  수곡1동,'65,60 - 64세,1998,664,298,366
'4311372700,  수곡1동,'70,65 - 69세,1998,422,172,250
'4311372700,  수곡1동,'75,70 - 74세,1998,292,115,177
'4311372700,  수곡1동,'80,75 - 79세,1998,202,67,135
'4311372700,  수곡1동,'85,80 - 84세,1998,116,30,86
'4311372700,  수곡1동,'90,85+ ,1998,80,16,64
'4311372800,  수곡2동,'00,계,1998,22723,11258,11465
'4311372800,  수곡2동,'05,0 - 4세,1998,2031,1071,960
'4311372800,  수곡2동,'10,5 - 9세,1998,2362,1268,1094
'4311372800,  수곡2동,'15,10 - 14세,1998,1908,980,928
'4311372800,  수곡2동,'20,15 - 19세,1998,1990,1042,948
'4311372800,  수곡2동,'25,20 - 24세,1998,1866,934,932
'4311372800,  수곡2동,'30,25 - 29세,1998,2099,1021,1078
'4311372800,  수곡2동,'35,30 - 34세,1998,2456,1107,1349
'4311372800,  수곡2동,'40,35 - 39세,1998,2637,1369,1268
'4311372800,  수곡2동,'45,40 - 44세,1998,1821,958,863
'4311372800,  수곡2동,'50,45 - 49세,1998,1005,488,517
'4311372800,  수곡2동,'55,50 - 54세,1998,720,343,377
'4311372800,  수곡2동,'60,55 - 59세,1998,587,267,320
'4311372800,  수곡2동,'65,60 - 64세,1998,426,180,246
'4311372800,  수곡2동,'70,65 - 69세,1998,278,79,199
'4311372800,  수곡2동,'75,70 - 74세,1998,245,69,176
'4311372800,  수곡2동,'80,75 - 79세,1998,161,48,113
'4311372800,  수곡2동,'85,80 - 84세,1998,88,23,65
'4311372800,  수곡2동,'90,85+ ,1998,43,11,32
'4311374100,  복대1동,'00,계,1998,11131,5425,5706
'4311374100,  복대1동,'05,0 - 4세,1998,778,386,392
'4311374100,  복대1동,'10,5 - 9세,1998,753,398,355
'4311374100,  복대1동,'15,10 - 14세,1998,705,370,335
'4311374100,  복대1동,'20,15 - 19세,1998,1278,518,760
'4311374100,  복대1동,'25,20 - 24세,1998,1423,625,798
'4311374100,  복대1동,'30,25 - 29세,1998,1286,693,593
'4311374100,  복대1동,'35,30 - 34세,1998,954,504,450
'4311374100,  복대1동,'40,35 - 39세,1998,897,458,439
'4311374100,  복대1동,'45,40 - 44세,1998,876,450,426
'4311374100,  복대1동,'50,45 - 49세,1998,516,264,252
'4311374100,  복대1동,'55,50 - 54세,1998,490,251,239
'4311374100,  복대1동,'60,55 - 59세,1998,450,219,231
'4311374100,  복대1동,'65,60 - 64세,1998,281,140,141
'4311374100,  복대1동,'70,65 - 69세,1998,162,57,105
'4311374100,  복대1동,'75,70 - 74세,1998,124,44,80
'4311374100,  복대1동,'80,75 - 79세,1998,84,34,50
'4311374100,  복대1동,'85,80 - 84세,1998,47,9,38
'4311374100,  복대1동,'90,85+ ,1998,27,5,22
'4311374200,  복대2동,'00,계,1998,26595,13286,13309
'4311374200,  복대2동,'05,0 - 4세,1998,2259,1211,1048
'4311374200,  복대2동,'10,5 - 9세,1998,2445,1299,1146
'4311374200,  복대2동,'15,10 - 14세,1998,2140,1138,1002
'4311374200,  복대2동,'20,15 - 19세,1998,2447,1242,1205
'4311374200,  복대2동,'25,20 - 24세,1998,2452,1171,1281
'4311374200,  복대2동,'30,25 - 29세,1998,2833,1392,1441
'4311374200,  복대2동,'35,30 - 34세,1998,2674,1292,1382
'4311374200,  복대2동,'40,35 - 39세,1998,2608,1308,1300
'4311374200,  복대2동,'45,40 - 44세,1998,2218,1121,1097
'4311374200,  복대2동,'50,45 - 49세,1998,1352,699,653
'4311374200,  복대2동,'55,50 - 54세,1998,877,441,436
'4311374200,  복대2동,'60,55 - 59세,1998,767,393,374
'4311374200,  복대2동,'65,60 - 64세,1998,514,242,272
'4311374200,  복대2동,'70,65 - 69세,1998,415,151,264
'4311374200,  복대2동,'75,70 - 74세,1998,249,90,159
'4311374200,  복대2동,'80,75 - 79세,1998,184,62,122
'4311374200,  복대2동,'85,80 - 84세,1998,103,25,78
'4311374200,  복대2동,'90,85+ ,1998,58,9,49
'4311374700,  가경동,'00,계,1998,34260,17053,17207
'4311374700,  가경동,'05,0 - 4세,1998,4140,2119,2021
'4311374700,  가경동,'10,5 - 9세,1998,3847,2006,1841
'4311374700,  가경동,'15,10 - 14세,1998,2965,1572,1393
'4311374700,  가경동,'20,15 - 19세,1998,2391,1195,1196
'4311374700,  가경동,'25,20 - 24세,1998,1870,839,1031
'4311374700,  가경동,'30,25 - 29세,1998,3616,1503,2113
'4311374700,  가경동,'35,30 - 34세,1998,4450,2195,2255
'4311374700,  가경동,'40,35 - 39세,1998,4240,2219,2021
'4311374700,  가경동,'45,40 - 44세,1998,2790,1560,1230
'4311374700,  가경동,'50,45 - 49세,1998,1216,655,561
'4311374700,  가경동,'55,50 - 54세,1998,755,440,315
'4311374700,  가경동,'60,55 - 59세,1998,561,259,302
'4311374700,  가경동,'65,60 - 64세,1998,460,196,264
'4311374700,  가경동,'70,65 - 69세,1998,350,115,235
'4311374700,  가경동,'75,70 - 74세,1998,270,85,185
'4311374700,  가경동,'80,75 - 79세,1998,163,48,115
'4311374700,  가경동,'85,80 - 84세,1998,118,40,78
'4311374700,  가경동,'90,85+ ,1998,58,7,51
'4311375100,  봉명1동,'00,계,1998,14212,7091,7121
'4311375100,  봉명1동,'05,0 - 4세,1998,1265,616,649
'4311375100,  봉명1동,'10,5 - 9세,1998,1062,577,485
'4311375100,  봉명1동,'15,10 - 14세,1998,976,528,448
'4311375100,  봉명1동,'20,15 - 19세,1998,1232,650,582
'4311375100,  봉명1동,'25,20 - 24세,1998,1493,657,836
'4311375100,  봉명1동,'30,25 - 29세,1998,1795,961,834
'4311375100,  봉명1동,'35,30 - 34세,1998,1487,755,732
'4311375100,  봉명1동,'40,35 - 39세,1998,1302,684,618
'4311375100,  봉명1동,'45,40 - 44세,1998,1045,522,523
'4311375100,  봉명1동,'50,45 - 49세,1998,660,326,334
'4311375100,  봉명1동,'55,50 - 54세,1998,521,248,273
'4311375100,  봉명1동,'60,55 - 59세,1998,456,222,234
'4311375100,  봉명1동,'65,60 - 64세,1998,359,163,196
'4311375100,  봉명1동,'70,65 - 69세,1998,220,85,135
'4311375100,  봉명1동,'75,70 - 74세,1998,138,41,97
'4311375100,  봉명1동,'80,75 - 79세,1998,93,31,62
'4311375100,  봉명1동,'85,80 - 84세,1998,69,23,46
'4311375100,  봉명1동,'90,85+ ,1998,39,2,37
'4311375600,  봉명2·송정동,'00,계,1998,25223,12086,13137
'4311375600,  봉명2·송정동,'05,0 - 4세,1998,2577,1348,1229
'4311375600,  봉명2·송정동,'10,5 - 9세,1998,2366,1278,1088
'4311375600,  봉명2·송정동,'15,10 - 14세,1998,2051,1069,982
'4311375600,  봉명2·송정동,'20,15 - 19세,1998,2348,968,1380
'4311375600,  봉명2·송정동,'25,20 - 24세,1998,2425,775,1650
'4311375600,  봉명2·송정동,'30,25 - 29세,1998,2838,1310,1528
'4311375600,  봉명2·송정동,'35,30 - 34세,1998,2839,1396,1443
'4311375600,  봉명2·송정동,'40,35 - 39세,1998,2686,1400,1286
'4311375600,  봉명2·송정동,'45,40 - 44세,1998,1807,984,823
'4311375600,  봉명2·송정동,'50,45 - 49세,1998,977,539,438
'4311375600,  봉명2·송정동,'55,50 - 54세,1998,660,370,290
'4311375600,  봉명2·송정동,'60,55 - 59세,1998,499,250,249
'4311375600,  봉명2·송정동,'65,60 - 64세,1998,371,164,207
'4311375600,  봉명2·송정동,'70,65 - 69세,1998,277,88,189
'4311375600,  봉명2·송정동,'75,70 - 74세,1998,209,71,138
'4311375600,  봉명2·송정동,'80,75 - 79세,1998,155,44,111
'4311375600,  봉명2·송정동,'85,80 - 84세,1998,88,24,64
'4311375600,  봉명2·송정동,'90,85+ ,1998,50,8,42
'4311376000,  강서1동,'00,계,1998,19002,9606,9396
'4311376000,  강서1동,'05,0 - 4세,1998,1767,923,844
'4311376000,  강서1동,'10,5 - 9세,1998,1415,776,639
'4311376000,  강서1동,'15,10 - 14세,1998,1235,659,576
'4311376000,  강서1동,'20,15 - 19세,1998,1517,839,678
'4311376000,  강서1동,'25,20 - 24세,1998,1604,777,827
'4311376000,  강서1동,'30,25 - 29세,1998,2240,1069,1171
'4311376000,  강서1동,'35,30 - 34세,1998,1960,1063,897
'4311376000,  강서1동,'40,35 - 39세,1998,1804,962,842
'4311376000,  강서1동,'45,40 - 44세,1998,1327,705,622
'4311376000,  강서1동,'50,45 - 49세,1998,925,477,448
'4311376000,  강서1동,'55,50 - 54세,1998,643,327,316
'4311376000,  강서1동,'60,55 - 59세,1998,707,329,378
'4311376000,  강서1동,'65,60 - 64세,1998,647,275,372
'4311376000,  강서1동,'70,65 - 69세,1998,436,163,273
'4311376000,  강서1동,'75,70 - 74세,1998,338,128,210
'4311376000,  강서1동,'80,75 - 79세,1998,248,81,167
'4311376000,  강서1동,'85,80 - 84세,1998,121,37,84
'4311376000,  강서1동,'90,85+ ,1998,68,16,52
'4311377000,  강서2동,'00,계,1998,4446,2512,1934
'4311377000,  강서2동,'05,0 - 4세,1998,163,86,77
'4311377000,  강서2동,'10,5 - 9세,1998,173,87,86
'4311377000,  강서2동,'15,10 - 14세,1998,245,127,118
'4311377000,  강서2동,'20,15 - 19세,1998,417,216,201
'4311377000,  강서2동,'25,20 - 24세,1998,568,388,180
'4311377000,  강서2동,'30,25 - 29세,1998,630,499,131
'4311377000,  강서2동,'35,30 - 34세,1998,258,159,99
'4311377000,  강서2동,'40,35 - 39세,1998,277,146,131
'4311377000,  강서2동,'45,40 - 44세,1998,271,150,121
'4311377000,  강서2동,'50,45 - 49세,1998,216,119,97
'4311377000,  강서2동,'55,50 - 54세,1998,178,82,96
'4311377000,  강서2동,'60,55 - 59세,1998,266,125,141
'4311377000,  강서2동,'65,60 - 64세,1998,284,126,158
'4311377000,  강서2동,'70,65 - 69세,1998,226,97,129
'4311377000,  강서2동,'75,70 - 74세,1998,96,39,57
'4311377000,  강서2동,'80,75 - 79세,1998,94,41,53
'4311377000,  강서2동,'85,80 - 84세,1998,54,20,34
'4311377000,  강서2동,'90,85+ ,1998,30,5,25
'4311378000,  성화·개신·죽림동,'00,계,1998,15661,7805,7856
'4311378000,  성화·개신·죽림동,'05,0 - 4세,1998,971,482,489
'4311378000,  성화·개신·죽림동,'10,5 - 9세,1998,1303,738,565
'4311378000,  성화·개신·죽림동,'15,10 - 14세,1998,1531,830,701
'4311378000,  성화·개신·죽림동,'20,15 - 19세,1998,1581,853,728
'4311378000,  성화·개신·죽림동,'25,20 - 24세,1998,1259,587,672
'4311378000,  성화·개신·죽림동,'30,25 - 29세,1998,1280,653,627
'4311378000,  성화·개신·죽림동,'35,30 - 34세,1998,1179,548,631
'4311378000,  성화·개신·죽림동,'40,35 - 39세,1998,1713,763,950
'4311378000,  성화·개신·죽림동,'45,40 - 44세,1998,1743,860,883
'4311378000,  성화·개신·죽림동,'50,45 - 49세,1998,958,540,418
'4311378000,  성화·개신·죽림동,'55,50 - 54세,1998,575,313,262
'4311378000,  성화·개신·죽림동,'60,55 - 59세,1998,446,239,207
'4311378000,  성화·개신·죽림동,'65,60 - 64세,1998,352,150,202
'4311378000,  성화·개신·죽림동,'70,65 - 69세,1998,279,93,186
'4311378000,  성화·개신·죽림동,'75,70 - 74세,1998,188,62,126
'4311378000,  성화·개신·죽림동,'80,75 - 79세,1998,171,56,115
'4311378000,  성화·개신·죽림동,'85,80 - 84세,1998,77,25,52
'4311378000,  성화·개신·죽림동,'90,85+ ,1998,55,13,42
'43130, 충주시,'00,계,1998,218846,110496,108350
'43130, 충주시,'05,0 - 4세,1998,15084,7952,7132
'43130, 충주시,'10,5 - 9세,1998,15766,8385,7381
'43130, 충주시,'15,10 - 14세,1998,15333,7997,7336
'43130, 충주시,'20,15 - 19세,1998,19281,9989,9292
'43130, 충주시,'25,20 - 24세,1998,18988,10206,8782
'43130, 충주시,'30,25 - 29세,1998,19975,10645,9330
'43130, 충주시,'35,30 - 34세,1998,18790,9720,9070
'43130, 충주시,'40,35 - 39세,1998,19590,10056,9534
'43130, 충주시,'45,40 - 44세,1998,16368,8576,7792
'43130, 충주시,'50,45 - 49세,1998,10954,5522,5432
'43130, 충주시,'55,50 - 54세,1998,9508,4652,4856
'43130, 충주시,'60,55 - 59세,1998,11324,5370,5954
'43130, 충주시,'65,60 - 64세,1998,9910,4560,5350
'43130, 충주시,'70,65 - 69세,1998,6913,2669,4244
'43130, 충주시,'75,70 - 74세,1998,4802,1981,2821
'43130, 충주시,'80,75 - 79세,1998,3424,1316,2108
'43130, 충주시,'85,80 - 84세,1998,1823,590,1233
'43130, 충주시,'90,85+ ,1998,1013,310,703
'4313025000,  주덕읍,'00,계,1998,7858,4003,3855
'4313025000,  주덕읍,'05,0 - 4세,1998,399,210,189
'4313025000,  주덕읍,'10,5 - 9세,1998,457,253,204
'4313025000,  주덕읍,'15,10 - 14세,1998,513,270,243
'4313025000,  주덕읍,'20,15 - 19세,1998,666,345,321
'4313025000,  주덕읍,'25,20 - 24세,1998,726,398,328
'4313025000,  주덕읍,'30,25 - 29세,1998,624,407,217
'4313025000,  주덕읍,'35,30 - 34세,1998,555,287,268
'4313025000,  주덕읍,'40,35 - 39세,1998,589,322,267
'4313025000,  주덕읍,'45,40 - 44세,1998,560,293,267
'4313025000,  주덕읍,'50,45 - 49세,1998,402,199,203
'4313025000,  주덕읍,'55,50 - 54세,1998,364,169,195
'4313025000,  주덕읍,'60,55 - 59세,1998,511,244,267
'4313025000,  주덕읍,'65,60 - 64세,1998,525,238,287
'4313025000,  주덕읍,'70,65 - 69세,1998,366,137,229
'4313025000,  주덕읍,'75,70 - 74세,1998,261,98,163
'4313025000,  주덕읍,'80,75 - 79세,1998,195,87,108
'4313025000,  주덕읍,'85,80 - 84세,1998,97,30,67
'4313025000,  주덕읍,'90,85+ ,1998,48,16,32
'4313031000,  살미면,'00,계,1998,2855,1472,1383
'4313031000,  살미면,'05,0 - 4세,1998,95,42,53
'4313031000,  살미면,'10,5 - 9세,1998,94,54,40
'4313031000,  살미면,'15,10 - 14세,1998,171,98,73
'4313031000,  살미면,'20,15 - 19세,1998,266,123,143
'4313031000,  살미면,'25,20 - 24세,1998,284,171,113
'4313031000,  살미면,'30,25 - 29세,1998,193,123,70
'4313031000,  살미면,'35,30 - 34세,1998,138,79,59
'4313031000,  살미면,'40,35 - 39세,1998,182,102,80
'4313031000,  살미면,'45,40 - 44세,1998,178,95,83
'4313031000,  살미면,'50,45 - 49세,1998,160,83,77
'4313031000,  살미면,'55,50 - 54세,1998,172,91,81
'4313031000,  살미면,'60,55 - 59세,1998,218,96,122
'4313031000,  살미면,'65,60 - 64세,1998,254,126,128
'4313031000,  살미면,'70,65 - 69세,1998,172,70,102
'4313031000,  살미면,'75,70 - 74세,1998,116,49,67
'4313031000,  살미면,'80,75 - 79세,1998,90,41,49
'4313031000,  살미면,'85,80 - 84세,1998,49,18,31
'4313031000,  살미면,'90,85+ ,1998,23,11,12
'4313032000,  상모면,'00,계,1998,4891,2500,2391
'4313032000,  상모면,'05,0 - 4세,1998,231,130,101
'4313032000,  상모면,'10,5 - 9세,1998,281,147,134
'4313032000,  상모면,'15,10 - 14세,1998,273,143,130
'4313032000,  상모면,'20,15 - 19세,1998,434,238,196
'4313032000,  상모면,'25,20 - 24세,1998,431,247,184
'4313032000,  상모면,'30,25 - 29세,1998,368,208,160
'4313032000,  상모면,'35,30 - 34세,1998,344,191,153
'4313032000,  상모면,'40,35 - 39세,1998,378,199,179
'4313032000,  상모면,'45,40 - 44세,1998,356,185,171
'4313032000,  상모면,'50,45 - 49세,1998,274,137,137
'4313032000,  상모면,'55,50 - 54세,1998,257,122,135
'4313032000,  상모면,'60,55 - 59세,1998,366,177,189
'4313032000,  상모면,'65,60 - 64세,1998,297,144,153
'4313032000,  상모면,'70,65 - 69세,1998,188,57,131
'4313032000,  상모면,'75,70 - 74세,1998,187,75,112
'4313032000,  상모면,'80,75 - 79세,1998,128,63,65
'4313032000,  상모면,'85,80 - 84세,1998,61,21,40
'4313032000,  상모면,'90,85+ ,1998,37,16,21
'4313032500,  수안보면,'00,계,1998,,,
'4313032500,  수안보면,'05,0 - 4세,1998,,,
'4313032500,  수안보면,'10,5 - 9세,1998,,,
'4313032500,  수안보면,'15,10 - 14세,1998,,,
'4313032500,  수안보면,'20,15 - 19세,1998,,,
'4313032500,  수안보면,'25,20 - 24세,1998,,,
'4313032500,  수안보면,'30,25 - 29세,1998,,,
'4313032500,  수안보면,'35,30 - 34세,1998,,,
'4313032500,  수안보면,'40,35 - 39세,1998,,,
'4313032500,  수안보면,'45,40 - 44세,1998,,,
'4313032500,  수안보면,'50,45 - 49세,1998,,,
'4313032500,  수안보면,'55,50 - 54세,1998,,,
'4313032500,  수안보면,'60,55 - 59세,1998,,,
'4313032500,  수안보면,'65,60 - 64세,1998,,,
'4313032500,  수안보면,'70,65 - 69세,1998,,,
'4313032500,  수안보면,'75,70 - 74세,1998,,,
'4313032500,  수안보면,'80,75 - 79세,1998,,,
'4313032500,  수안보면,'85,80 - 84세,1998,,,
'4313032500,  수안보면,'90,85+ ,1998,,,
'4313033000,  이류면,'00,계,1998,5866,3034,2832
'4313033000,  이류면,'05,0 - 4세,1998,265,145,120
'4313033000,  이류면,'10,5 - 9세,1998,265,123,142
'4313033000,  이류면,'15,10 - 14세,1998,319,168,151
'4313033000,  이류면,'20,15 - 19세,1998,501,260,241
'4313033000,  이류면,'25,20 - 24세,1998,614,378,236
'4313033000,  이류면,'30,25 - 29세,1998,470,292,178
'4313033000,  이류면,'35,30 - 34세,1998,394,229,165
'4313033000,  이류면,'40,35 - 39세,1998,386,215,171
'4313033000,  이류면,'45,40 - 44세,1998,381,201,180
'4313033000,  이류면,'50,45 - 49세,1998,269,139,130
'4313033000,  이류면,'55,50 - 54세,1998,285,145,140
'4313033000,  이류면,'60,55 - 59세,1998,419,183,236
'4313033000,  이류면,'65,60 - 64세,1998,485,218,267
'4313033000,  이류면,'70,65 - 69세,1998,331,153,178
'4313033000,  이류면,'75,70 - 74세,1998,220,95,125
'4313033000,  이류면,'80,75 - 79세,1998,145,50,95
'4313033000,  이류면,'85,80 - 84세,1998,72,27,45
'4313033000,  이류면,'90,85+ ,1998,45,13,32
'4313035000,  신니면,'00,계,1998,4937,2498,2439
'4313035000,  신니면,'05,0 - 4세,1998,169,80,89
'4313035000,  신니면,'10,5 - 9세,1998,232,127,105
'4313035000,  신니면,'15,10 - 14세,1998,313,153,160
'4313035000,  신니면,'20,15 - 19세,1998,470,239,231
'4313035000,  신니면,'25,20 - 24세,1998,435,255,180
'4313035000,  신니면,'30,25 - 29세,1998,317,192,125
'4313035000,  신니면,'35,30 - 34세,1998,261,147,114
'4313035000,  신니면,'40,35 - 39세,1998,347,186,161
'4313035000,  신니면,'45,40 - 44세,1998,323,183,140
'4313035000,  신니면,'50,45 - 49세,1998,256,147,109
'4313035000,  신니면,'55,50 - 54세,1998,256,111,145
'4313035000,  신니면,'60,55 - 59세,1998,401,192,209
'4313035000,  신니면,'65,60 - 64세,1998,406,170,236
'4313035000,  신니면,'70,65 - 69세,1998,294,120,174
'4313035000,  신니면,'75,70 - 74세,1998,193,90,103
'4313035000,  신니면,'80,75 - 79세,1998,157,69,88
'4313035000,  신니면,'85,80 - 84세,1998,66,28,38
'4313035000,  신니면,'90,85+ ,1998,41,9,32
'4313036000,  노은면,'00,계,1998,3199,1625,1574
'4313036000,  노은면,'05,0 - 4세,1998,107,58,49
'4313036000,  노은면,'10,5 - 9세,1998,135,67,68
'4313036000,  노은면,'15,10 - 14세,1998,150,66,84
'4313036000,  노은면,'20,15 - 19세,1998,317,154,163
'4313036000,  노은면,'25,20 - 24세,1998,298,184,114
'4313036000,  노은면,'30,25 - 29세,1998,208,149,59
'4313036000,  노은면,'35,30 - 34세,1998,143,83,60
'4313036000,  노은면,'40,35 - 39세,1998,191,99,92
'4313036000,  노은면,'45,40 - 44세,1998,190,102,88
'4313036000,  노은면,'50,45 - 49세,1998,200,111,89
'4313036000,  노은면,'55,50 - 54세,1998,171,80,91
'4313036000,  노은면,'60,55 - 59세,1998,268,113,155
'4313036000,  노은면,'65,60 - 64세,1998,310,158,152
'4313036000,  노은면,'70,65 - 69세,1998,209,87,122
'4313036000,  노은면,'75,70 - 74세,1998,135,58,77
'4313036000,  노은면,'80,75 - 79세,1998,76,30,46
'4313036000,  노은면,'85,80 - 84세,1998,69,17,52
'4313036000,  노은면,'90,85+ ,1998,22,9,13
'4313037000,  앙성면,'00,계,1998,5867,3020,2847
'4313037000,  앙성면,'05,0 - 4세,1998,301,165,136
'4313037000,  앙성면,'10,5 - 9세,1998,340,175,165
'4313037000,  앙성면,'15,10 - 14세,1998,366,201,165
'4313037000,  앙성면,'20,15 - 19세,1998,456,230,226
'4313037000,  앙성면,'25,20 - 24세,1998,493,286,207
'4313037000,  앙성면,'30,25 - 29세,1998,408,247,161
'4313037000,  앙성면,'35,30 - 34세,1998,407,225,182
'4313037000,  앙성면,'40,35 - 39세,1998,420,226,194
'4313037000,  앙성면,'45,40 - 44세,1998,390,219,171
'4313037000,  앙성면,'50,45 - 49세,1998,281,139,142
'4313037000,  앙성면,'55,50 - 54세,1998,283,147,136
'4313037000,  앙성면,'60,55 - 59세,1998,423,194,229
'4313037000,  앙성면,'65,60 - 64세,1998,411,187,224
'4313037000,  앙성면,'70,65 - 69세,1998,361,148,213
'4313037000,  앙성면,'75,70 - 74세,1998,247,112,135
'4313037000,  앙성면,'80,75 - 79세,1998,159,76,83
'4313037000,  앙성면,'85,80 - 84세,1998,69,25,44
'4313037000,  앙성면,'90,85+ ,1998,52,18,34
'4313038000,  가금면,'00,계,1998,3567,1839,1728
'4313038000,  가금면,'05,0 - 4세,1998,159,82,77
'4313038000,  가금면,'10,5 - 9세,1998,150,76,74
'4313038000,  가금면,'15,10 - 14세,1998,155,87,68
'4313038000,  가금면,'20,15 - 19세,1998,347,178,169
'4313038000,  가금면,'25,20 - 24세,1998,338,184,154
'4313038000,  가금면,'30,25 - 29세,1998,288,191,97
'4313038000,  가금면,'35,30 - 34세,1998,193,119,74
'4313038000,  가금면,'40,35 - 39세,1998,223,111,112
'4313038000,  가금면,'45,40 - 44세,1998,243,130,113
'4313038000,  가금면,'50,45 - 49세,1998,211,109,102
'4313038000,  가금면,'55,50 - 54세,1998,195,92,103
'4313038000,  가금면,'60,55 - 59세,1998,289,143,146
'4313038000,  가금면,'65,60 - 64세,1998,278,120,158
'4313038000,  가금면,'70,65 - 69세,1998,204,81,123
'4313038000,  가금면,'75,70 - 74세,1998,127,67,60
'4313038000,  가금면,'80,75 - 79세,1998,96,38,58
'4313038000,  가금면,'85,80 - 84세,1998,46,21,25
'4313038000,  가금면,'90,85+ ,1998,25,10,15
'4313039000,  금가면,'00,계,1998,5189,2644,2545
'4313039000,  금가면,'05,0 - 4세,1998,405,215,190
'4313039000,  금가면,'10,5 - 9세,1998,323,174,149
'4313039000,  금가면,'15,10 - 14세,1998,345,172,173
'4313039000,  금가면,'20,15 - 19세,1998,455,236,219
'4313039000,  금가면,'25,20 - 24세,1998,470,238,232
'4313039000,  금가면,'30,25 - 29세,1998,569,322,247
'4313039000,  금가면,'35,30 - 34세,1998,411,219,192
'4313039000,  금가면,'40,35 - 39세,1998,376,182,194
'4313039000,  금가면,'45,40 - 44세,1998,375,211,164
'4313039000,  금가면,'50,45 - 49세,1998,245,149,96
'4313039000,  금가면,'55,50 - 54세,1998,190,82,108
'4313039000,  금가면,'60,55 - 59세,1998,274,122,152
'4313039000,  금가면,'65,60 - 64세,1998,255,127,128
'4313039000,  금가면,'70,65 - 69세,1998,205,93,112
'4313039000,  금가면,'75,70 - 74세,1998,113,53,60
'4313039000,  금가면,'80,75 - 79세,1998,91,26,65
'4313039000,  금가면,'85,80 - 84세,1998,53,14,39
'4313039000,  금가면,'90,85+ ,1998,34,9,25
'4313040000,  동량면,'00,계,1998,5252,2696,2556
'4313040000,  동량면,'05,0 - 4세,1998,228,124,104
'4313040000,  동량면,'10,5 - 9세,1998,261,141,120
'4313040000,  동량면,'15,10 - 14세,1998,270,135,135
'4313040000,  동량면,'20,15 - 19세,1998,501,253,248
'4313040000,  동량면,'25,20 - 24세,1998,516,290,226
'4313040000,  동량면,'30,25 - 29세,1998,411,257,154
'4313040000,  동량면,'35,30 - 34세,1998,371,212,159
'4313040000,  동량면,'40,35 - 39세,1998,294,164,130
'4313040000,  동량면,'45,40 - 44세,1998,328,172,156
'4313040000,  동량면,'50,45 - 49세,1998,267,139,128
'4313040000,  동량면,'55,50 - 54세,1998,280,129,151
'4313040000,  동량면,'60,55 - 59세,1998,431,208,223
'4313040000,  동량면,'65,60 - 64세,1998,389,192,197
'4313040000,  동량면,'70,65 - 69세,1998,280,105,175
'4313040000,  동량면,'75,70 - 74세,1998,198,88,110
'4313040000,  동량면,'80,75 - 79세,1998,115,56,59
'4313040000,  동량면,'85,80 - 84세,1998,72,20,52
'4313040000,  동량면,'90,85+ ,1998,40,11,29
'4313041000,  산척면,'00,계,1998,3534,1816,1718
'4313041000,  산척면,'05,0 - 4세,1998,139,73,66
'4313041000,  산척면,'10,5 - 9세,1998,163,79,84
'4313041000,  산척면,'15,10 - 14세,1998,182,86,96
'4313041000,  산척면,'20,15 - 19세,1998,325,181,144
'4313041000,  산척면,'25,20 - 24세,1998,340,196,144
'4313041000,  산척면,'30,25 - 29세,1998,253,168,85
'4313041000,  산척면,'35,30 - 34세,1998,192,103,89
'4313041000,  산척면,'40,35 - 39세,1998,227,130,97
'4313041000,  산척면,'45,40 - 44세,1998,212,119,93
'4313041000,  산척면,'50,45 - 49세,1998,182,95,87
'4313041000,  산척면,'55,50 - 54세,1998,195,90,105
'4313041000,  산척면,'60,55 - 59세,1998,266,134,132
'4313041000,  산척면,'65,60 - 64세,1998,299,136,163
'4313041000,  산척면,'70,65 - 69세,1998,212,81,131
'4313041000,  산척면,'75,70 - 74세,1998,156,77,79
'4313041000,  산척면,'80,75 - 79세,1998,102,39,63
'4313041000,  산척면,'85,80 - 84세,1998,64,19,45
'4313041000,  산척면,'90,85+ ,1998,25,10,15
'4313042000,  엄정면,'00,계,1998,4957,2489,2468
'4313042000,  엄정면,'05,0 - 4세,1998,184,105,79
'4313042000,  엄정면,'10,5 - 9세,1998,225,107,118
'4313042000,  엄정면,'15,10 - 14세,1998,302,156,146
'4313042000,  엄정면,'20,15 - 19세,1998,431,222,209
'4313042000,  엄정면,'25,20 - 24세,1998,504,262,242
'4313042000,  엄정면,'30,25 - 29세,1998,343,220,123
'4313042000,  엄정면,'35,30 - 34세,1998,247,145,102
'4313042000,  엄정면,'40,35 - 39세,1998,350,176,174
'4313042000,  엄정면,'45,40 - 44세,1998,346,183,163
'4313042000,  엄정면,'50,45 - 49세,1998,230,125,105
'4313042000,  엄정면,'55,50 - 54세,1998,232,106,126
'4313042000,  엄정면,'60,55 - 59세,1998,392,176,216
'4313042000,  엄정면,'65,60 - 64세,1998,409,190,219
'4313042000,  엄정면,'70,65 - 69세,1998,288,118,170
'4313042000,  엄정면,'75,70 - 74세,1998,195,89,106
'4313042000,  엄정면,'80,75 - 79세,1998,155,65,90
'4313042000,  엄정면,'85,80 - 84세,1998,83,31,52
'4313042000,  엄정면,'90,85+ ,1998,41,13,28
'4313043000,  소태면,'00,계,1998,2424,1280,1144
'4313043000,  소태면,'05,0 - 4세,1998,65,33,32
'4313043000,  소태면,'10,5 - 9세,1998,99,51,48
'4313043000,  소태면,'15,10 - 14세,1998,113,63,50
'4313043000,  소태면,'20,15 - 19세,1998,205,100,105
'4313043000,  소태면,'25,20 - 24세,1998,220,136,84
'4313043000,  소태면,'30,25 - 29세,1998,148,108,40
'4313043000,  소태면,'35,30 - 34세,1998,121,76,45
'4313043000,  소태면,'40,35 - 39세,1998,134,81,53
'4313043000,  소태면,'45,40 - 44세,1998,152,83,69
'4313043000,  소태면,'50,45 - 49세,1998,106,56,50
'4313043000,  소태면,'55,50 - 54세,1998,139,67,72
'4313043000,  소태면,'60,55 - 59세,1998,240,113,127
'4313043000,  소태면,'65,60 - 64세,1998,252,129,123
'4313043000,  소태면,'70,65 - 69세,1998,167,66,101
'4313043000,  소태면,'75,70 - 74세,1998,115,51,64
'4313043000,  소태면,'80,75 - 79세,1998,82,36,46
'4313043000,  소태면,'85,80 - 84세,1998,39,20,19
'4313043000,  소태면,'90,85+ ,1998,27,11,16
'4313051500,  성내.충인동,'00,계,1998,5124,2537,2587
'4313051500,  성내.충인동,'05,0 - 4세,1998,226,113,113
'4313051500,  성내.충인동,'10,5 - 9세,1998,251,130,121
'4313051500,  성내.충인동,'15,10 - 14세,1998,289,150,139
'4313051500,  성내.충인동,'20,15 - 19세,1998,502,259,243
'4313051500,  성내.충인동,'25,20 - 24세,1998,555,297,258
'4313051500,  성내.충인동,'30,25 - 29세,1998,442,258,184
'4313051500,  성내.충인동,'35,30 - 34세,1998,324,164,160
'4313051500,  성내.충인동,'40,35 - 39세,1998,371,174,197
'4313051500,  성내.충인동,'45,40 - 44세,1998,397,199,198
'4313051500,  성내.충인동,'50,45 - 49세,1998,337,146,191
'4313051500,  성내.충인동,'55,50 - 54세,1998,355,168,187
'4313051500,  성내.충인동,'60,55 - 59세,1998,345,170,175
'4313051500,  성내.충인동,'65,60 - 64세,1998,264,134,130
'4313051500,  성내.충인동,'70,65 - 69세,1998,167,57,110
'4313051500,  성내.충인동,'75,70 - 74세,1998,129,54,75
'4313051500,  성내.충인동,'80,75 - 79세,1998,100,37,63
'4313051500,  성내.충인동,'85,80 - 84세,1998,46,18,28
'4313051500,  성내.충인동,'90,85+ ,1998,24,9,15
'4313053500,  교현.안림동,'00,계,1998,24460,12257,12203
'4313053500,  교현.안림동,'05,0 - 4세,1998,1597,830,767
'4313053500,  교현.안림동,'10,5 - 9세,1998,1887,1031,856
'4313053500,  교현.안림동,'15,10 - 14세,1998,1959,999,960
'4313053500,  교현.안림동,'20,15 - 19세,1998,2356,1218,1138
'4313053500,  교현.안림동,'25,20 - 24세,1998,2160,1161,999
'4313053500,  교현.안림동,'30,25 - 29세,1998,2048,1026,1022
'4313053500,  교현.안림동,'35,30 - 34세,1998,1995,991,1004
'4313053500,  교현.안림동,'40,35 - 39세,1998,2317,1143,1174
'4313053500,  교현.안림동,'45,40 - 44세,1998,2081,1068,1013
'4313053500,  교현.안림동,'50,45 - 49세,1998,1321,659,662
'4313053500,  교현.안림동,'55,50 - 54세,1998,1110,570,540
'4313053500,  교현.안림동,'60,55 - 59세,1998,1130,555,575
'4313053500,  교현.안림동,'65,60 - 64세,1998,894,409,485
'4313053500,  교현.안림동,'70,65 - 69세,1998,593,223,370
'4313053500,  교현.안림동,'75,70 - 74세,1998,425,180,245
'4313053500,  교현.안림동,'80,75 - 79세,1998,326,112,214
'4313053500,  교현.안림동,'85,80 - 84세,1998,171,57,114
'4313053500,  교현.안림동,'90,85+ ,1998,90,25,65
'4313054000,  교현2동,'00,계,1998,12199,6069,6130
'4313054000,  교현2동,'05,0 - 4세,1998,808,427,381
'4313054000,  교현2동,'10,5 - 9세,1998,884,468,416
'4313054000,  교현2동,'15,10 - 14세,1998,886,481,405
'4313054000,  교현2동,'20,15 - 19세,1998,1166,586,580
'4313054000,  교현2동,'25,20 - 24세,1998,1190,632,558
'4313054000,  교현2동,'30,25 - 29세,1998,1118,600,518
'4313054000,  교현2동,'35,30 - 34세,1998,995,482,513
'4313054000,  교현2동,'40,35 - 39세,1998,1095,534,561
'4313054000,  교현2동,'45,40 - 44세,1998,984,491,493
'4313054000,  교현2동,'50,45 - 49세,1998,668,324,344
'4313054000,  교현2동,'55,50 - 54세,1998,554,270,284
'4313054000,  교현2동,'60,55 - 59세,1998,578,285,293
'4313054000,  교현2동,'65,60 - 64세,1998,452,206,246
'4313054000,  교현2동,'70,65 - 69세,1998,298,111,187
'4313054000,  교현2동,'75,70 - 74세,1998,212,82,130
'4313054000,  교현2동,'80,75 - 79세,1998,167,46,121
'4313054000,  교현2동,'85,80 - 84세,1998,93,31,62
'4313054000,  교현2동,'90,85+ ,1998,51,13,38
'4313055000,  용산동,'00,계,1998,11468,5784,5684
'4313055000,  용산동,'05,0 - 4세,1998,809,433,376
'4313055000,  용산동,'10,5 - 9세,1998,912,477,435
'4313055000,  용산동,'15,10 - 14세,1998,859,483,376
'4313055000,  용산동,'20,15 - 19세,1998,1147,625,522
'4313055000,  용산동,'25,20 - 24세,1998,957,497,460
'4313055000,  용산동,'30,25 - 29세,1998,986,506,480
'4313055000,  용산동,'35,30 - 34세,1998,1071,527,544
'4313055000,  용산동,'40,35 - 39세,1998,1119,569,550
'4313055000,  용산동,'45,40 - 44세,1998,976,484,492
'4313055000,  용산동,'50,45 - 49세,1998,603,318,285
'4313055000,  용산동,'55,50 - 54세,1998,470,235,235
'4313055000,  용산동,'60,55 - 59세,1998,471,212,259
'4313055000,  용산동,'65,60 - 64세,1998,374,169,205
'4313055000,  용산동,'70,65 - 69세,1998,275,100,175
'4313055000,  용산동,'75,70 - 74세,1998,206,80,126
'4313055000,  용산동,'80,75 - 79세,1998,125,36,89
'4313055000,  용산동,'85,80 - 84세,1998,64,19,45
'4313055000,  용산동,'90,85+ ,1998,44,14,30
'4313056000,  지현동,'00,계,1998,7599,3923,3676
'4313056000,  지현동,'05,0 - 4세,1998,326,169,157
'4313056000,  지현동,'10,5 - 9세,1998,426,239,187
'4313056000,  지현동,'15,10 - 14세,1998,483,268,215
'4313056000,  지현동,'20,15 - 19세,1998,765,440,325
'4313056000,  지현동,'25,20 - 24세,1998,838,456,382
'4313056000,  지현동,'30,25 - 29세,1998,635,386,249
'4313056000,  지현동,'35,30 - 34세,1998,473,241,232
'4313056000,  지현동,'40,35 - 39세,1998,565,284,281
'4313056000,  지현동,'45,40 - 44세,1998,578,282,296
'4313056000,  지현동,'50,45 - 49세,1998,514,235,279
'4313056000,  지현동,'55,50 - 54세,1998,460,224,236
'4313056000,  지현동,'60,55 - 59세,1998,518,262,256
'4313056000,  지현동,'65,60 - 64세,1998,395,184,211
'4313056000,  지현동,'70,65 - 69세,1998,232,106,126
'4313056000,  지현동,'75,70 - 74세,1998,171,71,100
'4313056000,  지현동,'80,75 - 79세,1998,119,50,69
'4313056000,  지현동,'85,80 - 84세,1998,54,13,41
'4313056000,  지현동,'90,85+ ,1998,47,13,34
'4313057100,  문화동,'00,계,1998,14276,7228,7048
'4313057100,  문화동,'05,0 - 4세,1998,706,368,338
'4313057100,  문화동,'10,5 - 9세,1998,960,496,464
'4313057100,  문화동,'15,10 - 14세,1998,1051,575,476
'4313057100,  문화동,'20,15 - 19세,1998,1498,769,729
'4313057100,  문화동,'25,20 - 24세,1998,1407,792,615
'4313057100,  문화동,'30,25 - 29세,1998,1142,689,453
'4313057100,  문화동,'35,30 - 34세,1998,944,474,470
'4313057100,  문화동,'40,35 - 39세,1998,1222,588,634
'4313057100,  문화동,'45,40 - 44세,1998,1234,587,647
'4313057100,  문화동,'50,45 - 49세,1998,960,471,489
'4313057100,  문화동,'55,50 - 54세,1998,826,402,424
'4313057100,  문화동,'60,55 - 59세,1998,796,404,392
'4313057100,  문화동,'65,60 - 64세,1998,576,282,294
'4313057100,  문화동,'70,65 - 69세,1998,388,143,245
'4313057100,  문화동,'75,70 - 74세,1998,230,87,143
'4313057100,  문화동,'80,75 - 79세,1998,182,62,120
'4313057100,  문화동,'85,80 - 84세,1998,98,27,71
'4313057100,  문화동,'90,85+ ,1998,56,12,44
'4313058000,  호암.직동,'00,계,1998,8086,4057,4029
'4313058000,  호암.직동,'05,0 - 4세,1998,587,336,251
'4313058000,  호암.직동,'10,5 - 9세,1998,594,303,291
'4313058000,  호암.직동,'15,10 - 14세,1998,622,321,301
'4313058000,  호암.직동,'20,15 - 19세,1998,843,446,397
'4313058000,  호암.직동,'25,20 - 24세,1998,745,374,371
'4313058000,  호암.직동,'30,25 - 29세,1998,839,427,412
'4313058000,  호암.직동,'35,30 - 34세,1998,719,350,369
'4313058000,  호암.직동,'40,35 - 39세,1998,796,370,426
'4313058000,  호암.직동,'45,40 - 44세,1998,665,360,305
'4313058000,  호암.직동,'50,45 - 49세,1998,433,224,209
'4313058000,  호암.직동,'55,50 - 54세,1998,290,154,136
'4313058000,  호암.직동,'60,55 - 59세,1998,316,156,160
'4313058000,  호암.직동,'65,60 - 64세,1998,213,89,124
'4313058000,  호암.직동,'70,65 - 69세,1998,150,54,96
'4313058000,  호암.직동,'75,70 - 74세,1998,113,42,71
'4313058000,  호암.직동,'80,75 - 79세,1998,87,32,55
'4313058000,  호암.직동,'85,80 - 84세,1998,50,12,38
'4313058000,  호암.직동,'90,85+ ,1998,24,7,17
'4313060500,  달천동,'00,계,1998,5107,2605,2502
'4313060500,  달천동,'05,0 - 4세,1998,252,126,126
'4313060500,  달천동,'10,5 - 9세,1998,268,140,128
'4313060500,  달천동,'15,10 - 14세,1998,296,145,151
'4313060500,  달천동,'20,15 - 19세,1998,416,229,187
'4313060500,  달천동,'25,20 - 24세,1998,510,305,205
'4313060500,  달천동,'30,25 - 29세,1998,458,296,162
'4313060500,  달천동,'35,30 - 34세,1998,346,181,165
'4313060500,  달천동,'40,35 - 39세,1998,362,195,167
'4313060500,  달천동,'45,40 - 44세,1998,350,187,163
'4313060500,  달천동,'50,45 - 49세,1998,214,99,115
'4313060500,  달천동,'55,50 - 54세,1998,294,141,153
'4313060500,  달천동,'60,55 - 59세,1998,393,173,220
'4313060500,  달천동,'65,60 - 64세,1998,321,145,176
'4313060500,  달천동,'70,65 - 69세,1998,228,91,137
'4313060500,  달천동,'75,70 - 74세,1998,173,73,100
'4313060500,  달천동,'80,75 - 79세,1998,121,51,70
'4313060500,  달천동,'85,80 - 84세,1998,63,16,47
'4313060500,  달천동,'90,85+ ,1998,42,12,30
'4313061000,  봉방동,'00,계,1998,9928,5015,4913
'4313061000,  봉방동,'05,0 - 4세,1998,662,364,298
'4313061000,  봉방동,'10,5 - 9세,1998,589,306,283
'4313061000,  봉방동,'15,10 - 14세,1998,729,393,336
'4313061000,  봉방동,'20,15 - 19세,1998,986,502,484
'4313061000,  봉방동,'25,20 - 24세,1998,917,468,449
'4313061000,  봉방동,'30,25 - 29세,1998,961,513,448
'4313061000,  봉방동,'35,30 - 34세,1998,762,416,346
'4313061000,  봉방동,'40,35 - 39세,1998,871,414,457
'4313061000,  봉방동,'45,40 - 44세,1998,763,381,382
'4313061000,  봉방동,'50,45 - 49세,1998,576,287,289
'4313061000,  봉방동,'55,50 - 54세,1998,502,257,245
'4313061000,  봉방동,'60,55 - 59세,1998,525,261,264
'4313061000,  봉방동,'65,60 - 64세,1998,401,190,211
'4313061000,  봉방동,'70,65 - 69세,1998,285,114,171
'4313061000,  봉방동,'75,70 - 74세,1998,165,73,92
'4313061000,  봉방동,'80,75 - 79세,1998,135,51,84
'4313061000,  봉방동,'85,80 - 84세,1998,64,16,48
'4313061000,  봉방동,'90,85+ ,1998,35,9,26
'4313062500,  칠금.금릉동,'00,계,1998,17037,8483,8554
'4313062500,  칠금.금릉동,'05,0 - 4세,1998,2149,1129,1020
'4313062500,  칠금.금릉동,'10,5 - 9세,1998,1923,1024,899
'4313062500,  칠금.금릉동,'15,10 - 14세,1998,1212,613,599
'4313062500,  칠금.금릉동,'20,15 - 19세,1998,943,482,461
'4313062500,  칠금.금릉동,'25,20 - 24세,1998,938,448,490
'4313062500,  칠금.금릉동,'30,25 - 29세,1998,1994,816,1178
'4313062500,  칠금.금릉동,'35,30 - 34세,1998,2369,1230,1139
'4313062500,  칠금.금릉동,'40,35 - 39세,1998,1988,1072,916
'4313062500,  칠금.금릉동,'45,40 - 44세,1998,1133,647,486
'4313062500,  칠금.금릉동,'50,45 - 49세,1998,517,258,259
'4313062500,  칠금.금릉동,'55,50 - 54세,1998,387,186,201
'4313062500,  칠금.금릉동,'60,55 - 59세,1998,415,181,234
'4313062500,  칠금.금릉동,'65,60 - 64세,1998,405,174,231
'4313062500,  칠금.금릉동,'70,65 - 69세,1998,257,90,167
'4313062500,  칠금.금릉동,'75,70 - 74세,1998,185,67,118
'4313062500,  칠금.금릉동,'80,75 - 79세,1998,114,34,80
'4313062500,  칠금.금릉동,'85,80 - 84세,1998,74,22,52
'4313062500,  칠금.금릉동,'90,85+ ,1998,34,10,24
'4313063000,  연수동,'00,계,1998,36374,18132,18242
'4313063000,  연수동,'05,0 - 4세,1998,3466,1816,1650
'4313063000,  연수동,'10,5 - 9세,1998,3444,1860,1584
'4313063000,  연수동,'15,10 - 14세,1998,3071,1566,1505
'4313063000,  연수동,'20,15 - 19세,1998,2833,1442,1391
'4313063000,  연수동,'25,20 - 24세,1998,2548,1275,1273
'4313063000,  연수동,'30,25 - 29세,1998,3846,1796,2050
'4313063000,  연수동,'35,30 - 34세,1998,4207,2101,2106
'4313063000,  연수동,'40,35 - 39세,1998,4158,2163,1995
'4313063000,  연수동,'45,40 - 44세,1998,2765,1483,1282
'4313063000,  연수동,'50,45 - 49세,1998,1488,752,736
'4313063000,  연수동,'55,50 - 54세,1998,1044,504,540
'4313063000,  연수동,'60,55 - 59세,1998,1098,514,584
'4313063000,  연수동,'65,60 - 64세,1998,825,348,477
'4313063000,  연수동,'70,65 - 69세,1998,605,195,410
'4313063000,  연수동,'75,70 - 74세,1998,424,127,297
'4313063000,  연수동,'80,75 - 79세,1998,299,109,190
'4313063000,  연수동,'85,80 - 84세,1998,168,55,113
'4313063000,  연수동,'90,85+ ,1998,85,26,59
'4313064000,  목행.용탄동,'00,계,1998,6792,3490,3302
'4313064000,  목행.용탄동,'05,0 - 4세,1998,749,379,370
'4313064000,  목행.용탄동,'10,5 - 9세,1998,603,337,266
'4313064000,  목행.용탄동,'15,10 - 14세,1998,404,205,199
'4313064000,  목행.용탄동,'20,15 - 19세,1998,452,232,220
'4313064000,  목행.용탄동,'25,20 - 24세,1998,554,276,278
'4313064000,  목행.용탄동,'30,25 - 29세,1998,906,448,458
'4313064000,  목행.용탄동,'35,30 - 34세,1998,808,448,360
'4313064000,  목행.용탄동,'40,35 - 39세,1998,629,357,272
'4313064000,  목행.용탄동,'45,40 - 44세,1998,408,231,177
'4313064000,  목행.용탄동,'50,45 - 49세,1998,240,121,119
'4313064000,  목행.용탄동,'55,50 - 54세,1998,197,110,87
'4313064000,  목행.용탄동,'60,55 - 59세,1998,241,102,139
'4313064000,  목행.용탄동,'65,60 - 64세,1998,220,95,125
'4313064000,  목행.용탄동,'70,65 - 69세,1998,158,69,89
'4313064000,  목행.용탄동,'75,70 - 74세,1998,106,43,63
'4313064000,  목행.용탄동,'80,75 - 79세,1998,58,20,38
'4313064000,  목행.용탄동,'85,80 - 84세,1998,38,13,25
'4313064000,  목행.용탄동,'90,85+ ,1998,21,4,17
'43150, 제천시,'00,계,1998,147942,74681,73261
'43150, 제천시,'05,0 - 4세,1998,9532,5074,4458
'43150, 제천시,'10,5 - 9세,1998,9853,5208,4645
'43150, 제천시,'15,10 - 14세,1998,10391,5384,5007
'43150, 제천시,'20,15 - 19세,1998,14395,7310,7085
'43150, 제천시,'25,20 - 24세,1998,13161,7156,6005
'43150, 제천시,'30,25 - 29세,1998,12208,6553,5655
'43150, 제천시,'35,30 - 34세,1998,11704,6011,5693
'43150, 제천시,'40,35 - 39세,1998,13227,6701,6526
'43150, 제천시,'45,40 - 44세,1998,11964,6180,5784
'43150, 제천시,'50,45 - 49세,1998,8288,4263,4025
'43150, 제천시,'55,50 - 54세,1998,6884,3391,3493
'43150, 제천시,'60,55 - 59세,1998,7890,3835,4055
'43150, 제천시,'65,60 - 64세,1998,6693,3120,3573
'43150, 제천시,'70,65 - 69세,1998,4440,1812,2628
'43150, 제천시,'75,70 - 74세,1998,3232,1271,1961
'43150, 제천시,'80,75 - 79세,1998,2157,818,1339
'43150, 제천시,'85,80 - 84세,1998,1231,412,819
'43150, 제천시,'90,85+ ,1998,692,182,510
'4315025000,  봉양읍,'00,계,1998,9169,4608,4561
'4315025000,  봉양읍,'05,0 - 4세,1998,496,260,236
'4315025000,  봉양읍,'10,5 - 9세,1998,425,228,197
'4315025000,  봉양읍,'15,10 - 14세,1998,436,211,225
'4315025000,  봉양읍,'20,15 - 19세,1998,796,406,390
'4315025000,  봉양읍,'25,20 - 24세,1998,830,483,347
'4315025000,  봉양읍,'30,25 - 29세,1998,801,451,350
'4315025000,  봉양읍,'35,30 - 34세,1998,650,358,292
'4315025000,  봉양읍,'40,35 - 39세,1998,661,357,304
'4315025000,  봉양읍,'45,40 - 44세,1998,653,331,322
'4315025000,  봉양읍,'50,45 - 49세,1998,458,227,231
'4315025000,  봉양읍,'55,50 - 54세,1998,443,203,240
'4315025000,  봉양읍,'60,55 - 59세,1998,642,308,334
'4315025000,  봉양읍,'65,60 - 64세,1998,619,280,339
'4315025000,  봉양읍,'70,65 - 69세,1998,455,177,278
'4315025000,  봉양읍,'75,70 - 74세,1998,341,137,204
'4315025000,  봉양읍,'80,75 - 79세,1998,255,116,139
'4315025000,  봉양읍,'85,80 - 84세,1998,146,51,95
'4315025000,  봉양읍,'90,85+ ,1998,62,24,38
'4315031000,  금성면,'00,계,1998,2813,1464,1349
'4315031000,  금성면,'05,0 - 4세,1998,128,76,52
'4315031000,  금성면,'10,5 - 9세,1998,121,66,55
'4315031000,  금성면,'15,10 - 14세,1998,177,77,100
'4315031000,  금성면,'20,15 - 19세,1998,249,131,118
'4315031000,  금성면,'25,20 - 24세,1998,238,150,88
'4315031000,  금성면,'30,25 - 29세,1998,182,127,55
'4315031000,  금성면,'35,30 - 34세,1998,140,79,61
'4315031000,  금성면,'40,35 - 39세,1998,188,108,80
'4315031000,  금성면,'45,40 - 44세,1998,201,107,94
'4315031000,  금성면,'50,45 - 49세,1998,138,85,53
'4315031000,  금성면,'55,50 - 54세,1998,137,69,68
'4315031000,  금성면,'60,55 - 59세,1998,211,95,116
'4315031000,  금성면,'65,60 - 64세,1998,239,107,132
'4315031000,  금성면,'70,65 - 69세,1998,181,69,112
'4315031000,  금성면,'75,70 - 74세,1998,124,54,70
'4315031000,  금성면,'80,75 - 79세,1998,94,43,51
'4315031000,  금성면,'85,80 - 84세,1998,36,15,21
'4315031000,  금성면,'90,85+ ,1998,29,6,23
'4315032000,  청풍면,'00,계,1998,1596,842,754
'4315032000,  청풍면,'05,0 - 4세,1998,66,36,30
'4315032000,  청풍면,'10,5 - 9세,1998,47,22,25
'4315032000,  청풍면,'15,10 - 14세,1998,71,31,40
'4315032000,  청풍면,'20,15 - 19세,1998,149,68,81
'4315032000,  청풍면,'25,20 - 24세,1998,152,90,62
'4315032000,  청풍면,'30,25 - 29세,1998,124,81,43
'4315032000,  청풍면,'35,30 - 34세,1998,83,53,30
'4315032000,  청풍면,'40,35 - 39세,1998,102,63,39
'4315032000,  청풍면,'45,40 - 44세,1998,114,70,44
'4315032000,  청풍면,'50,45 - 49세,1998,83,41,42
'4315032000,  청풍면,'55,50 - 54세,1998,103,60,43
'4315032000,  청풍면,'60,55 - 59세,1998,156,75,81
'4315032000,  청풍면,'65,60 - 64세,1998,147,71,76
'4315032000,  청풍면,'70,65 - 69세,1998,73,25,48
'4315032000,  청풍면,'75,70 - 74세,1998,53,30,23
'4315032000,  청풍면,'80,75 - 79세,1998,38,12,26
'4315032000,  청풍면,'85,80 - 84세,1998,22,10,12
'4315032000,  청풍면,'90,85+ ,1998,13,4,9
'4315033000,  수산면,'00,계,1998,2903,1501,1402
'4315033000,  수산면,'05,0 - 4세,1998,73,32,41
'4315033000,  수산면,'10,5 - 9세,1998,101,61,40
'4315033000,  수산면,'15,10 - 14세,1998,122,62,60
'4315033000,  수산면,'20,15 - 19세,1998,275,148,127
'4315033000,  수산면,'25,20 - 24세,1998,274,167,107
'4315033000,  수산면,'30,25 - 29세,1998,167,113,54
'4315033000,  수산면,'35,30 - 34세,1998,108,70,38
'4315033000,  수산면,'40,35 - 39세,1998,154,85,69
'4315033000,  수산면,'45,40 - 44세,1998,174,83,91
'4315033000,  수산면,'50,45 - 49세,1998,188,97,91
'4315033000,  수산면,'55,50 - 54세,1998,196,106,90
'4315033000,  수산면,'60,55 - 59세,1998,297,133,164
'4315033000,  수산면,'65,60 - 64세,1998,293,142,151
'4315033000,  수산면,'70,65 - 69세,1998,162,72,90
'4315033000,  수산면,'75,70 - 74세,1998,141,58,83
'4315033000,  수산면,'80,75 - 79세,1998,99,43,56
'4315033000,  수산면,'85,80 - 84세,1998,46,18,28
'4315033000,  수산면,'90,85+ ,1998,33,11,22
'4315034000,  덕산면,'00,계,1998,3365,1706,1659
'4315034000,  덕산면,'05,0 - 4세,1998,112,63,49
'4315034000,  덕산면,'10,5 - 9세,1998,139,81,58
'4315034000,  덕산면,'15,10 - 14세,1998,197,95,102
'4315034000,  덕산면,'20,15 - 19세,1998,301,153,148
'4315034000,  덕산면,'25,20 - 24세,1998,329,198,131
'4315034000,  덕산면,'30,25 - 29세,1998,180,109,71
'4315034000,  덕산면,'35,30 - 34세,1998,145,75,70
'4315034000,  덕산면,'40,35 - 39세,1998,203,116,87
'4315034000,  덕산면,'45,40 - 44세,1998,214,109,105
'4315034000,  덕산면,'50,45 - 49세,1998,207,105,102
'4315034000,  덕산면,'55,50 - 54세,1998,215,114,101
'4315034000,  덕산면,'60,55 - 59세,1998,276,133,143
'4315034000,  덕산면,'65,60 - 64세,1998,285,118,167
'4315034000,  덕산면,'70,65 - 69세,1998,238,105,133
'4315034000,  덕산면,'75,70 - 74세,1998,147,61,86
'4315034000,  덕산면,'80,75 - 79세,1998,94,39,55
'4315034000,  덕산면,'85,80 - 84세,1998,55,23,32
'4315034000,  덕산면,'90,85+ ,1998,28,9,19
'4315035000,  한수면,'00,계,1998,946,489,457
'4315035000,  한수면,'05,0 - 4세,1998,33,20,13
'4315035000,  한수면,'10,5 - 9세,1998,50,24,26
'4315035000,  한수면,'15,10 - 14세,1998,50,28,22
'4315035000,  한수면,'20,15 - 19세,1998,98,52,46
'4315035000,  한수면,'25,20 - 24세,1998,77,52,25
'4315035000,  한수면,'30,25 - 29세,1998,60,38,22
'4315035000,  한수면,'35,30 - 34세,1998,49,25,24
'4315035000,  한수면,'40,35 - 39세,1998,57,34,23
'4315035000,  한수면,'45,40 - 44세,1998,77,38,39
'4315035000,  한수면,'50,45 - 49세,1998,49,24,25
'4315035000,  한수면,'55,50 - 54세,1998,52,23,29
'4315035000,  한수면,'60,55 - 59세,1998,66,33,33
'4315035000,  한수면,'65,60 - 64세,1998,85,40,45
'4315035000,  한수면,'70,65 - 69세,1998,50,20,30
'4315035000,  한수면,'75,70 - 74세,1998,49,23,26
'4315035000,  한수면,'80,75 - 79세,1998,23,9,14
'4315035000,  한수면,'85,80 - 84세,1998,12,5,7
'4315035000,  한수면,'90,85+ ,1998,9,1,8
'4315036000,  백운면,'00,계,1998,4203,2153,2050
'4315036000,  백운면,'05,0 - 4세,1998,147,83,64
'4315036000,  백운면,'10,5 - 9세,1998,197,91,106
'4315036000,  백운면,'15,10 - 14세,1998,263,141,122
'4315036000,  백운면,'20,15 - 19세,1998,362,179,183
'4315036000,  백운면,'25,20 - 24세,1998,380,230,150
'4315036000,  백운면,'30,25 - 29세,1998,233,143,90
'4315036000,  백운면,'35,30 - 34세,1998,215,126,89
'4315036000,  백운면,'40,35 - 39세,1998,278,152,126
'4315036000,  백운면,'45,40 - 44세,1998,295,164,131
'4315036000,  백운면,'50,45 - 49세,1998,220,115,105
'4315036000,  백운면,'55,50 - 54세,1998,209,102,107
'4315036000,  백운면,'60,55 - 59세,1998,373,173,200
'4315036000,  백운면,'65,60 - 64세,1998,343,149,194
'4315036000,  백운면,'70,65 - 69세,1998,242,106,136
'4315036000,  백운면,'75,70 - 74세,1998,189,84,105
'4315036000,  백운면,'80,75 - 79세,1998,129,60,69
'4315036000,  백운면,'85,80 - 84세,1998,82,33,49
'4315036000,  백운면,'90,85+ ,1998,46,22,24
'4315038000,  송학면,'00,계,1998,7225,3786,3439
'4315038000,  송학면,'05,0 - 4세,1998,328,181,147
'4315038000,  송학면,'10,5 - 9세,1998,328,169,159
'4315038000,  송학면,'15,10 - 14세,1998,444,218,226
'4315038000,  송학면,'20,15 - 19세,1998,708,386,322
'4315038000,  송학면,'25,20 - 24세,1998,770,461,309
'4315038000,  송학면,'30,25 - 29세,1998,574,357,217
'4315038000,  송학면,'35,30 - 34세,1998,450,265,185
'4315038000,  송학면,'40,35 - 39세,1998,478,257,221
'4315038000,  송학면,'45,40 - 44세,1998,547,295,252
'4315038000,  송학면,'50,45 - 49세,1998,364,191,173
'4315038000,  송학면,'55,50 - 54세,1998,349,160,189
'4315038000,  송학면,'60,55 - 59세,1998,521,243,278
'4315038000,  송학면,'65,60 - 64세,1998,480,226,254
'4315038000,  송학면,'70,65 - 69세,1998,354,167,187
'4315038000,  송학면,'75,70 - 74세,1998,257,112,145
'4315038000,  송학면,'80,75 - 79세,1998,115,50,65
'4315038000,  송학면,'85,80 - 84세,1998,98,32,66
'4315038000,  송학면,'90,85+ ,1998,60,16,44
'4315051000,  교동,'00,계,1998,20373,10254,10119
'4315051000,  교동,'05,0 - 4세,1998,1727,906,821
'4315051000,  교동,'10,5 - 9세,1998,1609,845,764
'4315051000,  교동,'15,10 - 14세,1998,1636,870,766
'4315051000,  교동,'20,15 - 19세,1998,1938,950,988
'4315051000,  교동,'25,20 - 24세,1998,1586,835,751
'4315051000,  교동,'30,25 - 29세,1998,1886,919,967
'4315051000,  교동,'35,30 - 34세,1998,1970,973,997
'4315051000,  교동,'40,35 - 39세,1998,2129,1070,1059
'4315051000,  교동,'45,40 - 44세,1998,1741,944,797
'4315051000,  교동,'50,45 - 49세,1998,1030,549,481
'4315051000,  교동,'55,50 - 54세,1998,751,382,369
'4315051000,  교동,'60,55 - 59세,1998,772,413,359
'4315051000,  교동,'65,60 - 64세,1998,586,260,326
'4315051000,  교동,'70,65 - 69세,1998,382,144,238
'4315051000,  교동,'75,70 - 74세,1998,268,88,180
'4315051000,  교동,'80,75 - 79세,1998,196,57,139
'4315051000,  교동,'85,80 - 84세,1998,105,38,67
'4315051000,  교동,'90,85+ ,1998,61,11,50
'4315052000,  중앙동,'00,계,1998,6765,3323,3442
'4315052000,  중앙동,'05,0 - 4세,1998,304,145,159
'4315052000,  중앙동,'10,5 - 9세,1998,375,184,191
'4315052000,  중앙동,'15,10 - 14세,1998,447,242,205
'4315052000,  중앙동,'20,15 - 19세,1998,718,368,350
'4315052000,  중앙동,'25,20 - 24세,1998,733,391,342
'4315052000,  중앙동,'30,25 - 29세,1998,539,301,238
'4315052000,  중앙동,'35,30 - 34세,1998,406,226,180
'4315052000,  중앙동,'40,35 - 39세,1998,491,224,267
'4315052000,  중앙동,'45,40 - 44세,1998,529,219,310
'4315052000,  중앙동,'50,45 - 49세,1998,488,219,269
'4315052000,  중앙동,'55,50 - 54세,1998,454,234,220
'4315052000,  중앙동,'60,55 - 59세,1998,419,211,208
'4315052000,  중앙동,'65,60 - 64세,1998,333,159,174
'4315052000,  중앙동,'70,65 - 69세,1998,216,98,118
'4315052000,  중앙동,'75,70 - 74세,1998,129,54,75
'4315052000,  중앙동,'80,75 - 79세,1998,87,27,60
'4315052000,  중앙동,'85,80 - 84세,1998,64,18,46
'4315052000,  중앙동,'90,85+ ,1998,33,3,30
'4315054000,  명서동,'00,계,1998,5712,2883,2829
'4315054000,  명서동,'05,0 - 4세,1998,283,137,146
'4315054000,  명서동,'10,5 - 9세,1998,328,176,152
'4315054000,  명서동,'15,10 - 14세,1998,366,219,147
'4315054000,  명서동,'20,15 - 19세,1998,577,280,297
'4315054000,  명서동,'25,20 - 24세,1998,559,317,242
'4315054000,  명서동,'30,25 - 29세,1998,456,265,191
'4315054000,  명서동,'35,30 - 34세,1998,396,209,187
'4315054000,  명서동,'40,35 - 39세,1998,462,215,247
'4315054000,  명서동,'45,40 - 44세,1998,450,222,228
'4315054000,  명서동,'50,45 - 49세,1998,428,195,233
'4315054000,  명서동,'55,50 - 54세,1998,334,164,170
'4315054000,  명서동,'60,55 - 59세,1998,376,197,179
'4315054000,  명서동,'65,60 - 64세,1998,242,122,120
'4315054000,  명서동,'70,65 - 69세,1998,152,69,83
'4315054000,  명서동,'75,70 - 74세,1998,127,40,87
'4315054000,  명서동,'80,75 - 79세,1998,90,32,58
'4315054000,  명서동,'85,80 - 84세,1998,57,17,40
'4315054000,  명서동,'90,85+ ,1998,29,7,22
'4315055000,  의림동,'00,계,1998,5051,2566,2485
'4315055000,  의림동,'05,0 - 4세,1998,218,123,95
'4315055000,  의림동,'10,5 - 9세,1998,306,171,135
'4315055000,  의림동,'15,10 - 14세,1998,315,175,140
'4315055000,  의림동,'20,15 - 19세,1998,555,310,245
'4315055000,  의림동,'25,20 - 24세,1998,559,305,254
'4315055000,  의림동,'30,25 - 29세,1998,388,217,171
'4315055000,  의림동,'35,30 - 34세,1998,301,157,144
'4315055000,  의림동,'40,35 - 39세,1998,372,166,206
'4315055000,  의림동,'45,40 - 44세,1998,438,200,238
'4315055000,  의림동,'50,45 - 49세,1998,363,174,189
'4315055000,  의림동,'55,50 - 54세,1998,343,160,183
'4315055000,  의림동,'60,55 - 59세,1998,301,160,141
'4315055000,  의림동,'65,60 - 64세,1998,202,104,98
'4315055000,  의림동,'70,65 - 69세,1998,127,54,73
'4315055000,  의림동,'75,70 - 74세,1998,113,46,67
'4315055000,  의림동,'80,75 - 79세,1998,71,20,51
'4315055000,  의림동,'85,80 - 84세,1998,49,13,36
'4315055000,  의림동,'90,85+ ,1998,30,11,19
'4315056000,  용두동,'00,계,1998,15026,7502,7524
'4315056000,  용두동,'05,0 - 4세,1998,1373,725,648
'4315056000,  용두동,'10,5 - 9세,1998,1378,722,656
'4315056000,  용두동,'15,10 - 14세,1998,1176,597,579
'4315056000,  용두동,'20,15 - 19세,1998,1257,657,600
'4315056000,  용두동,'25,20 - 24세,1998,1103,569,534
'4315056000,  용두동,'30,25 - 29세,1998,1362,633,729
'4315056000,  용두동,'35,30 - 34세,1998,1647,831,816
'4315056000,  용두동,'40,35 - 39세,1998,1653,871,782
'4315056000,  용두동,'45,40 - 44세,1998,1128,635,493
'4315056000,  용두동,'50,45 - 49세,1998,592,298,294
'4315056000,  용두동,'55,50 - 54세,1998,506,229,277
'4315056000,  용두동,'60,55 - 59세,1998,522,235,287
'4315056000,  용두동,'65,60 - 64세,1998,460,199,261
'4315056000,  용두동,'70,65 - 69세,1998,344,120,224
'4315056000,  용두동,'75,70 - 74세,1998,263,81,182
'4315056000,  용두동,'80,75 - 79세,1998,149,62,87
'4315056000,  용두동,'85,80 - 84세,1998,81,32,49
'4315056000,  용두동,'90,85+ ,1998,32,6,26
'4315057000,  동현동,'00,계,1998,20178,10105,10073
'4315057000,  동현동,'05,0 - 4세,1998,1593,859,734
'4315057000,  동현동,'10,5 - 9세,1998,1674,878,796
'4315057000,  동현동,'15,10 - 14세,1998,1541,807,734
'4315057000,  동현동,'20,15 - 19세,1998,1954,932,1022
'4315057000,  동현동,'25,20 - 24세,1998,1645,850,795
'4315057000,  동현동,'30,25 - 29세,1998,1709,834,875
'4315057000,  동현동,'35,30 - 34세,1998,1904,929,975
'4315057000,  동현동,'40,35 - 39세,1998,2083,1111,972
'4315057000,  동현동,'45,40 - 44세,1998,1591,852,739
'4315057000,  동현동,'50,45 - 49세,1998,1016,534,482
'4315057000,  동현동,'55,50 - 54세,1998,768,386,382
'4315057000,  동현동,'60,55 - 59세,1998,853,398,455
'4315057000,  동현동,'65,60 - 64세,1998,696,332,364
'4315057000,  동현동,'70,65 - 69세,1998,426,151,275
'4315057000,  동현동,'75,70 - 74세,1998,329,128,201
'4315057000,  동현동,'80,75 - 79세,1998,212,80,132
'4315057000,  동현동,'85,80 - 84세,1998,116,31,85
'4315057000,  동현동,'90,85+ ,1998,68,13,55
'4315059000,  청전동,'00,계,1998,25954,13013,12941
'4315059000,  청전동,'05,0 - 4세,1998,1688,917,771
'4315059000,  청전동,'10,5 - 9세,1998,1889,1015,874
'4315059000,  청전동,'15,10 - 14세,1998,2159,1095,1064
'4315059000,  청전동,'20,15 - 19세,1998,2889,1493,1396
'4315059000,  청전동,'25,20 - 24세,1998,2277,1170,1107
'4315059000,  청전동,'30,25 - 29세,1998,2055,1061,994
'4315059000,  청전동,'35,30 - 34세,1998,2012,982,1030
'4315059000,  청전동,'40,35 - 39세,1998,2702,1268,1434
'4315059000,  청전동,'45,40 - 44세,1998,2524,1240,1284
'4315059000,  청전동,'50,45 - 49세,1998,1664,926,738
'4315059000,  청전동,'55,50 - 54세,1998,1072,568,504
'4315059000,  청전동,'60,55 - 59세,1998,948,468,480
'4315059000,  청전동,'65,60 - 64세,1998,769,355,414
'4315059000,  청전동,'70,65 - 69세,1998,474,196,278
'4315059000,  청전동,'75,70 - 74세,1998,354,121,233
'4315059000,  청전동,'80,75 - 79세,1998,267,82,185
'4315059000,  청전동,'85,80 - 84세,1998,127,39,88
'4315059000,  청전동,'90,85+ ,1998,84,17,67
'4315060500,  화산동,'00,계,1998,10891,5534,5357
'4315060500,  화산동,'05,0 - 4세,1998,664,343,321
'4315060500,  화산동,'10,5 - 9세,1998,586,308,278
'4315060500,  화산동,'15,10 - 14세,1998,631,342,289
'4315060500,  화산동,'20,15 - 19세,1998,1023,526,497
'4315060500,  화산동,'25,20 - 24세,1998,1081,586,495
'4315060500,  화산동,'30,25 - 29세,1998,1040,617,423
'4315060500,  화산동,'35,30 - 34세,1998,841,450,391
'4315060500,  화산동,'40,35 - 39세,1998,788,405,383
'4315060500,  화산동,'45,40 - 44세,1998,862,437,425
'4315060500,  화산동,'50,45 - 49세,1998,626,293,333
'4315060500,  화산동,'55,50 - 54세,1998,606,279,327
'4315060500,  화산동,'60,55 - 59세,1998,731,358,373
'4315060500,  화산동,'65,60 - 64세,1998,580,287,293
'4315060500,  화산동,'70,65 - 69세,1998,323,131,192
'4315060500,  화산동,'75,70 - 74세,1998,213,88,125
'4315060500,  화산동,'80,75 - 79세,1998,157,50,107
'4315060500,  화산동,'85,80 - 84세,1998,90,24,66
'4315060500,  화산동,'90,85+ ,1998,49,10,39
'4315062500,  영천동,'00,계,1998,5772,2952,2820
'4315062500,  영천동,'05,0 - 4세,1998,299,168,131
'4315062500,  영천동,'10,5 - 9세,1998,300,167,133
'4315062500,  영천동,'15,10 - 14세,1998,360,174,186
'4315062500,  영천동,'20,15 - 19세,1998,546,271,275
'4315062500,  영천동,'25,20 - 24세,1998,568,302,266
'4315062500,  영천동,'30,25 - 29세,1998,452,287,165
'4315062500,  영천동,'35,30 - 34세,1998,387,203,184
'4315062500,  영천동,'40,35 - 39세,1998,426,199,227
'4315062500,  영천동,'45,40 - 44세,1998,426,234,192
'4315062500,  영천동,'50,45 - 49세,1998,374,190,184
'4315062500,  영천동,'55,50 - 54세,1998,346,152,194
'4315062500,  영천동,'60,55 - 59세,1998,426,202,224
'4315062500,  영천동,'65,60 - 64세,1998,334,169,165
'4315062500,  영천동,'70,65 - 69세,1998,241,108,133
'4315062500,  영천동,'75,70 - 74세,1998,135,66,69
'4315062500,  영천동,'80,75 - 79세,1998,81,36,45
'4315062500,  영천동,'85,80 - 84세,1998,45,13,32
'4315062500,  영천동,'90,85+ ,1998,26,11,15
'43710, 청원군,'00,계,1998,123385,62796,60589
'43710, 청원군,'05,0 - 4세,1998,8531,4474,4057
'43710, 청원군,'10,5 - 9세,1998,7230,3863,3367
'43710, 청원군,'15,10 - 14세,1998,7057,3627,3430
'43710, 청원군,'20,15 - 19세,1998,10535,5431,5104
'43710, 청원군,'25,20 - 24세,1998,11282,6105,5177
'43710, 청원군,'30,25 - 29세,1998,11799,6559,5240
'43710, 청원군,'35,30 - 34세,1998,9999,5567,4432
'43710, 청원군,'40,35 - 39세,1998,9226,5131,4095
'43710, 청원군,'45,40 - 44세,1998,8116,4327,3789
'43710, 청원군,'50,45 - 49세,1998,6000,3110,2890
'43710, 청원군,'55,50 - 54세,1998,5414,2671,2743
'43710, 청원군,'60,55 - 59세,1998,7138,3308,3830
'43710, 청원군,'65,60 - 64세,1998,7372,3326,4046
'43710, 청원군,'70,65 - 69세,1998,5300,2144,3156
'43710, 청원군,'75,70 - 74세,1998,3502,1430,2072
'43710, 청원군,'80,75 - 79세,1998,2554,989,1565
'43710, 청원군,'85,80 - 84세,1998,1466,503,963
'43710, 청원군,'90,85+ ,1998,864,231,633
'4371031000,  낭성면,'00,계,1998,2831,1471,1360
'4371031000,  낭성면,'05,0 - 4세,1998,115,68,47
'4371031000,  낭성면,'10,5 - 9세,1998,121,65,56
'4371031000,  낭성면,'15,10 - 14세,1998,129,62,67
'4371031000,  낭성면,'20,15 - 19세,1998,264,129,135
'4371031000,  낭성면,'25,20 - 24세,1998,261,168,93
'4371031000,  낭성면,'30,25 - 29세,1998,196,112,84
'4371031000,  낭성면,'35,30 - 34세,1998,158,103,55
'4371031000,  낭성면,'40,35 - 39세,1998,166,93,73
'4371031000,  낭성면,'45,40 - 44세,1998,184,103,81
'4371031000,  낭성면,'50,45 - 49세,1998,151,79,72
'4371031000,  낭성면,'55,50 - 54세,1998,145,78,67
'4371031000,  낭성면,'60,55 - 59세,1998,216,104,112
'4371031000,  낭성면,'65,60 - 64세,1998,238,98,140
'4371031000,  낭성면,'70,65 - 69세,1998,177,79,98
'4371031000,  낭성면,'75,70 - 74세,1998,114,55,59
'4371031000,  낭성면,'80,75 - 79세,1998,104,48,56
'4371031000,  낭성면,'85,80 - 84세,1998,60,19,41
'4371031000,  낭성면,'90,85+ ,1998,32,8,24
'4371032000,  미원면,'00,계,1998,7364,3765,3599
'4371032000,  미원면,'05,0 - 4세,1998,313,171,142
'4371032000,  미원면,'10,5 - 9세,1998,344,195,149
'4371032000,  미원면,'15,10 - 14세,1998,415,205,210
'4371032000,  미원면,'20,15 - 19세,1998,644,325,319
'4371032000,  미원면,'25,20 - 24세,1998,680,408,272
'4371032000,  미원면,'30,25 - 29세,1998,491,308,183
'4371032000,  미원면,'35,30 - 34세,1998,398,220,178
'4371032000,  미원면,'40,35 - 39세,1998,483,259,224
'4371032000,  미원면,'45,40 - 44세,1998,489,253,236
'4371032000,  미원면,'50,45 - 49세,1998,411,235,176
'4371032000,  미원면,'55,50 - 54세,1998,356,167,189
'4371032000,  미원면,'60,55 - 59세,1998,531,240,291
'4371032000,  미원면,'65,60 - 64세,1998,584,263,321
'4371032000,  미원면,'70,65 - 69세,1998,488,206,282
'4371032000,  미원면,'75,70 - 74세,1998,343,153,190
'4371032000,  미원면,'80,75 - 79세,1998,196,85,111
'4371032000,  미원면,'85,80 - 84세,1998,122,54,68
'4371032000,  미원면,'90,85+ ,1998,76,18,58
'4371033000,  가덕면,'00,계,1998,5617,2852,2765
'4371033000,  가덕면,'05,0 - 4세,1998,313,166,147
'4371033000,  가덕면,'10,5 - 9세,1998,290,149,141
'4371033000,  가덕면,'15,10 - 14세,1998,312,161,151
'4371033000,  가덕면,'20,15 - 19세,1998,472,234,238
'4371033000,  가덕면,'25,20 - 24세,1998,540,280,260
'4371033000,  가덕면,'30,25 - 29세,1998,437,252,185
'4371033000,  가덕면,'35,30 - 34세,1998,404,238,166
'4371033000,  가덕면,'40,35 - 39세,1998,423,255,168
'4371033000,  가덕면,'45,40 - 44세,1998,339,184,155
'4371033000,  가덕면,'50,45 - 49세,1998,290,156,134
'4371033000,  가덕면,'55,50 - 54세,1998,281,133,148
'4371033000,  가덕면,'60,55 - 59세,1998,366,170,196
'4371033000,  가덕면,'65,60 - 64세,1998,414,184,230
'4371033000,  가덕면,'70,65 - 69세,1998,260,110,150
'4371033000,  가덕면,'75,70 - 74세,1998,207,85,122
'4371033000,  가덕면,'80,75 - 79세,1998,147,56,91
'4371033000,  가덕면,'85,80 - 84세,1998,79,27,52
'4371033000,  가덕면,'90,85+ ,1998,43,12,31
'4371034000,  남일면,'00,계,1998,9139,4620,4519
'4371034000,  남일면,'05,0 - 4세,1998,639,346,293
'4371034000,  남일면,'10,5 - 9세,1998,665,350,315
'4371034000,  남일면,'15,10 - 14세,1998,687,348,339
'4371034000,  남일면,'20,15 - 19세,1998,769,393,376
'4371034000,  남일면,'25,20 - 24세,1998,721,398,323
'4371034000,  남일면,'30,25 - 29세,1998,806,439,367
'4371034000,  남일면,'35,30 - 34세,1998,740,385,355
'4371034000,  남일면,'40,35 - 39세,1998,797,434,363
'4371034000,  남일면,'45,40 - 44세,1998,662,356,306
'4371034000,  남일면,'50,45 - 49세,1998,410,223,187
'4371034000,  남일면,'55,50 - 54세,1998,331,150,181
'4371034000,  남일면,'60,55 - 59세,1998,483,228,255
'4371034000,  남일면,'65,60 - 64세,1998,481,208,273
'4371034000,  남일면,'70,65 - 69세,1998,391,156,235
'4371034000,  남일면,'75,70 - 74세,1998,234,92,142
'4371034000,  남일면,'80,75 - 79세,1998,168,64,104
'4371034000,  남일면,'85,80 - 84세,1998,99,33,66
'4371034000,  남일면,'90,85+ ,1998,56,17,39
'4371035000,  남이면,'00,계,1998,6194,3175,3019
'4371035000,  남이면,'05,0 - 4세,1998,277,157,120
'4371035000,  남이면,'10,5 - 9세,1998,269,147,122
'4371035000,  남이면,'15,10 - 14세,1998,372,219,153
'4371035000,  남이면,'20,15 - 19세,1998,590,304,286
'4371035000,  남이면,'25,20 - 24세,1998,620,351,269
'4371035000,  남이면,'30,25 - 29세,1998,462,276,186
'4371035000,  남이면,'35,30 - 34세,1998,372,207,165
'4371035000,  남이면,'40,35 - 39세,1998,438,248,190
'4371035000,  남이면,'45,40 - 44세,1998,428,234,194
'4371035000,  남이면,'50,45 - 49세,1998,375,189,186
'4371035000,  남이면,'55,50 - 54세,1998,292,147,145
'4371035000,  남이면,'60,55 - 59세,1998,424,182,242
'4371035000,  남이면,'65,60 - 64세,1998,441,202,239
'4371035000,  남이면,'70,65 - 69세,1998,338,127,211
'4371035000,  남이면,'75,70 - 74세,1998,217,94,123
'4371035000,  남이면,'80,75 - 79세,1998,128,40,88
'4371035000,  남이면,'85,80 - 84세,1998,92,36,56
'4371035000,  남이면,'90,85+ ,1998,59,15,44
'4371036000,  문의면,'00,계,1998,6130,3152,2978
'4371036000,  문의면,'05,0 - 4세,1998,292,164,128
'4371036000,  문의면,'10,5 - 9세,1998,274,145,129
'4371036000,  문의면,'15,10 - 14세,1998,280,137,143
'4371036000,  문의면,'20,15 - 19세,1998,575,308,267
'4371036000,  문의면,'25,20 - 24세,1998,592,313,279
'4371036000,  문의면,'30,25 - 29세,1998,486,299,187
'4371036000,  문의면,'35,30 - 34세,1998,385,227,158
'4371036000,  문의면,'40,35 - 39세,1998,361,215,146
'4371036000,  문의면,'45,40 - 44세,1998,414,225,189
'4371036000,  문의면,'50,45 - 49세,1998,328,168,160
'4371036000,  문의면,'55,50 - 54세,1998,290,146,144
'4371036000,  문의면,'60,55 - 59세,1998,468,218,250
'4371036000,  문의면,'65,60 - 64세,1998,499,233,266
'4371036000,  문의면,'70,65 - 69세,1998,329,125,204
'4371036000,  문의면,'75,70 - 74세,1998,230,102,128
'4371036000,  문의면,'80,75 - 79세,1998,180,75,105
'4371036000,  문의면,'85,80 - 84세,1998,94,36,58
'4371036000,  문의면,'90,85+ ,1998,53,16,37
'4371037000,  현도면,'00,계,1998,5213,2669,2544
'4371037000,  현도면,'05,0 - 4세,1998,209,96,113
'4371037000,  현도면,'10,5 - 9세,1998,198,114,84
'4371037000,  현도면,'15,10 - 14세,1998,240,131,109
'4371037000,  현도면,'20,15 - 19세,1998,432,224,208
'4371037000,  현도면,'25,20 - 24세,1998,547,329,218
'4371037000,  현도면,'30,25 - 29세,1998,398,254,144
'4371037000,  현도면,'35,30 - 34세,1998,343,198,145
'4371037000,  현도면,'40,35 - 39세,1998,297,169,128
'4371037000,  현도면,'45,40 - 44세,1998,339,174,165
'4371037000,  현도면,'50,45 - 49세,1998,279,139,140
'4371037000,  현도면,'55,50 - 54세,1998,286,140,146
'4371037000,  현도면,'60,55 - 59세,1998,366,170,196
'4371037000,  현도면,'65,60 - 64세,1998,417,202,215
'4371037000,  현도면,'70,65 - 69세,1998,301,131,170
'4371037000,  현도면,'75,70 - 74세,1998,220,84,136
'4371037000,  현도면,'80,75 - 79세,1998,176,66,110
'4371037000,  현도면,'85,80 - 84세,1998,98,36,62
'4371037000,  현도면,'90,85+ ,1998,67,12,55
'4371038000,  부용면,'00,계,1998,8762,4486,4276
'4371038000,  부용면,'05,0 - 4세,1998,629,335,294
'4371038000,  부용면,'10,5 - 9세,1998,577,293,284
'4371038000,  부용면,'15,10 - 14세,1998,464,241,223
'4371038000,  부용면,'20,15 - 19세,1998,714,395,319
'4371038000,  부용면,'25,20 - 24세,1998,837,450,387
'4371038000,  부용면,'30,25 - 29세,1998,840,476,364
'4371038000,  부용면,'35,30 - 34세,1998,765,430,335
'4371038000,  부용면,'40,35 - 39세,1998,640,341,299
'4371038000,  부용면,'45,40 - 44세,1998,544,295,249
'4371038000,  부용면,'50,45 - 49세,1998,402,189,213
'4371038000,  부용면,'55,50 - 54세,1998,417,205,212
'4371038000,  부용면,'60,55 - 59세,1998,518,235,283
'4371038000,  부용면,'65,60 - 64세,1998,499,250,249
'4371038000,  부용면,'70,65 - 69세,1998,339,137,202
'4371038000,  부용면,'75,70 - 74세,1998,242,106,136
'4371038000,  부용면,'80,75 - 79세,1998,164,55,109
'4371038000,  부용면,'85,80 - 84세,1998,100,30,70
'4371038000,  부용면,'90,85+ ,1998,71,23,48
'4371039000,  강내면,'00,계,1998,9607,4932,4675
'4371039000,  강내면,'05,0 - 4세,1998,691,376,315
'4371039000,  강내면,'10,5 - 9세,1998,697,379,318
'4371039000,  강내면,'15,10 - 14세,1998,654,339,315
'4371039000,  강내면,'20,15 - 19세,1998,808,449,359
'4371039000,  강내면,'25,20 - 24세,1998,845,439,406
'4371039000,  강내면,'30,25 - 29세,1998,943,527,416
'4371039000,  강내면,'35,30 - 34세,1998,855,451,404
'4371039000,  강내면,'40,35 - 39세,1998,849,448,401
'4371039000,  강내면,'45,40 - 44세,1998,691,356,335
'4371039000,  강내면,'50,45 - 49세,1998,464,252,212
'4371039000,  강내면,'55,50 - 54세,1998,362,180,182
'4371039000,  강내면,'60,55 - 59세,1998,459,215,244
'4371039000,  강내면,'65,60 - 64세,1998,465,206,259
'4371039000,  강내면,'70,65 - 69세,1998,311,124,187
'4371039000,  강내면,'75,70 - 74세,1998,214,81,133
'4371039000,  강내면,'80,75 - 79세,1998,161,64,97
'4371039000,  강내면,'85,80 - 84세,1998,87,29,58
'4371039000,  강내면,'90,85+ ,1998,51,17,34
'4371040000,  강외면,'00,계,1998,11816,5924,5892
'4371040000,  강외면,'05,0 - 4세,1998,831,434,397
'4371040000,  강외면,'10,5 - 9세,1998,656,358,298
'4371040000,  강외면,'15,10 - 14세,1998,716,356,360
'4371040000,  강외면,'20,15 - 19세,1998,1035,520,515
'4371040000,  강외면,'25,20 - 24세,1998,1139,595,544
'4371040000,  강외면,'30,25 - 29세,1998,1158,637,521
'4371040000,  강외면,'35,30 - 34세,1998,858,472,386
'4371040000,  강외면,'40,35 - 39세,1998,849,458,391
'4371040000,  강외면,'45,40 - 44세,1998,777,407,370
'4371040000,  강외면,'50,45 - 49세,1998,606,290,316
'4371040000,  강외면,'55,50 - 54세,1998,550,285,265
'4371040000,  강외면,'60,55 - 59세,1998,691,310,381
'4371040000,  강외면,'65,60 - 64세,1998,688,325,363
'4371040000,  강외면,'70,65 - 69세,1998,478,183,295
'4371040000,  강외면,'75,70 - 74세,1998,336,138,198
'4371040000,  강외면,'80,75 - 79세,1998,246,97,149
'4371040000,  강외면,'85,80 - 84세,1998,132,40,92
'4371040000,  강외면,'90,85+ ,1998,70,19,51
'4371041000,  옥산면,'00,계,1998,10838,5519,5319
'4371041000,  옥산면,'05,0 - 4세,1998,860,442,418
'4371041000,  옥산면,'10,5 - 9세,1998,696,372,324
'4371041000,  옥산면,'15,10 - 14세,1998,622,312,310
'4371041000,  옥산면,'20,15 - 19세,1998,947,491,456
'4371041000,  옥산면,'25,20 - 24세,1998,955,469,486
'4371041000,  옥산면,'30,25 - 29세,1998,1105,617,488
'4371041000,  옥산면,'35,30 - 34세,1998,964,525,439
'4371041000,  옥산면,'40,35 - 39세,1998,921,514,407
'4371041000,  옥산면,'45,40 - 44세,1998,705,374,331
'4371041000,  옥산면,'50,45 - 49세,1998,503,274,229
'4371041000,  옥산면,'55,50 - 54세,1998,481,250,231
'4371041000,  옥산면,'60,55 - 59세,1998,539,255,284
'4371041000,  옥산면,'65,60 - 64세,1998,569,252,317
'4371041000,  옥산면,'70,65 - 69세,1998,378,156,222
'4371041000,  옥산면,'75,70 - 74세,1998,227,87,140
'4371041000,  옥산면,'80,75 - 79세,1998,193,67,126
'4371041000,  옥산면,'85,80 - 84세,1998,116,41,75
'4371041000,  옥산면,'90,85+ ,1998,57,21,36
'4371042000,  오창면,'00,계,1998,11912,6048,5864
'4371042000,  오창면,'05,0 - 4세,1998,709,371,338
'4371042000,  오창면,'10,5 - 9세,1998,729,385,344
'4371042000,  오창면,'15,10 - 14세,1998,712,369,343
'4371042000,  오창면,'20,15 - 19세,1998,1132,555,577
'4371042000,  오창면,'25,20 - 24세,1998,1094,608,486
'4371042000,  오창면,'30,25 - 29세,1998,978,566,412
'4371042000,  오창면,'35,30 - 34세,1998,879,472,407
'4371042000,  오창면,'40,35 - 39세,1998,873,482,391
'4371042000,  오창면,'45,40 - 44세,1998,838,453,385
'4371042000,  오창면,'50,45 - 49세,1998,640,328,312
'4371042000,  오창면,'55,50 - 54세,1998,542,270,272
'4371042000,  오창면,'60,55 - 59세,1998,741,353,388
'4371042000,  오창면,'65,60 - 64세,1998,746,339,407
'4371042000,  오창면,'70,65 - 69세,1998,508,203,305
'4371042000,  오창면,'75,70 - 74세,1998,308,127,181
'4371042000,  오창면,'80,75 - 79세,1998,256,92,164
'4371042000,  오창면,'85,80 - 84세,1998,143,52,91
'4371042000,  오창면,'90,85+ ,1998,84,23,61
'4371043000,  북이면,'00,계,1998,7680,3981,3699
'4371043000,  북이면,'05,0 - 4세,1998,346,188,158
'4371043000,  북이면,'10,5 - 9세,1998,305,163,142
'4371043000,  북이면,'15,10 - 14세,1998,423,213,210
'4371043000,  북이면,'20,15 - 19세,1998,692,366,326
'4371043000,  북이면,'25,20 - 24세,1998,799,465,334
'4371043000,  북이면,'30,25 - 29세,1998,611,379,232
'4371043000,  북이면,'35,30 - 34세,1998,491,304,187
'4371043000,  북이면,'40,35 - 39세,1998,480,271,209
'4371043000,  북이면,'45,40 - 44세,1998,496,278,218
'4371043000,  북이면,'50,45 - 49세,1998,410,213,197
'4371043000,  북이면,'55,50 - 54세,1998,393,185,208
'4371043000,  북이면,'60,55 - 59세,1998,562,268,294
'4371043000,  북이면,'65,60 - 64세,1998,583,258,325
'4371043000,  북이면,'70,65 - 69세,1998,461,200,261
'4371043000,  북이면,'75,70 - 74세,1998,254,95,159
'4371043000,  북이면,'80,75 - 79세,1998,195,87,108
'4371043000,  북이면,'85,80 - 84세,1998,109,33,76
'4371043000,  북이면,'90,85+ ,1998,70,15,55
'4371044000,  북일면,'00,계,1998,20282,10202,10080
'4371044000,  북일면,'05,0 - 4세,1998,2307,1160,1147
'4371044000,  북일면,'10,5 - 9세,1998,1409,748,661
'4371044000,  북일면,'15,10 - 14세,1998,1031,534,497
'4371044000,  북일면,'20,15 - 19세,1998,1461,738,723
'4371044000,  북일면,'25,20 - 24세,1998,1652,832,820
'4371044000,  북일면,'30,25 - 29세,1998,2888,1417,1471
'4371044000,  북일면,'35,30 - 34세,1998,2387,1335,1052
'4371044000,  북일면,'40,35 - 39세,1998,1649,944,705
'4371044000,  북일면,'45,40 - 44세,1998,1210,635,575
'4371044000,  북일면,'50,45 - 49세,1998,731,375,356
'4371044000,  북일면,'55,50 - 54세,1998,688,335,353
'4371044000,  북일면,'60,55 - 59세,1998,774,360,414
'4371044000,  북일면,'65,60 - 64세,1998,748,306,442
'4371044000,  북일면,'70,65 - 69세,1998,541,207,334
'4371044000,  북일면,'75,70 - 74세,1998,356,131,225
'4371044000,  북일면,'80,75 - 79세,1998,240,93,147
'4371044000,  북일면,'85,80 - 84세,1998,135,37,98
'4371044000,  북일면,'90,85+ ,1998,75,15,60
'43720, 보은군,'00,계,1998,45554,22930,22624
'43720, 보은군,'05,0 - 4세,1998,2182,1146,1036
'43720, 보은군,'10,5 - 9세,1998,2403,1264,1139
'43720, 보은군,'15,10 - 14세,1998,2738,1427,1311
'43720, 보은군,'20,15 - 19세,1998,3917,1966,1951
'43720, 보은군,'25,20 - 24세,1998,3889,2167,1722
'43720, 보은군,'30,25 - 29세,1998,3113,1875,1238
'43720, 보은군,'35,30 - 34세,1998,2711,1490,1221
'43720, 보은군,'40,35 - 39세,1998,3109,1655,1454
'43720, 보은군,'45,40 - 44세,1998,3042,1636,1406
'43720, 보은군,'50,45 - 49세,1998,2354,1228,1126
'43720, 보은군,'55,50 - 54세,1998,2299,1121,1178
'43720, 보은군,'60,55 - 59세,1998,3337,1504,1833
'43720, 보은군,'65,60 - 64세,1998,3413,1562,1851
'43720, 보은군,'70,65 - 69세,1998,2691,1121,1570
'43720, 보은군,'75,70 - 74세,1998,1883,805,1078
'43720, 보은군,'80,75 - 79세,1998,1299,558,741
'43720, 보은군,'85,80 - 84세,1998,719,258,461
'43720, 보은군,'90,85+ ,1998,455,147,308
'4372025000,  보은읍,'00,계,1998,18343,9140,9203
'4372025000,  보은읍,'05,0 - 4세,1998,1278,654,624
'4372025000,  보은읍,'10,5 - 9세,1998,1352,692,660
'4372025000,  보은읍,'15,10 - 14세,1998,1293,653,640
'4372025000,  보은읍,'20,15 - 19세,1998,1618,823,795
'4372025000,  보은읍,'25,20 - 24세,1998,1465,787,678
'4372025000,  보은읍,'30,25 - 29세,1998,1422,756,666
'4372025000,  보은읍,'35,30 - 34세,1998,1407,726,681
'4372025000,  보은읍,'40,35 - 39세,1998,1555,779,776
'4372025000,  보은읍,'45,40 - 44세,1998,1317,714,603
'4372025000,  보은읍,'50,45 - 49세,1998,905,488,417
'4372025000,  보은읍,'55,50 - 54세,1998,783,372,411
'4372025000,  보은읍,'60,55 - 59세,1998,1003,456,547
'4372025000,  보은읍,'65,60 - 64세,1998,991,463,528
'4372025000,  보은읍,'70,65 - 69세,1998,751,309,442
'4372025000,  보은읍,'75,70 - 74세,1998,507,216,291
'4372025000,  보은읍,'80,75 - 79세,1998,364,142,222
'4372025000,  보은읍,'85,80 - 84세,1998,199,70,129
'4372025000,  보은읍,'90,85+ ,1998,133,40,93
'4372031000,  내속리면,'00,계,1998,3244,1715,1529
'4372031000,  내속리면,'05,0 - 4세,1998,147,88,59
'4372031000,  내속리면,'10,5 - 9세,1998,156,87,69
'4372031000,  내속리면,'15,10 - 14세,1998,176,98,78
'4372031000,  내속리면,'20,15 - 19세,1998,267,134,133
'4372031000,  내속리면,'25,20 - 24세,1998,286,166,120
'4372031000,  내속리면,'30,25 - 29세,1998,242,157,85
'4372031000,  내속리면,'35,30 - 34세,1998,211,112,99
'4372031000,  내속리면,'40,35 - 39세,1998,225,134,91
'4372031000,  내속리면,'45,40 - 44세,1998,223,123,100
'4372031000,  내속리면,'50,45 - 49세,1998,205,118,87
'4372031000,  내속리면,'55,50 - 54세,1998,212,95,117
'4372031000,  내속리면,'60,55 - 59세,1998,272,125,147
'4372031000,  내속리면,'65,60 - 64세,1998,210,107,103
'4372031000,  내속리면,'70,65 - 69세,1998,154,69,85
'4372031000,  내속리면,'75,70 - 74세,1998,120,43,77
'4372031000,  내속리면,'80,75 - 79세,1998,75,37,38
'4372031000,  내속리면,'85,80 - 84세,1998,47,12,35
'4372031000,  내속리면,'90,85+ ,1998,16,10,6
'4372032000,  외속리면,'00,계,1998,1933,1018,915
'4372032000,  외속리면,'05,0 - 4세,1998,75,43,32
'4372032000,  외속리면,'10,5 - 9세,1998,80,46,34
'4372032000,  외속리면,'15,10 - 14세,1998,106,56,50
'4372032000,  외속리면,'20,15 - 19세,1998,165,97,68
'4372032000,  외속리면,'25,20 - 24세,1998,181,112,69
'4372032000,  외속리면,'30,25 - 29세,1998,148,112,36
'4372032000,  외속리면,'35,30 - 34세,1998,112,66,46
'4372032000,  외속리면,'40,35 - 39세,1998,93,49,44
'4372032000,  외속리면,'45,40 - 44세,1998,124,66,58
'4372032000,  외속리면,'50,45 - 49세,1998,92,45,47
'4372032000,  외속리면,'55,50 - 54세,1998,105,54,51
'4372032000,  외속리면,'60,55 - 59세,1998,171,68,103
'4372032000,  외속리면,'65,60 - 64세,1998,149,73,76
'4372032000,  외속리면,'70,65 - 69세,1998,123,47,76
'4372032000,  외속리면,'75,70 - 74세,1998,94,37,57
'4372032000,  외속리면,'80,75 - 79세,1998,55,20,35
'4372032000,  외속리면,'85,80 - 84세,1998,37,15,22
'4372032000,  외속리면,'90,85+ ,1998,23,12,11
'4372033000,  마로면,'00,계,1998,3947,1935,2012
'4372033000,  마로면,'05,0 - 4세,1998,139,78,61
'4372033000,  마로면,'10,5 - 9세,1998,186,99,87
'4372033000,  마로면,'15,10 - 14세,1998,228,113,115
'4372033000,  마로면,'20,15 - 19세,1998,339,154,185
'4372033000,  마로면,'25,20 - 24세,1998,337,201,136
'4372033000,  마로면,'30,25 - 29세,1998,242,148,94
'4372033000,  마로면,'35,30 - 34세,1998,179,94,85
'4372033000,  마로면,'40,35 - 39세,1998,221,125,96
'4372033000,  마로면,'45,40 - 44세,1998,243,118,125
'4372033000,  마로면,'50,45 - 49세,1998,220,95,125
'4372033000,  마로면,'55,50 - 54세,1998,233,123,110
'4372033000,  마로면,'60,55 - 59세,1998,334,158,176
'4372033000,  마로면,'65,60 - 64세,1998,357,153,204
'4372033000,  마로면,'70,65 - 69세,1998,234,92,142
'4372033000,  마로면,'75,70 - 74세,1998,188,88,100
'4372033000,  마로면,'80,75 - 79세,1998,129,51,78
'4372033000,  마로면,'85,80 - 84세,1998,84,29,55
'4372033000,  마로면,'90,85+ ,1998,54,16,38
'4372034000,  탄부면,'00,계,1998,2947,1475,1472
'4372034000,  탄부면,'05,0 - 4세,1998,78,44,34
'4372034000,  탄부면,'10,5 - 9세,1998,75,38,37
'4372034000,  탄부면,'15,10 - 14세,1998,155,89,66
'4372034000,  탄부면,'20,15 - 19세,1998,254,126,128
'4372034000,  탄부면,'25,20 - 24세,1998,268,148,120
'4372034000,  탄부면,'30,25 - 29세,1998,156,107,49
'4372034000,  탄부면,'35,30 - 34세,1998,98,65,33
'4372034000,  탄부면,'40,35 - 39세,1998,134,69,65
'4372034000,  탄부면,'45,40 - 44세,1998,177,89,88
'4372034000,  탄부면,'50,45 - 49세,1998,163,83,80
'4372034000,  탄부면,'55,50 - 54세,1998,179,86,93
'4372034000,  탄부면,'60,55 - 59세,1998,269,121,148
'4372034000,  탄부면,'65,60 - 64세,1998,282,127,155
'4372034000,  탄부면,'70,65 - 69세,1998,253,109,144
'4372034000,  탄부면,'75,70 - 74세,1998,152,59,93
'4372034000,  탄부면,'80,75 - 79세,1998,141,70,71
'4372034000,  탄부면,'85,80 - 84세,1998,71,32,39
'4372034000,  탄부면,'90,85+ ,1998,42,13,29
'4372035000,  삼승면,'00,계,1998,3890,1928,1962
'4372035000,  삼승면,'05,0 - 4세,1998,112,63,49
'4372035000,  삼승면,'10,5 - 9세,1998,181,101,80
'4372035000,  삼승면,'15,10 - 14세,1998,242,129,113
'4372035000,  삼승면,'20,15 - 19세,1998,377,175,202
'4372035000,  삼승면,'25,20 - 24세,1998,359,201,158
'4372035000,  삼승면,'30,25 - 29세,1998,233,154,79
'4372035000,  삼승면,'35,30 - 34세,1998,151,78,73
'4372035000,  삼승면,'40,35 - 39세,1998,241,129,112
'4372035000,  삼승면,'45,40 - 44세,1998,255,133,122
'4372035000,  삼승면,'50,45 - 49세,1998,212,110,102
'4372035000,  삼승면,'55,50 - 54세,1998,193,94,99
'4372035000,  삼승면,'60,55 - 59세,1998,335,153,182
'4372035000,  삼승면,'65,60 - 64세,1998,340,148,192
'4372035000,  삼승면,'70,65 - 69세,1998,259,108,151
'4372035000,  삼승면,'75,70 - 74세,1998,164,66,98
'4372035000,  삼승면,'80,75 - 79세,1998,139,55,84
'4372035000,  삼승면,'85,80 - 84세,1998,65,20,45
'4372035000,  삼승면,'90,85+ ,1998,32,11,21
'4372036000,  수한면,'00,계,1998,2526,1297,1229
'4372036000,  수한면,'05,0 - 4세,1998,71,37,34
'4372036000,  수한면,'10,5 - 9세,1998,83,44,39
'4372036000,  수한면,'15,10 - 14세,1998,122,69,53
'4372036000,  수한면,'20,15 - 19세,1998,207,117,90
'4372036000,  수한면,'25,20 - 24세,1998,220,126,94
'4372036000,  수한면,'30,25 - 29세,1998,135,93,42
'4372036000,  수한면,'35,30 - 34세,1998,122,76,46
'4372036000,  수한면,'40,35 - 39세,1998,155,91,64
'4372036000,  수한면,'45,40 - 44세,1998,152,80,72
'4372036000,  수한면,'50,45 - 49세,1998,126,65,61
'4372036000,  수한면,'55,50 - 54세,1998,131,66,65
'4372036000,  수한면,'60,55 - 59세,1998,217,96,121
'4372036000,  수한면,'65,60 - 64세,1998,255,111,144
'4372036000,  수한면,'70,65 - 69세,1998,197,94,103
'4372036000,  수한면,'75,70 - 74세,1998,146,60,86
'4372036000,  수한면,'80,75 - 79세,1998,86,37,49
'4372036000,  수한면,'85,80 - 84세,1998,51,21,30
'4372036000,  수한면,'90,85+ ,1998,50,14,36
'4372037000,  회남면,'00,계,1998,943,484,459
'4372037000,  회남면,'05,0 - 4세,1998,39,22,17
'4372037000,  회남면,'10,5 - 9세,1998,23,15,8
'4372037000,  회남면,'15,10 - 14세,1998,43,24,19
'4372037000,  회남면,'20,15 - 19세,1998,71,37,34
'4372037000,  회남면,'25,20 - 24세,1998,71,35,36
'4372037000,  회남면,'30,25 - 29세,1998,57,40,17
'4372037000,  회남면,'35,30 - 34세,1998,51,32,19
'4372037000,  회남면,'40,35 - 39세,1998,38,20,18
'4372037000,  회남면,'45,40 - 44세,1998,64,33,31
'4372037000,  회남면,'50,45 - 49세,1998,57,30,27
'4372037000,  회남면,'55,50 - 54세,1998,47,26,21
'4372037000,  회남면,'60,55 - 59세,1998,81,33,48
'4372037000,  회남면,'65,60 - 64세,1998,91,45,46
'4372037000,  회남면,'70,65 - 69세,1998,84,34,50
'4372037000,  회남면,'75,70 - 74세,1998,59,28,31
'4372037000,  회남면,'80,75 - 79세,1998,43,22,21
'4372037000,  회남면,'85,80 - 84세,1998,15,7,8
'4372037000,  회남면,'90,85+ ,1998,9,1,8
'4372038000,  회북면,'00,계,1998,2924,1459,1465
'4372038000,  회북면,'05,0 - 4세,1998,85,48,37
'4372038000,  회북면,'10,5 - 9세,1998,105,53,52
'4372038000,  회북면,'15,10 - 14세,1998,133,68,65
'4372038000,  회북면,'20,15 - 19세,1998,245,125,120
'4372038000,  회북면,'25,20 - 24세,1998,258,137,121
'4372038000,  회북면,'30,25 - 29세,1998,184,116,68
'4372038000,  회북면,'35,30 - 34세,1998,140,84,56
'4372038000,  회북면,'40,35 - 39세,1998,166,98,68
'4372038000,  회북면,'45,40 - 44세,1998,168,90,78
'4372038000,  회북면,'50,45 - 49세,1998,166,89,77
'4372038000,  회북면,'55,50 - 54세,1998,163,82,81
'4372038000,  회북면,'60,55 - 59세,1998,221,98,123
'4372038000,  회북면,'65,60 - 64세,1998,275,130,145
'4372038000,  회북면,'70,65 - 69세,1998,223,81,142
'4372038000,  회북면,'75,70 - 74세,1998,173,75,98
'4372038000,  회북면,'80,75 - 79세,1998,126,54,72
'4372038000,  회북면,'85,80 - 84세,1998,60,26,34
'4372038000,  회북면,'90,85+ ,1998,33,5,28
'4372039000,  내북면,'00,계,1998,2411,1219,1192
'4372039000,  내북면,'05,0 - 4세,1998,86,35,51
'4372039000,  내북면,'10,5 - 9세,1998,75,40,35
'4372039000,  내북면,'15,10 - 14세,1998,101,64,37
'4372039000,  내북면,'20,15 - 19세,1998,196,92,104
'4372039000,  내북면,'25,20 - 24세,1998,210,122,88
'4372039000,  내북면,'30,25 - 29세,1998,139,86,53
'4372039000,  내북면,'35,30 - 34세,1998,117,78,39
'4372039000,  내북면,'40,35 - 39세,1998,138,77,61
'4372039000,  내북면,'45,40 - 44세,1998,152,89,63
'4372039000,  내북면,'50,45 - 49세,1998,111,58,53
'4372039000,  내북면,'55,50 - 54세,1998,132,57,75
'4372039000,  내북면,'60,55 - 59세,1998,216,99,117
'4372039000,  내북면,'65,60 - 64세,1998,221,100,121
'4372039000,  내북면,'70,65 - 69세,1998,232,97,135
'4372039000,  내북면,'75,70 - 74세,1998,133,63,70
'4372039000,  내북면,'80,75 - 79세,1998,69,35,34
'4372039000,  내북면,'85,80 - 84세,1998,50,14,36
'4372039000,  내북면,'90,85+ ,1998,33,13,20
'4372040000,  산외면,'00,계,1998,2446,1260,1186
'4372040000,  산외면,'05,0 - 4세,1998,72,34,38
'4372040000,  산외면,'10,5 - 9세,1998,87,49,38
'4372040000,  산외면,'15,10 - 14세,1998,139,64,75
'4372040000,  산외면,'20,15 - 19세,1998,178,86,92
'4372040000,  산외면,'25,20 - 24세,1998,234,132,102
'4372040000,  산외면,'30,25 - 29세,1998,155,106,49
'4372040000,  산외면,'35,30 - 34세,1998,123,79,44
'4372040000,  산외면,'40,35 - 39세,1998,143,84,59
'4372040000,  산외면,'45,40 - 44세,1998,167,101,66
'4372040000,  산외면,'50,45 - 49세,1998,97,47,50
'4372040000,  산외면,'55,50 - 54세,1998,121,66,55
'4372040000,  산외면,'60,55 - 59세,1998,218,97,121
'4372040000,  산외면,'65,60 - 64세,1998,242,105,137
'4372040000,  산외면,'70,65 - 69세,1998,181,81,100
'4372040000,  산외면,'75,70 - 74세,1998,147,70,77
'4372040000,  산외면,'80,75 - 79세,1998,72,35,37
'4372040000,  산외면,'85,80 - 84세,1998,40,12,28
'4372040000,  산외면,'90,85+ ,1998,30,12,18
'43730, 옥천군,'00,계,1998,62708,31486,31222
'43730, 옥천군,'05,0 - 4세,1998,3454,1855,1599
'43730, 옥천군,'10,5 - 9세,1998,3335,1779,1556
'43730, 옥천군,'15,10 - 14세,1998,3786,1943,1843
'43730, 옥천군,'20,15 - 19세,1998,5867,2946,2921
'43730, 옥천군,'25,20 - 24세,1998,5927,3268,2659
'43730, 옥천군,'30,25 - 29세,1998,4927,2802,2125
'43730, 옥천군,'35,30 - 34세,1998,4015,2197,1818
'43730, 옥천군,'40,35 - 39세,1998,4371,2299,2072
'43730, 옥천군,'45,40 - 44세,1998,4141,2193,1948
'43730, 옥천군,'50,45 - 49세,1998,3490,1764,1726
'43730, 옥천군,'55,50 - 54세,1998,3001,1446,1555
'43730, 옥천군,'60,55 - 59세,1998,4194,1869,2325
'43730, 옥천군,'65,60 - 64세,1998,4246,1920,2326
'43730, 옥천군,'70,65 - 69세,1998,3082,1289,1793
'43730, 옥천군,'75,70 - 74세,1998,2118,928,1190
'43730, 옥천군,'80,75 - 79세,1998,1514,593,921
'43730, 옥천군,'85,80 - 84세,1998,742,275,467
'43730, 옥천군,'90,85+ ,1998,498,120,378
'4373025000,  옥천읍,'00,계,1998,30975,15593,15382
'4373025000,  옥천읍,'05,0 - 4세,1998,2306,1213,1093
'4373025000,  옥천읍,'10,5 - 9세,1998,2166,1195,971
'4373025000,  옥천읍,'15,10 - 14세,1998,2174,1117,1057
'4373025000,  옥천읍,'20,15 - 19세,1998,3098,1574,1524
'4373025000,  옥천읍,'25,20 - 24세,1998,2831,1469,1362
'4373025000,  옥천읍,'30,25 - 29세,1998,2869,1491,1378
'4373025000,  옥천읍,'35,30 - 34세,1998,2560,1355,1205
'4373025000,  옥천읍,'40,35 - 39세,1998,2571,1316,1255
'4373025000,  옥천읍,'45,40 - 44세,1998,2272,1170,1102
'4373025000,  옥천읍,'50,45 - 49세,1998,1716,879,837
'4373025000,  옥천읍,'55,50 - 54세,1998,1315,637,678
'4373025000,  옥천읍,'60,55 - 59세,1998,1523,709,814
'4373025000,  옥천읍,'65,60 - 64세,1998,1281,610,671
'4373025000,  옥천읍,'70,65 - 69세,1998,905,363,542
'4373025000,  옥천읍,'75,70 - 74세,1998,598,239,359
'4373025000,  옥천읍,'80,75 - 79세,1998,426,159,267
'4373025000,  옥천읍,'85,80 - 84세,1998,206,64,142
'4373025000,  옥천읍,'90,85+ ,1998,158,33,125
'4373031000,  동이면,'00,계,1998,4251,2174,2077
'4373031000,  동이면,'05,0 - 4세,1998,153,92,61
'4373031000,  동이면,'10,5 - 9세,1998,138,73,65
'4373031000,  동이면,'15,10 - 14세,1998,201,103,98
'4373031000,  동이면,'20,15 - 19세,1998,386,192,194
'4373031000,  동이면,'25,20 - 24세,1998,433,233,200
'4373031000,  동이면,'30,25 - 29세,1998,293,194,99
'4373031000,  동이면,'35,30 - 34세,1998,199,118,81
'4373031000,  동이면,'40,35 - 39세,1998,260,146,114
'4373031000,  동이면,'45,40 - 44세,1998,263,153,110
'4373031000,  동이면,'50,45 - 49세,1998,219,104,115
'4373031000,  동이면,'55,50 - 54세,1998,230,101,129
'4373031000,  동이면,'60,55 - 59세,1998,381,162,219
'4373031000,  동이면,'65,60 - 64세,1998,385,185,200
'4373031000,  동이면,'70,65 - 69세,1998,266,121,145
'4373031000,  동이면,'75,70 - 74세,1998,201,102,99
'4373031000,  동이면,'80,75 - 79세,1998,143,66,77
'4373031000,  동이면,'85,80 - 84세,1998,60,21,39
'4373031000,  동이면,'90,85+ ,1998,40,8,32
'4373032000,  안남면,'00,계,1998,2138,1063,1075
'4373032000,  안남면,'05,0 - 4세,1998,71,46,25
'4373032000,  안남면,'10,5 - 9세,1998,71,33,38
'4373032000,  안남면,'15,10 - 14세,1998,108,51,57
'4373032000,  안남면,'20,15 - 19세,1998,171,85,86
'4373032000,  안남면,'25,20 - 24세,1998,187,104,83
'4373032000,  안남면,'30,25 - 29세,1998,136,92,44
'4373032000,  안남면,'35,30 - 34세,1998,86,44,42
'4373032000,  안남면,'40,35 - 39세,1998,117,58,59
'4373032000,  안남면,'45,40 - 44세,1998,107,71,36
'4373032000,  안남면,'50,45 - 49세,1998,115,53,62
'4373032000,  안남면,'55,50 - 54세,1998,99,49,50
'4373032000,  안남면,'60,55 - 59세,1998,181,79,102
'4373032000,  안남면,'65,60 - 64세,1998,222,96,126
'4373032000,  안남면,'70,65 - 69세,1998,185,79,106
'4373032000,  안남면,'75,70 - 74세,1998,129,65,64
'4373032000,  안남면,'80,75 - 79세,1998,89,35,54
'4373032000,  안남면,'85,80 - 84세,1998,36,15,21
'4373032000,  안남면,'90,85+ ,1998,28,8,20
'4373033000,  안내면,'00,계,1998,2913,1471,1442
'4373033000,  안내면,'05,0 - 4세,1998,102,55,47
'4373033000,  안내면,'10,5 - 9세,1998,93,45,48
'4373033000,  안내면,'15,10 - 14세,1998,129,68,61
'4373033000,  안내면,'20,15 - 19세,1998,245,132,113
'4373033000,  안내면,'25,20 - 24세,1998,281,153,128
'4373033000,  안내면,'30,25 - 29세,1998,208,144,64
'4373033000,  안내면,'35,30 - 34세,1998,146,91,55
'4373033000,  안내면,'40,35 - 39세,1998,152,85,67
'4373033000,  안내면,'45,40 - 44세,1998,163,81,82
'4373033000,  안내면,'50,45 - 49세,1998,172,94,78
'4373033000,  안내면,'55,50 - 54세,1998,163,76,87
'4373033000,  안내면,'60,55 - 59세,1998,264,114,150
'4373033000,  안내면,'65,60 - 64세,1998,267,113,154
'4373033000,  안내면,'70,65 - 69세,1998,202,87,115
'4373033000,  안내면,'75,70 - 74세,1998,142,59,83
'4373033000,  안내면,'80,75 - 79세,1998,100,41,59
'4373033000,  안내면,'85,80 - 84세,1998,48,23,25
'4373033000,  안내면,'90,85+ ,1998,36,10,26
'4373034000,  청성면,'00,계,1998,3788,1851,1937
'4373034000,  청성면,'05,0 - 4세,1998,82,54,28
'4373034000,  청성면,'10,5 - 9세,1998,106,57,49
'4373034000,  청성면,'15,10 - 14세,1998,180,86,94
'4373034000,  청성면,'20,15 - 19세,1998,327,163,164
'4373034000,  청성면,'25,20 - 24세,1998,334,187,147
'4373034000,  청성면,'30,25 - 29세,1998,197,132,65
'4373034000,  청성면,'35,30 - 34세,1998,143,85,58
'4373034000,  청성면,'40,35 - 39세,1998,168,86,82
'4373034000,  청성면,'45,40 - 44세,1998,216,118,98
'4373034000,  청성면,'50,45 - 49세,1998,186,86,100
'4373034000,  청성면,'55,50 - 54세,1998,197,91,106
'4373034000,  청성면,'60,55 - 59세,1998,361,155,206
'4373034000,  청성면,'65,60 - 64세,1998,454,197,257
'4373034000,  청성면,'70,65 - 69세,1998,318,134,184
'4373034000,  청성면,'75,70 - 74세,1998,230,107,123
'4373034000,  청성면,'80,75 - 79세,1998,150,67,83
'4373034000,  청성면,'85,80 - 84세,1998,87,33,54
'4373034000,  청성면,'90,85+ ,1998,52,13,39
'4373035000,  청산면,'00,계,1998,5210,2582,2628
'4373035000,  청산면,'05,0 - 4세,1998,201,102,99
'4373035000,  청산면,'10,5 - 9세,1998,194,93,101
'4373035000,  청산면,'15,10 - 14세,1998,290,154,136
'4373035000,  청산면,'20,15 - 19세,1998,490,234,256
'4373035000,  청산면,'25,20 - 24세,1998,499,309,190
'4373035000,  청산면,'30,25 - 29세,1998,268,184,84
'4373035000,  청산면,'35,30 - 34세,1998,209,106,103
'4373035000,  청산면,'40,35 - 39세,1998,313,171,142
'4373035000,  청산면,'45,40 - 44세,1998,325,169,156
'4373035000,  청산면,'50,45 - 49세,1998,288,146,142
'4373035000,  청산면,'55,50 - 54세,1998,287,144,143
'4373035000,  청산면,'60,55 - 59세,1998,457,207,250
'4373035000,  청산면,'65,60 - 64세,1998,473,213,260
'4373035000,  청산면,'70,65 - 69세,1998,337,134,203
'4373035000,  청산면,'75,70 - 74세,1998,210,84,126
'4373035000,  청산면,'80,75 - 79세,1998,201,80,121
'4373035000,  청산면,'85,80 - 84세,1998,102,37,65
'4373035000,  청산면,'90,85+ ,1998,66,15,51
'4373036000,  이원면,'00,계,1998,6657,3313,3344
'4373036000,  이원면,'05,0 - 4세,1998,259,143,116
'4373036000,  이원면,'10,5 - 9세,1998,301,150,151
'4373036000,  이원면,'15,10 - 14세,1998,348,177,171
'4373036000,  이원면,'20,15 - 19세,1998,595,284,311
'4373036000,  이원면,'25,20 - 24세,1998,694,415,279
'4373036000,  이원면,'30,25 - 29세,1998,459,271,188
'4373036000,  이원면,'35,30 - 34세,1998,336,192,144
'4373036000,  이원면,'40,35 - 39세,1998,359,199,160
'4373036000,  이원면,'45,40 - 44세,1998,397,213,184
'4373036000,  이원면,'50,45 - 49세,1998,400,193,207
'4373036000,  이원면,'55,50 - 54세,1998,338,181,157
'4373036000,  이원면,'60,55 - 59세,1998,499,212,287
'4373036000,  이원면,'65,60 - 64세,1998,563,233,330
'4373036000,  이원면,'70,65 - 69세,1998,424,180,244
'4373036000,  이원면,'75,70 - 74세,1998,317,133,184
'4373036000,  이원면,'80,75 - 79세,1998,210,78,132
'4373036000,  이원면,'85,80 - 84세,1998,103,43,60
'4373036000,  이원면,'90,85+ ,1998,55,16,39
'4373037000,  군서면,'00,계,1998,3205,1649,1556
'4373037000,  군서면,'05,0 - 4세,1998,121,63,58
'4373037000,  군서면,'10,5 - 9세,1998,119,64,55
'4373037000,  군서면,'15,10 - 14세,1998,176,94,82
'4373037000,  군서면,'20,15 - 19세,1998,266,142,124
'4373037000,  군서면,'25,20 - 24세,1998,326,198,128
'4373037000,  군서면,'30,25 - 29세,1998,232,151,81
'4373037000,  군서면,'35,30 - 34세,1998,146,86,60
'4373037000,  군서면,'40,35 - 39세,1998,187,112,75
'4373037000,  군서면,'45,40 - 44세,1998,176,96,80
'4373037000,  군서면,'50,45 - 49세,1998,184,98,86
'4373037000,  군서면,'55,50 - 54세,1998,187,87,100
'4373037000,  군서면,'60,55 - 59세,1998,238,95,143
'4373037000,  군서면,'65,60 - 64세,1998,318,149,169
'4373037000,  군서면,'70,65 - 69세,1998,219,92,127
'4373037000,  군서면,'75,70 - 74세,1998,131,60,71
'4373037000,  군서면,'80,75 - 79세,1998,91,32,59
'4373037000,  군서면,'85,80 - 84세,1998,50,19,31
'4373037000,  군서면,'90,85+ ,1998,38,11,27
'4373038000,  군북면,'00,계,1998,3571,1790,1781
'4373038000,  군북면,'05,0 - 4세,1998,159,87,72
'4373038000,  군북면,'10,5 - 9세,1998,147,69,78
'4373038000,  군북면,'15,10 - 14세,1998,180,93,87
'4373038000,  군북면,'20,15 - 19세,1998,289,140,149
'4373038000,  군북면,'25,20 - 24세,1998,342,200,142
'4373038000,  군북면,'30,25 - 29세,1998,265,143,122
'4373038000,  군북면,'35,30 - 34세,1998,190,120,70
'4373038000,  군북면,'40,35 - 39세,1998,244,126,118
'4373038000,  군북면,'45,40 - 44세,1998,222,122,100
'4373038000,  군북면,'50,45 - 49세,1998,210,111,99
'4373038000,  군북면,'55,50 - 54세,1998,185,80,105
'4373038000,  군북면,'60,55 - 59세,1998,290,136,154
'4373038000,  군북면,'65,60 - 64세,1998,283,124,159
'4373038000,  군북면,'70,65 - 69세,1998,226,99,127
'4373038000,  군북면,'75,70 - 74세,1998,160,79,81
'4373038000,  군북면,'80,75 - 79세,1998,104,35,69
'4373038000,  군북면,'85,80 - 84세,1998,50,20,30
'4373038000,  군북면,'90,85+ ,1998,25,6,19
'43740, 영동군,'00,계,1998,60890,30295,30595
'43740, 영동군,'05,0 - 4세,1998,3116,1642,1474
'43740, 영동군,'10,5 - 9세,1998,3304,1768,1536
'43740, 영동군,'15,10 - 14세,1998,3665,1924,1741
'43740, 영동군,'20,15 - 19세,1998,5445,2757,2688
'43740, 영동군,'25,20 - 24세,1998,5432,3083,2349
'43740, 영동군,'30,25 - 29세,1998,4385,2548,1837
'43740, 영동군,'35,30 - 34세,1998,3790,2005,1785
'43740, 영동군,'40,35 - 39세,1998,4160,2128,2032
'43740, 영동군,'45,40 - 44세,1998,3975,2117,1858
'43740, 영동군,'50,45 - 49세,1998,3280,1613,1667
'43740, 영동군,'55,50 - 54세,1998,3127,1453,1674
'43740, 영동군,'60,55 - 59세,1998,4448,2010,2438
'43740, 영동군,'65,60 - 64세,1998,4344,1926,2418
'43740, 영동군,'70,65 - 69세,1998,3090,1317,1773
'43740, 영동군,'75,70 - 74세,1998,2427,995,1432
'43740, 영동군,'80,75 - 79세,1998,1636,625,1011
'43740, 영동군,'85,80 - 84세,1998,792,254,538
'43740, 영동군,'90,85+ ,1998,474,130,344
'4374025000,  영동읍,'00,계,1998,22717,11351,11366
'4374025000,  영동읍,'05,0 - 4세,1998,1582,829,753
'4374025000,  영동읍,'10,5 - 9세,1998,1642,894,748
'4374025000,  영동읍,'15,10 - 14세,1998,1624,872,752
'4374025000,  영동읍,'20,15 - 19세,1998,2060,1023,1037
'4374025000,  영동읍,'25,20 - 24세,1998,1931,1047,884
'4374025000,  영동읍,'30,25 - 29세,1998,1928,993,935
'4374025000,  영동읍,'35,30 - 34세,1998,1831,927,904
'4374025000,  영동읍,'40,35 - 39세,1998,1956,983,973
'4374025000,  영동읍,'45,40 - 44세,1998,1668,915,753
'4374025000,  영동읍,'50,45 - 49세,1998,1201,594,607
'4374025000,  영동읍,'55,50 - 54세,1998,1096,533,563
'4374025000,  영동읍,'60,55 - 59세,1998,1198,552,646
'4374025000,  영동읍,'65,60 - 64세,1998,1074,489,585
'4374025000,  영동읍,'70,65 - 69세,1998,702,269,433
'4374025000,  영동읍,'75,70 - 74세,1998,585,236,349
'4374025000,  영동읍,'80,75 - 79세,1998,368,128,240
'4374025000,  영동읍,'85,80 - 84세,1998,183,48,135
'4374025000,  영동읍,'90,85+ ,1998,88,19,69
'4374031000,  용산면,'00,계,1998,4840,2401,2439
'4374031000,  용산면,'05,0 - 4세,1998,251,134,117
'4374031000,  용산면,'10,5 - 9세,1998,230,113,117
'4374031000,  용산면,'15,10 - 14세,1998,276,152,124
'4374031000,  용산면,'20,15 - 19세,1998,421,205,216
'4374031000,  용산면,'25,20 - 24세,1998,425,226,199
'4374031000,  용산면,'30,25 - 29세,1998,322,200,122
'4374031000,  용산면,'35,30 - 34세,1998,279,161,118
'4374031000,  용산면,'40,35 - 39세,1998,304,156,148
'4374031000,  용산면,'45,40 - 44세,1998,276,148,128
'4374031000,  용산면,'50,45 - 49세,1998,257,133,124
'4374031000,  용산면,'55,50 - 54세,1998,234,121,113
'4374031000,  용산면,'60,55 - 59세,1998,391,171,220
'4374031000,  용산면,'65,60 - 64세,1998,393,164,229
'4374031000,  용산면,'70,65 - 69세,1998,290,128,162
'4374031000,  용산면,'75,70 - 74세,1998,214,87,127
'4374031000,  용산면,'80,75 - 79세,1998,162,68,94
'4374031000,  용산면,'85,80 - 84세,1998,65,20,45
'4374031000,  용산면,'90,85+ ,1998,50,14,36
'4374032000,  황간면,'00,계,1998,6221,3075,3146
'4374032000,  황간면,'05,0 - 4세,1998,254,145,109
'4374032000,  황간면,'10,5 - 9세,1998,349,167,182
'4374032000,  황간면,'15,10 - 14세,1998,415,211,204
'4374032000,  황간면,'20,15 - 19세,1998,574,294,280
'4374032000,  황간면,'25,20 - 24세,1998,525,302,223
'4374032000,  황간면,'30,25 - 29세,1998,439,270,169
'4374032000,  황간면,'35,30 - 34세,1998,360,193,167
'4374032000,  황간면,'40,35 - 39세,1998,426,211,215
'4374032000,  황간면,'45,40 - 44세,1998,413,220,193
'4374032000,  황간면,'50,45 - 49세,1998,344,163,181
'4374032000,  황간면,'55,50 - 54세,1998,311,134,177
'4374032000,  황간면,'60,55 - 59세,1998,468,208,260
'4374032000,  황간면,'65,60 - 64세,1998,465,208,257
'4374032000,  황간면,'70,65 - 69세,1998,286,127,159
'4374032000,  황간면,'75,70 - 74세,1998,280,117,163
'4374032000,  황간면,'80,75 - 79세,1998,186,72,114
'4374032000,  황간면,'85,80 - 84세,1998,77,24,53
'4374032000,  황간면,'90,85+ ,1998,49,9,40
'4374033500,  추풍령면,'00,계,1998,3369,1641,1728
'4374033500,  추풍령면,'05,0 - 4세,1998,155,85,70
'4374033500,  추풍령면,'10,5 - 9세,1998,175,102,73
'4374033500,  추풍령면,'15,10 - 14세,1998,170,79,91
'4374033500,  추풍령면,'20,15 - 19세,1998,320,162,158
'4374033500,  추풍령면,'25,20 - 24세,1998,301,172,129
'4374033500,  추풍령면,'30,25 - 29세,1998,242,137,105
'4374033500,  추풍령면,'35,30 - 34세,1998,182,87,95
'4374033500,  추풍령면,'40,35 - 39세,1998,179,92,87
'4374033500,  추풍령면,'45,40 - 44세,1998,235,105,130
'4374033500,  추풍령면,'50,45 - 49세,1998,181,100,81
'4374033500,  추풍령면,'55,50 - 54세,1998,196,79,117
'4374033500,  추풍령면,'60,55 - 59세,1998,267,114,153
'4374033500,  추풍령면,'65,60 - 64세,1998,238,100,138
'4374033500,  추풍령면,'70,65 - 69세,1998,197,99,98
'4374033500,  추풍령면,'75,70 - 74세,1998,144,57,87
'4374033500,  추풍령면,'80,75 - 79세,1998,114,48,66
'4374033500,  추풍령면,'85,80 - 84세,1998,47,12,35
'4374033500,  추풍령면,'90,85+ ,1998,26,11,15
'4374034000,  매곡면,'00,계,1998,2640,1295,1345
'4374034000,  매곡면,'05,0 - 4세,1998,78,42,36
'4374034000,  매곡면,'10,5 - 9세,1998,85,48,37
'4374034000,  매곡면,'15,10 - 14세,1998,148,77,71
'4374034000,  매곡면,'20,15 - 19세,1998,237,109,128
'4374034000,  매곡면,'25,20 - 24세,1998,247,145,102
'4374034000,  매곡면,'30,25 - 29세,1998,159,111,48
'4374034000,  매곡면,'35,30 - 34세,1998,113,74,39
'4374034000,  매곡면,'40,35 - 39세,1998,136,66,70
'4374034000,  매곡면,'45,40 - 44세,1998,156,80,76
'4374034000,  매곡면,'50,45 - 49세,1998,143,78,65
'4374034000,  매곡면,'55,50 - 54세,1998,144,64,80
'4374034000,  매곡면,'60,55 - 59세,1998,231,97,134
'4374034000,  매곡면,'65,60 - 64세,1998,260,116,144
'4374034000,  매곡면,'70,65 - 69세,1998,189,79,110
'4374034000,  매곡면,'75,70 - 74세,1998,127,45,82
'4374034000,  매곡면,'80,75 - 79세,1998,95,32,63
'4374034000,  매곡면,'85,80 - 84세,1998,57,19,38
'4374034000,  매곡면,'90,85+ ,1998,35,13,22
'4374035000,  상촌면,'00,계,1998,3178,1586,1592
'4374035000,  상촌면,'05,0 - 4세,1998,95,52,43
'4374035000,  상촌면,'10,5 - 9세,1998,120,66,54
'4374035000,  상촌면,'15,10 - 14세,1998,151,85,66
'4374035000,  상촌면,'20,15 - 19세,1998,238,125,113
'4374035000,  상촌면,'25,20 - 24세,1998,292,179,113
'4374035000,  상촌면,'30,25 - 29세,1998,196,140,56
'4374035000,  상촌면,'35,30 - 34세,1998,117,65,52
'4374035000,  상촌면,'40,35 - 39세,1998,145,68,77
'4374035000,  상촌면,'45,40 - 44세,1998,180,90,90
'4374035000,  상촌면,'50,45 - 49세,1998,182,90,92
'4374035000,  상촌면,'55,50 - 54세,1998,192,88,104
'4374035000,  상촌면,'60,55 - 59세,1998,315,134,181
'4374035000,  상촌면,'65,60 - 64세,1998,288,122,166
'4374035000,  상촌면,'70,65 - 69세,1998,230,103,127
'4374035000,  상촌면,'75,70 - 74세,1998,207,88,119
'4374035000,  상촌면,'80,75 - 79세,1998,118,45,73
'4374035000,  상촌면,'85,80 - 84세,1998,69,29,40
'4374035000,  상촌면,'90,85+ ,1998,43,17,26
'4374036000,  양강면,'00,계,1998,4588,2297,2291
'4374036000,  양강면,'05,0 - 4세,1998,197,105,92
'4374036000,  양강면,'10,5 - 9세,1998,212,108,104
'4374036000,  양강면,'15,10 - 14세,1998,249,119,130
'4374036000,  양강면,'20,15 - 19세,1998,407,222,185
'4374036000,  양강면,'25,20 - 24세,1998,454,259,195
'4374036000,  양강면,'30,25 - 29세,1998,326,202,124
'4374036000,  양강면,'35,30 - 34세,1998,262,144,118
'4374036000,  양강면,'40,35 - 39세,1998,280,149,131
'4374036000,  양강면,'45,40 - 44세,1998,254,130,124
'4374036000,  양강면,'50,45 - 49세,1998,225,96,129
'4374036000,  양강면,'55,50 - 54세,1998,245,120,125
'4374036000,  양강면,'60,55 - 59세,1998,369,167,202
'4374036000,  양강면,'65,60 - 64세,1998,396,179,217
'4374036000,  양강면,'70,65 - 69세,1998,270,120,150
'4374036000,  양강면,'75,70 - 74세,1998,191,77,114
'4374036000,  양강면,'80,75 - 79세,1998,131,52,79
'4374036000,  양강면,'85,80 - 84세,1998,81,39,42
'4374036000,  양강면,'90,85+ ,1998,39,9,30
'4374037000,  용화면,'00,계,1998,1250,630,620
'4374037000,  용화면,'05,0 - 4세,1998,55,23,32
'4374037000,  용화면,'10,5 - 9세,1998,48,26,22
'4374037000,  용화면,'15,10 - 14세,1998,41,17,24
'4374037000,  용화면,'20,15 - 19세,1998,82,41,41
'4374037000,  용화면,'25,20 - 24세,1998,123,79,44
'4374037000,  용화면,'30,25 - 29세,1998,77,53,24
'4374037000,  용화면,'35,30 - 34세,1998,57,37,20
'4374037000,  용화면,'40,35 - 39세,1998,64,34,30
'4374037000,  용화면,'45,40 - 44세,1998,75,43,32
'4374037000,  용화면,'50,45 - 49세,1998,56,29,27
'4374037000,  용화면,'55,50 - 54세,1998,72,31,41
'4374037000,  용화면,'60,55 - 59세,1998,153,66,87
'4374037000,  용화면,'65,60 - 64세,1998,117,56,61
'4374037000,  용화면,'70,65 - 69세,1998,99,52,47
'4374037000,  용화면,'75,70 - 74세,1998,60,22,38
'4374037000,  용화면,'80,75 - 79세,1998,45,18,27
'4374037000,  용화면,'85,80 - 84세,1998,17,3,14
'4374037000,  용화면,'90,85+ ,1998,9,0,9
'4374038000,  학산면,'00,계,1998,4480,2216,2264
'4374038000,  학산면,'05,0 - 4세,1998,144,75,69
'4374038000,  학산면,'10,5 - 9세,1998,157,85,72
'4374038000,  학산면,'15,10 - 14세,1998,209,106,103
'4374038000,  학산면,'20,15 - 19세,1998,449,232,217
'4374038000,  학산면,'25,20 - 24세,1998,432,254,178
'4374038000,  학산면,'30,25 - 29세,1998,228,145,83
'4374038000,  학산면,'35,30 - 34세,1998,205,117,88
'4374038000,  학산면,'40,35 - 39세,1998,243,132,111
'4374038000,  학산면,'45,40 - 44세,1998,268,142,126
'4374038000,  학산면,'50,45 - 49세,1998,237,116,121
'4374038000,  학산면,'55,50 - 54세,1998,234,99,135
'4374038000,  학산면,'60,55 - 59세,1998,383,181,202
'4374038000,  학산면,'65,60 - 64세,1998,438,200,238
'4374038000,  학산면,'70,65 - 69세,1998,322,139,183
'4374038000,  학산면,'75,70 - 74세,1998,233,93,140
'4374038000,  학산면,'80,75 - 79세,1998,165,60,105
'4374038000,  학산면,'85,80 - 84세,1998,83,26,57
'4374038000,  학산면,'90,85+ ,1998,50,14,36
'4374039000,  양산면,'00,계,1998,2881,1446,1435
'4374039000,  양산면,'05,0 - 4세,1998,122,65,57
'4374039000,  양산면,'10,5 - 9세,1998,115,63,52
'4374039000,  양산면,'15,10 - 14세,1998,143,79,64
'4374039000,  양산면,'20,15 - 19세,1998,240,127,113
'4374039000,  양산면,'25,20 - 24세,1998,286,175,111
'4374039000,  양산면,'30,25 - 29세,1998,180,116,64
'4374039000,  양산면,'35,30 - 34세,1998,149,76,73
'4374039000,  양산면,'40,35 - 39세,1998,155,86,69
'4374039000,  양산면,'45,40 - 44세,1998,165,95,70
'4374039000,  양산면,'50,45 - 49세,1998,167,73,94
'4374039000,  양산면,'55,50 - 54세,1998,142,58,84
'4374039000,  양산면,'60,55 - 59세,1998,261,127,134
'4374039000,  양산면,'65,60 - 64세,1998,257,110,147
'4374039000,  양산면,'70,65 - 69세,1998,194,83,111
'4374039000,  양산면,'75,70 - 74세,1998,142,63,79
'4374039000,  양산면,'80,75 - 79세,1998,92,32,60
'4374039000,  양산면,'85,80 - 84세,1998,43,11,32
'4374039000,  양산면,'90,85+ ,1998,28,7,21
'4374040000,  심천면,'00,계,1998,4726,2357,2369
'4374040000,  심천면,'05,0 - 4세,1998,183,87,96
'4374040000,  심천면,'10,5 - 9세,1998,171,96,75
'4374040000,  심천면,'15,10 - 14세,1998,239,127,112
'4374040000,  심천면,'20,15 - 19세,1998,417,217,200
'4374040000,  심천면,'25,20 - 24세,1998,416,245,171
'4374040000,  심천면,'30,25 - 29세,1998,288,181,107
'4374040000,  심천면,'35,30 - 34세,1998,235,124,111
'4374040000,  심천면,'40,35 - 39세,1998,272,151,121
'4374040000,  심천면,'45,40 - 44세,1998,285,149,136
'4374040000,  심천면,'50,45 - 49세,1998,287,141,146
'4374040000,  심천면,'55,50 - 54세,1998,261,126,135
'4374040000,  심천면,'60,55 - 59세,1998,412,193,219
'4374040000,  심천면,'65,60 - 64세,1998,418,182,236
'4374040000,  심천면,'70,65 - 69세,1998,311,118,193
'4374040000,  심천면,'75,70 - 74세,1998,244,110,134
'4374040000,  심천면,'80,75 - 79세,1998,160,70,90
'4374040000,  심천면,'85,80 - 84세,1998,70,23,47
'4374040000,  심천면,'90,85+ ,1998,57,17,40
'43750, 진천군,'00,계,1998,59177,30166,29011
'43750, 진천군,'05,0 - 4세,1998,4512,2397,2115
'43750, 진천군,'10,5 - 9세,1998,4216,2205,2011
'43750, 진천군,'15,10 - 14세,1998,3703,1895,1808
'43750, 진천군,'20,15 - 19세,1998,4510,2312,2198
'43750, 진천군,'25,20 - 24세,1998,4848,2571,2277
'43750, 진천군,'30,25 - 29세,1998,5347,2892,2455
'43750, 진천군,'35,30 - 34세,1998,5224,2863,2361
'43750, 진천군,'40,35 - 39세,1998,4923,2722,2201
'43750, 진천군,'45,40 - 44세,1998,3961,2154,1807
'43750, 진천군,'50,45 - 49세,1998,2689,1419,1270
'43750, 진천군,'55,50 - 54세,1998,2555,1294,1261
'43750, 진천군,'60,55 - 59세,1998,3222,1480,1742
'43750, 진천군,'65,60 - 64세,1998,3403,1561,1842
'43750, 진천군,'70,65 - 69세,1998,2286,923,1363
'43750, 진천군,'75,70 - 74세,1998,1606,629,977
'43750, 진천군,'80,75 - 79세,1998,1206,479,727
'43750, 진천군,'85,80 - 84세,1998,622,255,367
'43750, 진천군,'90,85+ ,1998,344,115,229
'4375025000,  진천읍,'00,계,1998,24974,12632,12342
'4375025000,  진천읍,'05,0 - 4세,1998,2225,1166,1059
'4375025000,  진천읍,'10,5 - 9세,1998,2040,1081,959
'4375025000,  진천읍,'15,10 - 14세,1998,1621,835,786
'4375025000,  진천읍,'20,15 - 19세,1998,1877,946,931
'4375025000,  진천읍,'25,20 - 24세,1998,2018,1017,1001
'4375025000,  진천읍,'30,25 - 29세,1998,2533,1285,1248
'4375025000,  진천읍,'35,30 - 34세,1998,2503,1322,1181
'4375025000,  진천읍,'40,35 - 39세,1998,2225,1216,1009
'4375025000,  진천읍,'45,40 - 44세,1998,1635,883,752
'4375025000,  진천읍,'50,45 - 49세,1998,1118,573,545
'4375025000,  진천읍,'55,50 - 54세,1998,1007,503,504
'4375025000,  진천읍,'60,55 - 59세,1998,1126,527,599
'4375025000,  진천읍,'65,60 - 64세,1998,1090,503,587
'4375025000,  진천읍,'70,65 - 69세,1998,713,292,421
'4375025000,  진천읍,'75,70 - 74세,1998,517,199,318
'4375025000,  진천읍,'80,75 - 79세,1998,409,167,242
'4375025000,  진천읍,'85,80 - 84세,1998,213,83,130
'4375025000,  진천읍,'90,85+ ,1998,104,34,70
'4375031000,  덕산면,'00,계,1998,6570,3368,3202
'4375031000,  덕산면,'05,0 - 4세,1998,344,193,151
'4375031000,  덕산면,'10,5 - 9세,1998,381,195,186
'4375031000,  덕산면,'15,10 - 14세,1998,439,226,213
'4375031000,  덕산면,'20,15 - 19세,1998,586,303,283
'4375031000,  덕산면,'25,20 - 24세,1998,582,308,274
'4375031000,  덕산면,'30,25 - 29세,1998,513,313,200
'4375031000,  덕산면,'35,30 - 34세,1998,423,244,179
'4375031000,  덕산면,'40,35 - 39세,1998,499,261,238
'4375031000,  덕산면,'45,40 - 44세,1998,497,279,218
'4375031000,  덕산면,'50,45 - 49세,1998,334,174,160
'4375031000,  덕산면,'55,50 - 54세,1998,324,160,164
'4375031000,  덕산면,'60,55 - 59세,1998,429,196,233
'4375031000,  덕산면,'65,60 - 64세,1998,481,229,252
'4375031000,  덕산면,'70,65 - 69세,1998,272,106,166
'4375031000,  덕산면,'75,70 - 74세,1998,209,84,125
'4375031000,  덕산면,'80,75 - 79세,1998,141,57,84
'4375031000,  덕산면,'85,80 - 84세,1998,69,24,45
'4375031000,  덕산면,'90,85+ ,1998,47,16,31
'4375032000,  초평면,'00,계,1998,4669,2419,2250
'4375032000,  초평면,'05,0 - 4세,1998,171,88,83
'4375032000,  초평면,'10,5 - 9세,1998,180,91,89
'4375032000,  초평면,'15,10 - 14세,1998,287,152,135
'4375032000,  초평면,'20,15 - 19세,1998,402,205,197
'4375032000,  초평면,'25,20 - 24세,1998,445,275,170
'4375032000,  초평면,'30,25 - 29세,1998,325,211,114
'4375032000,  초평면,'35,30 - 34세,1998,232,137,95
'4375032000,  초평면,'40,35 - 39세,1998,292,167,125
'4375032000,  초평면,'45,40 - 44세,1998,325,169,156
'4375032000,  초평면,'50,45 - 49세,1998,240,131,109
'4375032000,  초평면,'55,50 - 54세,1998,235,127,108
'4375032000,  초평면,'60,55 - 59세,1998,378,168,210
'4375032000,  초평면,'65,60 - 64세,1998,422,185,237
'4375032000,  초평면,'70,65 - 69세,1998,297,122,175
'4375032000,  초평면,'75,70 - 74세,1998,198,93,105
'4375032000,  초평면,'80,75 - 79세,1998,139,55,84
'4375032000,  초평면,'85,80 - 84세,1998,67,29,38
'4375032000,  초평면,'90,85+ ,1998,34,14,20
'4375033000,  문백면,'00,계,1998,4349,2245,2104
'4375033000,  문백면,'05,0 - 4세,1998,223,123,100
'4375033000,  문백면,'10,5 - 9세,1998,195,107,88
'4375033000,  문백면,'15,10 - 14세,1998,247,125,122
'4375033000,  문백면,'20,15 - 19세,1998,330,165,165
'4375033000,  문백면,'25,20 - 24세,1998,381,215,166
'4375033000,  문백면,'30,25 - 29세,1998,351,209,142
'4375033000,  문백면,'35,30 - 34세,1998,281,173,108
'4375033000,  문백면,'40,35 - 39세,1998,306,166,140
'4375033000,  문백면,'45,40 - 44세,1998,276,156,120
'4375033000,  문백면,'50,45 - 49세,1998,209,114,95
'4375033000,  문백면,'55,50 - 54세,1998,236,121,115
'4375033000,  문백면,'60,55 - 59세,1998,313,147,166
'4375033000,  문백면,'65,60 - 64세,1998,360,165,195
'4375033000,  문백면,'70,65 - 69세,1998,234,95,139
'4375033000,  문백면,'75,70 - 74세,1998,158,62,96
'4375033000,  문백면,'80,75 - 79세,1998,131,54,77
'4375033000,  문백면,'85,80 - 84세,1998,73,36,37
'4375033000,  문백면,'90,85+ ,1998,45,12,33
'4375034000,  백곡면,'00,계,1998,2620,1321,1299
'4375034000,  백곡면,'05,0 - 4세,1998,113,69,44
'4375034000,  백곡면,'10,5 - 9세,1998,92,50,42
'4375034000,  백곡면,'15,10 - 14세,1998,121,51,70
'4375034000,  백곡면,'20,15 - 19세,1998,207,108,99
'4375034000,  백곡면,'25,20 - 24세,1998,267,154,113
'4375034000,  백곡면,'30,25 - 29세,1998,172,113,59
'4375034000,  백곡면,'35,30 - 34세,1998,130,83,47
'4375034000,  백곡면,'40,35 - 39세,1998,117,64,53
'4375034000,  백곡면,'45,40 - 44세,1998,164,82,82
'4375034000,  백곡면,'50,45 - 49세,1998,144,78,66
'4375034000,  백곡면,'55,50 - 54세,1998,159,75,84
'4375034000,  백곡면,'60,55 - 59세,1998,211,87,124
'4375034000,  백곡면,'65,60 - 64세,1998,255,126,129
'4375034000,  백곡면,'70,65 - 69세,1998,176,72,104
'4375034000,  백곡면,'75,70 - 74세,1998,127,47,80
'4375034000,  백곡면,'80,75 - 79세,1998,91,38,53
'4375034000,  백곡면,'85,80 - 84세,1998,53,19,34
'4375034000,  백곡면,'90,85+ ,1998,21,5,16
'4375035000,  이월면,'00,계,1998,7716,3942,3774
'4375035000,  이월면,'05,0 - 4세,1998,547,287,260
'4375035000,  이월면,'10,5 - 9세,1998,465,251,214
'4375035000,  이월면,'15,10 - 14세,1998,461,231,230
'4375035000,  이월면,'20,15 - 19세,1998,628,332,296
'4375035000,  이월면,'25,20 - 24세,1998,624,342,282
'4375035000,  이월면,'30,25 - 29세,1998,612,335,277
'4375035000,  이월면,'35,30 - 34세,1998,605,357,248
'4375035000,  이월면,'40,35 - 39세,1998,591,329,262
'4375035000,  이월면,'45,40 - 44세,1998,555,287,268
'4375035000,  이월면,'50,45 - 49세,1998,359,201,158
'4375035000,  이월면,'55,50 - 54세,1998,335,176,159
'4375035000,  이월면,'60,55 - 59세,1998,457,212,245
'4375035000,  이월면,'65,60 - 64세,1998,501,217,284
'4375035000,  이월면,'70,65 - 69세,1998,376,152,224
'4375035000,  이월면,'75,70 - 74세,1998,249,94,155
'4375035000,  이월면,'80,75 - 79세,1998,190,68,122
'4375035000,  이월면,'85,80 - 84세,1998,95,44,51
'4375035000,  이월면,'90,85+ ,1998,66,27,39
'4375036000,  만승면,'00,계,1998,8279,4239,4040
'4375036000,  만승면,'05,0 - 4세,1998,889,471,418
'4375036000,  만승면,'10,5 - 9세,1998,863,430,433
'4375036000,  만승면,'15,10 - 14세,1998,527,275,252
'4375036000,  만승면,'20,15 - 19세,1998,480,253,227
'4375036000,  만승면,'25,20 - 24세,1998,531,260,271
'4375036000,  만승면,'30,25 - 29세,1998,841,426,415
'4375036000,  만승면,'35,30 - 34세,1998,1050,547,503
'4375036000,  만승면,'40,35 - 39세,1998,893,519,374
'4375036000,  만승면,'45,40 - 44세,1998,509,298,211
'4375036000,  만승면,'50,45 - 49세,1998,285,148,137
'4375036000,  만승면,'55,50 - 54세,1998,259,132,127
'4375036000,  만승면,'60,55 - 59세,1998,308,143,165
'4375036000,  만승면,'65,60 - 64세,1998,294,136,158
'4375036000,  만승면,'70,65 - 69세,1998,218,84,134
'4375036000,  만승면,'75,70 - 74세,1998,148,50,98
'4375036000,  만승면,'80,75 - 79세,1998,105,40,65
'4375036000,  만승면,'85,80 - 84세,1998,52,20,32
'4375036000,  만승면,'90,85+ ,1998,27,7,20
'43760, 괴산군,'00,계,1998,46272,23382,22890
'43760, 괴산군,'05,0 - 4세,1998,2044,1097,947
'43760, 괴산군,'10,5 - 9세,1998,2089,1090,999
'43760, 괴산군,'15,10 - 14세,1998,2617,1303,1314
'43760, 괴산군,'20,15 - 19세,1998,3974,2023,1951
'43760, 괴산군,'25,20 - 24세,1998,4195,2356,1839
'43760, 괴산군,'30,25 - 29세,1998,3219,2003,1216
'43760, 괴산군,'35,30 - 34세,1998,2628,1493,1135
'43760, 괴산군,'40,35 - 39세,1998,2978,1637,1341
'43760, 괴산군,'45,40 - 44세,1998,3052,1658,1394
'43760, 괴산군,'50,45 - 49세,1998,2425,1284,1141
'43760, 괴산군,'55,50 - 54세,1998,2513,1225,1288
'43760, 괴산군,'60,55 - 59세,1998,3662,1685,1977
'43760, 괴산군,'65,60 - 64세,1998,3674,1659,2015
'43760, 괴산군,'70,65 - 69세,1998,2726,1122,1604
'43760, 괴산군,'75,70 - 74세,1998,1896,756,1140
'43760, 괴산군,'80,75 - 79세,1998,1343,554,789
'43760, 괴산군,'85,80 - 84세,1998,757,300,457
'43760, 괴산군,'90,85+ ,1998,480,137,343
'4376025000,  괴산읍,'00,계,1998,10825,5479,5346
'4376025000,  괴산읍,'05,0 - 4세,1998,768,386,382
'4376025000,  괴산읍,'10,5 - 9세,1998,702,378,324
'4376025000,  괴산읍,'15,10 - 14세,1998,667,334,333
'4376025000,  괴산읍,'20,15 - 19세,1998,934,482,452
'4376025000,  괴산읍,'25,20 - 24세,1998,944,498,446
'4376025000,  괴산읍,'30,25 - 29세,1998,902,475,427
'4376025000,  괴산읍,'35,30 - 34세,1998,874,474,400
'4376025000,  괴산읍,'40,35 - 39세,1998,864,460,404
'4376025000,  괴산읍,'45,40 - 44세,1998,749,415,334
'4376025000,  괴산읍,'50,45 - 49세,1998,601,327,274
'4376025000,  괴산읍,'55,50 - 54세,1998,554,257,297
'4376025000,  괴산읍,'60,55 - 59세,1998,650,307,343
'4376025000,  괴산읍,'65,60 - 64세,1998,542,273,269
'4376025000,  괴산읍,'70,65 - 69세,1998,408,166,242
'4376025000,  괴산읍,'75,70 - 74세,1998,277,100,177
'4376025000,  괴산읍,'80,75 - 79세,1998,198,82,116
'4376025000,  괴산읍,'85,80 - 84세,1998,132,53,79
'4376025000,  괴산읍,'90,85+ ,1998,59,12,47
'4376025400,  증천지소,'00,계,1998,22825,11501,11324
'4376025400,  증천지소,'05,0 - 4세,1998,2138,1110,1028
'4376025400,  증천지소,'10,5 - 9세,1998,2023,1058,965
'4376025400,  증천지소,'15,10 - 14세,1998,1623,837,786
'4376025400,  증천지소,'20,15 - 19세,1998,1808,939,869
'4376025400,  증천지소,'25,20 - 24세,1998,1837,977,860
'4376025400,  증천지소,'30,25 - 29세,1998,2305,1145,1160
'4376025400,  증천지소,'35,30 - 34세,1998,2384,1243,1141
'4376025400,  증천지소,'40,35 - 39세,1998,2107,1148,959
'4376025400,  증천지소,'45,40 - 44세,1998,1564,823,741
'4376025400,  증천지소,'50,45 - 49세,1998,944,476,468
'4376025400,  증천지소,'55,50 - 54세,1998,790,395,395
'4376025400,  증천지소,'60,55 - 59세,1998,914,422,492
'4376025400,  증천지소,'65,60 - 64세,1998,859,361,498
'4376025400,  증천지소,'70,65 - 69세,1998,615,256,359
'4376025400,  증천지소,'75,70 - 74세,1998,404,140,264
'4376025400,  증천지소,'80,75 - 79세,1998,276,99,177
'4376025400,  증천지소,'85,80 - 84세,1998,147,51,96
'4376025400,  증천지소,'90,85+ ,1998,87,21,66
'4376025500,  장평지소,'00,계,1998,6912,3507,3405
'4376025500,  장평지소,'05,0 - 4세,1998,363,191,172
'4376025500,  장평지소,'10,5 - 9세,1998,421,235,186
'4376025500,  장평지소,'15,10 - 14세,1998,466,245,221
'4376025500,  장평지소,'20,15 - 19세,1998,675,346,329
'4376025500,  장평지소,'25,20 - 24세,1998,657,361,296
'4376025500,  장평지소,'30,25 - 29세,1998,575,332,243
'4376025500,  장평지소,'35,30 - 34세,1998,488,260,228
'4376025500,  장평지소,'40,35 - 39세,1998,526,273,253
'4376025500,  장평지소,'45,40 - 44세,1998,515,250,265
'4376025500,  장평지소,'50,45 - 49세,1998,409,206,203
'4376025500,  장평지소,'55,50 - 54세,1998,372,196,176
'4376025500,  장평지소,'60,55 - 59세,1998,427,198,229
'4376025500,  장평지소,'65,60 - 64세,1998,364,163,201
'4376025500,  장평지소,'70,65 - 69세,1998,259,103,156
'4376025500,  장평지소,'75,70 - 74세,1998,171,68,103
'4376025500,  장평지소,'80,75 - 79세,1998,115,50,65
'4376025500,  장평지소,'85,80 - 84세,1998,79,22,57
'4376025500,  장평지소,'90,85+ ,1998,30,8,22
'4376031000,  감물면,'00,계,1998,2583,1288,1295
'4376031000,  감물면,'05,0 - 4세,1998,88,49,39
'4376031000,  감물면,'10,5 - 9세,1998,93,44,49
'4376031000,  감물면,'15,10 - 14세,1998,174,88,86
'4376031000,  감물면,'20,15 - 19세,1998,220,111,109
'4376031000,  감물면,'25,20 - 24세,1998,226,130,96
'4376031000,  감물면,'30,25 - 29세,1998,160,114,46
'4376031000,  감물면,'35,30 - 34세,1998,105,61,44
'4376031000,  감물면,'40,35 - 39세,1998,165,89,76
'4376031000,  감물면,'45,40 - 44세,1998,167,86,81
'4376031000,  감물면,'50,45 - 49세,1998,134,75,59
'4376031000,  감물면,'55,50 - 54세,1998,133,59,74
'4376031000,  감물면,'60,55 - 59세,1998,218,98,120
'4376031000,  감물면,'65,60 - 64세,1998,245,114,131
'4376031000,  감물면,'70,65 - 69세,1998,176,66,110
'4376031000,  감물면,'75,70 - 74세,1998,127,54,73
'4376031000,  감물면,'80,75 - 79세,1998,71,20,51
'4376031000,  감물면,'85,80 - 84세,1998,53,20,33
'4376031000,  감물면,'90,85+ ,1998,28,10,18
'4376032000,  장연면,'00,계,1998,2456,1259,1197
'4376032000,  장연면,'05,0 - 4세,1998,64,35,29
'4376032000,  장연면,'10,5 - 9세,1998,94,59,35
'4376032000,  장연면,'15,10 - 14세,1998,125,56,69
'4376032000,  장연면,'20,15 - 19세,1998,206,102,104
'4376032000,  장연면,'25,20 - 24세,1998,222,132,90
'4376032000,  장연면,'30,25 - 29세,1998,135,91,44
'4376032000,  장연면,'35,30 - 34세,1998,106,63,43
'4376032000,  장연면,'40,35 - 39세,1998,136,86,50
'4376032000,  장연면,'45,40 - 44세,1998,153,90,63
'4376032000,  장연면,'50,45 - 49세,1998,114,56,58
'4376032000,  장연면,'55,50 - 54세,1998,145,69,76
'4376032000,  장연면,'60,55 - 59세,1998,211,97,114
'4376032000,  장연면,'65,60 - 64세,1998,264,123,141
'4376032000,  장연면,'70,65 - 69세,1998,187,74,113
'4376032000,  장연면,'75,70 - 74세,1998,135,48,87
'4376032000,  장연면,'80,75 - 79세,1998,71,40,31
'4376032000,  장연면,'85,80 - 84세,1998,51,19,32
'4376032000,  장연면,'90,85+ ,1998,37,19,18
'4376033000,  연풍면,'00,계,1998,3414,1736,1678
'4376033000,  연풍면,'05,0 - 4세,1998,132,74,58
'4376033000,  연풍면,'10,5 - 9세,1998,157,89,68
'4376033000,  연풍면,'15,10 - 14세,1998,211,103,108
'4376033000,  연풍면,'20,15 - 19세,1998,286,147,139
'4376033000,  연풍면,'25,20 - 24세,1998,283,176,107
'4376033000,  연풍면,'30,25 - 29세,1998,197,127,70
'4376033000,  연풍면,'35,30 - 34세,1998,179,103,76
'4376033000,  연풍면,'40,35 - 39세,1998,239,126,113
'4376033000,  연풍면,'45,40 - 44세,1998,244,132,112
'4376033000,  연풍면,'50,45 - 49세,1998,148,75,73
'4376033000,  연풍면,'55,50 - 54세,1998,197,101,96
'4376033000,  연풍면,'60,55 - 59세,1998,297,149,148
'4376033000,  연풍면,'65,60 - 64세,1998,261,123,138
'4376033000,  연풍면,'70,65 - 69세,1998,188,69,119
'4376033000,  연풍면,'75,70 - 74세,1998,164,55,109
'4376033000,  연풍면,'80,75 - 79세,1998,143,54,89
'4376033000,  연풍면,'85,80 - 84세,1998,53,23,30
'4376033000,  연풍면,'90,85+ ,1998,35,10,25
'4376034000,  칠성면,'00,계,1998,3621,1838,1783
'4376034000,  칠성면,'05,0 - 4세,1998,124,71,53
'4376034000,  칠성면,'10,5 - 9세,1998,166,76,90
'4376034000,  칠성면,'15,10 - 14세,1998,214,114,100
'4376034000,  칠성면,'20,15 - 19세,1998,282,137,145
'4376034000,  칠성면,'25,20 - 24세,1998,306,190,116
'4376034000,  칠성면,'30,25 - 29세,1998,224,149,75
'4376034000,  칠성면,'35,30 - 34세,1998,213,123,90
'4376034000,  칠성면,'40,35 - 39세,1998,218,124,94
'4376034000,  칠성면,'45,40 - 44세,1998,244,128,116
'4376034000,  칠성면,'50,45 - 49세,1998,181,107,74
'4376034000,  칠성면,'55,50 - 54세,1998,199,96,103
'4376034000,  칠성면,'60,55 - 59세,1998,344,145,199
'4376034000,  칠성면,'65,60 - 64세,1998,318,131,187
'4376034000,  칠성면,'70,65 - 69세,1998,219,96,123
'4376034000,  칠성면,'75,70 - 74세,1998,148,51,97
'4376034000,  칠성면,'80,75 - 79세,1998,114,55,59
'4376034000,  칠성면,'85,80 - 84세,1998,68,34,34
'4376034000,  칠성면,'90,85+ ,1998,39,11,28
'4376035000,  문광면,'00,계,1998,2502,1273,1229
'4376035000,  문광면,'05,0 - 4세,1998,93,54,39
'4376035000,  문광면,'10,5 - 9세,1998,82,43,39
'4376035000,  문광면,'15,10 - 14세,1998,115,67,48
'4376035000,  문광면,'20,15 - 19세,1998,206,99,107
'4376035000,  문광면,'25,20 - 24세,1998,254,149,105
'4376035000,  문광면,'30,25 - 29세,1998,153,103,50
'4376035000,  문광면,'35,30 - 34세,1998,123,70,53
'4376035000,  문광면,'40,35 - 39세,1998,134,75,59
'4376035000,  문광면,'45,40 - 44세,1998,143,78,65
'4376035000,  문광면,'50,45 - 49세,1998,132,73,59
'4376035000,  문광면,'55,50 - 54세,1998,141,68,73
'4376035000,  문광면,'60,55 - 59세,1998,203,96,107
'4376035000,  문광면,'65,60 - 64세,1998,234,93,141
'4376035000,  문광면,'70,65 - 69세,1998,191,75,116
'4376035000,  문광면,'75,70 - 74세,1998,160,76,84
'4376035000,  문광면,'80,75 - 79세,1998,69,31,38
'4376035000,  문광면,'85,80 - 84세,1998,41,13,28
'4376035000,  문광면,'90,85+ ,1998,28,10,18
'4376036000,  청천면,'00,계,1998,6366,3162,3204
'4376036000,  청천면,'05,0 - 4세,1998,207,107,100
'4376036000,  청천면,'10,5 - 9세,1998,254,131,123
'4376036000,  청천면,'15,10 - 14세,1998,379,172,207
'4376036000,  청천면,'20,15 - 19세,1998,582,287,295
'4376036000,  청천면,'25,20 - 24세,1998,539,302,237
'4376036000,  청천면,'30,25 - 29세,1998,394,256,138
'4376036000,  청천면,'35,30 - 34세,1998,304,175,129
'4376036000,  청천면,'40,35 - 39세,1998,383,203,180
'4376036000,  청천면,'45,40 - 44세,1998,445,245,200
'4376036000,  청천면,'50,45 - 49세,1998,360,186,174
'4376036000,  청천면,'55,50 - 54세,1998,349,163,186
'4376036000,  청천면,'60,55 - 59세,1998,587,278,309
'4376036000,  청천면,'65,60 - 64세,1998,540,231,309
'4376036000,  청천면,'70,65 - 69세,1998,389,171,218
'4376036000,  청천면,'75,70 - 74세,1998,253,110,143
'4376036000,  청천면,'80,75 - 79세,1998,191,79,112
'4376036000,  청천면,'85,80 - 84세,1998,122,45,77
'4376036000,  청천면,'90,85+ ,1998,88,21,67
'4376037000,  청안면,'00,계,1998,4493,2294,2199
'4376037000,  청안면,'05,0 - 4세,1998,175,94,81
'4376037000,  청안면,'10,5 - 9세,1998,176,89,87
'4376037000,  청안면,'15,10 - 14세,1998,229,121,108
'4376037000,  청안면,'20,15 - 19세,1998,393,211,182
'4376037000,  청안면,'25,20 - 24세,1998,435,243,192
'4376037000,  청안면,'30,25 - 29세,1998,323,218,105
'4376037000,  청안면,'35,30 - 34세,1998,228,137,91
'4376037000,  청안면,'40,35 - 39세,1998,276,156,120
'4376037000,  청안면,'45,40 - 44세,1998,287,161,126
'4376037000,  청안면,'50,45 - 49세,1998,236,112,124
'4376037000,  청안면,'55,50 - 54세,1998,238,131,107
'4376037000,  청안면,'60,55 - 59세,1998,328,148,180
'4376037000,  청안면,'65,60 - 64세,1998,389,157,232
'4376037000,  청안면,'70,65 - 69세,1998,296,126,170
'4376037000,  청안면,'75,70 - 74세,1998,199,75,124
'4376037000,  청안면,'80,75 - 79세,1998,154,68,86
'4376037000,  청안면,'85,80 - 84세,1998,71,32,39
'4376037000,  청안면,'90,85+ ,1998,60,15,45
'4376038500,  도안지소,'00,계,1998,3225,1667,1558
'4376038500,  도안지소,'05,0 - 4세,1998,155,81,74
'4376038500,  도안지소,'10,5 - 9세,1998,136,59,77
'4376038500,  도안지소,'15,10 - 14세,1998,185,92,93
'4376038500,  도안지소,'20,15 - 19세,1998,285,149,136
'4376038500,  도안지소,'25,20 - 24세,1998,317,194,123
'4376038500,  도안지소,'30,25 - 29세,1998,265,170,95
'4376038500,  도안지소,'35,30 - 34세,1998,211,126,85
'4376038500,  도안지소,'40,35 - 39세,1998,192,109,83
'4376038500,  도안지소,'45,40 - 44세,1998,213,111,102
'4376038500,  도안지소,'50,45 - 49세,1998,165,102,63
'4376038500,  도안지소,'55,50 - 54세,1998,160,89,71
'4376038500,  도안지소,'60,55 - 59세,1998,227,97,130
'4376038500,  도안지소,'65,60 - 64세,1998,268,125,143
'4376038500,  도안지소,'70,65 - 69세,1998,169,65,104
'4376038500,  도안지소,'75,70 - 74세,1998,115,47,68
'4376038500,  도안지소,'80,75 - 79세,1998,91,37,54
'4376038500,  도안지소,'85,80 - 84세,1998,51,10,41
'4376038500,  도안지소,'90,85+ ,1998,20,4,16
'4376039000,  사리면,'00,계,1998,3759,1925,1834
'4376039000,  사리면,'05,0 - 4세,1998,195,120,75
'4376039000,  사리면,'10,5 - 9세,1998,122,58,64
'4376039000,  사리면,'15,10 - 14세,1998,160,79,81
'4376039000,  사리면,'20,15 - 19세,1998,286,140,146
'4376039000,  사리면,'25,20 - 24세,1998,426,222,204
'4376039000,  사리면,'30,25 - 29세,1998,357,239,118
'4376039000,  사리면,'35,30 - 34세,1998,219,138,81
'4376039000,  사리면,'40,35 - 39세,1998,211,120,91
'4376039000,  사리면,'45,40 - 44세,1998,194,110,84
'4376039000,  사리면,'50,45 - 49세,1998,176,87,89
'4376039000,  사리면,'55,50 - 54세,1998,212,109,103
'4376039000,  사리면,'60,55 - 59세,1998,323,140,183
'4376039000,  사리면,'65,60 - 64세,1998,300,135,165
'4376039000,  사리면,'70,65 - 69세,1998,249,103,146
'4376039000,  사리면,'75,70 - 74세,1998,140,59,81
'4376039000,  사리면,'80,75 - 79세,1998,106,40,66
'4376039000,  사리면,'85,80 - 84세,1998,46,19,27
'4376039000,  사리면,'90,85+ ,1998,37,7,30
'4376040000,  소수면,'00,계,1998,2379,1195,1184
'4376040000,  소수면,'05,0 - 4세,1998,90,48,42
'4376040000,  소수면,'10,5 - 9세,1998,80,47,33
'4376040000,  소수면,'15,10 - 14세,1998,117,61,56
'4376040000,  소수면,'20,15 - 19세,1998,222,115,107
'4376040000,  소수면,'25,20 - 24세,1998,212,120,92
'4376040000,  소수면,'30,25 - 29세,1998,151,94,57
'4376040000,  소수면,'35,30 - 34세,1998,105,61,44
'4376040000,  소수면,'40,35 - 39세,1998,124,67,57
'4376040000,  소수면,'45,40 - 44세,1998,153,74,79
'4376040000,  소수면,'50,45 - 49세,1998,131,70,61
'4376040000,  소수면,'55,50 - 54세,1998,138,72,66
'4376040000,  소수면,'60,55 - 59세,1998,189,86,103
'4376040000,  소수면,'65,60 - 64세,1998,207,98,109
'4376040000,  소수면,'70,65 - 69세,1998,163,62,101
'4376040000,  소수면,'75,70 - 74세,1998,119,54,65
'4376040000,  소수면,'80,75 - 79세,1998,103,36,67
'4376040000,  소수면,'85,80 - 84세,1998,48,22,26
'4376040000,  소수면,'90,85+ ,1998,27,8,19
'4376041000,  불정면,'00,계,1998,3874,1933,1941
'4376041000,  불정면,'05,0 - 4세,1998,108,59,49
'4376041000,  불정면,'10,5 - 9세,1998,163,76,87
'4376041000,  불정면,'15,10 - 14세,1998,226,108,118
'4376041000,  불정면,'20,15 - 19세,1998,357,192,165
'4376041000,  불정면,'25,20 - 24세,1998,348,194,154
'4376041000,  불정면,'30,25 - 29세,1998,223,137,86
'4376041000,  불정면,'35,30 - 34세,1998,172,88,84
'4376041000,  불정면,'40,35 - 39세,1998,228,131,97
'4376041000,  불정면,'45,40 - 44세,1998,273,139,134
'4376041000,  불정면,'50,45 - 49세,1998,212,116,96
'4376041000,  불정면,'55,50 - 54세,1998,207,100,107
'4376041000,  불정면,'60,55 - 59세,1998,312,141,171
'4376041000,  불정면,'65,60 - 64세,1998,374,181,193
'4376041000,  불정면,'70,65 - 69세,1998,260,114,146
'4376041000,  불정면,'75,70 - 74세,1998,174,74,100
'4376041000,  불정면,'80,75 - 79세,1998,123,49,74
'4376041000,  불정면,'85,80 - 84세,1998,72,20,52
'4376041000,  불정면,'90,85+ ,1998,42,14,28
'43770, 음성군,'00,계,1998,87023,44611,42412
'43770, 음성군,'05,0 - 4세,1998,6606,3543,3063
'43770, 음성군,'10,5 - 9세,1998,6204,3281,2923
'43770, 음성군,'15,10 - 14세,1998,5539,2829,2710
'43770, 음성군,'20,15 - 19세,1998,6432,3171,3261
'43770, 음성군,'25,20 - 24세,1998,6841,3732,3109
'43770, 음성군,'30,25 - 29세,1998,7776,4253,3523
'43770, 음성군,'35,30 - 34세,1998,7825,4208,3617
'43770, 음성군,'40,35 - 39세,1998,7560,4217,3343
'43770, 음성군,'45,40 - 44세,1998,5792,3186,2606
'43770, 음성군,'50,45 - 49세,1998,4020,2118,1902
'43770, 음성군,'55,50 - 54세,1998,3736,1954,1782
'43770, 음성군,'60,55 - 59세,1998,4833,2336,2497
'43770, 음성군,'65,60 - 64세,1998,4740,2110,2630
'43770, 음성군,'70,65 - 69세,1998,3551,1469,2082
'43770, 음성군,'75,70 - 74세,1998,2431,1022,1409
'43770, 음성군,'80,75 - 79세,1998,1621,667,954
'43770, 음성군,'85,80 - 84세,1998,960,350,610
'43770, 음성군,'90,85+ ,1998,556,165,391
'4377025000,  음성읍,'00,계,1998,20163,10261,9902
'4377025000,  음성읍,'05,0 - 4세,1998,1590,891,699
'4377025000,  음성읍,'10,5 - 9세,1998,1557,820,737
'4377025000,  음성읍,'15,10 - 14세,1998,1380,739,641
'4377025000,  음성읍,'20,15 - 19세,1998,1603,794,809
'4377025000,  음성읍,'25,20 - 24세,1998,1593,839,754
'4377025000,  음성읍,'30,25 - 29세,1998,1818,938,880
'4377025000,  음성읍,'35,30 - 34세,1998,1851,954,897
'4377025000,  음성읍,'40,35 - 39세,1998,1816,998,818
'4377025000,  음성읍,'45,40 - 44세,1998,1384,739,645
'4377025000,  음성읍,'50,45 - 49세,1998,938,490,448
'4377025000,  음성읍,'55,50 - 54세,1998,862,440,422
'4377025000,  음성읍,'60,55 - 59세,1998,1014,496,518
'4377025000,  음성읍,'65,60 - 64세,1998,953,393,560
'4377025000,  음성읍,'70,65 - 69세,1998,699,281,418
'4377025000,  음성읍,'75,70 - 74세,1998,489,212,277
'4377025000,  음성읍,'80,75 - 79세,1998,307,124,183
'4377025000,  음성읍,'85,80 - 84세,1998,213,85,128
'4377025000,  음성읍,'90,85+ ,1998,96,28,68
'4377025300,  금왕읍,'00,계,1998,16194,8307,7887
'4377025300,  금왕읍,'05,0 - 4세,1998,1381,728,653
'4377025300,  금왕읍,'10,5 - 9세,1998,1285,696,589
'4377025300,  금왕읍,'15,10 - 14세,1998,1075,550,525
'4377025300,  금왕읍,'20,15 - 19세,1998,1196,590,606
'4377025300,  금왕읍,'25,20 - 24세,1998,1281,682,599
'4377025300,  금왕읍,'30,25 - 29세,1998,1501,792,709
'4377025300,  금왕읍,'35,30 - 34세,1998,1525,805,720
'4377025300,  금왕읍,'40,35 - 39세,1998,1516,838,678
'4377025300,  금왕읍,'45,40 - 44세,1998,1062,599,463
'4377025300,  금왕읍,'50,45 - 49세,1998,714,368,346
'4377025300,  금왕읍,'55,50 - 54세,1998,623,337,286
'4377025300,  금왕읍,'60,55 - 59세,1998,837,401,436
'4377025300,  금왕읍,'65,60 - 64세,1998,802,363,439
'4377025300,  금왕읍,'70,65 - 69세,1998,585,235,350
'4377025300,  금왕읍,'75,70 - 74세,1998,373,163,210
'4377025300,  금왕읍,'80,75 - 79세,1998,228,88,140
'4377025300,  금왕읍,'85,80 - 84세,1998,133,45,88
'4377025300,  금왕읍,'90,85+ ,1998,77,27,50
'4377031000,  소이면,'00,계,1998,5386,2790,2596
'4377031000,  소이면,'05,0 - 4세,1998,391,215,176
'4377031000,  소이면,'10,5 - 9세,1998,321,182,139
'4377031000,  소이면,'15,10 - 14세,1998,265,119,146
'4377031000,  소이면,'20,15 - 19세,1998,340,165,175
'4377031000,  소이면,'25,20 - 24세,1998,439,246,193
'4377031000,  소이면,'30,25 - 29세,1998,525,315,210
'4377031000,  소이면,'35,30 - 34세,1998,441,261,180
'4377031000,  소이면,'40,35 - 39세,1998,392,227,165
'4377031000,  소이면,'45,40 - 44세,1998,305,181,124
'4377031000,  소이면,'50,45 - 49세,1998,227,114,113
'4377031000,  소이면,'55,50 - 54세,1998,255,118,137
'4377031000,  소이면,'60,55 - 59세,1998,344,165,179
'4377031000,  소이면,'65,60 - 64세,1998,374,164,210
'4377031000,  소이면,'70,65 - 69세,1998,313,132,181
'4377031000,  소이면,'75,70 - 74세,1998,203,90,113
'4377031000,  소이면,'80,75 - 79세,1998,144,59,85
'4377031000,  소이면,'85,80 - 84세,1998,66,23,43
'4377031000,  소이면,'90,85+ ,1998,41,14,27
'4377032000,  원남면,'00,계,1998,4307,2193,2114
'4377032000,  원남면,'05,0 - 4세,1998,148,85,63
'4377032000,  원남면,'10,5 - 9세,1998,183,85,98
'4377032000,  원남면,'15,10 - 14세,1998,240,125,115
'4377032000,  원남면,'20,15 - 19세,1998,342,170,172
'4377032000,  원남면,'25,20 - 24세,1998,415,245,170
'4377032000,  원남면,'30,25 - 29세,1998,266,174,92
'4377032000,  원남면,'35,30 - 34세,1998,194,103,91
'4377032000,  원남면,'40,35 - 39세,1998,237,129,108
'4377032000,  원남면,'45,40 - 44세,1998,278,156,122
'4377032000,  원남면,'50,45 - 49세,1998,231,125,106
'4377032000,  원남면,'55,50 - 54세,1998,274,144,130
'4377032000,  원남면,'60,55 - 59세,1998,338,158,180
'4377032000,  원남면,'65,60 - 64세,1998,374,177,197
'4377032000,  원남면,'70,65 - 69세,1998,316,130,186
'4377032000,  원남면,'75,70 - 74세,1998,216,89,127
'4377032000,  원남면,'80,75 - 79세,1998,135,56,79
'4377032000,  원남면,'85,80 - 84세,1998,73,29,44
'4377032000,  원남면,'90,85+ ,1998,47,13,34
'4377033000,  맹동면,'00,계,1998,4544,2281,2263
'4377033000,  맹동면,'05,0 - 4세,1998,156,87,69
'4377033000,  맹동면,'10,5 - 9세,1998,206,97,109
'4377033000,  맹동면,'15,10 - 14세,1998,239,104,135
'4377033000,  맹동면,'20,15 - 19세,1998,282,130,152
'4377033000,  맹동면,'25,20 - 24세,1998,299,168,131
'4377033000,  맹동면,'30,25 - 29세,1998,351,194,157
'4377033000,  맹동면,'35,30 - 34세,1998,361,176,185
'4377033000,  맹동면,'40,35 - 39세,1998,395,208,187
'4377033000,  맹동면,'45,40 - 44세,1998,373,221,152
'4377033000,  맹동면,'50,45 - 49세,1998,266,151,115
'4377033000,  맹동면,'55,50 - 54세,1998,234,136,98
'4377033000,  맹동면,'60,55 - 59세,1998,310,162,148
'4377033000,  맹동면,'65,60 - 64세,1998,321,157,164
'4377033000,  맹동면,'70,65 - 69세,1998,239,110,129
'4377033000,  맹동면,'75,70 - 74세,1998,201,80,121
'4377033000,  맹동면,'80,75 - 79세,1998,134,47,87
'4377033000,  맹동면,'85,80 - 84세,1998,87,34,53
'4377033000,  맹동면,'90,85+ ,1998,90,19,71
'4377034000,  대소면,'00,계,1998,12301,6342,5959
'4377034000,  대소면,'05,0 - 4세,1998,1403,720,683
'4377034000,  대소면,'10,5 - 9세,1998,1060,541,519
'4377034000,  대소면,'15,10 - 14세,1998,662,337,325
'4377034000,  대소면,'20,15 - 19세,1998,681,336,345
'4377034000,  대소면,'25,20 - 24세,1998,925,469,456
'4377034000,  대소면,'30,25 - 29세,1998,1542,797,745
'4377034000,  대소면,'35,30 - 34세,1998,1541,875,666
'4377034000,  대소면,'40,35 - 39세,1998,1124,676,448
'4377034000,  대소면,'45,40 - 44세,1998,682,373,309
'4377034000,  대소면,'50,45 - 49세,1998,393,204,189
'4377034000,  대소면,'55,50 - 54세,1998,369,198,171
'4377034000,  대소면,'60,55 - 59세,1998,509,234,275
'4377034000,  대소면,'65,60 - 64세,1998,520,226,294
'4377034000,  대소면,'70,65 - 69세,1998,365,164,201
'4377034000,  대소면,'75,70 - 74세,1998,229,94,135
'4377034000,  대소면,'80,75 - 79세,1998,167,69,98
'4377034000,  대소면,'85,80 - 84세,1998,86,21,65
'4377034000,  대소면,'90,85+ ,1998,43,8,35
'4377035000,  삼성면,'00,계,1998,8052,4175,3877
'4377035000,  삼성면,'05,0 - 4세,1998,569,297,272
'4377035000,  삼성면,'10,5 - 9세,1998,574,286,288
'4377035000,  삼성면,'15,10 - 14세,1998,521,284,237
'4377035000,  삼성면,'20,15 - 19세,1998,614,306,308
'4377035000,  삼성면,'25,20 - 24세,1998,615,351,264
'4377035000,  삼성면,'30,25 - 29세,1998,619,368,251
'4377035000,  삼성면,'35,30 - 34세,1998,700,377,323
'4377035000,  삼성면,'40,35 - 39세,1998,716,403,313
'4377035000,  삼성면,'45,40 - 44세,1998,573,317,256
'4377035000,  삼성면,'50,45 - 49세,1998,402,225,177
'4377035000,  삼성면,'55,50 - 54세,1998,354,184,170
'4377035000,  삼성면,'60,55 - 59세,1998,482,228,254
'4377035000,  삼성면,'65,60 - 64세,1998,439,198,241
'4377035000,  삼성면,'70,65 - 69세,1998,371,150,221
'4377035000,  삼성면,'75,70 - 74세,1998,235,103,132
'4377035000,  삼성면,'80,75 - 79세,1998,139,55,84
'4377035000,  삼성면,'85,80 - 84세,1998,83,25,58
'4377035000,  삼성면,'90,85+ ,1998,46,18,28
'4377036000,  생극면,'00,계,1998,5627,2878,2749
'4377036000,  생극면,'05,0 - 4세,1998,320,160,160
'4377036000,  생극면,'10,5 - 9세,1998,319,186,133
'4377036000,  생극면,'15,10 - 14세,1998,403,195,208
'4377036000,  생극면,'20,15 - 19세,1998,462,218,244
'4377036000,  생극면,'25,20 - 24세,1998,438,252,186
'4377036000,  생극면,'30,25 - 29세,1998,410,237,173
'4377036000,  생극면,'35,30 - 34세,1998,370,216,154
'4377036000,  생극면,'40,35 - 39세,1998,428,232,196
'4377036000,  생극면,'45,40 - 44세,1998,381,202,179
'4377036000,  생극면,'50,45 - 49세,1998,292,153,139
'4377036000,  생극면,'55,50 - 54세,1998,281,143,138
'4377036000,  생극면,'60,55 - 59세,1998,387,190,197
'4377036000,  생극면,'65,60 - 64세,1998,387,178,209
'4377036000,  생극면,'70,65 - 69세,1998,271,117,154
'4377036000,  생극면,'75,70 - 74세,1998,179,71,108
'4377036000,  생극면,'80,75 - 79세,1998,144,71,73
'4377036000,  생극면,'85,80 - 84세,1998,99,39,60
'4377036000,  생극면,'90,85+ ,1998,56,18,38
'4377037000,  감곡면,'00,계,1998,10449,5384,5065
'4377037000,  감곡면,'05,0 - 4세,1998,648,360,288
'4377037000,  감곡면,'10,5 - 9세,1998,699,388,311
'4377037000,  감곡면,'15,10 - 14세,1998,754,376,378
'4377037000,  감곡면,'20,15 - 19세,1998,912,462,450
'4377037000,  감곡면,'25,20 - 24세,1998,836,480,356
'4377037000,  감곡면,'30,25 - 29세,1998,744,438,306
'4377037000,  감곡면,'35,30 - 34세,1998,842,441,401
'4377037000,  감곡면,'40,35 - 39세,1998,936,506,430
'4377037000,  감곡면,'45,40 - 44세,1998,754,398,356
'4377037000,  감곡면,'50,45 - 49세,1998,557,288,269
'4377037000,  감곡면,'55,50 - 54세,1998,484,254,230
'4377037000,  감곡면,'60,55 - 59세,1998,612,302,310
'4377037000,  감곡면,'65,60 - 64세,1998,570,254,316
'4377037000,  감곡면,'70,65 - 69세,1998,392,150,242
'4377037000,  감곡면,'75,70 - 74세,1998,306,120,186
'4377037000,  감곡면,'80,75 - 79세,1998,223,98,125
'4377037000,  감곡면,'85,80 - 84세,1998,120,49,71
'4377037000,  감곡면,'90,85+ ,1998,60,20,40
'43800, 단양군,'00,계,1998,42302,21453,20849
'43800, 단양군,'05,0 - 4세,1998,2475,1288,1187
'43800, 단양군,'10,5 - 9세,1998,2424,1335,1089
'43800, 단양군,'15,10 - 14세,1998,2632,1286,1346
'43800, 단양군,'20,15 - 19세,1998,3873,1964,1909
'43800, 단양군,'25,20 - 24세,1998,3803,2151,1652
'43800, 단양군,'30,25 - 29세,1998,3334,1915,1419
'43800, 단양군,'35,30 - 34세,1998,3086,1651,1435
'43800, 단양군,'40,35 - 39세,1998,3243,1702,1541
'43800, 단양군,'45,40 - 44세,1998,3026,1628,1398
'43800, 단양군,'50,45 - 49세,1998,2200,1119,1081
'43800, 단양군,'55,50 - 54세,1998,2155,1022,1133
'43800, 단양군,'60,55 - 59세,1998,2809,1320,1489
'43800, 단양군,'65,60 - 64세,1998,2492,1147,1345
'43800, 단양군,'70,65 - 69세,1998,1829,725,1104
'43800, 단양군,'75,70 - 74세,1998,1272,523,749
'43800, 단양군,'80,75 - 79세,1998,870,375,495
'43800, 단양군,'85,80 - 84세,1998,510,213,297
'43800, 단양군,'90,85+ ,1998,269,89,180
'4380025000,  단양읍,'00,계,1998,14446,7356,7090
'4380025000,  단양읍,'05,0 - 4세,1998,1098,573,525
'4380025000,  단양읍,'10,5 - 9세,1998,1040,584,456
'4380025000,  단양읍,'15,10 - 14세,1998,1063,521,542
'4380025000,  단양읍,'20,15 - 19세,1998,1329,696,633
'4380025000,  단양읍,'25,20 - 24세,1998,1105,611,494
'4380025000,  단양읍,'30,25 - 29세,1998,1268,657,611
'4380025000,  단양읍,'35,30 - 34세,1998,1319,660,659
'4380025000,  단양읍,'40,35 - 39세,1998,1393,731,662
'4380025000,  단양읍,'45,40 - 44세,1998,1183,615,568
'4380025000,  단양읍,'50,45 - 49세,1998,731,391,340
'4380025000,  단양읍,'55,50 - 54세,1998,650,317,333
'4380025000,  단양읍,'60,55 - 59세,1998,686,334,352
'4380025000,  단양읍,'65,60 - 64세,1998,567,264,303
'4380025000,  단양읍,'70,65 - 69세,1998,393,163,230
'4380025000,  단양읍,'75,70 - 74세,1998,265,107,158
'4380025000,  단양읍,'80,75 - 79세,1998,201,82,119
'4380025000,  단양읍,'85,80 - 84세,1998,96,35,61
'4380025000,  단양읍,'90,85+ ,1998,59,15,44
'4380025300,  매포읍,'00,계,1998,9739,4991,4748
'4380025300,  매포읍,'05,0 - 4세,1998,753,392,361
'4380025300,  매포읍,'10,5 - 9세,1998,643,362,281
'4380025300,  매포읍,'15,10 - 14세,1998,607,297,310
'4380025300,  매포읍,'20,15 - 19세,1998,890,437,453
'4380025300,  매포읍,'25,20 - 24세,1998,948,502,446
'4380025300,  매포읍,'30,25 - 29세,1998,922,518,404
'4380025300,  매포읍,'35,30 - 34세,1998,845,480,365
'4380025300,  매포읍,'40,35 - 39세,1998,758,386,372
'4380025300,  매포읍,'45,40 - 44세,1998,658,368,290
'4380025300,  매포읍,'50,45 - 49세,1998,542,272,270
'4380025300,  매포읍,'55,50 - 54세,1998,437,228,209
'4380025300,  매포읍,'60,55 - 59세,1998,552,242,310
'4380025300,  매포읍,'65,60 - 64세,1998,431,209,222
'4380025300,  매포읍,'70,65 - 69세,1998,302,109,193
'4380025300,  매포읍,'75,70 - 74세,1998,209,90,119
'4380025300,  매포읍,'80,75 - 79세,1998,130,60,70
'4380025300,  매포읍,'85,80 - 84세,1998,73,29,44
'4380025300,  매포읍,'90,85+ ,1998,39,10,29
'4380031000,  대강면,'00,계,1998,3491,1719,1772
'4380031000,  대강면,'05,0 - 4세,1998,144,67,77
'4380031000,  대강면,'10,5 - 9세,1998,156,85,71
'4380031000,  대강면,'15,10 - 14세,1998,198,91,107
'4380031000,  대강면,'20,15 - 19세,1998,324,155,169
'4380031000,  대강면,'25,20 - 24세,1998,301,180,121
'4380031000,  대강면,'30,25 - 29세,1998,199,122,77
'4380031000,  대강면,'35,30 - 34세,1998,196,103,93
'4380031000,  대강면,'40,35 - 39세,1998,229,125,104
'4380031000,  대강면,'45,40 - 44세,1998,244,127,117
'4380031000,  대강면,'50,45 - 49세,1998,171,91,80
'4380031000,  대강면,'55,50 - 54세,1998,204,87,117
'4380031000,  대강면,'60,55 - 59세,1998,295,128,167
'4380031000,  대강면,'65,60 - 64세,1998,264,130,134
'4380031000,  대강면,'70,65 - 69세,1998,220,86,134
'4380031000,  대강면,'75,70 - 74세,1998,154,64,90
'4380031000,  대강면,'80,75 - 79세,1998,86,41,45
'4380031000,  대강면,'85,80 - 84세,1998,70,29,41
'4380031000,  대강면,'90,85+ ,1998,36,8,28
'4380032000,  가곡면,'00,계,1998,2706,1397,1309
'4380032000,  가곡면,'05,0 - 4세,1998,82,41,41
'4380032000,  가곡면,'10,5 - 9세,1998,122,64,58
'4380032000,  가곡면,'15,10 - 14세,1998,140,62,78
'4380032000,  가곡면,'20,15 - 19세,1998,260,128,132
'4380032000,  가곡면,'25,20 - 24세,1998,287,174,113
'4380032000,  가곡면,'30,25 - 29세,1998,185,132,53
'4380032000,  가곡면,'35,30 - 34세,1998,145,78,67
'4380032000,  가곡면,'40,35 - 39세,1998,133,75,58
'4380032000,  가곡면,'45,40 - 44세,1998,184,102,82
'4380032000,  가곡면,'50,45 - 49세,1998,146,78,68
'4380032000,  가곡면,'55,50 - 54세,1998,154,75,79
'4380032000,  가곡면,'60,55 - 59세,1998,254,131,123
'4380032000,  가곡면,'65,60 - 64세,1998,227,97,130
'4380032000,  가곡면,'70,65 - 69세,1998,125,48,77
'4380032000,  가곡면,'75,70 - 74세,1998,116,43,73
'4380032000,  가곡면,'80,75 - 79세,1998,74,33,41
'4380032000,  가곡면,'85,80 - 84세,1998,49,25,24
'4380032000,  가곡면,'90,85+ ,1998,23,11,12
'4380033000,  영춘면,'00,계,1998,4775,2373,2402
'4380033000,  영춘면,'05,0 - 4세,1998,167,88,79
'4380033000,  영춘면,'10,5 - 9세,1998,217,121,96
'4380033000,  영춘면,'15,10 - 14세,1998,273,146,127
'4380033000,  영춘면,'20,15 - 19세,1998,427,209,218
'4380033000,  영춘면,'25,20 - 24세,1998,459,259,200
'4380033000,  영춘면,'30,25 - 29세,1998,299,189,110
'4380033000,  영춘면,'35,30 - 34세,1998,259,129,130
'4380033000,  영춘면,'40,35 - 39세,1998,359,187,172
'4380033000,  영춘면,'45,40 - 44세,1998,334,171,163
'4380033000,  영춘면,'50,45 - 49세,1998,249,108,141
'4380033000,  영춘면,'55,50 - 54세,1998,270,128,142
'4380033000,  영춘면,'60,55 - 59세,1998,387,189,198
'4380033000,  영춘면,'65,60 - 64세,1998,349,168,181
'4380033000,  영춘면,'70,65 - 69세,1998,271,103,168
'4380033000,  영춘면,'75,70 - 74세,1998,186,80,106
'4380033000,  영춘면,'80,75 - 79세,1998,121,41,80
'4380033000,  영춘면,'85,80 - 84세,1998,90,31,59
'4380033000,  영춘면,'90,85+ ,1998,58,26,32
'4380034000,  어상천면,'00,계,1998,2480,1245,1235
'4380034000,  어상천면,'05,0 - 4세,1998,60,36,24
'4380034000,  어상천면,'10,5 - 9세,1998,72,34,38
'4380034000,  어상천면,'15,10 - 14세,1998,114,58,56
'4380034000,  어상천면,'20,15 - 19세,1998,223,108,115
'4380034000,  어상천면,'25,20 - 24세,1998,244,155,89
'4380034000,  어상천면,'30,25 - 29세,1998,167,113,54
'4380034000,  어상천면,'35,30 - 34세,1998,89,54,35
'4380034000,  어상천면,'40,35 - 39세,1998,129,65,64
'4380034000,  어상천면,'45,40 - 44세,1998,162,100,62
'4380034000,  어상천면,'50,45 - 49세,1998,116,57,59
'4380034000,  어상천면,'55,50 - 54세,1998,140,58,82
'4380034000,  어상천면,'60,55 - 59세,1998,227,103,124
'4380034000,  어상천면,'65,60 - 64세,1998,248,105,143
'4380034000,  어상천면,'70,65 - 69세,1998,185,70,115
'4380034000,  어상천면,'75,70 - 74세,1998,134,54,80
'4380034000,  어상천면,'80,75 - 79세,1998,110,49,61
'4380034000,  어상천면,'85,80 - 84세,1998,45,21,24
'4380034000,  어상천면,'90,85+ ,1998,15,5,10
'4380035000,  적성면,'00,계,1998,2004,1017,987
'4380035000,  적성면,'05,0 - 4세,1998,56,30,26
'4380035000,  적성면,'10,5 - 9세,1998,69,35,34
'4380035000,  적성면,'15,10 - 14세,1998,97,45,52
'4380035000,  적성면,'20,15 - 19세,1998,184,103,81
'4380035000,  적성면,'25,20 - 24세,1998,211,122,89
'4380035000,  적성면,'30,25 - 29세,1998,120,78,42
'4380035000,  적성면,'35,30 - 34세,1998,84,51,33
'4380035000,  적성면,'40,35 - 39세,1998,91,48,43
'4380035000,  적성면,'45,40 - 44세,1998,91,48,43
'4380035000,  적성면,'50,45 - 49세,1998,100,46,54
'4380035000,  적성면,'55,50 - 54세,1998,134,66,68
'4380035000,  적성면,'60,55 - 59세,1998,182,80,102
'4380035000,  적성면,'65,60 - 64세,1998,198,88,110
'4380035000,  적성면,'70,65 - 69세,1998,168,74,94
'4380035000,  적성면,'75,70 - 74세,1998,91,45,46
'4380035000,  적성면,'80,75 - 79세,1998,70,35,35
'4380035000,  적성면,'85,80 - 84세,1998,41,18,23
'4380035000,  적성면,'90,85+ ,1998,17,5,12
'4380036000,  단성면,'00,계,1998,2661,1355,1306
'4380036000,  단성면,'05,0 - 4세,1998,115,61,54
'4380036000,  단성면,'10,5 - 9세,1998,105,50,55
'4380036000,  단성면,'15,10 - 14세,1998,140,66,74
'4380036000,  단성면,'20,15 - 19세,1998,236,128,108
'4380036000,  단성면,'25,20 - 24세,1998,248,148,100
'4380036000,  단성면,'30,25 - 29세,1998,174,106,68
'4380036000,  단성면,'35,30 - 34세,1998,149,96,53
'4380036000,  단성면,'40,35 - 39세,1998,151,85,66
'4380036000,  단성면,'45,40 - 44세,1998,170,97,73
'4380036000,  단성면,'50,45 - 49세,1998,145,76,69
'4380036000,  단성면,'55,50 - 54세,1998,166,63,103
'4380036000,  단성면,'60,55 - 59세,1998,226,113,113
'4380036000,  단성면,'65,60 - 64세,1998,208,86,122
'4380036000,  단성면,'70,65 - 69세,1998,165,72,93
'4380036000,  단성면,'75,70 - 74세,1998,117,40,77
'4380036000,  단성면,'80,75 - 79세,1998,78,34,44
'4380036000,  단성면,'85,80 - 84세,1998,46,25,21
'4380036000,  단성면,'90,85+ ,1998,22,9,13
'43950, 증평출장소,'00,계,1998,32962,16675,16287
'43950, 증평출장소,'05,0 - 4세,1998,2656,1382,1274
'43950, 증평출장소,'10,5 - 9세,1998,2580,1352,1228
'43950, 증평출장소,'15,10 - 14세,1998,2274,1174,1100
'43950, 증평출장소,'20,15 - 19세,1998,2768,1434,1334
'43950, 증평출장소,'25,20 - 24세,1998,2811,1532,1279
'43950, 증평출장소,'30,25 - 29세,1998,3145,1647,1498
'43950, 증평출장소,'35,30 - 34세,1998,3083,1629,1454
'43950, 증평출장소,'40,35 - 39세,1998,2825,1530,1295
'43950, 증평출장소,'45,40 - 44세,1998,2292,1184,1108
'43950, 증평출장소,'50,45 - 49세,1998,1518,784,734
'43950, 증평출장소,'55,50 - 54세,1998,1322,680,642
'43950, 증평출장소,'60,55 - 59세,1998,1568,717,851
'43950, 증평출장소,'65,60 - 64세,1998,1491,649,842
'43950, 증평출장소,'70,65 - 69세,1998,1043,424,619
'43950, 증평출장소,'75,70 - 74세,1998,690,255,435
'43950, 증평출장소,'80,75 - 79세,1998,482,186,296
'43950, 증평출장소,'85,80 - 84세,1998,277,83,194
'43950, 증평출장소,'90,85+ ,1998,137,33,104
'44,충청남도,'00,계,1998,1913428,962117,951311
'44,충청남도,'05,0 - 4세,1998,127576,67142,60434
'44,충청남도,'10,5 - 9세,1998,127623,67279,60344
'44,충청남도,'15,10 - 14세,1998,126614,65104,61510
'44,충청남도,'20,15 - 19세,1998,171153,86441,84712
'44,충청남도,'25,20 - 24세,1998,169344,91917,77427
'44,충청남도,'30,25 - 29세,1998,162767,89208,73559
'44,충청남도,'35,30 - 34세,1998,148834,77847,70987
'44,충청남도,'40,35 - 39세,1998,157460,82478,74982
'44,충청남도,'45,40 - 44세,1998,132608,69160,63448
'44,충청남도,'50,45 - 49세,1998,99928,50773,49155
'44,충청남도,'55,50 - 54세,1998,87814,43582,44232
'44,충청남도,'60,55 - 59세,1998,103153,47400,55753
'44,충청남도,'65,60 - 64세,1998,102941,46633,56308
'44,충청남도,'70,65 - 69세,1998,76518,32712,43806
'44,충청남도,'75,70 - 74세,1998,52288,21510,30778
'44,충청남도,'80,75 - 79세,1998,35770,13659,22111
'44,충청남도,'85,80 - 84세,1998,19200,6432,12768
'44,충청남도,'90,85+ ,1998,11837,2840,8997
'44130, 천안시,'00,계,1998,383990,193747,190243
'44130, 천안시,'05,0 - 4세,1998,34189,18055,16134
'44130, 천안시,'10,5 - 9세,1998,33125,17409,15716
'44130, 천안시,'15,10 - 14세,1998,27766,14355,13411
'44130, 천안시,'20,15 - 19세,1998,30119,15171,14948
'44130, 천안시,'25,20 - 24세,1998,30360,15231,15129
'44130, 천안시,'30,25 - 29세,1998,39650,19875,19775
'44130, 천안시,'35,30 - 34세,1998,40101,20203,19898
'44130, 천안시,'40,35 - 39세,1998,40014,21241,18773
'44130, 천안시,'45,40 - 44세,1998,28608,15279,13329
'44130, 천안시,'50,45 - 49세,1998,17679,9276,8403
'44130, 천안시,'55,50 - 54세,1998,13891,7023,6868
'44130, 천안시,'60,55 - 59세,1998,13557,6465,7092
'44130, 천안시,'65,60 - 64세,1998,12118,5439,6679
'44130, 천안시,'70,65 - 69세,1998,8990,3683,5307
'44130, 천안시,'75,70 - 74세,1998,6077,2377,3700
'44130, 천안시,'80,75 - 79세,1998,4252,1583,2669
'44130, 천안시,'85,80 - 84세,1998,2242,775,1467
'44130, 천안시,'90,85+ ,1998,1252,307,945
'4413025000,  성환읍,'00,계,1998,26850,13592,13258
'4413025000,  성환읍,'05,0 - 4세,1998,1815,962,853
'4413025000,  성환읍,'10,5 - 9세,1998,1745,893,852
'4413025000,  성환읍,'15,10 - 14세,1998,1700,858,842
'4413025000,  성환읍,'20,15 - 19세,1998,2333,1153,1180
'4413025000,  성환읍,'25,20 - 24세,1998,2497,1329,1168
'4413025000,  성환읍,'30,25 - 29세,1998,2660,1417,1243
'4413025000,  성환읍,'35,30 - 34세,1998,2161,1191,970
'4413025000,  성환읍,'40,35 - 39세,1998,2237,1202,1035
'4413025000,  성환읍,'45,40 - 44세,1998,1944,1016,928
'4413025000,  성환읍,'50,45 - 49세,1998,1415,714,701
'4413025000,  성환읍,'55,50 - 54세,1998,1336,671,665
'4413025000,  성환읍,'60,55 - 59세,1998,1466,687,779
'4413025000,  성환읍,'65,60 - 64세,1998,1330,609,721
'4413025000,  성환읍,'70,65 - 69세,1998,889,414,475
'4413025000,  성환읍,'75,70 - 74세,1998,583,227,356
'4413025000,  성환읍,'80,75 - 79세,1998,408,151,257
'4413025000,  성환읍,'85,80 - 84세,1998,216,69,147
'4413025000,  성환읍,'90,85+ ,1998,115,29,86
'4413025300,  성거읍,'00,계,1998,14075,7172,6903
'4413025300,  성거읍,'05,0 - 4세,1998,1404,736,668
'4413025300,  성거읍,'10,5 - 9세,1998,1028,553,475
'4413025300,  성거읍,'15,10 - 14세,1998,820,399,421
'4413025300,  성거읍,'20,15 - 19세,1998,976,486,490
'4413025300,  성거읍,'25,20 - 24세,1998,1284,578,706
'4413025300,  성거읍,'30,25 - 29세,1998,1961,1047,914
'4413025300,  성거읍,'35,30 - 34세,1998,1568,856,712
'4413025300,  성거읍,'40,35 - 39세,1998,1230,688,542
'4413025300,  성거읍,'45,40 - 44세,1998,845,457,388
'4413025300,  성거읍,'50,45 - 49세,1998,574,278,296
'4413025300,  성거읍,'55,50 - 54세,1998,501,253,248
'4413025300,  성거읍,'60,55 - 59세,1998,524,253,271
'4413025300,  성거읍,'65,60 - 64세,1998,491,232,259
'4413025300,  성거읍,'70,65 - 69세,1998,377,160,217
'4413025300,  성거읍,'75,70 - 74세,1998,210,84,126
'4413025300,  성거읍,'80,75 - 79세,1998,155,70,85
'4413025300,  성거읍,'85,80 - 84세,1998,83,27,56
'4413025300,  성거읍,'90,85+ ,1998,44,15,29
'4413031000,  풍세면,'00,계,1998,5767,2975,2792
'4413031000,  풍세면,'05,0 - 4세,1998,320,175,145
'4413031000,  풍세면,'10,5 - 9세,1998,307,160,147
'4413031000,  풍세면,'15,10 - 14세,1998,387,203,184
'4413031000,  풍세면,'20,15 - 19세,1998,550,291,259
'4413031000,  풍세면,'25,20 - 24세,1998,471,243,228
'4413031000,  풍세면,'30,25 - 29세,1998,466,287,179
'4413031000,  풍세면,'35,30 - 34세,1998,415,239,176
'4413031000,  풍세면,'40,35 - 39세,1998,488,260,228
'4413031000,  풍세면,'45,40 - 44세,1998,395,224,171
'4413031000,  풍세면,'50,45 - 49세,1998,298,159,139
'4413031000,  풍세면,'55,50 - 54세,1998,267,150,117
'4413031000,  풍세면,'60,55 - 59세,1998,320,169,151
'4413031000,  풍세면,'65,60 - 64세,1998,337,140,197
'4413031000,  풍세면,'70,65 - 69세,1998,291,107,184
'4413031000,  풍세면,'75,70 - 74세,1998,198,74,124
'4413031000,  풍세면,'80,75 - 79세,1998,140,56,84
'4413031000,  풍세면,'85,80 - 84세,1998,70,26,44
'4413031000,  풍세면,'90,85+ ,1998,47,12,35
'4413032000,  광덕면,'00,계,1998,4752,2365,2387
'4413032000,  광덕면,'05,0 - 4세,1998,230,127,103
'4413032000,  광덕면,'10,5 - 9세,1998,254,130,124
'4413032000,  광덕면,'15,10 - 14세,1998,288,130,158
'4413032000,  광덕면,'20,15 - 19세,1998,400,198,202
'4413032000,  광덕면,'25,20 - 24세,1998,442,241,201
'4413032000,  광덕면,'30,25 - 29세,1998,340,209,131
'4413032000,  광덕면,'35,30 - 34세,1998,282,148,134
'4413032000,  광덕면,'40,35 - 39세,1998,370,201,169
'4413032000,  광덕면,'45,40 - 44세,1998,294,164,130
'4413032000,  광덕면,'50,45 - 49세,1998,230,124,106
'4413032000,  광덕면,'55,50 - 54세,1998,228,119,109
'4413032000,  광덕면,'60,55 - 59세,1998,297,129,168
'4413032000,  광덕면,'65,60 - 64세,1998,313,135,178
'4413032000,  광덕면,'70,65 - 69세,1998,302,116,186
'4413032000,  광덕면,'75,70 - 74세,1998,207,89,118
'4413032000,  광덕면,'80,75 - 79세,1998,149,58,91
'4413032000,  광덕면,'85,80 - 84세,1998,82,35,47
'4413032000,  광덕면,'90,85+ ,1998,44,12,32
'4413033000,  목천면,'00,계,1998,12611,6515,6096
'4413033000,  목천면,'05,0 - 4세,1998,1411,752,659
'4413033000,  목천면,'10,5 - 9세,1998,838,442,396
'4413033000,  목천면,'15,10 - 14세,1998,641,347,294
'4413033000,  목천면,'20,15 - 19세,1998,796,416,380
'4413033000,  목천면,'25,20 - 24세,1998,900,457,443
'4413033000,  목천면,'30,25 - 29세,1998,1801,913,888
'4413033000,  목천면,'35,30 - 34세,1998,1523,881,642
'4413033000,  목천면,'40,35 - 39세,1998,1098,605,493
'4413033000,  목천면,'45,40 - 44세,1998,762,423,339
'4413033000,  목천면,'50,45 - 49세,1998,452,243,209
'4413033000,  목천면,'55,50 - 54세,1998,401,196,205
'4413033000,  목천면,'60,55 - 59세,1998,476,220,256
'4413033000,  목천면,'65,60 - 64세,1998,509,222,287
'4413033000,  목천면,'70,65 - 69세,1998,407,174,233
'4413033000,  목천면,'75,70 - 74세,1998,296,119,177
'4413033000,  목천면,'80,75 - 79세,1998,194,71,123
'4413033000,  목천면,'85,80 - 84세,1998,62,30,32
'4413033000,  목천면,'90,85+ ,1998,44,4,40
'4413034000,  북면,'00,계,1998,5306,2689,2617
'4413034000,  북면,'05,0 - 4세,1998,469,261,208
'4413034000,  북면,'10,5 - 9세,1998,299,146,153
'4413034000,  북면,'15,10 - 14세,1998,276,132,144
'4413034000,  북면,'20,15 - 19세,1998,354,186,168
'4413034000,  북면,'25,20 - 24세,1998,452,245,207
'4413034000,  북면,'30,25 - 29세,1998,575,292,283
'4413034000,  북면,'35,30 - 34세,1998,537,297,240
'4413034000,  북면,'40,35 - 39세,1998,423,251,172
'4413034000,  북면,'45,40 - 44세,1998,304,154,150
'4413034000,  북면,'50,45 - 49세,1998,234,118,116
'4413034000,  북면,'55,50 - 54세,1998,212,113,99
'4413034000,  북면,'60,55 - 59세,1998,242,104,138
'4413034000,  북면,'65,60 - 64세,1998,306,144,162
'4413034000,  북면,'70,65 - 69세,1998,255,88,167
'4413034000,  북면,'75,70 - 74세,1998,156,69,87
'4413034000,  북면,'80,75 - 79세,1998,120,53,67
'4413034000,  북면,'85,80 - 84세,1998,59,24,35
'4413034000,  북면,'90,85+ ,1998,33,12,21
'4413035000,  성남면,'00,계,1998,4859,2475,2384
'4413035000,  성남면,'05,0 - 4세,1998,312,155,157
'4413035000,  성남면,'10,5 - 9세,1998,239,117,122
'4413035000,  성남면,'15,10 - 14세,1998,232,116,116
'4413035000,  성남면,'20,15 - 19세,1998,382,197,185
'4413035000,  성남면,'25,20 - 24세,1998,442,239,203
'4413035000,  성남면,'30,25 - 29세,1998,454,259,195
'4413035000,  성남면,'35,30 - 34세,1998,358,220,138
'4413035000,  성남면,'40,35 - 39세,1998,335,189,146
'4413035000,  성남면,'45,40 - 44세,1998,316,177,139
'4413035000,  성남면,'50,45 - 49세,1998,264,132,132
'4413035000,  성남면,'55,50 - 54세,1998,232,121,111
'4413035000,  성남면,'60,55 - 59세,1998,301,139,162
'4413035000,  성남면,'65,60 - 64세,1998,285,119,166
'4413035000,  성남면,'70,65 - 69세,1998,286,122,164
'4413035000,  성남면,'75,70 - 74세,1998,182,80,102
'4413035000,  성남면,'80,75 - 79세,1998,127,54,73
'4413035000,  성남면,'85,80 - 84세,1998,72,27,45
'4413035000,  성남면,'90,85+ ,1998,40,12,28
'4413036000,  수신면,'00,계,1998,3350,1711,1639
'4413036000,  수신면,'05,0 - 4세,1998,133,71,62
'4413036000,  수신면,'10,5 - 9세,1998,151,81,70
'4413036000,  수신면,'15,10 - 14세,1998,181,88,93
'4413036000,  수신면,'20,15 - 19세,1998,290,143,147
'4413036000,  수신면,'25,20 - 24세,1998,328,188,140
'4413036000,  수신면,'30,25 - 29세,1998,252,168,84
'4413036000,  수신면,'35,30 - 34세,1998,199,115,84
'4413036000,  수신면,'40,35 - 39세,1998,213,119,94
'4413036000,  수신면,'45,40 - 44세,1998,238,119,119
'4413036000,  수신면,'50,45 - 49세,1998,178,97,81
'4413036000,  수신면,'55,50 - 54세,1998,168,75,93
'4413036000,  수신면,'60,55 - 59세,1998,240,107,133
'4413036000,  수신면,'65,60 - 64세,1998,279,138,141
'4413036000,  수신면,'70,65 - 69세,1998,207,78,129
'4413036000,  수신면,'75,70 - 74세,1998,119,59,60
'4413036000,  수신면,'80,75 - 79세,1998,97,40,57
'4413036000,  수신면,'85,80 - 84세,1998,54,21,33
'4413036000,  수신면,'90,85+ ,1998,23,4,19
'4413037000,  병천면,'00,계,1998,6625,3345,3280
'4413037000,  병천면,'05,0 - 4세,1998,489,265,224
'4413037000,  병천면,'10,5 - 9세,1998,432,229,203
'4413037000,  병천면,'15,10 - 14세,1998,362,185,177
'4413037000,  병천면,'20,15 - 19세,1998,551,275,276
'4413037000,  병천면,'25,20 - 24세,1998,569,311,258
'4413037000,  병천면,'30,25 - 29세,1998,602,334,268
'4413037000,  병천면,'35,30 - 34세,1998,556,309,247
'4413037000,  병천면,'40,35 - 39세,1998,510,279,231
'4413037000,  병천면,'45,40 - 44세,1998,434,221,213
'4413037000,  병천면,'50,45 - 49세,1998,308,173,135
'4413037000,  병천면,'55,50 - 54세,1998,289,133,156
'4413037000,  병천면,'60,55 - 59세,1998,332,153,179
'4413037000,  병천면,'65,60 - 64세,1998,388,175,213
'4413037000,  병천면,'70,65 - 69세,1998,303,119,184
'4413037000,  병천면,'75,70 - 74세,1998,216,87,129
'4413037000,  병천면,'80,75 - 79세,1998,147,48,99
'4413037000,  병천면,'85,80 - 84세,1998,82,34,48
'4413037000,  병천면,'90,85+ ,1998,55,15,40
'4413038000,  동면,'00,계,1998,3235,1665,1570
'4413038000,  동면,'05,0 - 4세,1998,115,55,60
'4413038000,  동면,'10,5 - 9세,1998,141,73,68
'4413038000,  동면,'15,10 - 14세,1998,152,81,71
'4413038000,  동면,'20,15 - 19세,1998,238,125,113
'4413038000,  동면,'25,20 - 24세,1998,321,202,119
'4413038000,  동면,'30,25 - 29세,1998,218,140,78
'4413038000,  동면,'35,30 - 34세,1998,183,104,79
'4413038000,  동면,'40,35 - 39세,1998,201,117,84
'4413038000,  동면,'45,40 - 44세,1998,176,84,92
'4413038000,  동면,'50,45 - 49세,1998,170,86,84
'4413038000,  동면,'55,50 - 54세,1998,181,97,84
'4413038000,  동면,'60,55 - 59세,1998,247,103,144
'4413038000,  동면,'65,60 - 64세,1998,303,136,167
'4413038000,  동면,'70,65 - 69세,1998,220,105,115
'4413038000,  동면,'75,70 - 74세,1998,150,71,79
'4413038000,  동면,'80,75 - 79세,1998,110,44,66
'4413038000,  동면,'85,80 - 84세,1998,69,30,39
'4413038000,  동면,'90,85+ ,1998,40,12,28
'4413039000,  직산면,'00,계,1998,21480,11140,10340
'4413039000,  직산면,'05,0 - 4세,1998,2713,1392,1321
'4413039000,  직산면,'10,5 - 9세,1998,1787,943,844
'4413039000,  직산면,'15,10 - 14세,1998,1241,625,616
'4413039000,  직산면,'20,15 - 19세,1998,1277,655,622
'4413039000,  직산면,'25,20 - 24세,1998,1574,787,787
'4413039000,  직산면,'30,25 - 29세,1998,3092,1591,1501
'4413039000,  직산면,'35,30 - 34세,1998,2795,1521,1274
'4413039000,  직산면,'40,35 - 39세,1998,2055,1210,845
'4413039000,  직산면,'45,40 - 44세,1998,1224,689,535
'4413039000,  직산면,'50,45 - 49세,1998,710,397,313
'4413039000,  직산면,'55,50 - 54세,1998,618,290,328
'4413039000,  직산면,'60,55 - 59세,1998,692,333,359
'4413039000,  직산면,'65,60 - 64세,1998,610,261,349
'4413039000,  직산면,'70,65 - 69세,1998,450,203,247
'4413039000,  직산면,'75,70 - 74세,1998,290,113,177
'4413039000,  직산면,'80,75 - 79세,1998,208,85,123
'4413039000,  직산면,'85,80 - 84세,1998,99,31,68
'4413039000,  직산면,'90,85+ ,1998,45,14,31
'4413040000,  입장면,'00,계,1998,11628,5940,5688
'4413040000,  입장면,'05,0 - 4세,1998,892,474,418
'4413040000,  입장면,'10,5 - 9세,1998,865,451,414
'4413040000,  입장면,'15,10 - 14세,1998,754,393,361
'4413040000,  입장면,'20,15 - 19세,1998,919,455,464
'4413040000,  입장면,'25,20 - 24세,1998,981,541,440
'4413040000,  입장면,'30,25 - 29세,1998,1109,617,492
'4413040000,  입장면,'35,30 - 34세,1998,1038,566,472
'4413040000,  입장면,'40,35 - 39세,1998,1036,563,473
'4413040000,  입장면,'45,40 - 44세,1998,743,411,332
'4413040000,  입장면,'50,45 - 49세,1998,566,283,283
'4413040000,  입장면,'55,50 - 54세,1998,498,245,253
'4413040000,  입장면,'60,55 - 59세,1998,614,275,339
'4413040000,  입장면,'65,60 - 64세,1998,567,262,305
'4413040000,  입장면,'70,65 - 69세,1998,403,175,228
'4413040000,  입장면,'75,70 - 74세,1998,304,119,185
'4413040000,  입장면,'80,75 - 79세,1998,191,71,120
'4413040000,  입장면,'85,80 - 84세,1998,81,26,55
'4413040000,  입장면,'90,85+ ,1998,67,13,54
'4413051000,  대룡동,'00,계,1998,2904,1426,1478
'4413051000,  대룡동,'05,0 - 4세,1998,137,75,62
'4413051000,  대룡동,'10,5 - 9세,1998,180,93,87
'4413051000,  대룡동,'15,10 - 14세,1998,225,106,119
'4413051000,  대룡동,'20,15 - 19세,1998,261,137,124
'4413051000,  대룡동,'25,20 - 24세,1998,255,123,132
'4413051000,  대룡동,'30,25 - 29세,1998,249,143,106
'4413051000,  대룡동,'35,30 - 34세,1998,205,100,105
'4413051000,  대룡동,'40,35 - 39세,1998,270,131,139
'4413051000,  대룡동,'45,40 - 44세,1998,242,110,132
'4413051000,  대룡동,'50,45 - 49세,1998,213,103,110
'4413051000,  대룡동,'55,50 - 54세,1998,159,77,82
'4413051000,  대룡동,'60,55 - 59세,1998,156,72,84
'4413051000,  대룡동,'65,60 - 64세,1998,118,56,62
'4413051000,  대룡동,'70,65 - 69세,1998,103,42,61
'4413051000,  대룡동,'75,70 - 74세,1998,50,25,25
'4413051000,  대룡동,'80,75 - 79세,1998,41,20,21
'4413051000,  대룡동,'85,80 - 84세,1998,27,9,18
'4413051000,  대룡동,'90,85+ ,1998,13,4,9
'4413052000,  문성동,'00,계,1998,7184,3606,3578
'4413052000,  문성동,'05,0 - 4세,1998,381,200,181
'4413052000,  문성동,'10,5 - 9세,1998,428,231,197
'4413052000,  문성동,'15,10 - 14세,1998,410,223,187
'4413052000,  문성동,'20,15 - 19세,1998,663,355,308
'4413052000,  문성동,'25,20 - 24세,1998,820,417,403
'4413052000,  문성동,'30,25 - 29세,1998,747,405,342
'4413052000,  문성동,'35,30 - 34세,1998,484,250,234
'4413052000,  문성동,'40,35 - 39세,1998,563,282,281
'4413052000,  문성동,'45,40 - 44세,1998,509,255,254
'4413052000,  문성동,'50,45 - 49세,1998,442,203,239
'4413052000,  문성동,'55,50 - 54세,1998,423,196,227
'4413052000,  문성동,'60,55 - 59세,1998,410,190,220
'4413052000,  문성동,'65,60 - 64세,1998,356,167,189
'4413052000,  문성동,'70,65 - 69세,1998,195,94,101
'4413052000,  문성동,'75,70 - 74세,1998,168,81,87
'4413052000,  문성동,'80,75 - 79세,1998,92,29,63
'4413052000,  문성동,'85,80 - 84세,1998,58,19,39
'4413052000,  문성동,'90,85+ ,1998,35,9,26
'4413053000,  남산동,'00,계,1998,6638,3288,3350
'4413053000,  남산동,'05,0 - 4세,1998,320,156,164
'4413053000,  남산동,'10,5 - 9세,1998,465,254,211
'4413053000,  남산동,'15,10 - 14세,1998,496,243,253
'4413053000,  남산동,'20,15 - 19세,1998,615,306,309
'4413053000,  남산동,'25,20 - 24세,1998,656,360,296
'4413053000,  남산동,'30,25 - 29세,1998,554,285,269
'4413053000,  남산동,'35,30 - 34세,1998,436,221,215
'4413053000,  남산동,'40,35 - 39세,1998,579,291,288
'4413053000,  남산동,'45,40 - 44세,1998,512,247,265
'4413053000,  남산동,'50,45 - 49세,1998,416,205,211
'4413053000,  남산동,'55,50 - 54세,1998,364,181,183
'4413053000,  남산동,'60,55 - 59세,1998,387,173,214
'4413053000,  남산동,'65,60 - 64세,1998,304,139,165
'4413053000,  남산동,'70,65 - 69세,1998,209,94,115
'4413053000,  남산동,'75,70 - 74세,1998,136,51,85
'4413053000,  남산동,'80,75 - 79세,1998,102,43,59
'4413053000,  남산동,'85,80 - 84세,1998,66,30,36
'4413053000,  남산동,'90,85+ ,1998,21,9,12
'4413054000,  원성1동,'00,계,1998,12245,6224,6021
'4413054000,  원성1동,'05,0 - 4세,1998,789,421,368
'4413054000,  원성1동,'10,5 - 9세,1998,815,414,401
'4413054000,  원성1동,'15,10 - 14세,1998,812,431,381
'4413054000,  원성1동,'20,15 - 19세,1998,1212,637,575
'4413054000,  원성1동,'25,20 - 24세,1998,1238,662,576
'4413054000,  원성1동,'30,25 - 29세,1998,1232,697,535
'4413054000,  원성1동,'35,30 - 34세,1998,968,488,480
'4413054000,  원성1동,'40,35 - 39세,1998,1065,542,523
'4413054000,  원성1동,'45,40 - 44세,1998,957,447,510
'4413054000,  원성1동,'50,45 - 49세,1998,769,381,388
'4413054000,  원성1동,'55,50 - 54세,1998,612,314,298
'4413054000,  원성1동,'60,55 - 59세,1998,519,267,252
'4413054000,  원성1동,'65,60 - 64세,1998,477,220,257
'4413054000,  원성1동,'70,65 - 69세,1998,288,137,151
'4413054000,  원성1동,'75,70 - 74세,1998,204,76,128
'4413054000,  원성1동,'80,75 - 79세,1998,149,52,97
'4413054000,  원성1동,'85,80 - 84세,1998,84,26,58
'4413054000,  원성1동,'90,85+ ,1998,55,12,43
'4413055000,  원성2동,'00,계,1998,15126,7444,7682
'4413055000,  원성2동,'05,0 - 4세,1998,1067,567,500
'4413055000,  원성2동,'10,5 - 9세,1998,1033,540,493
'4413055000,  원성2동,'15,10 - 14세,1998,1046,546,500
'4413055000,  원성2동,'20,15 - 19세,1998,1396,662,734
'4413055000,  원성2동,'25,20 - 24세,1998,1520,732,788
'4413055000,  원성2동,'30,25 - 29세,1998,1617,797,820
'4413055000,  원성2동,'35,30 - 34세,1998,1284,664,620
'4413055000,  원성2동,'40,35 - 39세,1998,1280,637,643
'4413055000,  원성2동,'45,40 - 44세,1998,1127,545,582
'4413055000,  원성2동,'50,45 - 49세,1998,908,450,458
'4413055000,  원성2동,'55,50 - 54세,1998,739,369,370
'4413055000,  원성2동,'60,55 - 59세,1998,685,327,358
'4413055000,  원성2동,'65,60 - 64세,1998,538,264,274
'4413055000,  원성2동,'70,65 - 69세,1998,329,148,181
'4413055000,  원성2동,'75,70 - 74세,1998,221,88,133
'4413055000,  원성2동,'80,75 - 79세,1998,187,63,124
'4413055000,  원성2동,'85,80 - 84세,1998,83,30,53
'4413055000,  원성2동,'90,85+ ,1998,66,15,51
'4413056100,  성정1동,'00,계,1998,20055,10097,9958
'4413056100,  성정1동,'05,0 - 4세,1998,1670,848,822
'4413056100,  성정1동,'10,5 - 9세,1998,1687,886,801
'4413056100,  성정1동,'15,10 - 14세,1998,1566,845,721
'4413056100,  성정1동,'20,15 - 19세,1998,1696,839,857
'4413056100,  성정1동,'25,20 - 24세,1998,1820,887,933
'4413056100,  성정1동,'30,25 - 29세,1998,2105,1097,1008
'4413056100,  성정1동,'35,30 - 34세,1998,2037,1010,1027
'4413056100,  성정1동,'40,35 - 39세,1998,2085,1079,1006
'4413056100,  성정1동,'45,40 - 44세,1998,1556,797,759
'4413056100,  성정1동,'50,45 - 49세,1998,969,504,465
'4413056100,  성정1동,'55,50 - 54세,1998,759,376,383
'4413056100,  성정1동,'60,55 - 59세,1998,685,364,321
'4413056100,  성정1동,'65,60 - 64세,1998,511,227,284
'4413056100,  성정1동,'70,65 - 69세,1998,359,141,218
'4413056100,  성정1동,'75,70 - 74세,1998,233,99,134
'4413056100,  성정1동,'80,75 - 79세,1998,169,59,110
'4413056100,  성정1동,'85,80 - 84세,1998,101,29,72
'4413056100,  성정1동,'90,85+ ,1998,47,10,37
'4413056200,  성정2동,'00,계,1998,20469,10267,10202
'4413056200,  성정2동,'05,0 - 4세,1998,1729,916,813
'4413056200,  성정2동,'10,5 - 9세,1998,2088,1089,999
'4413056200,  성정2동,'15,10 - 14세,1998,1841,982,859
'4413056200,  성정2동,'20,15 - 19세,1998,1779,915,864
'4413056200,  성정2동,'25,20 - 24세,1998,1658,801,857
'4413056200,  성정2동,'30,25 - 29세,1998,1900,950,950
'4413056200,  성정2동,'35,30 - 34세,1998,2025,943,1082
'4413056200,  성정2동,'40,35 - 39세,1998,2413,1190,1223
'4413056200,  성정2동,'45,40 - 44세,1998,1816,975,841
'4413056200,  성정2동,'50,45 - 49세,1998,1011,521,490
'4413056200,  성정2동,'55,50 - 54세,1998,678,356,322
'4413056200,  성정2동,'60,55 - 59세,1998,514,247,267
'4413056200,  성정2동,'65,60 - 64세,1998,324,142,182
'4413056200,  성정2동,'70,65 - 69세,1998,263,92,171
'4413056200,  성정2동,'75,70 - 74세,1998,198,73,125
'4413056200,  성정2동,'80,75 - 79세,1998,130,44,86
'4413056200,  성정2동,'85,80 - 84세,1998,70,24,46
'4413056200,  성정2동,'90,85+ ,1998,32,7,25
'4413057500,  봉명동,'00,계,1998,18898,9408,9490
'4413057500,  봉명동,'05,0 - 4세,1998,1494,818,676
'4413057500,  봉명동,'10,5 - 9세,1998,1648,874,774
'4413057500,  봉명동,'15,10 - 14세,1998,1484,761,723
'4413057500,  봉명동,'20,15 - 19세,1998,1676,859,817
'4413057500,  봉명동,'25,20 - 24세,1998,1712,838,874
'4413057500,  봉명동,'30,25 - 29세,1998,1948,952,996
'4413057500,  봉명동,'35,30 - 34세,1998,1824,865,959
'4413057500,  봉명동,'40,35 - 39세,1998,1977,999,978
'4413057500,  봉명동,'45,40 - 44세,1998,1580,826,754
'4413057500,  봉명동,'50,45 - 49세,1998,958,470,488
'4413057500,  봉명동,'55,50 - 54세,1998,687,347,340
'4413057500,  봉명동,'60,55 - 59세,1998,606,300,306
'4413057500,  봉명동,'65,60 - 64세,1998,458,192,266
'4413057500,  봉명동,'70,65 - 69세,1998,345,125,220
'4413057500,  봉명동,'75,70 - 74세,1998,236,86,150
'4413057500,  봉명동,'80,75 - 79세,1998,148,54,94
'4413057500,  봉명동,'85,80 - 84세,1998,77,26,51
'4413057500,  봉명동,'90,85+ ,1998,40,16,24
'4413057800,  쌍용1동,'00,계,1998,17547,8689,8858
'4413057800,  쌍용1동,'05,0 - 4세,1998,1365,737,628
'4413057800,  쌍용1동,'10,5 - 9세,1998,2053,1074,979
'4413057800,  쌍용1동,'15,10 - 14세,1998,1904,978,926
'4413057800,  쌍용1동,'20,15 - 19세,1998,1560,769,791
'4413057800,  쌍용1동,'25,20 - 24세,1998,959,464,495
'4413057800,  쌍용1동,'30,25 - 29세,1998,1064,488,576
'4413057800,  쌍용1동,'35,30 - 34세,1998,1684,674,1010
'4413057800,  쌍용1동,'40,35 - 39세,1998,2517,1197,1320
'4413057800,  쌍용1동,'45,40 - 44세,1998,1886,1060,826
'4413057800,  쌍용1동,'50,45 - 49세,1998,850,496,354
'4413057800,  쌍용1동,'55,50 - 54세,1998,467,250,217
'4413057800,  쌍용1동,'60,55 - 59세,1998,328,158,170
'4413057800,  쌍용1동,'65,60 - 64세,1998,297,128,169
'4413057800,  쌍용1동,'70,65 - 69세,1998,231,89,142
'4413057800,  쌍용1동,'75,70 - 74세,1998,178,66,112
'4413057800,  쌍용1동,'80,75 - 79세,1998,117,38,79
'4413057800,  쌍용1동,'85,80 - 84세,1998,56,16,40
'4413057800,  쌍용1동,'90,85+ ,1998,31,7,24
'4413057900,  쌍용2동,'00,계,1998,39125,19586,19539
'4413057900,  쌍용2동,'05,0 - 4세,1998,4007,2099,1908
'4413057900,  쌍용2동,'10,5 - 9세,1998,4834,2563,2271
'4413057900,  쌍용2동,'15,10 - 14세,1998,3671,1881,1790
'4413057900,  쌍용2동,'20,15 - 19세,1998,2815,1423,1392
'4413057900,  쌍용2동,'25,20 - 24세,1998,1942,919,1023
'4413057900,  쌍용2동,'30,25 - 29세,1998,3236,1431,1805
'4413057900,  쌍용2동,'35,30 - 34세,1998,4938,2220,2718
'4413057900,  쌍용2동,'40,35 - 39세,1998,5519,2961,2558
'4413057900,  쌍용2동,'45,40 - 44세,1998,3214,1754,1460
'4413057900,  쌍용2동,'50,45 - 49세,1998,1436,850,586
'4413057900,  쌍용2동,'55,50 - 54세,1998,856,453,403
'4413057900,  쌍용2동,'60,55 - 59세,1998,668,322,346
'4413057900,  쌍용2동,'65,60 - 64세,1998,616,239,377
'4413057900,  쌍용2동,'70,65 - 69세,1998,547,192,355
'4413057900,  쌍용2동,'75,70 - 74세,1998,366,134,232
'4413057900,  쌍용2동,'80,75 - 79세,1998,249,90,159
'4413057900,  쌍용2동,'85,80 - 84세,1998,133,41,92
'4413057900,  쌍용2동,'90,85+ ,1998,78,14,64
'4413058500,  신용동,'00,계,1998,35917,18162,17755
'4413058500,  신용동,'05,0 - 4세,1998,4425,2376,2049
'4413058500,  신용동,'10,5 - 9세,1998,3881,2088,1793
'4413058500,  신용동,'15,10 - 14세,1998,2592,1353,1239
'4413058500,  신용동,'20,15 - 19세,1998,2079,1037,1042
'4413058500,  신용동,'25,20 - 24세,1998,2190,1024,1166
'4413058500,  신용동,'30,25 - 29세,1998,4175,1813,2362
'4413058500,  신용동,'35,30 - 34세,1998,5013,2521,2492
'4413058500,  신용동,'40,35 - 39세,1998,4225,2323,1902
'4413058500,  신용동,'45,40 - 44세,1998,2336,1367,969
'4413058500,  신용동,'50,45 - 49세,1998,1239,666,573
'4413058500,  신용동,'55,50 - 54세,1998,949,457,492
'4413058500,  신용동,'60,55 - 59세,1998,839,387,452
'4413058500,  신용동,'65,60 - 64세,1998,684,310,374
'4413058500,  신용동,'70,65 - 69세,1998,525,203,322
'4413058500,  신용동,'75,70 - 74세,1998,345,114,231
'4413058500,  신용동,'80,75 - 79세,1998,231,77,154
'4413058500,  신용동,'85,80 - 84세,1998,128,37,91
'4413058500,  신용동,'90,85+ ,1998,61,9,52
'4413059000,  청룡동,'00,계,1998,20169,10100,10069
'4413059000,  청룡동,'05,0 - 4세,1998,1449,733,716
'4413059000,  청룡동,'10,5 - 9세,1998,1592,816,776
'4413059000,  청룡동,'15,10 - 14세,1998,1555,841,714
'4413059000,  청룡동,'20,15 - 19세,1998,2036,1010,1026
'4413059000,  청룡동,'25,20 - 24세,1998,1694,883,811
'4413059000,  청룡동,'30,25 - 29세,1998,1727,888,839
'4413059000,  청룡동,'35,30 - 34세,1998,1698,835,863
'4413059000,  청룡동,'40,35 - 39세,1998,2026,1011,1015
'4413059000,  청룡동,'45,40 - 44세,1998,1769,896,873
'4413059000,  청룡동,'50,45 - 49세,1998,1173,630,543
'4413059000,  청룡동,'55,50 - 54세,1998,861,464,397
'4413059000,  청룡동,'60,55 - 59세,1998,750,369,381
'4413059000,  청룡동,'65,60 - 64세,1998,655,302,353
'4413059000,  청룡동,'70,65 - 69세,1998,468,181,287
'4413059000,  청룡동,'75,70 - 74세,1998,309,122,187
'4413059000,  청룡동,'80,75 - 79세,1998,214,69,145
'4413059000,  청룡동,'85,80 - 84세,1998,122,36,86
'4413059000,  청룡동,'90,85+ ,1998,71,14,57
'4413060000,  신안동,'00,계,1998,26491,13283,13208
'4413060000,  신안동,'05,0 - 4세,1998,2225,1205,1020
'4413060000,  신안동,'10,5 - 9세,1998,2436,1316,1120
'4413060000,  신안동,'15,10 - 14세,1998,1824,959,865
'4413060000,  신안동,'20,15 - 19세,1998,2072,1051,1021
'4413060000,  신안동,'25,20 - 24세,1998,2432,1131,1301
'4413060000,  신안동,'30,25 - 29세,1998,3033,1515,1518
'4413060000,  신안동,'35,30 - 34세,1998,2883,1381,1502
'4413060000,  신안동,'40,35 - 39세,1998,2881,1506,1375
'4413060000,  신안동,'45,40 - 44세,1998,2076,1075,1001
'4413060000,  신안동,'50,45 - 49세,1998,1229,621,608
'4413060000,  신안동,'55,50 - 54세,1998,898,464,434
'4413060000,  신안동,'60,55 - 59세,1998,794,387,407
'4413060000,  신안동,'65,60 - 64세,1998,630,299,331
'4413060000,  신안동,'70,65 - 69세,1998,387,143,244
'4413060000,  신안동,'75,70 - 74세,1998,290,90,200
'4413060000,  신안동,'80,75 - 79세,1998,215,80,135
'4413060000,  신안동,'85,80 - 84세,1998,119,44,75
'4413060000,  신안동,'90,85+ ,1998,67,16,51
'4413061000,  부성동,'00,계,1998,20684,10583,10101
'4413061000,  부성동,'05,0 - 4세,1998,2828,1479,1349
'4413061000,  부성동,'10,5 - 9세,1998,1899,953,946
'4413061000,  부성동,'15,10 - 14세,1998,1306,649,657
'4413061000,  부성동,'20,15 - 19세,1998,1193,591,602
'4413061000,  부성동,'25,20 - 24세,1998,1203,629,574
'4413061000,  부성동,'30,25 - 29세,1998,2533,1140,1393
'4413061000,  부성동,'35,30 - 34세,1998,3007,1584,1423
'4413061000,  부성동,'40,35 - 39세,1998,2418,1408,1010
'4413061000,  부성동,'45,40 - 44세,1998,1353,786,567
'4413061000,  부성동,'50,45 - 49세,1998,667,372,295
'4413061000,  부성동,'55,50 - 54세,1998,508,256,252
'4413061000,  부성동,'60,55 - 59세,1998,465,230,235
'4413061000,  부성동,'65,60 - 64세,1998,432,181,251
'4413061000,  부성동,'70,65 - 69세,1998,351,141,210
'4413061000,  부성동,'75,70 - 74세,1998,232,81,151
'4413061000,  부성동,'80,75 - 79세,1998,162,64,98
'4413061000,  부성동,'85,80 - 84세,1998,89,28,61
'4413061000,  부성동,'90,85+ ,1998,38,11,27
'44150, 공주시,'00,계,1998,136988,68733,68255
'44150, 공주시,'05,0 - 4세,1998,7863,4147,3716
'44150, 공주시,'10,5 - 9세,1998,8476,4553,3923
'44150, 공주시,'15,10 - 14세,1998,9461,4935,4526
'44150, 공주시,'20,15 - 19세,1998,13390,6800,6590
'44150, 공주시,'25,20 - 24세,1998,12920,7063,5857
'44150, 공주시,'30,25 - 29세,1998,10468,5812,4656
'44150, 공주시,'35,30 - 34세,1998,9147,4711,4436
'44150, 공주시,'40,35 - 39세,1998,10665,5537,5128
'44150, 공주시,'45,40 - 44세,1998,9749,5042,4707
'44150, 공주시,'50,45 - 49세,1998,7367,3773,3594
'44150, 공주시,'55,50 - 54세,1998,6310,3083,3227
'44150, 공주시,'60,55 - 59세,1998,7878,3552,4326
'44150, 공주시,'65,60 - 64세,1998,7660,3446,4214
'44150, 공주시,'70,65 - 69세,1998,6052,2579,3473
'44150, 공주시,'75,70 - 74세,1998,3899,1623,2276
'44150, 공주시,'80,75 - 79세,1998,3001,1162,1839
'44150, 공주시,'85,80 - 84세,1998,1651,618,1033
'44150, 공주시,'90,85+ ,1998,1031,297,734
'4415025000,  유구읍,'00,계,1998,13078,6632,6446
'4415025000,  유구읍,'05,0 - 4세,1998,585,329,256
'4415025000,  유구읍,'10,5 - 9세,1998,767,429,338
'4415025000,  유구읍,'15,10 - 14세,1998,1075,602,473
'4415025000,  유구읍,'20,15 - 19세,1998,1479,756,723
'4415025000,  유구읍,'25,20 - 24세,1998,1198,692,506
'4415025000,  유구읍,'30,25 - 29세,1998,869,497,372
'4415025000,  유구읍,'35,30 - 34세,1998,753,352,401
'4415025000,  유구읍,'40,35 - 39세,1998,1050,520,530
'4415025000,  유구읍,'45,40 - 44세,1998,918,468,450
'4415025000,  유구읍,'50,45 - 49세,1998,756,403,353
'4415025000,  유구읍,'55,50 - 54세,1998,591,283,308
'4415025000,  유구읍,'60,55 - 59세,1998,787,356,431
'4415025000,  유구읍,'65,60 - 64세,1998,760,338,422
'4415025000,  유구읍,'70,65 - 69세,1998,589,259,330
'4415025000,  유구읍,'75,70 - 74세,1998,377,153,224
'4415025000,  유구읍,'80,75 - 79세,1998,265,108,157
'4415025000,  유구읍,'85,80 - 84세,1998,156,59,97
'4415025000,  유구읍,'90,85+ ,1998,103,28,75
'4415031000,  이인면,'00,계,1998,5415,2708,2707
'4415031000,  이인면,'05,0 - 4세,1998,208,103,105
'4415031000,  이인면,'10,5 - 9세,1998,244,137,107
'4415031000,  이인면,'15,10 - 14세,1998,343,168,175
'4415031000,  이인면,'20,15 - 19세,1998,595,301,294
'4415031000,  이인면,'25,20 - 24세,1998,545,311,234
'4415031000,  이인면,'30,25 - 29세,1998,318,201,117
'4415031000,  이인면,'35,30 - 34세,1998,245,143,102
'4415031000,  이인면,'40,35 - 39세,1998,332,179,153
'4415031000,  이인면,'45,40 - 44세,1998,342,187,155
'4415031000,  이인면,'50,45 - 49세,1998,298,146,152
'4415031000,  이인면,'55,50 - 54세,1998,277,144,133
'4415031000,  이인면,'60,55 - 59세,1998,373,154,219
'4415031000,  이인면,'65,60 - 64세,1998,393,176,217
'4415031000,  이인면,'70,65 - 69세,1998,363,144,219
'4415031000,  이인면,'75,70 - 74세,1998,228,99,129
'4415031000,  이인면,'80,75 - 79세,1998,149,54,95
'4415031000,  이인면,'85,80 - 84세,1998,108,47,61
'4415031000,  이인면,'90,85+ ,1998,54,14,40
'4415032000,  탄천면,'00,계,1998,4911,2486,2425
'4415032000,  탄천면,'05,0 - 4세,1998,147,73,74
'4415032000,  탄천면,'10,5 - 9세,1998,194,99,95
'4415032000,  탄천면,'15,10 - 14세,1998,271,147,124
'4415032000,  탄천면,'20,15 - 19세,1998,472,252,220
'4415032000,  탄천면,'25,20 - 24세,1998,435,258,177
'4415032000,  탄천면,'30,25 - 29세,1998,261,177,84
'4415032000,  탄천면,'35,30 - 34세,1998,204,116,88
'4415032000,  탄천면,'40,35 - 39세,1998,281,155,126
'4415032000,  탄천면,'45,40 - 44세,1998,283,149,134
'4415032000,  탄천면,'50,45 - 49세,1998,278,143,135
'4415032000,  탄천면,'55,50 - 54세,1998,256,122,134
'4415032000,  탄천면,'60,55 - 59세,1998,400,178,222
'4415032000,  탄천면,'65,60 - 64세,1998,459,214,245
'4415032000,  탄천면,'70,65 - 69세,1998,377,169,208
'4415032000,  탄천면,'75,70 - 74세,1998,240,103,137
'4415032000,  탄천면,'80,75 - 79세,1998,180,69,111
'4415032000,  탄천면,'85,80 - 84세,1998,106,41,65
'4415032000,  탄천면,'90,85+ ,1998,67,21,46
'4415033000,  계룡면,'00,계,1998,8376,4254,4122
'4415033000,  계룡면,'05,0 - 4세,1998,321,166,155
'4415033000,  계룡면,'10,5 - 9세,1998,348,175,173
'4415033000,  계룡면,'15,10 - 14세,1998,473,249,224
'4415033000,  계룡면,'20,15 - 19세,1998,846,437,409
'4415033000,  계룡면,'25,20 - 24세,1998,800,494,306
'4415033000,  계룡면,'30,25 - 29세,1998,578,359,219
'4415033000,  계룡면,'35,30 - 34세,1998,410,253,157
'4415033000,  계룡면,'40,35 - 39세,1998,476,252,224
'4415033000,  계룡면,'45,40 - 44세,1998,549,280,269
'4415033000,  계룡면,'50,45 - 49세,1998,494,254,240
'4415033000,  계룡면,'55,50 - 54세,1998,424,205,219
'4415033000,  계룡면,'60,55 - 59세,1998,639,274,365
'4415033000,  계룡면,'65,60 - 64세,1998,652,293,359
'4415033000,  계룡면,'70,65 - 69세,1998,519,236,283
'4415033000,  계룡면,'75,70 - 74세,1998,342,144,198
'4415033000,  계룡면,'80,75 - 79세,1998,269,98,171
'4415033000,  계룡면,'85,80 - 84세,1998,152,58,94
'4415033000,  계룡면,'90,85+ ,1998,84,27,57
'4415034000,  반포면,'00,계,1998,5816,3016,2800
'4415034000,  반포면,'05,0 - 4세,1998,310,161,149
'4415034000,  반포면,'10,5 - 9세,1998,305,171,134
'4415034000,  반포면,'15,10 - 14세,1998,300,165,135
'4415034000,  반포면,'20,15 - 19세,1998,420,235,185
'4415034000,  반포면,'25,20 - 24세,1998,508,286,222
'4415034000,  반포면,'30,25 - 29세,1998,469,264,205
'4415034000,  반포면,'35,30 - 34세,1998,434,256,178
'4415034000,  반포면,'40,35 - 39세,1998,465,264,201
'4415034000,  반포면,'45,40 - 44세,1998,386,219,167
'4415034000,  반포면,'50,45 - 49세,1998,320,160,160
'4415034000,  반포면,'55,50 - 54세,1998,303,149,154
'4415034000,  반포면,'60,55 - 59세,1998,420,175,245
'4415034000,  반포면,'65,60 - 64세,1998,412,197,215
'4415034000,  반포면,'70,65 - 69세,1998,311,131,180
'4415034000,  반포면,'75,70 - 74세,1998,186,80,106
'4415034000,  반포면,'80,75 - 79세,1998,153,61,92
'4415034000,  반포면,'85,80 - 84세,1998,78,31,47
'4415034000,  반포면,'90,85+ ,1998,36,11,25
'4415035000,  장기면,'00,계,1998,6446,3340,3106
'4415035000,  장기면,'05,0 - 4세,1998,327,196,131
'4415035000,  장기면,'10,5 - 9세,1998,279,156,123
'4415035000,  장기면,'15,10 - 14세,1998,388,209,179
'4415035000,  장기면,'20,15 - 19세,1998,617,314,303
'4415035000,  장기면,'25,20 - 24세,1998,652,366,286
'4415035000,  장기면,'30,25 - 29세,1998,534,332,202
'4415035000,  장기면,'35,30 - 34세,1998,398,214,184
'4415035000,  장기면,'40,35 - 39세,1998,412,229,183
'4415035000,  장기면,'45,40 - 44세,1998,437,237,200
'4415035000,  장기면,'50,45 - 49세,1998,350,168,182
'4415035000,  장기면,'55,50 - 54세,1998,313,146,167
'4415035000,  장기면,'60,55 - 59세,1998,410,191,219
'4415035000,  장기면,'65,60 - 64세,1998,478,215,263
'4415035000,  장기면,'70,65 - 69세,1998,331,157,174
'4415035000,  장기면,'75,70 - 74세,1998,199,88,111
'4415035000,  장기면,'80,75 - 79세,1998,169,67,102
'4415035000,  장기면,'85,80 - 84세,1998,86,36,50
'4415035000,  장기면,'90,85+ ,1998,66,19,47
'4415036000,  의당면,'00,계,1998,6388,3247,3141
'4415036000,  의당면,'05,0 - 4세,1998,453,237,216
'4415036000,  의당면,'10,5 - 9세,1998,280,160,120
'4415036000,  의당면,'15,10 - 14세,1998,356,180,176
'4415036000,  의당면,'20,15 - 19세,1998,535,254,281
'4415036000,  의당면,'25,20 - 24세,1998,688,355,333
'4415036000,  의당면,'30,25 - 29세,1998,693,384,309
'4415036000,  의당면,'35,30 - 34세,1998,435,274,161
'4415036000,  의당면,'40,35 - 39세,1998,414,239,175
'4415036000,  의당면,'45,40 - 44세,1998,341,181,160
'4415036000,  의당면,'50,45 - 49세,1998,307,157,150
'4415036000,  의당면,'55,50 - 54세,1998,256,126,130
'4415036000,  의당면,'60,55 - 59세,1998,367,164,203
'4415036000,  의당면,'65,60 - 64세,1998,400,180,220
'4415036000,  의당면,'70,65 - 69세,1998,326,133,193
'4415036000,  의당면,'75,70 - 74세,1998,197,82,115
'4415036000,  의당면,'80,75 - 79세,1998,186,88,98
'4415036000,  의당면,'85,80 - 84세,1998,105,34,71
'4415036000,  의당면,'90,85+ ,1998,49,19,30
'4415037000,  정안면,'00,계,1998,7049,3542,3507
'4415037000,  정안면,'05,0 - 4세,1998,267,143,124
'4415037000,  정안면,'10,5 - 9세,1998,329,168,161
'4415037000,  정안면,'15,10 - 14세,1998,415,187,228
'4415037000,  정안면,'20,15 - 19세,1998,613,331,282
'4415037000,  정안면,'25,20 - 24세,1998,641,369,272
'4415037000,  정안면,'30,25 - 29세,1998,457,290,167
'4415037000,  정안면,'35,30 - 34세,1998,333,184,149
'4415037000,  정안면,'40,35 - 39세,1998,450,237,213
'4415037000,  정안면,'45,40 - 44세,1998,481,263,218
'4415037000,  정안면,'50,45 - 49세,1998,374,193,181
'4415037000,  정안면,'55,50 - 54세,1998,363,182,181
'4415037000,  정안면,'60,55 - 59세,1998,494,210,284
'4415037000,  정안면,'65,60 - 64세,1998,569,257,312
'4415037000,  정안면,'70,65 - 69세,1998,498,219,279
'4415037000,  정안면,'75,70 - 74세,1998,321,136,185
'4415037000,  정안면,'80,75 - 79세,1998,236,95,141
'4415037000,  정안면,'85,80 - 84세,1998,125,55,70
'4415037000,  정안면,'90,85+ ,1998,83,23,60
'4415038000,  우성면,'00,계,1998,8070,4165,3905
'4415038000,  우성면,'05,0 - 4세,1998,351,200,151
'4415038000,  우성면,'10,5 - 9세,1998,365,189,176
'4415038000,  우성면,'15,10 - 14세,1998,480,261,219
'4415038000,  우성면,'20,15 - 19세,1998,783,423,360
'4415038000,  우성면,'25,20 - 24세,1998,860,491,369
'4415038000,  우성면,'30,25 - 29세,1998,586,365,221
'4415038000,  우성면,'35,30 - 34세,1998,402,232,170
'4415038000,  우성면,'40,35 - 39세,1998,527,290,237
'4415038000,  우성면,'45,40 - 44세,1998,501,272,229
'4415038000,  우성면,'50,45 - 49세,1998,418,220,198
'4415038000,  우성면,'55,50 - 54세,1998,382,178,204
'4415038000,  우성면,'60,55 - 59세,1998,581,251,330
'4415038000,  우성면,'65,60 - 64세,1998,619,276,343
'4415038000,  우성면,'70,65 - 69세,1998,479,209,270
'4415038000,  우성면,'75,70 - 74세,1998,299,140,159
'4415038000,  우성면,'80,75 - 79세,1998,248,109,139
'4415038000,  우성면,'85,80 - 84세,1998,114,43,71
'4415038000,  우성면,'90,85+ ,1998,75,16,59
'4415039000,  사곡면,'00,계,1998,4643,2345,2298
'4415039000,  사곡면,'05,0 - 4세,1998,162,82,80
'4415039000,  사곡면,'10,5 - 9세,1998,192,96,96
'4415039000,  사곡면,'15,10 - 14세,1998,234,132,102
'4415039000,  사곡면,'20,15 - 19세,1998,434,220,214
'4415039000,  사곡면,'25,20 - 24세,1998,489,278,211
'4415039000,  사곡면,'30,25 - 29세,1998,301,206,95
'4415039000,  사곡면,'35,30 - 34세,1998,211,101,110
'4415039000,  사곡면,'40,35 - 39세,1998,275,168,107
'4415039000,  사곡면,'45,40 - 44세,1998,249,127,122
'4415039000,  사곡면,'50,45 - 49세,1998,248,125,123
'4415039000,  사곡면,'55,50 - 54세,1998,255,107,148
'4415039000,  사곡면,'60,55 - 59세,1998,387,182,205
'4415039000,  사곡면,'65,60 - 64세,1998,434,189,245
'4415039000,  사곡면,'70,65 - 69세,1998,293,137,156
'4415039000,  사곡면,'75,70 - 74세,1998,211,92,119
'4415039000,  사곡면,'80,75 - 79세,1998,133,57,76
'4415039000,  사곡면,'85,80 - 84세,1998,81,27,54
'4415039000,  사곡면,'90,85+ ,1998,54,19,35
'4415040000,  신풍면,'00,계,1998,4572,2237,2335
'4415040000,  신풍면,'05,0 - 4세,1998,144,61,83
'4415040000,  신풍면,'10,5 - 9세,1998,170,93,77
'4415040000,  신풍면,'15,10 - 14세,1998,228,99,129
'4415040000,  신풍면,'20,15 - 19세,1998,455,236,219
'4415040000,  신풍면,'25,20 - 24세,1998,478,289,189
'4415040000,  신풍면,'30,25 - 29세,1998,258,150,108
'4415040000,  신풍면,'35,30 - 34세,1998,197,102,95
'4415040000,  신풍면,'40,35 - 39세,1998,271,143,128
'4415040000,  신풍면,'45,40 - 44세,1998,293,151,142
'4415040000,  신풍면,'50,45 - 49세,1998,259,122,137
'4415040000,  신풍면,'55,50 - 54세,1998,239,120,119
'4415040000,  신풍면,'60,55 - 59세,1998,353,166,187
'4415040000,  신풍면,'65,60 - 64세,1998,359,145,214
'4415040000,  신풍면,'70,65 - 69세,1998,351,150,201
'4415040000,  신풍면,'75,70 - 74세,1998,235,105,130
'4415040000,  신풍면,'80,75 - 79세,1998,165,68,97
'4415040000,  신풍면,'85,80 - 84세,1998,69,24,45
'4415040000,  신풍면,'90,85+ ,1998,48,13,35
'4415051000,  중학동,'00,계,1998,9838,4796,5042
'4415051000,  중학동,'05,0 - 4세,1998,502,249,253
'4415051000,  중학동,'10,5 - 9세,1998,587,314,273
'4415051000,  중학동,'15,10 - 14세,1998,701,359,342
'4415051000,  중학동,'20,15 - 19세,1998,1118,571,547
'4415051000,  중학동,'25,20 - 24세,1998,1098,555,543
'4415051000,  중학동,'30,25 - 29세,1998,811,452,359
'4415051000,  중학동,'35,30 - 34세,1998,607,301,306
'4415051000,  중학동,'40,35 - 39세,1998,666,311,355
'4415051000,  중학동,'45,40 - 44세,1998,774,356,418
'4415051000,  중학동,'50,45 - 49세,1998,601,302,299
'4415051000,  중학동,'55,50 - 54세,1998,524,234,290
'4415051000,  중학동,'60,55 - 59세,1998,555,263,292
'4415051000,  중학동,'65,60 - 64세,1998,431,204,227
'4415051000,  중학동,'70,65 - 69세,1998,324,134,190
'4415051000,  중학동,'75,70 - 74세,1998,234,90,144
'4415051000,  중학동,'80,75 - 79세,1998,160,54,106
'4415051000,  중학동,'85,80 - 84세,1998,89,34,55
'4415051000,  중학동,'90,85+ ,1998,56,13,43
'4415053000,  산성동,'00,계,1998,5104,2544,2560
'4415053000,  산성동,'05,0 - 4세,1998,264,146,118
'4415053000,  산성동,'10,5 - 9세,1998,294,161,133
'4415053000,  산성동,'15,10 - 14세,1998,385,208,177
'4415053000,  산성동,'20,15 - 19세,1998,559,288,271
'4415053000,  산성동,'25,20 - 24세,1998,570,298,272
'4415053000,  산성동,'30,25 - 29세,1998,412,234,178
'4415053000,  산성동,'35,30 - 34세,1998,307,154,153
'4415053000,  산성동,'40,35 - 39세,1998,397,198,199
'4415053000,  산성동,'45,40 - 44세,1998,417,187,230
'4415053000,  산성동,'50,45 - 49세,1998,335,161,174
'4415053000,  산성동,'55,50 - 54세,1998,279,138,141
'4415053000,  산성동,'60,55 - 59세,1998,281,137,144
'4415053000,  산성동,'65,60 - 64세,1998,220,92,128
'4415053000,  산성동,'70,65 - 69세,1998,162,69,93
'4415053000,  산성동,'75,70 - 74세,1998,85,34,51
'4415053000,  산성동,'80,75 - 79세,1998,70,19,51
'4415053000,  산성동,'85,80 - 84세,1998,43,12,31
'4415053000,  산성동,'90,85+ ,1998,24,8,16
'4415054000,  웅진동,'00,계,1998,7547,3728,3819
'4415054000,  웅진동,'05,0 - 4세,1998,585,301,284
'4415054000,  웅진동,'10,5 - 9세,1998,579,317,262
'4415054000,  웅진동,'15,10 - 14세,1998,629,312,317
'4415054000,  웅진동,'20,15 - 19세,1998,734,341,393
'4415054000,  웅진동,'25,20 - 24세,1998,679,377,302
'4415054000,  웅진동,'30,25 - 29세,1998,636,319,317
'4415054000,  웅진동,'35,30 - 34세,1998,602,286,316
'4415054000,  웅진동,'40,35 - 39세,1998,676,351,325
'4415054000,  웅진동,'45,40 - 44세,1998,599,300,299
'4415054000,  웅진동,'50,45 - 49세,1998,423,209,214
'4415054000,  웅진동,'55,50 - 54세,1998,359,188,171
'4415054000,  웅진동,'60,55 - 59세,1998,339,156,183
'4415054000,  웅진동,'65,60 - 64세,1998,235,111,124
'4415054000,  웅진동,'70,65 - 69세,1998,167,63,104
'4415054000,  웅진동,'75,70 - 74세,1998,122,44,78
'4415054000,  웅진동,'80,75 - 79세,1998,101,35,66
'4415054000,  웅진동,'85,80 - 84세,1998,46,12,34
'4415054000,  웅진동,'90,85+ ,1998,36,6,30
'4415055000,  금학동,'00,계,1998,5122,2525,2597
'4415055000,  금학동,'05,0 - 4세,1998,236,124,112
'4415055000,  금학동,'10,5 - 9세,1998,258,126,132
'4415055000,  금학동,'15,10 - 14세,1998,355,204,151
'4415055000,  금학동,'20,15 - 19세,1998,588,263,325
'4415055000,  금학동,'25,20 - 24세,1998,586,260,326
'4415055000,  금학동,'30,25 - 29세,1998,350,209,141
'4415055000,  금학동,'35,30 - 34세,1998,291,156,135
'4415055000,  금학동,'40,35 - 39세,1998,384,184,200
'4415055000,  금학동,'45,40 - 44세,1998,413,217,196
'4415055000,  금학동,'50,45 - 49세,1998,295,163,132
'4415055000,  금학동,'55,50 - 54세,1998,255,140,115
'4415055000,  금학동,'60,55 - 59세,1998,272,131,141
'4415055000,  금학동,'65,60 - 64세,1998,262,115,147
'4415055000,  금학동,'70,65 - 69세,1998,218,86,132
'4415055000,  금학동,'75,70 - 74세,1998,136,52,84
'4415055000,  금학동,'80,75 - 79세,1998,119,50,69
'4415055000,  금학동,'85,80 - 84세,1998,65,28,37
'4415055000,  금학동,'90,85+ ,1998,39,17,22
'4415056000,  옥룡동,'00,계,1998,14735,7270,7465
'4415056000,  옥룡동,'05,0 - 4세,1998,1172,614,558
'4415056000,  옥룡동,'10,5 - 9세,1998,1290,678,612
'4415056000,  옥룡동,'15,10 - 14세,1998,1119,574,545
'4415056000,  옥룡동,'20,15 - 19세,1998,1451,739,712
'4415056000,  옥룡동,'25,20 - 24세,1998,1302,667,635
'4415056000,  옥룡동,'30,25 - 29세,1998,1331,639,692
'4415056000,  옥룡동,'35,30 - 34세,1998,1284,620,664
'4415056000,  옥룡동,'40,35 - 39세,1998,1337,666,671
'4415056000,  옥룡동,'45,40 - 44세,1998,1133,582,551
'4415056000,  옥룡동,'50,45 - 49세,1998,738,365,373
'4415056000,  옥룡동,'55,50 - 54세,1998,633,312,321
'4415056000,  옥룡동,'60,55 - 59세,1998,631,290,341
'4415056000,  옥룡동,'65,60 - 64세,1998,463,213,250
'4415056000,  옥룡동,'70,65 - 69세,1998,323,136,187
'4415056000,  옥룡동,'75,70 - 74세,1998,193,74,119
'4415056000,  옥룡동,'80,75 - 79세,1998,176,57,119
'4415056000,  옥룡동,'85,80 - 84세,1998,96,30,66
'4415056000,  옥룡동,'90,85+ ,1998,63,14,49
'4415057000,  신관동,'00,계,1998,19878,9898,9980
'4415057000,  신관동,'05,0 - 4세,1998,1829,962,867
'4415057000,  신관동,'10,5 - 9세,1998,1995,1084,911
'4415057000,  신관동,'15,10 - 14세,1998,1709,879,830
'4415057000,  신관동,'20,15 - 19세,1998,1691,839,852
'4415057000,  신관동,'25,20 - 24세,1998,1391,717,674
'4415057000,  신관동,'30,25 - 29세,1998,1604,734,870
'4415057000,  신관동,'35,30 - 34세,1998,2034,967,1067
'4415057000,  신관동,'40,35 - 39세,1998,2252,1151,1101
'4415057000,  신관동,'45,40 - 44세,1998,1633,866,767
'4415057000,  신관동,'50,45 - 49세,1998,873,482,391
'4415057000,  신관동,'55,50 - 54세,1998,601,309,292
'4415057000,  신관동,'60,55 - 59세,1998,589,274,315
'4415057000,  신관동,'65,60 - 64세,1998,514,231,283
'4415057000,  신관동,'70,65 - 69세,1998,421,147,274
'4415057000,  신관동,'75,70 - 74세,1998,294,107,187
'4415057000,  신관동,'80,75 - 79세,1998,222,73,149
'4415057000,  신관동,'85,80 - 84세,1998,132,47,85
'4415057000,  신관동,'90,85+ ,1998,94,29,65
'44180, 보령시,'00,계,1998,122191,62038,60153
'44180, 보령시,'05,0 - 4세,1998,7207,3808,3399
'44180, 보령시,'10,5 - 9세,1998,7381,4011,3370
'44180, 보령시,'15,10 - 14세,1998,8157,4184,3973
'44180, 보령시,'20,15 - 19세,1998,12120,6136,5984
'44180, 보령시,'25,20 - 24세,1998,11655,6668,4987
'44180, 보령시,'30,25 - 29세,1998,9571,5443,4128
'44180, 보령시,'35,30 - 34세,1998,8671,4638,4033
'44180, 보령시,'40,35 - 39세,1998,9607,4963,4644
'44180, 보령시,'45,40 - 44세,1998,8513,4414,4099
'44180, 보령시,'50,45 - 49세,1998,6856,3411,3445
'44180, 보령시,'55,50 - 54세,1998,6265,3079,3186
'44180, 보령시,'60,55 - 59세,1998,6973,3269,3704
'44180, 보령시,'65,60 - 64세,1998,6721,3103,3618
'44180, 보령시,'70,65 - 69세,1998,4921,2104,2817
'44180, 보령시,'75,70 - 74세,1998,3289,1366,1923
'44180, 보령시,'80,75 - 79세,1998,2302,878,1424
'44180, 보령시,'85,80 - 84세,1998,1244,402,842
'44180, 보령시,'90,85+ ,1998,738,161,577
'4418025000,  웅천읍,'00,계,1998,10161,5103,5058
'4418025000,  웅천읍,'05,0 - 4세,1998,428,238,190
'4418025000,  웅천읍,'10,5 - 9세,1998,533,286,247
'4418025000,  웅천읍,'15,10 - 14세,1998,657,353,304
'4418025000,  웅천읍,'20,15 - 19세,1998,1125,529,596
'4418025000,  웅천읍,'25,20 - 24세,1998,994,600,394
'4418025000,  웅천읍,'30,25 - 29세,1998,628,380,248
'4418025000,  웅천읍,'35,30 - 34세,1998,551,287,264
'4418025000,  웅천읍,'40,35 - 39세,1998,679,351,328
'4418025000,  웅천읍,'45,40 - 44세,1998,717,368,349
'4418025000,  웅천읍,'50,45 - 49세,1998,602,305,297
'4418025000,  웅천읍,'55,50 - 54세,1998,549,264,285
'4418025000,  웅천읍,'60,55 - 59세,1998,676,304,372
'4418025000,  웅천읍,'65,60 - 64세,1998,659,301,358
'4418025000,  웅천읍,'70,65 - 69세,1998,526,227,299
'4418025000,  웅천읍,'75,70 - 74세,1998,364,156,208
'4418025000,  웅천읍,'80,75 - 79세,1998,274,109,165
'4418025000,  웅천읍,'85,80 - 84세,1998,120,33,87
'4418025000,  웅천읍,'90,85+ ,1998,79,12,67
'4418031000,  주포면,'00,계,1998,2232,1142,1090
'4418031000,  주포면,'05,0 - 4세,1998,95,46,49
'4418031000,  주포면,'10,5 - 9세,1998,92,52,40
'4418031000,  주포면,'15,10 - 14세,1998,140,70,70
'4418031000,  주포면,'20,15 - 19세,1998,221,99,122
'4418031000,  주포면,'25,20 - 24세,1998,208,127,81
'4418031000,  주포면,'30,25 - 29세,1998,150,102,48
'4418031000,  주포면,'35,30 - 34세,1998,114,73,41
'4418031000,  주포면,'40,35 - 39세,1998,169,91,78
'4418031000,  주포면,'45,40 - 44세,1998,131,66,65
'4418031000,  주포면,'50,45 - 49세,1998,133,76,57
'4418031000,  주포면,'55,50 - 54세,1998,118,57,61
'4418031000,  주포면,'60,55 - 59세,1998,131,58,73
'4418031000,  주포면,'65,60 - 64세,1998,160,73,87
'4418031000,  주포면,'70,65 - 69세,1998,137,57,80
'4418031000,  주포면,'75,70 - 74세,1998,108,45,63
'4418031000,  주포면,'80,75 - 79세,1998,66,31,35
'4418031000,  주포면,'85,80 - 84세,1998,40,17,23
'4418031000,  주포면,'90,85+ ,1998,19,2,17
'4418032000,  오천면,'00,계,1998,6817,3565,3252
'4418032000,  오천면,'05,0 - 4세,1998,253,138,115
'4418032000,  오천면,'10,5 - 9세,1998,282,147,135
'4418032000,  오천면,'15,10 - 14세,1998,414,202,212
'4418032000,  오천면,'20,15 - 19세,1998,722,371,351
'4418032000,  오천면,'25,20 - 24세,1998,683,421,262
'4418032000,  오천면,'30,25 - 29세,1998,469,315,154
'4418032000,  오천면,'35,30 - 34세,1998,353,212,141
'4418032000,  오천면,'40,35 - 39세,1998,467,258,209
'4418032000,  오천면,'45,40 - 44세,1998,460,252,208
'4418032000,  오천면,'50,45 - 49세,1998,453,231,222
'4418032000,  오천면,'55,50 - 54세,1998,392,209,183
'4418032000,  오천면,'60,55 - 59세,1998,472,225,247
'4418032000,  오천면,'65,60 - 64세,1998,502,233,269
'4418032000,  오천면,'70,65 - 69세,1998,358,155,203
'4418032000,  오천면,'75,70 - 74세,1998,260,107,153
'4418032000,  오천면,'80,75 - 79세,1998,149,54,95
'4418032000,  오천면,'85,80 - 84세,1998,79,26,53
'4418032000,  오천면,'90,85+ ,1998,49,9,40
'4418033000,  천북면,'00,계,1998,5612,2880,2732
'4418033000,  천북면,'05,0 - 4세,1998,182,100,82
'4418033000,  천북면,'10,5 - 9세,1998,254,132,122
'4418033000,  천북면,'15,10 - 14세,1998,388,189,199
'4418033000,  천북면,'20,15 - 19세,1998,574,315,259
'4418033000,  천북면,'25,20 - 24세,1998,541,313,228
'4418033000,  천북면,'30,25 - 29세,1998,293,195,98
'4418033000,  천북면,'35,30 - 34세,1998,272,146,126
'4418033000,  천북면,'40,35 - 39세,1998,398,212,186
'4418033000,  천북면,'45,40 - 44세,1998,376,196,180
'4418033000,  천북면,'50,45 - 49세,1998,345,179,166
'4418033000,  천북면,'55,50 - 54세,1998,326,151,175
'4418033000,  천북면,'60,55 - 59세,1998,380,181,199
'4418033000,  천북면,'65,60 - 64세,1998,439,205,234
'4418033000,  천북면,'70,65 - 69세,1998,299,139,160
'4418033000,  천북면,'75,70 - 74세,1998,239,105,134
'4418033000,  천북면,'80,75 - 79세,1998,175,74,101
'4418033000,  천북면,'85,80 - 84세,1998,84,32,52
'4418033000,  천북면,'90,85+ ,1998,47,16,31
'4418034000,  청소면,'00,계,1998,4555,2251,2304
'4418034000,  청소면,'05,0 - 4세,1998,159,76,83
'4418034000,  청소면,'10,5 - 9세,1998,163,89,74
'4418034000,  청소면,'15,10 - 14세,1998,215,113,102
'4418034000,  청소면,'20,15 - 19세,1998,446,227,219
'4418034000,  청소면,'25,20 - 24세,1998,425,246,179
'4418034000,  청소면,'30,25 - 29세,1998,280,169,111
'4418034000,  청소면,'35,30 - 34세,1998,217,127,90
'4418034000,  청소면,'40,35 - 39세,1998,230,118,112
'4418034000,  청소면,'45,40 - 44세,1998,289,142,147
'4418034000,  청소면,'50,45 - 49세,1998,260,129,131
'4418034000,  청소면,'55,50 - 54세,1998,267,124,143
'4418034000,  청소면,'60,55 - 59세,1998,377,164,213
'4418034000,  청소면,'65,60 - 64세,1998,410,185,225
'4418034000,  청소면,'70,65 - 69세,1998,318,150,168
'4418034000,  청소면,'75,70 - 74세,1998,233,99,134
'4418034000,  청소면,'80,75 - 79세,1998,133,55,78
'4418034000,  청소면,'85,80 - 84세,1998,85,27,58
'4418034000,  청소면,'90,85+ ,1998,48,11,37
'4418035000,  청라면,'00,계,1998,6166,3182,2984
'4418035000,  청라면,'05,0 - 4세,1998,220,113,107
'4418035000,  청라면,'10,5 - 9세,1998,203,120,83
'4418035000,  청라면,'15,10 - 14세,1998,331,165,166
'4418035000,  청라면,'20,15 - 19세,1998,663,333,330
'4418035000,  청라면,'25,20 - 24세,1998,733,443,290
'4418035000,  청라면,'30,25 - 29세,1998,414,289,125
'4418035000,  청라면,'35,30 - 34세,1998,274,166,108
'4418035000,  청라면,'40,35 - 39세,1998,325,171,154
'4418035000,  청라면,'45,40 - 44세,1998,366,184,182
'4418035000,  청라면,'50,45 - 49세,1998,365,172,193
'4418035000,  청라면,'55,50 - 54세,1998,370,172,198
'4418035000,  청라면,'60,55 - 59세,1998,492,234,258
'4418035000,  청라면,'65,60 - 64세,1998,525,258,267
'4418035000,  청라면,'70,65 - 69세,1998,377,159,218
'4418035000,  청라면,'75,70 - 74세,1998,233,107,126
'4418035000,  청라면,'80,75 - 79세,1998,154,62,92
'4418035000,  청라면,'85,80 - 84세,1998,77,31,46
'4418035000,  청라면,'90,85+ ,1998,44,3,41
'4418036000,  남포면,'00,계,1998,7376,3722,3654
'4418036000,  남포면,'05,0 - 4세,1998,288,137,151
'4418036000,  남포면,'10,5 - 9세,1998,284,159,125
'4418036000,  남포면,'15,10 - 14세,1998,413,213,200
'4418036000,  남포면,'20,15 - 19세,1998,730,380,350
'4418036000,  남포면,'25,20 - 24세,1998,753,450,303
'4418036000,  남포면,'30,25 - 29세,1998,534,335,199
'4418036000,  남포면,'35,30 - 34세,1998,380,220,160
'4418036000,  남포면,'40,35 - 39세,1998,445,248,197
'4418036000,  남포면,'45,40 - 44세,1998,459,253,206
'4418036000,  남포면,'50,45 - 49세,1998,413,201,212
'4418036000,  남포면,'55,50 - 54세,1998,417,182,235
'4418036000,  남포면,'60,55 - 59세,1998,548,242,306
'4418036000,  남포면,'65,60 - 64세,1998,549,239,310
'4418036000,  남포면,'70,65 - 69세,1998,440,176,264
'4418036000,  남포면,'75,70 - 74세,1998,308,129,179
'4418036000,  남포면,'80,75 - 79세,1998,218,95,123
'4418036000,  남포면,'85,80 - 84세,1998,129,43,86
'4418036000,  남포면,'90,85+ ,1998,68,20,48
'4418038000,  주산면,'00,계,1998,4241,2093,2148
'4418038000,  주산면,'05,0 - 4세,1998,121,58,63
'4418038000,  주산면,'10,5 - 9세,1998,129,72,57
'4418038000,  주산면,'15,10 - 14세,1998,231,124,107
'4418038000,  주산면,'20,15 - 19세,1998,420,220,200
'4418038000,  주산면,'25,20 - 24세,1998,418,247,171
'4418038000,  주산면,'30,25 - 29세,1998,238,166,72
'4418038000,  주산면,'35,30 - 34세,1998,137,77,60
'4418038000,  주산면,'40,35 - 39세,1998,206,96,110
'4418038000,  주산면,'45,40 - 44세,1998,259,129,130
'4418038000,  주산면,'50,45 - 49세,1998,229,112,117
'4418038000,  주산면,'55,50 - 54세,1998,266,129,137
'4418038000,  주산면,'60,55 - 59세,1998,360,158,202
'4418038000,  주산면,'65,60 - 64세,1998,398,171,227
'4418038000,  주산면,'70,65 - 69세,1998,329,144,185
'4418038000,  주산면,'75,70 - 74세,1998,211,88,123
'4418038000,  주산면,'80,75 - 79세,1998,135,54,81
'4418038000,  주산면,'85,80 - 84세,1998,84,29,55
'4418038000,  주산면,'90,85+ ,1998,70,19,51
'4418039000,  미산면,'00,계,1998,2733,1393,1340
'4418039000,  미산면,'05,0 - 4세,1998,90,43,47
'4418039000,  미산면,'10,5 - 9세,1998,102,49,53
'4418039000,  미산면,'15,10 - 14세,1998,142,68,74
'4418039000,  미산면,'20,15 - 19세,1998,270,143,127
'4418039000,  미산면,'25,20 - 24세,1998,298,197,101
'4418039000,  미산면,'30,25 - 29세,1998,139,94,45
'4418039000,  미산면,'35,30 - 34세,1998,128,72,56
'4418039000,  미산면,'40,35 - 39세,1998,120,67,53
'4418039000,  미산면,'45,40 - 44세,1998,138,75,63
'4418039000,  미산면,'50,45 - 49세,1998,147,64,83
'4418039000,  미산면,'55,50 - 54세,1998,161,70,91
'4418039000,  미산면,'60,55 - 59세,1998,254,117,137
'4418039000,  미산면,'65,60 - 64세,1998,254,121,133
'4418039000,  미산면,'70,65 - 69세,1998,217,103,114
'4418039000,  미산면,'75,70 - 74세,1998,126,57,69
'4418039000,  미산면,'80,75 - 79세,1998,73,31,42
'4418039000,  미산면,'85,80 - 84세,1998,39,14,25
'4418039000,  미산면,'90,85+ ,1998,35,8,27
'4418040000,  성주면,'00,계,1998,4211,2174,2037
'4418040000,  성주면,'05,0 - 4세,1998,190,109,81
'4418040000,  성주면,'10,5 - 9세,1998,202,106,96
'4418040000,  성주면,'15,10 - 14세,1998,307,165,142
'4418040000,  성주면,'20,15 - 19세,1998,506,264,242
'4418040000,  성주면,'25,20 - 24세,1998,498,282,216
'4418040000,  성주면,'30,25 - 29세,1998,293,163,130
'4418040000,  성주면,'35,30 - 34세,1998,234,127,107
'4418040000,  성주면,'40,35 - 39세,1998,318,157,161
'4418040000,  성주면,'45,40 - 44세,1998,307,153,154
'4418040000,  성주면,'50,45 - 49세,1998,267,131,136
'4418040000,  성주면,'55,50 - 54세,1998,271,135,136
'4418040000,  성주면,'60,55 - 59세,1998,300,160,140
'4418040000,  성주면,'65,60 - 64세,1998,222,103,119
'4418040000,  성주면,'70,65 - 69세,1998,140,71,69
'4418040000,  성주면,'75,70 - 74세,1998,75,28,47
'4418040000,  성주면,'80,75 - 79세,1998,38,12,26
'4418040000,  성주면,'85,80 - 84세,1998,27,6,21
'4418040000,  성주면,'90,85+ ,1998,16,2,14
'4418041000,  주교면,'00,계,1998,6823,3532,3291
'4418041000,  주교면,'05,0 - 4세,1998,259,140,119
'4418041000,  주교면,'10,5 - 9세,1998,263,139,124
'4418041000,  주교면,'15,10 - 14세,1998,395,200,195
'4418041000,  주교면,'20,15 - 19세,1998,807,407,400
'4418041000,  주교면,'25,20 - 24세,1998,758,454,304
'4418041000,  주교면,'30,25 - 29세,1998,615,418,197
'4418041000,  주교면,'35,30 - 34세,1998,386,222,164
'4418041000,  주교면,'40,35 - 39세,1998,456,238,218
'4418041000,  주교면,'45,40 - 44세,1998,455,216,239
'4418041000,  주교면,'50,45 - 49세,1998,400,200,200
'4418041000,  주교면,'55,50 - 54세,1998,382,195,187
'4418041000,  주교면,'60,55 - 59세,1998,479,229,250
'4418041000,  주교면,'65,60 - 64세,1998,452,208,244
'4418041000,  주교면,'70,65 - 69세,1998,293,124,169
'4418041000,  주교면,'75,70 - 74세,1998,179,69,110
'4418041000,  주교면,'80,75 - 79세,1998,131,38,93
'4418041000,  주교면,'85,80 - 84세,1998,73,21,52
'4418041000,  주교면,'90,85+ ,1998,40,14,26
'4418051000,  원동,'00,계,1998,16602,8387,8215
'4418051000,  원동,'05,0 - 4세,1998,1471,796,675
'4418051000,  원동,'10,5 - 9세,1998,1461,789,672
'4418051000,  원동,'15,10 - 14세,1998,1277,670,607
'4418051000,  원동,'20,15 - 19세,1998,1451,738,713
'4418051000,  원동,'25,20 - 24세,1998,1329,716,613
'4418051000,  원동,'30,25 - 29세,1998,1394,662,732
'4418051000,  원동,'35,30 - 34세,1998,1671,848,823
'4418051000,  원동,'40,35 - 39세,1998,1647,822,825
'4418051000,  원동,'45,40 - 44세,1998,1296,667,629
'4418051000,  원동,'50,45 - 49세,1998,880,458,422
'4418051000,  원동,'55,50 - 54세,1998,651,333,318
'4418051000,  원동,'60,55 - 59세,1998,610,294,316
'4418051000,  원동,'65,60 - 64세,1998,522,234,288
'4418051000,  원동,'70,65 - 69세,1998,358,136,222
'4418051000,  원동,'75,70 - 74세,1998,268,109,159
'4418051000,  원동,'80,75 - 79세,1998,167,74,93
'4418051000,  원동,'85,80 - 84세,1998,100,30,70
'4418051000,  원동,'90,85+ ,1998,49,11,38
'4418052000,  대관동,'00,계,1998,9285,4683,4602
'4418052000,  대관동,'05,0 - 4세,1998,704,356,348
'4418052000,  대관동,'10,5 - 9세,1998,821,456,365
'4418052000,  대관동,'15,10 - 14세,1998,671,347,324
'4418052000,  대관동,'20,15 - 19세,1998,799,407,392
'4418052000,  대관동,'25,20 - 24세,1998,796,427,369
'4418052000,  대관동,'30,25 - 29세,1998,831,429,402
'4418052000,  대관동,'35,30 - 34세,1998,804,399,405
'4418052000,  대관동,'40,35 - 39세,1998,848,454,394
'4418052000,  대관동,'45,40 - 44세,1998,658,334,324
'4418052000,  대관동,'50,45 - 49세,1998,515,241,274
'4418052000,  대관동,'55,50 - 54세,1998,456,234,222
'4418052000,  대관동,'60,55 - 59세,1998,418,199,219
'4418052000,  대관동,'65,60 - 64세,1998,350,177,173
'4418052000,  대관동,'70,65 - 69세,1998,231,92,139
'4418052000,  대관동,'75,70 - 74세,1998,141,56,85
'4418052000,  대관동,'80,75 - 79세,1998,130,48,82
'4418052000,  대관동,'85,80 - 84세,1998,66,17,49
'4418052000,  대관동,'90,85+ ,1998,46,10,36
'4418053000,  대신동,'00,계,1998,11749,5931,5818
'4418053000,  대신동,'05,0 - 4세,1998,836,454,382
'4418053000,  대신동,'10,5 - 9세,1998,855,486,369
'4418053000,  대신동,'15,10 - 14세,1998,916,466,450
'4418053000,  대신동,'20,15 - 19세,1998,1216,599,617
'4418053000,  대신동,'25,20 - 24세,1998,1083,592,491
'4418053000,  대신동,'30,25 - 29세,1998,970,505,465
'4418053000,  대신동,'35,30 - 34세,1998,1006,507,499
'4418053000,  대신동,'40,35 - 39세,1998,1084,529,555
'4418053000,  대신동,'45,40 - 44세,1998,938,487,451
'4418053000,  대신동,'50,45 - 49세,1998,668,331,337
'4418053000,  대신동,'55,50 - 54세,1998,595,314,281
'4418053000,  대신동,'60,55 - 59세,1998,465,223,242
'4418053000,  대신동,'65,60 - 64세,1998,392,181,211
'4418053000,  대신동,'70,65 - 69세,1998,296,120,176
'4418053000,  대신동,'75,70 - 74세,1998,172,63,109
'4418053000,  대신동,'80,75 - 79세,1998,153,50,103
'4418053000,  대신동,'85,80 - 84세,1998,71,21,50
'4418053000,  대신동,'90,85+ ,1998,33,3,30
'4418054000,  흥덕동,'00,계,1998,14226,7158,7068
'4418054000,  흥덕동,'05,0 - 4세,1998,1390,740,650
'4418054000,  흥덕동,'10,5 - 9세,1998,1163,615,548
'4418054000,  흥덕동,'15,10 - 14세,1998,1100,540,560
'4418054000,  흥덕동,'20,15 - 19세,1998,1289,653,636
'4418054000,  흥덕동,'25,20 - 24세,1998,1145,587,558
'4418054000,  흥덕동,'30,25 - 29세,1998,1507,722,785
'4418054000,  흥덕동,'35,30 - 34세,1998,1467,777,690
'4418054000,  흥덕동,'40,35 - 39세,1998,1452,769,683
'4418054000,  흥덕동,'45,40 - 44세,1998,1019,538,481
'4418054000,  흥덕동,'50,45 - 49세,1998,618,311,307
'4418054000,  흥덕동,'55,50 - 54세,1998,506,262,244
'4418054000,  흥덕동,'60,55 - 59세,1998,467,223,244
'4418054000,  흥덕동,'65,60 - 64세,1998,383,168,215
'4418054000,  흥덕동,'70,65 - 69세,1998,283,115,168
'4418054000,  흥덕동,'75,70 - 74세,1998,172,70,102
'4418054000,  흥덕동,'80,75 - 79세,1998,152,39,113
'4418054000,  흥덕동,'85,80 - 84세,1998,73,23,50
'4418054000,  흥덕동,'90,85+ ,1998,40,6,34
'4418056000,  현포동,'00,계,1998,9402,4842,4560
'4418056000,  현포동,'05,0 - 4세,1998,521,264,257
'4418056000,  현포동,'10,5 - 9세,1998,574,314,260
'4418056000,  현포동,'15,10 - 14세,1998,560,299,261
'4418056000,  현포동,'20,15 - 19세,1998,881,451,430
'4418056000,  현포동,'25,20 - 24세,1998,993,566,427
'4418056000,  현포동,'30,25 - 29세,1998,816,499,317
'4418056000,  현포동,'35,30 - 34세,1998,677,378,299
'4418056000,  현포동,'40,35 - 39세,1998,763,382,381
'4418056000,  현포동,'45,40 - 44세,1998,645,354,291
'4418056000,  현포동,'50,45 - 49세,1998,561,270,291
'4418056000,  현포동,'55,50 - 54세,1998,538,248,290
'4418056000,  현포동,'60,55 - 59세,1998,544,258,286
'4418056000,  현포동,'65,60 - 64세,1998,504,246,258
'4418056000,  현포동,'70,65 - 69세,1998,319,136,183
'4418056000,  현포동,'75,70 - 74세,1998,200,78,122
'4418056000,  현포동,'80,75 - 79세,1998,154,52,102
'4418056000,  현포동,'85,80 - 84세,1998,97,32,65
'4418056000,  현포동,'90,85+ ,1998,55,15,40
'44200, 아산시,'00,계,1998,179199,90538,88661
'44200, 아산시,'05,0 - 4세,1998,14550,7704,6846
'44200, 아산시,'10,5 - 9세,1998,12656,6686,5970
'44200, 아산시,'15,10 - 14세,1998,10673,5409,5264
'44200, 아산시,'20,15 - 19세,1998,13941,7141,6800
'44200, 아산시,'25,20 - 24세,1998,15928,7872,8056
'44200, 아산시,'30,25 - 29세,1998,18831,10152,8679
'44200, 아산시,'35,30 - 34세,1998,16492,8893,7599
'44200, 아산시,'40,35 - 39세,1998,15588,8470,7118
'44200, 아산시,'45,40 - 44세,1998,11778,6240,5538
'44200, 아산시,'50,45 - 49세,1998,8456,4247,4209
'44200, 아산시,'55,50 - 54세,1998,7577,3759,3818
'44200, 아산시,'60,55 - 59세,1998,8529,3951,4578
'44200, 아산시,'65,60 - 64세,1998,8354,3860,4494
'44200, 아산시,'70,65 - 69세,1998,6185,2590,3595
'44200, 아산시,'75,70 - 74세,1998,4187,1650,2537
'44200, 아산시,'80,75 - 79세,1998,2982,1152,1830
'44200, 아산시,'85,80 - 84세,1998,1578,522,1056
'44200, 아산시,'90,85+ ,1998,914,240,674
'4420025000,  염치읍,'00,계,1998,7319,3754,3565
'4420025000,  염치읍,'05,0 - 4세,1998,442,238,204
'4420025000,  염치읍,'10,5 - 9세,1998,340,175,165
'4420025000,  염치읍,'15,10 - 14세,1998,449,227,222
'4420025000,  염치읍,'20,15 - 19세,1998,681,361,320
'4420025000,  염치읍,'25,20 - 24세,1998,656,340,316
'4420025000,  염치읍,'30,25 - 29세,1998,640,388,252
'4420025000,  염치읍,'35,30 - 34세,1998,515,298,217
'4420025000,  염치읍,'40,35 - 39세,1998,543,293,250
'4420025000,  염치읍,'45,40 - 44세,1998,509,267,242
'4420025000,  염치읍,'50,45 - 49세,1998,378,201,177
'4420025000,  염치읍,'55,50 - 54세,1998,394,190,204
'4420025000,  염치읍,'60,55 - 59세,1998,455,212,243
'4420025000,  염치읍,'65,60 - 64세,1998,485,225,260
'4420025000,  염치읍,'70,65 - 69세,1998,341,164,177
'4420025000,  염치읍,'75,70 - 74세,1998,209,81,128
'4420025000,  염치읍,'80,75 - 79세,1998,153,58,95
'4420025000,  염치읍,'85,80 - 84세,1998,85,27,58
'4420025000,  염치읍,'90,85+ ,1998,44,9,35
'4420031000,  송악면,'00,계,1998,4218,2194,2024
'4420031000,  송악면,'05,0 - 4세,1998,141,80,61
'4420031000,  송악면,'10,5 - 9세,1998,182,106,76
'4420031000,  송악면,'15,10 - 14세,1998,214,104,110
'4420031000,  송악면,'20,15 - 19세,1998,348,180,168
'4420031000,  송악면,'25,20 - 24세,1998,458,274,184
'4420031000,  송악면,'30,25 - 29세,1998,330,228,102
'4420031000,  송악면,'35,30 - 34세,1998,219,125,94
'4420031000,  송악면,'40,35 - 39세,1998,269,157,112
'4420031000,  송악면,'45,40 - 44세,1998,246,130,116
'4420031000,  송악면,'50,45 - 49세,1998,219,102,117
'4420031000,  송악면,'55,50 - 54세,1998,245,115,130
'4420031000,  송악면,'60,55 - 59세,1998,326,156,170
'4420031000,  송악면,'65,60 - 64세,1998,326,158,168
'4420031000,  송악면,'70,65 - 69세,1998,259,106,153
'4420031000,  송악면,'75,70 - 74세,1998,189,74,115
'4420031000,  송악면,'80,75 - 79세,1998,138,61,77
'4420031000,  송악면,'85,80 - 84세,1998,61,24,37
'4420031000,  송악면,'90,85+ ,1998,48,14,34
'4420032000,  배방면,'00,계,1998,18389,9077,9312
'4420032000,  배방면,'05,0 - 4세,1998,1485,770,715
'4420032000,  배방면,'10,5 - 9세,1998,1094,573,521
'4420032000,  배방면,'15,10 - 14세,1998,927,496,431
'4420032000,  배방면,'20,15 - 19세,1998,1543,768,775
'4420032000,  배방면,'25,20 - 24세,1998,2450,921,1529
'4420032000,  배방면,'30,25 - 29세,1998,2314,1242,1072
'4420032000,  배방면,'35,30 - 34세,1998,1558,890,668
'4420032000,  배방면,'40,35 - 39세,1998,1435,774,661
'4420032000,  배방면,'45,40 - 44세,1998,1121,610,511
'4420032000,  배방면,'50,45 - 49세,1998,811,408,403
'4420032000,  배방면,'55,50 - 54세,1998,737,368,369
'4420032000,  배방면,'60,55 - 59세,1998,788,398,390
'4420032000,  배방면,'65,60 - 64세,1998,776,352,424
'4420032000,  배방면,'70,65 - 69세,1998,521,212,309
'4420032000,  배방면,'75,70 - 74세,1998,354,136,218
'4420032000,  배방면,'80,75 - 79세,1998,258,96,162
'4420032000,  배방면,'85,80 - 84세,1998,132,40,92
'4420032000,  배방면,'90,85+ ,1998,85,23,62
'4420033000,  탕정면,'00,계,1998,6577,3381,3196
'4420033000,  탕정면,'05,0 - 4세,1998,724,388,336
'4420033000,  탕정면,'10,5 - 9세,1998,476,247,229
'4420033000,  탕정면,'15,10 - 14세,1998,344,169,175
'4420033000,  탕정면,'20,15 - 19세,1998,423,226,197
'4420033000,  탕정면,'25,20 - 24세,1998,543,261,282
'4420033000,  탕정면,'30,25 - 29세,1998,858,468,390
'4420033000,  탕정면,'35,30 - 34세,1998,683,362,321
'4420033000,  탕정면,'40,35 - 39세,1998,543,324,219
'4420033000,  탕정면,'45,40 - 44세,1998,364,201,163
'4420033000,  탕정면,'50,45 - 49세,1998,233,134,99
'4420033000,  탕정면,'55,50 - 54세,1998,213,107,106
'4420033000,  탕정면,'60,55 - 59세,1998,286,144,142
'4420033000,  탕정면,'65,60 - 64세,1998,289,136,153
'4420033000,  탕정면,'70,65 - 69세,1998,242,92,150
'4420033000,  탕정면,'75,70 - 74세,1998,154,60,94
'4420033000,  탕정면,'80,75 - 79세,1998,101,39,62
'4420033000,  탕정면,'85,80 - 84세,1998,68,19,49
'4420033000,  탕정면,'90,85+ ,1998,33,4,29
'4420035000,  음봉면,'00,계,1998,12009,6225,5784
'4420035000,  음봉면,'05,0 - 4세,1998,1331,710,621
'4420035000,  음봉면,'10,5 - 9세,1998,758,401,357
'4420035000,  음봉면,'15,10 - 14세,1998,574,294,280
'4420035000,  음봉면,'20,15 - 19세,1998,710,349,361
'4420035000,  음봉면,'25,20 - 24세,1998,1014,490,524
'4420035000,  음봉면,'30,25 - 29세,1998,1786,984,802
'4420035000,  음봉면,'35,30 - 34세,1998,1275,744,531
'4420035000,  음봉면,'40,35 - 39세,1998,947,547,400
'4420035000,  음봉면,'45,40 - 44세,1998,670,371,299
'4420035000,  음봉면,'50,45 - 49세,1998,478,248,230
'4420035000,  음봉면,'55,50 - 54세,1998,423,211,212
'4420035000,  음봉면,'60,55 - 59세,1998,468,210,258
'4420035000,  음봉면,'65,60 - 64세,1998,521,247,274
'4420035000,  음봉면,'70,65 - 69세,1998,411,168,243
'4420035000,  음봉면,'75,70 - 74세,1998,276,108,168
'4420035000,  음봉면,'80,75 - 79세,1998,204,90,114
'4420035000,  음봉면,'85,80 - 84세,1998,99,32,67
'4420035000,  음봉면,'90,85+ ,1998,64,21,43
'4420036000,  둔포면,'00,계,1998,11496,5899,5597
'4420036000,  둔포면,'05,0 - 4세,1998,707,395,312
'4420036000,  둔포면,'10,5 - 9세,1998,739,390,349
'4420036000,  둔포면,'15,10 - 14세,1998,711,352,359
'4420036000,  둔포면,'20,15 - 19세,1998,967,518,449
'4420036000,  둔포면,'25,20 - 24세,1998,1028,564,464
'4420036000,  둔포면,'30,25 - 29세,1998,979,561,418
'4420036000,  둔포면,'35,30 - 34세,1998,887,487,400
'4420036000,  둔포면,'40,35 - 39세,1998,958,524,434
'4420036000,  둔포면,'45,40 - 44세,1998,798,409,389
'4420036000,  둔포면,'50,45 - 49세,1998,613,311,302
'4420036000,  둔포면,'55,50 - 54세,1998,567,282,285
'4420036000,  둔포면,'60,55 - 59세,1998,649,303,346
'4420036000,  둔포면,'65,60 - 64세,1998,632,290,342
'4420036000,  둔포면,'70,65 - 69세,1998,516,223,293
'4420036000,  둔포면,'75,70 - 74세,1998,318,138,180
'4420036000,  둔포면,'80,75 - 79세,1998,254,89,165
'4420036000,  둔포면,'85,80 - 84세,1998,104,41,63
'4420036000,  둔포면,'90,85+ ,1998,69,22,47
'4420037000,  영인면,'00,계,1998,8074,4094,3980
'4420037000,  영인면,'05,0 - 4세,1998,330,164,166
'4420037000,  영인면,'10,5 - 9세,1998,412,226,186
'4420037000,  영인면,'15,10 - 14세,1998,497,249,248
'4420037000,  영인면,'20,15 - 19세,1998,707,361,346
'4420037000,  영인면,'25,20 - 24세,1998,791,446,345
'4420037000,  영인면,'30,25 - 29세,1998,548,336,212
'4420037000,  영인면,'35,30 - 34세,1998,448,263,185
'4420037000,  영인면,'40,35 - 39세,1998,597,327,270
'4420037000,  영인면,'45,40 - 44세,1998,540,284,256
'4420037000,  영인면,'50,45 - 49세,1998,422,195,227
'4420037000,  영인면,'55,50 - 54세,1998,422,214,208
'4420037000,  영인면,'60,55 - 59세,1998,632,285,347
'4420037000,  영인면,'65,60 - 64세,1998,637,310,327
'4420037000,  영인면,'70,65 - 69세,1998,421,173,248
'4420037000,  영인면,'75,70 - 74세,1998,285,117,168
'4420037000,  영인면,'80,75 - 79세,1998,212,94,118
'4420037000,  영인면,'85,80 - 84세,1998,109,35,74
'4420037000,  영인면,'90,85+ ,1998,64,15,49
'4420038000,  인주면,'00,계,1998,7574,3962,3612
'4420038000,  인주면,'05,0 - 4세,1998,583,333,250
'4420038000,  인주면,'10,5 - 9세,1998,562,318,244
'4420038000,  인주면,'15,10 - 14세,1998,411,203,208
'4420038000,  인주면,'20,15 - 19세,1998,491,246,245
'4420038000,  인주면,'25,20 - 24세,1998,565,291,274
'4420038000,  인주면,'30,25 - 29세,1998,698,461,237
'4420038000,  인주면,'35,30 - 34세,1998,738,392,346
'4420038000,  인주면,'40,35 - 39세,1998,633,381,252
'4420038000,  인주면,'45,40 - 44세,1998,464,264,200
'4420038000,  인주면,'50,45 - 49세,1998,287,153,134
'4420038000,  인주면,'55,50 - 54세,1998,333,146,187
'4420038000,  인주면,'60,55 - 59세,1998,425,195,230
'4420038000,  인주면,'65,60 - 64세,1998,521,254,267
'4420038000,  인주면,'70,65 - 69세,1998,369,143,226
'4420038000,  인주면,'75,70 - 74세,1998,213,86,127
'4420038000,  인주면,'80,75 - 79세,1998,147,55,92
'4420038000,  인주면,'85,80 - 84세,1998,72,27,45
'4420038000,  인주면,'90,85+ ,1998,62,14,48
'4420039000,  선장면,'00,계,1998,5491,2742,2749
'4420039000,  선장면,'05,0 - 4세,1998,185,96,89
'4420039000,  선장면,'10,5 - 9세,1998,218,112,106
'4420039000,  선장면,'15,10 - 14세,1998,271,142,129
'4420039000,  선장면,'20,15 - 19세,1998,518,255,263
'4420039000,  선장면,'25,20 - 24세,1998,528,303,225
'4420039000,  선장면,'30,25 - 29세,1998,390,256,134
'4420039000,  선장면,'35,30 - 34세,1998,271,167,104
'4420039000,  선장면,'40,35 - 39세,1998,305,148,157
'4420039000,  선장면,'45,40 - 44세,1998,365,188,177
'4420039000,  선장면,'50,45 - 49세,1998,327,155,172
'4420039000,  선장면,'55,50 - 54세,1998,329,166,163
'4420039000,  선장면,'60,55 - 59세,1998,370,164,206
'4420039000,  선장면,'65,60 - 64세,1998,480,222,258
'4420039000,  선장면,'70,65 - 69세,1998,369,170,199
'4420039000,  선장면,'75,70 - 74세,1998,234,91,143
'4420039000,  선장면,'80,75 - 79세,1998,172,71,101
'4420039000,  선장면,'85,80 - 84세,1998,104,27,77
'4420039000,  선장면,'90,85+ ,1998,55,9,46
'4420040000,  도고면,'00,계,1998,6511,3283,3228
'4420040000,  도고면,'05,0 - 4세,1998,260,137,123
'4420040000,  도고면,'10,5 - 9세,1998,313,155,158
'4420040000,  도고면,'15,10 - 14세,1998,332,173,159
'4420040000,  도고면,'20,15 - 19세,1998,532,272,260
'4420040000,  도고면,'25,20 - 24세,1998,653,347,306
'4420040000,  도고면,'30,25 - 29세,1998,545,359,186
'4420040000,  도고면,'35,30 - 34세,1998,364,207,157
'4420040000,  도고면,'40,35 - 39세,1998,392,221,171
'4420040000,  도고면,'45,40 - 44세,1998,396,199,197
'4420040000,  도고면,'50,45 - 49세,1998,363,188,175
'4420040000,  도고면,'55,50 - 54세,1998,362,165,197
'4420040000,  도고면,'60,55 - 59세,1998,522,240,282
'4420040000,  도고면,'65,60 - 64세,1998,523,228,295
'4420040000,  도고면,'70,65 - 69세,1998,386,161,225
'4420040000,  도고면,'75,70 - 74세,1998,255,108,147
'4420040000,  도고면,'80,75 - 79세,1998,159,70,89
'4420040000,  도고면,'85,80 - 84세,1998,101,39,62
'4420040000,  도고면,'90,85+ ,1998,53,14,39
'4420041000,  신창면,'00,계,1998,13841,7087,6754
'4420041000,  신창면,'05,0 - 4세,1998,1432,719,713
'4420041000,  신창면,'10,5 - 9세,1998,926,448,478
'4420041000,  신창면,'15,10 - 14세,1998,633,319,314
'4420041000,  신창면,'20,15 - 19세,1998,874,462,412
'4420041000,  신창면,'25,20 - 24세,1998,1273,656,617
'4420041000,  신창면,'30,25 - 29세,1998,1840,964,876
'4420041000,  신창면,'35,30 - 34세,1998,1539,869,670
'4420041000,  신창면,'40,35 - 39세,1998,1125,665,460
'4420041000,  신창면,'45,40 - 44세,1998,720,384,336
'4420041000,  신창면,'50,45 - 49세,1998,579,290,289
'4420041000,  신창면,'55,50 - 54세,1998,491,245,246
'4420041000,  신창면,'60,55 - 59세,1998,626,293,333
'4420041000,  신창면,'65,60 - 64세,1998,612,295,317
'4420041000,  신창면,'70,65 - 69세,1998,441,191,250
'4420041000,  신창면,'75,70 - 74세,1998,322,139,183
'4420041000,  신창면,'80,75 - 79세,1998,212,84,128
'4420041000,  신창면,'85,80 - 84세,1998,138,48,90
'4420041000,  신창면,'90,85+ ,1998,58,16,42
'4420051500,  온양온천1동,'00,계,1998,9336,4659,4677
'4420051500,  온양온천1동,'05,0 - 4세,1998,589,307,282
'4420051500,  온양온천1동,'10,5 - 9세,1998,718,374,344
'4420051500,  온양온천1동,'15,10 - 14세,1998,665,336,329
'4420051500,  온양온천1동,'20,15 - 19세,1998,820,439,381
'4420051500,  온양온천1동,'25,20 - 24세,1998,790,425,365
'4420051500,  온양온천1동,'30,25 - 29세,1998,778,433,345
'4420051500,  온양온천1동,'35,30 - 34세,1998,766,359,407
'4420051500,  온양온천1동,'40,35 - 39세,1998,897,436,461
'4420051500,  온양온천1동,'45,40 - 44세,1998,705,349,356
'4420051500,  온양온천1동,'50,45 - 49세,1998,539,266,273
'4420051500,  온양온천1동,'55,50 - 54세,1998,474,249,225
'4420051500,  온양온천1동,'60,55 - 59세,1998,457,205,252
'4420051500,  온양온천1동,'65,60 - 64세,1998,382,182,200
'4420051500,  온양온천1동,'70,65 - 69세,1998,264,109,155
'4420051500,  온양온천1동,'75,70 - 74세,1998,213,83,130
'4420051500,  온양온천1동,'80,75 - 79세,1998,147,58,89
'4420051500,  온양온천1동,'85,80 - 84세,1998,82,30,52
'4420051500,  온양온천1동,'90,85+ ,1998,50,19,31
'4420052500,  온양온천2동,'00,계,1998,10512,5202,5310
'4420052500,  온양온천2동,'05,0 - 4세,1998,866,456,410
'4420052500,  온양온천2동,'10,5 - 9세,1998,928,497,431
'4420052500,  온양온천2동,'15,10 - 14세,1998,787,410,377
'4420052500,  온양온천2동,'20,15 - 19세,1998,834,431,403
'4420052500,  온양온천2동,'25,20 - 24세,1998,823,407,416
'4420052500,  온양온천2동,'30,25 - 29세,1998,1021,497,524
'4420052500,  온양온천2동,'35,30 - 34세,1998,1024,505,519
'4420052500,  온양온천2동,'40,35 - 39세,1998,1128,546,582
'4420052500,  온양온천2동,'45,40 - 44세,1998,809,412,397
'4420052500,  온양온천2동,'50,45 - 49세,1998,536,268,268
'4420052500,  온양온천2동,'55,50 - 54세,1998,432,225,207
'4420052500,  온양온천2동,'60,55 - 59세,1998,420,195,225
'4420052500,  온양온천2동,'65,60 - 64세,1998,286,131,155
'4420052500,  온양온천2동,'70,65 - 69세,1998,234,94,140
'4420052500,  온양온천2동,'75,70 - 74세,1998,184,68,116
'4420052500,  온양온천2동,'80,75 - 79세,1998,110,37,73
'4420052500,  온양온천2동,'85,80 - 84세,1998,61,20,41
'4420052500,  온양온천2동,'90,85+ ,1998,29,3,26
'4420053000,  권곡동,'00,계,1998,15273,7594,7679
'4420053000,  권곡동,'05,0 - 4세,1998,1118,597,521
'4420053000,  권곡동,'10,5 - 9세,1998,1233,669,564
'4420053000,  권곡동,'15,10 - 14세,1998,1057,504,553
'4420053000,  권곡동,'20,15 - 19세,1998,1399,701,698
'4420053000,  권곡동,'25,20 - 24세,1998,1280,650,630
'4420053000,  권곡동,'30,25 - 29세,1998,1362,696,666
'4420053000,  권곡동,'35,30 - 34세,1998,1400,707,693
'4420053000,  권곡동,'40,35 - 39세,1998,1476,732,744
'4420053000,  권곡동,'45,40 - 44세,1998,1194,619,575
'4420053000,  권곡동,'50,45 - 49세,1998,840,418,422
'4420053000,  권곡동,'55,50 - 54세,1998,709,341,368
'4420053000,  권곡동,'60,55 - 59세,1998,654,318,336
'4420053000,  권곡동,'65,60 - 64세,1998,526,247,279
'4420053000,  권곡동,'70,65 - 69세,1998,393,178,215
'4420053000,  권곡동,'75,70 - 74세,1998,268,98,170
'4420053000,  권곡동,'80,75 - 79세,1998,191,59,132
'4420053000,  권곡동,'85,80 - 84세,1998,110,39,71
'4420053000,  권곡동,'90,85+ ,1998,63,21,42
'4420054000,  신정동,'00,계,1998,13836,6997,6839
'4420054000,  신정동,'05,0 - 4세,1998,1397,747,650
'4420054000,  신정동,'10,5 - 9세,1998,1165,609,556
'4420054000,  신정동,'15,10 - 14세,1998,918,479,439
'4420054000,  신정동,'20,15 - 19세,1998,993,521,472
'4420054000,  신정동,'25,20 - 24세,1998,1042,519,523
'4420054000,  신정동,'30,25 - 29세,1998,1535,766,769
'4420054000,  신정동,'35,30 - 34세,1998,1484,764,720
'4420054000,  신정동,'40,35 - 39세,1998,1455,776,679
'4420054000,  신정동,'45,40 - 44세,1998,962,519,443
'4420054000,  신정동,'50,45 - 49세,1998,629,328,301
'4420054000,  신정동,'55,50 - 54세,1998,473,243,230
'4420054000,  신정동,'60,55 - 59세,1998,461,209,252
'4420054000,  신정동,'65,60 - 64세,1998,461,195,266
'4420054000,  신정동,'70,65 - 69세,1998,332,134,198
'4420054000,  신정동,'75,70 - 74세,1998,235,87,148
'4420054000,  신정동,'80,75 - 79세,1998,157,58,99
'4420054000,  신정동,'85,80 - 84세,1998,85,27,58
'4420054000,  신정동,'90,85+ ,1998,52,16,36
'4420055000,  용화동,'00,계,1998,14039,7013,7026
'4420055000,  용화동,'05,0 - 4세,1998,1305,689,616
'4420055000,  용화동,'10,5 - 9세,1998,1280,677,603
'4420055000,  용화동,'15,10 - 14세,1998,990,514,476
'4420055000,  용화동,'20,15 - 19세,1998,1075,552,523
'4420055000,  용화동,'25,20 - 24세,1998,1000,481,519
'4420055000,  용화동,'30,25 - 29세,1998,1467,711,756
'4420055000,  용화동,'35,30 - 34세,1998,1538,784,754
'4420055000,  용화동,'40,35 - 39세,1998,1386,734,652
'4420055000,  용화동,'45,40 - 44세,1998,990,534,456
'4420055000,  용화동,'50,45 - 49세,1998,622,301,321
'4420055000,  용화동,'55,50 - 54세,1998,516,262,254
'4420055000,  용화동,'60,55 - 59세,1998,555,245,310
'4420055000,  용화동,'65,60 - 64세,1998,438,210,228
'4420055000,  용화동,'70,65 - 69세,1998,341,143,198
'4420055000,  용화동,'75,70 - 74세,1998,232,86,146
'4420055000,  용화동,'80,75 - 79세,1998,176,60,116
'4420055000,  용화동,'85,80 - 84세,1998,86,23,63
'4420055000,  용화동,'90,85+ ,1998,42,7,35
'4420056000,  온주동,'00,계,1998,14704,7375,7329
'4420056000,  온주동,'05,0 - 4세,1998,1655,878,777
'4420056000,  온주동,'10,5 - 9세,1998,1312,709,603
'4420056000,  온주동,'15,10 - 14세,1998,893,438,455
'4420056000,  온주동,'20,15 - 19세,1998,1026,499,527
'4420056000,  온주동,'25,20 - 24세,1998,1034,497,537
'4420056000,  온주동,'30,25 - 29세,1998,1740,802,938
'4420056000,  온주동,'35,30 - 34세,1998,1783,970,813
'4420056000,  온주동,'40,35 - 39세,1998,1499,885,614
'4420056000,  온주동,'45,40 - 44세,1998,925,500,425
'4420056000,  온주동,'50,45 - 49세,1998,580,281,299
'4420056000,  온주동,'55,50 - 54세,1998,457,230,227
'4420056000,  온주동,'60,55 - 59세,1998,435,179,256
'4420056000,  온주동,'65,60 - 64세,1998,459,178,281
'4420056000,  온주동,'70,65 - 69세,1998,345,129,216
'4420056000,  온주동,'75,70 - 74세,1998,246,90,156
'4420056000,  온주동,'80,75 - 79세,1998,191,73,118
'4420056000,  온주동,'85,80 - 84세,1998,81,24,57
'4420056000,  온주동,'90,85+ ,1998,43,13,30
'44210, 서산시,'00,계,1998,150618,76302,74316
'44210, 서산시,'05,0 - 4세,1998,11306,5976,5330
'44210, 서산시,'10,5 - 9세,1998,11315,5884,5431
'44210, 서산시,'15,10 - 14세,1998,10116,5256,4860
'44210, 서산시,'20,15 - 19세,1998,13130,6689,6441
'44210, 서산시,'25,20 - 24세,1998,12765,7045,5720
'44210, 서산시,'30,25 - 29세,1998,13436,7283,6153
'44210, 서산시,'35,30 - 34세,1998,13047,6798,6249
'44210, 서산시,'40,35 - 39세,1998,12970,6807,6163
'44210, 서산시,'45,40 - 44세,1998,9985,5178,4807
'44210, 서산시,'50,45 - 49세,1998,7693,3969,3724
'44210, 서산시,'55,50 - 54세,1998,6467,3290,3177
'44210, 서산시,'60,55 - 59세,1998,7448,3521,3927
'44210, 서산시,'65,60 - 64세,1998,7519,3376,4143
'44210, 서산시,'70,65 - 69세,1998,5330,2259,3071
'44210, 서산시,'75,70 - 74세,1998,3678,1482,2196
'44210, 서산시,'80,75 - 79세,1998,2291,872,1419
'44210, 서산시,'85,80 - 84세,1998,1288,434,854
'44210, 서산시,'90,85+ ,1998,834,183,651
'4421025000,  대산읍,'00,계,1998,20161,10572,9589
'4421025000,  대산읍,'05,0 - 4세,1998,2076,1076,1000
'4421025000,  대산읍,'10,5 - 9세,1998,1988,1025,963
'4421025000,  대산읍,'15,10 - 14세,1998,1500,828,672
'4421025000,  대산읍,'20,15 - 19세,1998,1425,722,703
'4421025000,  대산읍,'25,20 - 24세,1998,1136,634,502
'4421025000,  대산읍,'30,25 - 29세,1998,2120,1155,965
'4421025000,  대산읍,'35,30 - 34세,1998,2363,1265,1098
'4421025000,  대산읍,'40,35 - 39세,1998,2145,1158,987
'4421025000,  대산읍,'45,40 - 44세,1998,1457,839,618
'4421025000,  대산읍,'50,45 - 49세,1998,809,491,318
'4421025000,  대산읍,'55,50 - 54세,1998,601,322,279
'4421025000,  대산읍,'60,55 - 59세,1998,614,290,324
'4421025000,  대산읍,'65,60 - 64세,1998,663,280,383
'4421025000,  대산읍,'70,65 - 69세,1998,525,218,307
'4421025000,  대산읍,'75,70 - 74세,1998,355,140,215
'4421025000,  대산읍,'80,75 - 79세,1998,204,80,124
'4421025000,  대산읍,'85,80 - 84세,1998,118,36,82
'4421025000,  대산읍,'90,85+ ,1998,62,13,49
'4421031000,  인지면,'00,계,1998,5708,2908,2800
'4421031000,  인지면,'05,0 - 4세,1998,323,173,150
'4421031000,  인지면,'10,5 - 9세,1998,301,149,152
'4421031000,  인지면,'15,10 - 14세,1998,311,164,147
'4421031000,  인지면,'20,15 - 19세,1998,468,223,245
'4421031000,  인지면,'25,20 - 24세,1998,560,313,247
'4421031000,  인지면,'30,25 - 29세,1998,533,335,198
'4421031000,  인지면,'35,30 - 34세,1998,358,213,145
'4421031000,  인지면,'40,35 - 39세,1998,390,214,176
'4421031000,  인지면,'45,40 - 44세,1998,306,159,147
'4421031000,  인지면,'50,45 - 49세,1998,297,150,147
'4421031000,  인지면,'55,50 - 54세,1998,282,143,139
'4421031000,  인지면,'60,55 - 59세,1998,398,181,217
'4421031000,  인지면,'65,60 - 64세,1998,421,192,229
'4421031000,  인지면,'70,65 - 69세,1998,331,139,192
'4421031000,  인지면,'75,70 - 74세,1998,208,86,122
'4421031000,  인지면,'80,75 - 79세,1998,114,48,66
'4421031000,  인지면,'85,80 - 84세,1998,64,23,41
'4421031000,  인지면,'90,85+ ,1998,43,3,40
'4421032000,  부석면,'00,계,1998,8302,4268,4034
'4421032000,  부석면,'05,0 - 4세,1998,249,138,111
'4421032000,  부석면,'10,5 - 9세,1998,340,197,143
'4421032000,  부석면,'15,10 - 14세,1998,487,266,221
'4421032000,  부석면,'20,15 - 19세,1998,882,453,429
'4421032000,  부석면,'25,20 - 24세,1998,948,572,376
'4421032000,  부석면,'30,25 - 29세,1998,496,323,173
'4421032000,  부석면,'35,30 - 34세,1998,383,215,168
'4421032000,  부석면,'40,35 - 39세,1998,480,245,235
'4421032000,  부석면,'45,40 - 44세,1998,509,247,262
'4421032000,  부석면,'50,45 - 49세,1998,521,261,260
'4421032000,  부석면,'55,50 - 54세,1998,510,257,253
'4421032000,  부석면,'60,55 - 59세,1998,644,295,349
'4421032000,  부석면,'65,60 - 64세,1998,687,309,378
'4421032000,  부석면,'70,65 - 69세,1998,511,238,273
'4421032000,  부석면,'75,70 - 74세,1998,321,146,175
'4421032000,  부석면,'80,75 - 79세,1998,184,73,111
'4421032000,  부석면,'85,80 - 84세,1998,95,20,75
'4421032000,  부석면,'90,85+ ,1998,55,13,42
'4421033000,  팔봉면,'00,계,1998,4610,2326,2284
'4421033000,  팔봉면,'05,0 - 4세,1998,148,72,76
'4421033000,  팔봉면,'10,5 - 9세,1998,170,88,82
'4421033000,  팔봉면,'15,10 - 14세,1998,232,113,119
'4421033000,  팔봉면,'20,15 - 19세,1998,494,239,255
'4421033000,  팔봉면,'25,20 - 24세,1998,503,314,189
'4421033000,  팔봉면,'30,25 - 29세,1998,255,162,93
'4421033000,  팔봉면,'35,30 - 34세,1998,206,124,82
'4421033000,  팔봉면,'40,35 - 39세,1998,241,138,103
'4421033000,  팔봉면,'45,40 - 44세,1998,279,134,145
'4421033000,  팔봉면,'50,45 - 49세,1998,316,161,155
'4421033000,  팔봉면,'55,50 - 54세,1998,296,148,148
'4421033000,  팔봉면,'60,55 - 59세,1998,350,172,178
'4421033000,  팔봉면,'65,60 - 64세,1998,387,169,218
'4421033000,  팔봉면,'70,65 - 69세,1998,284,114,170
'4421033000,  팔봉면,'75,70 - 74세,1998,207,95,112
'4421033000,  팔봉면,'80,75 - 79세,1998,133,53,80
'4421033000,  팔봉면,'85,80 - 84세,1998,68,23,45
'4421033000,  팔봉면,'90,85+ ,1998,41,7,34
'4421034000,  지곡면,'00,계,1998,5136,2612,2524
'4421034000,  지곡면,'05,0 - 4세,1998,173,94,79
'4421034000,  지곡면,'10,5 - 9세,1998,253,126,127
'4421034000,  지곡면,'15,10 - 14세,1998,314,147,167
'4421034000,  지곡면,'20,15 - 19세,1998,508,263,245
'4421034000,  지곡면,'25,20 - 24세,1998,500,305,195
'4421034000,  지곡면,'30,25 - 29세,1998,298,206,92
'4421034000,  지곡면,'35,30 - 34세,1998,261,142,119
'4421034000,  지곡면,'40,35 - 39세,1998,346,194,152
'4421034000,  지곡면,'45,40 - 44세,1998,293,149,144
'4421034000,  지곡면,'50,45 - 49세,1998,289,143,146
'4421034000,  지곡면,'55,50 - 54세,1998,301,159,142
'4421034000,  지곡면,'60,55 - 59세,1998,379,177,202
'4421034000,  지곡면,'65,60 - 64세,1998,421,183,238
'4421034000,  지곡면,'70,65 - 69세,1998,309,145,164
'4421034000,  지곡면,'75,70 - 74세,1998,238,95,143
'4421034000,  지곡면,'80,75 - 79세,1998,113,44,69
'4421034000,  지곡면,'85,80 - 84세,1998,76,27,49
'4421034000,  지곡면,'90,85+ ,1998,64,13,51
'4421036000,  성연면,'00,계,1998,3901,1980,1921
'4421036000,  성연면,'05,0 - 4세,1998,166,93,73
'4421036000,  성연면,'10,5 - 9세,1998,173,88,85
'4421036000,  성연면,'15,10 - 14세,1998,194,79,115
'4421036000,  성연면,'20,15 - 19세,1998,373,192,181
'4421036000,  성연면,'25,20 - 24세,1998,425,251,174
'4421036000,  성연면,'30,25 - 29세,1998,281,198,83
'4421036000,  성연면,'35,30 - 34세,1998,204,114,90
'4421036000,  성연면,'40,35 - 39세,1998,246,129,117
'4421036000,  성연면,'45,40 - 44세,1998,241,124,117
'4421036000,  성연면,'50,45 - 49세,1998,196,102,94
'4421036000,  성연면,'55,50 - 54세,1998,221,105,116
'4421036000,  성연면,'60,55 - 59세,1998,267,128,139
'4421036000,  성연면,'65,60 - 64세,1998,326,147,179
'4421036000,  성연면,'70,65 - 69세,1998,230,92,138
'4421036000,  성연면,'75,70 - 74세,1998,176,72,104
'4421036000,  성연면,'80,75 - 79세,1998,88,36,52
'4421036000,  성연면,'85,80 - 84세,1998,63,23,40
'4421036000,  성연면,'90,85+ ,1998,31,7,24
'4421037000,  음암면,'00,계,1998,9408,4836,4572
'4421037000,  음암면,'05,0 - 4세,1998,838,448,390
'4421037000,  음암면,'10,5 - 9세,1998,595,307,288
'4421037000,  음암면,'15,10 - 14세,1998,525,268,257
'4421037000,  음암면,'20,15 - 19세,1998,733,364,369
'4421037000,  음암면,'25,20 - 24세,1998,775,446,329
'4421037000,  음암면,'30,25 - 29세,1998,1006,553,453
'4421037000,  음암면,'35,30 - 34세,1998,847,467,380
'4421037000,  음암면,'40,35 - 39세,1998,637,379,258
'4421037000,  음암면,'45,40 - 44세,1998,478,260,218
'4421037000,  음암면,'50,45 - 49세,1998,407,207,200
'4421037000,  음암면,'55,50 - 54세,1998,382,179,203
'4421037000,  음암면,'60,55 - 59세,1998,551,258,293
'4421037000,  음암면,'65,60 - 64세,1998,654,303,351
'4421037000,  음암면,'70,65 - 69세,1998,383,161,222
'4421037000,  음암면,'75,70 - 74세,1998,263,119,144
'4421037000,  음암면,'80,75 - 79세,1998,168,66,102
'4421037000,  음암면,'85,80 - 84세,1998,94,32,62
'4421037000,  음암면,'90,85+ ,1998,72,19,53
'4421038000,  운산면,'00,계,1998,7264,3708,3556
'4421038000,  운산면,'05,0 - 4세,1998,297,146,151
'4421038000,  운산면,'10,5 - 9세,1998,383,192,191
'4421038000,  운산면,'15,10 - 14세,1998,406,214,192
'4421038000,  운산면,'20,15 - 19세,1998,665,339,326
'4421038000,  운산면,'25,20 - 24세,1998,790,479,311
'4421038000,  운산면,'30,25 - 29세,1998,479,313,166
'4421038000,  운산면,'35,30 - 34세,1998,404,219,185
'4421038000,  운산면,'40,35 - 39세,1998,446,249,197
'4421038000,  운산면,'45,40 - 44세,1998,381,182,199
'4421038000,  운산면,'50,45 - 49세,1998,426,209,217
'4421038000,  운산면,'55,50 - 54세,1998,382,201,181
'4421038000,  운산면,'60,55 - 59세,1998,588,275,313
'4421038000,  운산면,'65,60 - 64세,1998,601,279,322
'4421038000,  운산면,'70,65 - 69세,1998,398,167,231
'4421038000,  운산면,'75,70 - 74세,1998,252,100,152
'4421038000,  운산면,'80,75 - 79세,1998,185,85,100
'4421038000,  운산면,'85,80 - 84세,1998,110,40,70
'4421038000,  운산면,'90,85+ ,1998,71,19,52
'4421039000,  해미면,'00,계,1998,9775,4996,4779
'4421039000,  해미면,'05,0 - 4세,1998,533,295,238
'4421039000,  해미면,'10,5 - 9세,1998,496,246,250
'4421039000,  해미면,'15,10 - 14세,1998,547,315,232
'4421039000,  해미면,'20,15 - 19세,1998,897,470,427
'4421039000,  해미면,'25,20 - 24세,1998,1032,571,461
'4421039000,  해미면,'30,25 - 29세,1998,869,532,337
'4421039000,  해미면,'35,30 - 34세,1998,590,310,280
'4421039000,  해미면,'40,35 - 39세,1998,685,365,320
'4421039000,  해미면,'45,40 - 44세,1998,621,310,311
'4421039000,  해미면,'50,45 - 49세,1998,593,286,307
'4421039000,  해미면,'55,50 - 54세,1998,516,255,261
'4421039000,  해미면,'60,55 - 59세,1998,696,317,379
'4421039000,  해미면,'65,60 - 64세,1998,596,280,316
'4421039000,  해미면,'70,65 - 69세,1998,443,190,253
'4421039000,  해미면,'75,70 - 74세,1998,274,116,158
'4421039000,  해미면,'80,75 - 79세,1998,202,71,131
'4421039000,  해미면,'85,80 - 84세,1998,115,48,67
'4421039000,  해미면,'90,85+ ,1998,70,19,51
'4421040000,  고북면,'00,계,1998,9513,4821,4692
'4421040000,  고북면,'05,0 - 4세,1998,613,354,259
'4421040000,  고북면,'10,5 - 9세,1998,588,310,278
'4421040000,  고북면,'15,10 - 14세,1998,579,293,286
'4421040000,  고북면,'20,15 - 19세,1998,869,438,431
'4421040000,  고북면,'25,20 - 24세,1998,905,527,378
'4421040000,  고북면,'30,25 - 29세,1998,824,474,350
'4421040000,  고북면,'35,30 - 34세,1998,690,360,330
'4421040000,  고북면,'40,35 - 39세,1998,668,339,329
'4421040000,  고북면,'45,40 - 44세,1998,574,285,289
'4421040000,  고북면,'50,45 - 49세,1998,494,255,239
'4421040000,  고북면,'55,50 - 54세,1998,416,195,221
'4421040000,  고북면,'60,55 - 59세,1998,600,268,332
'4421040000,  고북면,'65,60 - 64세,1998,620,285,335
'4421040000,  고북면,'70,65 - 69세,1998,408,195,213
'4421040000,  고북면,'75,70 - 74세,1998,268,114,154
'4421040000,  고북면,'80,75 - 79세,1998,208,75,133
'4421040000,  고북면,'85,80 - 84세,1998,108,34,74
'4421040000,  고북면,'90,85+ ,1998,81,20,61
'4421051000,  부춘동,'00,계,1998,14783,7350,7433
'4421051000,  부춘동,'05,0 - 4세,1998,1393,737,656
'4421051000,  부춘동,'10,5 - 9세,1998,1375,729,646
'4421051000,  부춘동,'15,10 - 14세,1998,1069,553,516
'4421051000,  부춘동,'20,15 - 19세,1998,1193,589,604
'4421051000,  부춘동,'25,20 - 24세,1998,1150,585,565
'4421051000,  부춘동,'30,25 - 29세,1998,1596,741,855
'4421051000,  부춘동,'35,30 - 34세,1998,1574,809,765
'4421051000,  부춘동,'40,35 - 39세,1998,1453,740,713
'4421051000,  부춘동,'45,40 - 44세,1998,989,498,491
'4421051000,  부춘동,'50,45 - 49세,1998,724,368,356
'4421051000,  부춘동,'55,50 - 54세,1998,550,284,266
'4421051000,  부춘동,'60,55 - 59세,1998,496,235,261
'4421051000,  부춘동,'65,60 - 64세,1998,450,208,242
'4421051000,  부춘동,'70,65 - 69세,1998,300,119,181
'4421051000,  부춘동,'75,70 - 74세,1998,220,83,137
'4421051000,  부춘동,'80,75 - 79세,1998,120,35,85
'4421051000,  부춘동,'85,80 - 84세,1998,76,23,53
'4421051000,  부춘동,'90,85+ ,1998,55,14,41
'4421052000,  동문동,'00,계,1998,16661,8341,8320
'4421052000,  동문동,'05,0 - 4세,1998,1333,704,629
'4421052000,  동문동,'10,5 - 9세,1998,1487,790,697
'4421052000,  동문동,'15,10 - 14세,1998,1253,653,600
'4421052000,  동문동,'20,15 - 19세,1998,1577,820,757
'4421052000,  동문동,'25,20 - 24세,1998,1423,733,690
'4421052000,  동문동,'30,25 - 29세,1998,1420,720,700
'4421052000,  동문동,'35,30 - 34세,1998,1594,760,834
'4421052000,  동문동,'40,35 - 39세,1998,1538,773,765
'4421052000,  동문동,'45,40 - 44세,1998,1274,635,639
'4421052000,  동문동,'50,45 - 49세,1998,934,482,452
'4421052000,  동문동,'55,50 - 54세,1998,695,373,322
'4421052000,  동문동,'60,55 - 59세,1998,612,306,306
'4421052000,  동문동,'65,60 - 64세,1998,540,242,298
'4421052000,  동문동,'70,65 - 69세,1998,347,138,209
'4421052000,  동문동,'75,70 - 74세,1998,289,102,187
'4421052000,  동문동,'80,75 - 79세,1998,177,63,114
'4421052000,  동문동,'85,80 - 84세,1998,107,34,73
'4421052000,  동문동,'90,85+ ,1998,61,13,48
'4421053000,  활성동,'00,계,1998,7797,3864,3933
'4421053000,  활성동,'05,0 - 4세,1998,464,261,203
'4421053000,  활성동,'10,5 - 9세,1998,667,346,321
'4421053000,  활성동,'15,10 - 14세,1998,590,315,275
'4421053000,  활성동,'20,15 - 19세,1998,823,423,400
'4421053000,  활성동,'25,20 - 24세,1998,663,332,331
'4421053000,  활성동,'30,25 - 29세,1998,634,345,289
'4421053000,  활성동,'35,30 - 34세,1998,617,277,340
'4421053000,  활성동,'40,35 - 39세,1998,738,340,398
'4421053000,  활성동,'45,40 - 44세,1998,659,333,326
'4421053000,  활성동,'50,45 - 49세,1998,447,218,229
'4421053000,  활성동,'55,50 - 54세,1998,395,191,204
'4421053000,  활성동,'60,55 - 59세,1998,356,179,177
'4421053000,  활성동,'65,60 - 64세,1998,266,127,139
'4421053000,  활성동,'70,65 - 69세,1998,199,84,115
'4421053000,  활성동,'75,70 - 74세,1998,115,43,72
'4421053000,  활성동,'80,75 - 79세,1998,91,31,60
'4421053000,  활성동,'85,80 - 84세,1998,45,15,30
'4421053000,  활성동,'90,85+ ,1998,28,4,24
'4421054000,  수석동,'00,계,1998,14264,7048,7216
'4421054000,  수석동,'05,0 - 4세,1998,1377,711,666
'4421054000,  수석동,'10,5 - 9세,1998,1236,635,601
'4421054000,  수석동,'15,10 - 14세,1998,1136,583,553
'4421054000,  수석동,'20,15 - 19세,1998,1250,646,604
'4421054000,  수석동,'25,20 - 24세,1998,1032,502,530
'4421054000,  수석동,'30,25 - 29세,1998,1417,649,768
'4421054000,  수석동,'35,30 - 34세,1998,1531,796,735
'4421054000,  수석동,'40,35 - 39세,1998,1486,767,719
'4421054000,  수석동,'45,40 - 44세,1998,1014,516,498
'4421054000,  수석동,'50,45 - 49세,1998,709,349,360
'4421054000,  수석동,'55,50 - 54세,1998,485,249,236
'4421054000,  수석동,'60,55 - 59세,1998,428,216,212
'4421054000,  수석동,'65,60 - 64세,1998,391,163,228
'4421054000,  수석동,'70,65 - 69세,1998,297,110,187
'4421054000,  수석동,'75,70 - 74세,1998,238,77,161
'4421054000,  수석동,'80,75 - 79세,1998,131,52,79
'4421054000,  수석동,'85,80 - 84세,1998,68,26,42
'4421054000,  수석동,'90,85+ ,1998,38,1,37
'4421055000,  석남동,'00,계,1998,13335,6672,6663
'4421055000,  석남동,'05,0 - 4세,1998,1323,674,649
'4421055000,  석남동,'10,5 - 9세,1998,1263,656,607
'4421055000,  석남동,'15,10 - 14세,1998,973,465,508
'4421055000,  석남동,'20,15 - 19세,1998,973,508,465
'4421055000,  석남동,'25,20 - 24세,1998,923,481,442
'4421055000,  석남동,'30,25 - 29세,1998,1208,577,631
'4421055000,  석남동,'35,30 - 34세,1998,1425,727,698
'4421055000,  석남동,'40,35 - 39세,1998,1471,777,694
'4421055000,  석남동,'45,40 - 44세,1998,910,507,403
'4421055000,  석남동,'50,45 - 49세,1998,531,287,244
'4421055000,  석남동,'55,50 - 54세,1998,435,229,206
'4421055000,  석남동,'60,55 - 59세,1998,469,224,245
'4421055000,  석남동,'65,60 - 64세,1998,496,209,287
'4421055000,  석남동,'70,65 - 69세,1998,365,149,216
'4421055000,  석남동,'75,70 - 74세,1998,254,94,160
'4421055000,  석남동,'80,75 - 79세,1998,173,60,113
'4421055000,  석남동,'85,80 - 84세,1998,81,30,51
'4421055000,  석남동,'90,85+ ,1998,62,18,44
'44220, 계룡출장소,'00,계,1998,25707,12697,13010
'44220, 계룡출장소,'05,0 - 4세,1998,2329,1209,1120
'44220, 계룡출장소,'10,5 - 9세,1998,2434,1279,1155
'44220, 계룡출장소,'15,10 - 14세,1998,2430,1244,1186
'44220, 계룡출장소,'20,15 - 19세,1998,2358,1204,1154
'44220, 계룡출장소,'25,20 - 24세,1998,1353,694,659
'44220, 계룡출장소,'30,25 - 29세,1998,2331,1080,1251
'44220, 계룡출장소,'35,30 - 34세,1998,2670,1306,1364
'44220, 계룡출장소,'40,35 - 39세,1998,2915,1309,1606
'44220, 계룡출장소,'45,40 - 44세,1998,2806,1479,1327
'44220, 계룡출장소,'50,45 - 49세,1998,1277,729,548
'44220, 계룡출장소,'55,50 - 54세,1998,601,337,264
'44220, 계룡출장소,'60,55 - 59세,1998,475,208,267
'44220, 계룡출장소,'65,60 - 64세,1998,515,190,325
'44220, 계룡출장소,'70,65 - 69세,1998,426,156,270
'44220, 계룡출장소,'75,70 - 74세,1998,367,141,226
'44220, 계룡출장소,'80,75 - 79세,1998,214,77,137
'44220, 계룡출장소,'85,80 - 84세,1998,122,37,85
'44220, 계룡출장소,'90,85+ ,1998,84,18,66
'4422037000,  두마지소,'00,계,1998,17189,8413,8776
'4422037000,  두마지소,'05,0 - 4세,1998,1627,835,792
'4422037000,  두마지소,'10,5 - 9세,1998,1465,782,683
'4422037000,  두마지소,'15,10 - 14세,1998,1265,642,623
'4422037000,  두마지소,'20,15 - 19세,1998,1452,745,707
'4422037000,  두마지소,'25,20 - 24세,1998,1037,502,535
'4422037000,  두마지소,'30,25 - 29세,1998,1848,859,989
'4422037000,  두마지소,'35,30 - 34세,1998,1882,963,919
'4422037000,  두마지소,'40,35 - 39세,1998,1744,816,928
'4422037000,  두마지소,'45,40 - 44세,1998,1519,772,747
'4422037000,  두마지소,'50,45 - 49세,1998,847,460,387
'4422037000,  두마지소,'55,50 - 54세,1998,484,251,233
'4422037000,  두마지소,'60,55 - 59세,1998,456,196,260
'4422037000,  두마지소,'65,60 - 64세,1998,486,187,299
'4422037000,  두마지소,'70,65 - 69세,1998,391,150,241
'4422037000,  두마지소,'75,70 - 74세,1998,327,132,195
'4422037000,  두마지소,'80,75 - 79세,1998,186,71,115
'4422037000,  두마지소,'85,80 - 84세,1998,101,35,66
'4422037000,  두마지소,'90,85+ ,1998,72,15,57
'4422037500,  남선지소,'00,계,1998,8518,4284,4234
'4422037500,  남선지소,'05,0 - 4세,1998,702,374,328
'4422037500,  남선지소,'10,5 - 9세,1998,969,497,472
'4422037500,  남선지소,'15,10 - 14세,1998,1165,602,563
'4422037500,  남선지소,'20,15 - 19세,1998,906,459,447
'4422037500,  남선지소,'25,20 - 24세,1998,316,192,124
'4422037500,  남선지소,'30,25 - 29세,1998,483,221,262
'4422037500,  남선지소,'35,30 - 34세,1998,788,343,445
'4422037500,  남선지소,'40,35 - 39세,1998,1171,493,678
'4422037500,  남선지소,'45,40 - 44세,1998,1287,707,580
'4422037500,  남선지소,'50,45 - 49세,1998,430,269,161
'4422037500,  남선지소,'55,50 - 54세,1998,117,86,31
'4422037500,  남선지소,'60,55 - 59세,1998,19,12,7
'4422037500,  남선지소,'65,60 - 64세,1998,29,3,26
'4422037500,  남선지소,'70,65 - 69세,1998,35,6,29
'4422037500,  남선지소,'75,70 - 74세,1998,40,9,31
'4422037500,  남선지소,'80,75 - 79세,1998,28,6,22
'4422037500,  남선지소,'85,80 - 84세,1998,21,2,19
'4422037500,  남선지소,'90,85+ ,1998,12,3,9
'44230, 논산시,'00,계,1998,146629,73269,73360
'44230, 논산시,'05,0 - 4세,1998,8370,4355,4015
'44230, 논산시,'10,5 - 9세,1998,8843,4672,4171
'44230, 논산시,'15,10 - 14세,1998,9941,5071,4870
'44230, 논산시,'20,15 - 19세,1998,13762,6925,6837
'44230, 논산시,'25,20 - 24세,1998,13368,7516,5852
'44230, 논산시,'30,25 - 29세,1998,11157,6222,4935
'44230, 논산시,'35,30 - 34세,1998,9797,5128,4669
'44230, 논산시,'40,35 - 39세,1998,10975,5756,5219
'44230, 논산시,'45,40 - 44세,1998,10299,5380,4919
'44230, 논산시,'50,45 - 49세,1998,7938,3991,3947
'44230, 논산시,'55,50 - 54세,1998,7220,3563,3657
'44230, 논산시,'60,55 - 59세,1998,8840,3970,4870
'44230, 논산시,'65,60 - 64세,1998,8809,3842,4967
'44230, 논산시,'70,65 - 69세,1998,6621,2821,3800
'44230, 논산시,'75,70 - 74세,1998,4893,2039,2854
'44230, 논산시,'80,75 - 79세,1998,3173,1220,1953
'44230, 논산시,'85,80 - 84세,1998,1634,561,1073
'44230, 논산시,'90,85+ ,1998,989,237,752
'4423025000,  강경읍,'00,계,1998,14327,7058,7269
'4423025000,  강경읍,'05,0 - 4세,1998,776,393,383
'4423025000,  강경읍,'10,5 - 9세,1998,856,449,407
'4423025000,  강경읍,'15,10 - 14세,1998,998,506,492
'4423025000,  강경읍,'20,15 - 19세,1998,1438,727,711
'4423025000,  강경읍,'25,20 - 24세,1998,1374,761,613
'4423025000,  강경읍,'30,25 - 29세,1998,1015,538,477
'4423025000,  강경읍,'35,30 - 34세,1998,920,458,462
'4423025000,  강경읍,'40,35 - 39세,1998,1008,530,478
'4423025000,  강경읍,'45,40 - 44세,1998,1059,543,516
'4423025000,  강경읍,'50,45 - 49세,1998,811,386,425
'4423025000,  강경읍,'55,50 - 54세,1998,778,392,386
'4423025000,  강경읍,'60,55 - 59세,1998,805,366,439
'4423025000,  강경읍,'65,60 - 64세,1998,836,371,465
'4423025000,  강경읍,'70,65 - 69세,1998,625,271,354
'4423025000,  강경읍,'75,70 - 74세,1998,481,189,292
'4423025000,  강경읍,'80,75 - 79세,1998,316,109,207
'4423025000,  강경읍,'85,80 - 84세,1998,144,54,90
'4423025000,  강경읍,'90,85+ ,1998,87,15,72
'4423025300,  연무읍,'00,계,1998,21850,10958,10892
'4423025300,  연무읍,'05,0 - 4세,1998,1318,686,632
'4423025300,  연무읍,'10,5 - 9세,1998,1333,683,650
'4423025300,  연무읍,'15,10 - 14세,1998,1494,768,726
'4423025300,  연무읍,'20,15 - 19세,1998,2015,1002,1013
'4423025300,  연무읍,'25,20 - 24세,1998,1994,1108,886
'4423025300,  연무읍,'30,25 - 29세,1998,1886,1061,825
'4423025300,  연무읍,'35,30 - 34세,1998,1541,847,694
'4423025300,  연무읍,'40,35 - 39세,1998,1640,838,802
'4423025300,  연무읍,'45,40 - 44세,1998,1470,788,682
'4423025300,  연무읍,'50,45 - 49세,1998,1171,591,580
'4423025300,  연무읍,'55,50 - 54세,1998,1026,512,514
'4423025300,  연무읍,'60,55 - 59세,1998,1189,531,658
'4423025300,  연무읍,'65,60 - 64세,1998,1269,523,746
'4423025300,  연무읍,'70,65 - 69세,1998,979,418,561
'4423025300,  연무읍,'75,70 - 74세,1998,729,301,428
'4423025300,  연무읍,'80,75 - 79세,1998,473,201,272
'4423025300,  연무읍,'85,80 - 84세,1998,199,65,134
'4423025300,  연무읍,'90,85+ ,1998,124,35,89
'4423031000,  성동면,'00,계,1998,7591,3844,3747
'4423031000,  성동면,'05,0 - 4세,1998,317,166,151
'4423031000,  성동면,'10,5 - 9세,1998,331,174,157
'4423031000,  성동면,'15,10 - 14세,1998,462,238,224
'4423031000,  성동면,'20,15 - 19세,1998,737,362,375
'4423031000,  성동면,'25,20 - 24세,1998,830,495,335
'4423031000,  성동면,'30,25 - 29세,1998,494,308,186
'4423031000,  성동면,'35,30 - 34세,1998,357,197,160
'4423031000,  성동면,'40,35 - 39세,1998,497,273,224
'4423031000,  성동면,'45,40 - 44세,1998,504,271,233
'4423031000,  성동면,'50,45 - 49세,1998,425,218,207
'4423031000,  성동면,'55,50 - 54세,1998,425,204,221
'4423031000,  성동면,'60,55 - 59세,1998,579,257,322
'4423031000,  성동면,'65,60 - 64세,1998,589,269,320
'4423031000,  성동면,'70,65 - 69세,1998,402,192,210
'4423031000,  성동면,'75,70 - 74세,1998,294,116,178
'4423031000,  성동면,'80,75 - 79세,1998,179,62,117
'4423031000,  성동면,'85,80 - 84세,1998,107,34,73
'4423031000,  성동면,'90,85+ ,1998,62,8,54
'4423032000,  광석면,'00,계,1998,7144,3616,3528
'4423032000,  광석면,'05,0 - 4세,1998,339,187,152
'4423032000,  광석면,'10,5 - 9세,1998,315,170,145
'4423032000,  광석면,'15,10 - 14세,1998,422,217,205
'4423032000,  광석면,'20,15 - 19세,1998,690,368,322
'4423032000,  광석면,'25,20 - 24세,1998,683,401,282
'4423032000,  광석면,'30,25 - 29세,1998,477,280,197
'4423032000,  광석면,'35,30 - 34세,1998,364,203,161
'4423032000,  광석면,'40,35 - 39세,1998,459,242,217
'4423032000,  광석면,'45,40 - 44세,1998,425,218,207
'4423032000,  광석면,'50,45 - 49세,1998,444,229,215
'4423032000,  광석면,'55,50 - 54세,1998,369,173,196
'4423032000,  광석면,'60,55 - 59세,1998,557,249,308
'4423032000,  광석면,'65,60 - 64세,1998,568,248,320
'4423032000,  광석면,'70,65 - 69세,1998,437,196,241
'4423032000,  광석면,'75,70 - 74세,1998,267,115,152
'4423032000,  광석면,'80,75 - 79세,1998,173,64,109
'4423032000,  광석면,'85,80 - 84세,1998,95,40,55
'4423032000,  광석면,'90,85+ ,1998,60,16,44
'4423033000,  노성면,'00,계,1998,5405,2730,2675
'4423033000,  노성면,'05,0 - 4세,1998,263,139,124
'4423033000,  노성면,'10,5 - 9세,1998,271,159,112
'4423033000,  노성면,'15,10 - 14세,1998,389,208,181
'4423033000,  노성면,'20,15 - 19세,1998,503,248,255
'4423033000,  노성면,'25,20 - 24세,1998,498,282,216
'4423033000,  노성면,'30,25 - 29세,1998,394,235,159
'4423033000,  노성면,'35,30 - 34세,1998,305,166,139
'4423033000,  노성면,'40,35 - 39세,1998,374,195,179
'4423033000,  노성면,'45,40 - 44세,1998,347,181,166
'4423033000,  노성면,'50,45 - 49세,1998,282,149,133
'4423033000,  노성면,'55,50 - 54세,1998,271,134,137
'4423033000,  노성면,'60,55 - 59세,1998,310,136,174
'4423033000,  노성면,'65,60 - 64세,1998,404,180,224
'4423033000,  노성면,'70,65 - 69세,1998,288,106,182
'4423033000,  노성면,'75,70 - 74세,1998,247,110,137
'4423033000,  노성면,'80,75 - 79세,1998,147,62,85
'4423033000,  노성면,'85,80 - 84세,1998,72,29,43
'4423033000,  노성면,'90,85+ ,1998,40,11,29
'4423034000,  상월면,'00,계,1998,4848,2437,2411
'4423034000,  상월면,'05,0 - 4세,1998,140,80,60
'4423034000,  상월면,'10,5 - 9세,1998,193,100,93
'4423034000,  상월면,'15,10 - 14세,1998,253,136,117
'4423034000,  상월면,'20,15 - 19세,1998,443,218,225
'4423034000,  상월면,'25,20 - 24세,1998,494,285,209
'4423034000,  상월면,'30,25 - 29세,1998,275,178,97
'4423034000,  상월면,'35,30 - 34세,1998,226,134,92
'4423034000,  상월면,'40,35 - 39세,1998,257,153,104
'4423034000,  상월면,'45,40 - 44세,1998,313,153,160
'4423034000,  상월면,'50,45 - 49세,1998,298,158,140
'4423034000,  상월면,'55,50 - 54세,1998,246,126,120
'4423034000,  상월면,'60,55 - 59세,1998,384,166,218
'4423034000,  상월면,'65,60 - 64세,1998,427,188,239
'4423034000,  상월면,'70,65 - 69세,1998,348,159,189
'4423034000,  상월면,'75,70 - 74세,1998,241,93,148
'4423034000,  상월면,'80,75 - 79세,1998,168,68,100
'4423034000,  상월면,'85,80 - 84세,1998,97,31,66
'4423034000,  상월면,'90,85+ ,1998,45,11,34
'4423035000,  부적면,'00,계,1998,5266,2624,2642
'4423035000,  부적면,'05,0 - 4세,1998,203,106,97
'4423035000,  부적면,'10,5 - 9세,1998,219,117,102
'4423035000,  부적면,'15,10 - 14세,1998,333,180,153
'4423035000,  부적면,'20,15 - 19세,1998,470,245,225
'4423035000,  부적면,'25,20 - 24세,1998,512,282,230
'4423035000,  부적면,'30,25 - 29세,1998,382,241,141
'4423035000,  부적면,'35,30 - 34세,1998,269,143,126
'4423035000,  부적면,'40,35 - 39세,1998,327,184,143
'4423035000,  부적면,'45,40 - 44세,1998,325,167,158
'4423035000,  부적면,'50,45 - 49세,1998,280,137,143
'4423035000,  부적면,'55,50 - 54세,1998,280,138,142
'4423035000,  부적면,'60,55 - 59세,1998,419,183,236
'4423035000,  부적면,'65,60 - 64세,1998,421,175,246
'4423035000,  부적면,'70,65 - 69세,1998,307,132,175
'4423035000,  부적면,'75,70 - 74세,1998,226,93,133
'4423035000,  부적면,'80,75 - 79세,1998,150,56,94
'4423035000,  부적면,'85,80 - 84세,1998,94,30,64
'4423035000,  부적면,'90,85+ ,1998,49,15,34
'4423036000,  연산면,'00,계,1998,8895,4495,4400
'4423036000,  연산면,'05,0 - 4세,1998,386,212,174
'4423036000,  연산면,'10,5 - 9세,1998,464,254,210
'4423036000,  연산면,'15,10 - 14세,1998,534,257,277
'4423036000,  연산면,'20,15 - 19세,1998,794,385,409
'4423036000,  연산면,'25,20 - 24세,1998,799,486,313
'4423036000,  연산면,'30,25 - 29세,1998,591,366,225
'4423036000,  연산면,'35,30 - 34세,1998,507,273,234
'4423036000,  연산면,'40,35 - 39세,1998,627,358,269
'4423036000,  연산면,'45,40 - 44세,1998,607,321,286
'4423036000,  연산면,'50,45 - 49세,1998,437,215,222
'4423036000,  연산면,'55,50 - 54세,1998,502,245,257
'4423036000,  연산면,'60,55 - 59세,1998,664,292,372
'4423036000,  연산면,'65,60 - 64세,1998,625,277,348
'4423036000,  연산면,'70,65 - 69세,1998,495,212,283
'4423036000,  연산면,'75,70 - 74세,1998,388,163,225
'4423036000,  연산면,'80,75 - 79세,1998,244,99,145
'4423036000,  연산면,'85,80 - 84세,1998,145,60,85
'4423036000,  연산면,'90,85+ ,1998,86,20,66
'4423038000,  벌곡면,'00,계,1998,3239,1640,1599
'4423038000,  벌곡면,'05,0 - 4세,1998,105,53,52
'4423038000,  벌곡면,'10,5 - 9세,1998,132,65,67
'4423038000,  벌곡면,'15,10 - 14세,1998,137,69,68
'4423038000,  벌곡면,'20,15 - 19세,1998,260,135,125
'4423038000,  벌곡면,'25,20 - 24세,1998,313,198,115
'4423038000,  벌곡면,'30,25 - 29세,1998,212,149,63
'4423038000,  벌곡면,'35,30 - 34세,1998,156,88,68
'4423038000,  벌곡면,'40,35 - 39세,1998,184,91,93
'4423038000,  벌곡면,'45,40 - 44세,1998,215,117,98
'4423038000,  벌곡면,'50,45 - 49세,1998,170,88,82
'4423038000,  벌곡면,'55,50 - 54세,1998,196,89,107
'4423038000,  벌곡면,'60,55 - 59세,1998,278,129,149
'4423038000,  벌곡면,'65,60 - 64세,1998,269,125,144
'4423038000,  벌곡면,'70,65 - 69세,1998,220,91,129
'4423038000,  벌곡면,'75,70 - 74세,1998,180,70,110
'4423038000,  벌곡면,'80,75 - 79세,1998,108,45,63
'4423038000,  벌곡면,'85,80 - 84세,1998,72,25,47
'4423038000,  벌곡면,'90,85+ ,1998,32,13,19
'4423039000,  양촌면,'00,계,1998,8168,4132,4036
'4423039000,  양촌면,'05,0 - 4세,1998,329,180,149
'4423039000,  양촌면,'10,5 - 9세,1998,382,202,180
'4423039000,  양촌면,'15,10 - 14세,1998,492,254,238
'4423039000,  양촌면,'20,15 - 19세,1998,764,371,393
'4423039000,  양촌면,'25,20 - 24세,1998,754,432,322
'4423039000,  양촌면,'30,25 - 29세,1998,537,347,190
'4423039000,  양촌면,'35,30 - 34세,1998,409,231,178
'4423039000,  양촌면,'40,35 - 39세,1998,500,249,251
'4423039000,  양촌면,'45,40 - 44세,1998,523,292,231
'4423039000,  양촌면,'50,45 - 49세,1998,461,235,226
'4423039000,  양촌면,'55,50 - 54세,1998,450,222,228
'4423039000,  양촌면,'60,55 - 59세,1998,647,284,363
'4423039000,  양촌면,'65,60 - 64세,1998,649,288,361
'4423039000,  양촌면,'70,65 - 69세,1998,505,223,282
'4423039000,  양촌면,'75,70 - 74세,1998,370,174,196
'4423039000,  양촌면,'80,75 - 79세,1998,215,94,121
'4423039000,  양촌면,'85,80 - 84세,1998,102,35,67
'4423039000,  양촌면,'90,85+ ,1998,79,19,60
'4423040000,  가야곡면,'00,계,1998,5901,2998,2903
'4423040000,  가야곡면,'05,0 - 4세,1998,253,128,125
'4423040000,  가야곡면,'10,5 - 9세,1998,250,135,115
'4423040000,  가야곡면,'15,10 - 14세,1998,354,170,184
'4423040000,  가야곡면,'20,15 - 19세,1998,508,262,246
'4423040000,  가야곡면,'25,20 - 24세,1998,627,367,260
'4423040000,  가야곡면,'30,25 - 29세,1998,428,277,151
'4423040000,  가야곡면,'35,30 - 34세,1998,304,178,126
'4423040000,  가야곡면,'40,35 - 39세,1998,330,168,162
'4423040000,  가야곡면,'45,40 - 44세,1998,359,191,168
'4423040000,  가야곡면,'50,45 - 49세,1998,290,145,145
'4423040000,  가야곡면,'55,50 - 54세,1998,317,156,161
'4423040000,  가야곡면,'60,55 - 59세,1998,493,224,269
'4423040000,  가야곡면,'65,60 - 64세,1998,464,205,259
'4423040000,  가야곡면,'70,65 - 69세,1998,307,140,167
'4423040000,  가야곡면,'75,70 - 74세,1998,268,120,148
'4423040000,  가야곡면,'80,75 - 79세,1998,181,77,104
'4423040000,  가야곡면,'85,80 - 84세,1998,103,41,62
'4423040000,  가야곡면,'90,85+ ,1998,65,14,51
'4423041000,  은진면,'00,계,1998,5794,2930,2864
'4423041000,  은진면,'05,0 - 4세,1998,256,137,119
'4423041000,  은진면,'10,5 - 9세,1998,257,133,124
'4423041000,  은진면,'15,10 - 14세,1998,326,158,168
'4423041000,  은진면,'20,15 - 19세,1998,587,295,292
'4423041000,  은진면,'25,20 - 24세,1998,588,330,258
'4423041000,  은진면,'30,25 - 29세,1998,417,265,152
'4423041000,  은진면,'35,30 - 34세,1998,313,188,125
'4423041000,  은진면,'40,35 - 39세,1998,367,211,156
'4423041000,  은진면,'45,40 - 44세,1998,421,209,212
'4423041000,  은진면,'50,45 - 49세,1998,321,165,156
'4423041000,  은진면,'55,50 - 54세,1998,302,151,151
'4423041000,  은진면,'60,55 - 59세,1998,410,174,236
'4423041000,  은진면,'65,60 - 64세,1998,440,199,241
'4423041000,  은진면,'70,65 - 69세,1998,313,140,173
'4423041000,  은진면,'75,70 - 74세,1998,222,105,117
'4423041000,  은진면,'80,75 - 79세,1998,127,43,84
'4423041000,  은진면,'85,80 - 84세,1998,81,17,64
'4423041000,  은진면,'90,85+ ,1998,46,10,36
'4423042000,  채운면,'00,계,1998,4151,2050,2101
'4423042000,  채운면,'05,0 - 4세,1998,160,93,67
'4423042000,  채운면,'10,5 - 9세,1998,162,85,77
'4423042000,  채운면,'15,10 - 14세,1998,251,126,125
'4423042000,  채운면,'20,15 - 19세,1998,446,220,226
'4423042000,  채운면,'25,20 - 24세,1998,381,205,176
'4423042000,  채운면,'30,25 - 29세,1998,265,158,107
'4423042000,  채운면,'35,30 - 34세,1998,185,101,84
'4423042000,  채운면,'40,35 - 39세,1998,251,134,117
'4423042000,  채운면,'45,40 - 44세,1998,304,163,141
'4423042000,  채운면,'50,45 - 49세,1998,249,132,117
'4423042000,  채운면,'55,50 - 54세,1998,197,86,111
'4423042000,  채운면,'60,55 - 59세,1998,288,123,165
'4423042000,  채운면,'65,60 - 64세,1998,326,150,176
'4423042000,  채운면,'70,65 - 69세,1998,269,98,171
'4423042000,  채운면,'75,70 - 74세,1998,191,90,101
'4423042000,  채운면,'80,75 - 79세,1998,130,60,70
'4423042000,  채운면,'85,80 - 84세,1998,58,15,43
'4423042000,  채운면,'90,85+ ,1998,38,11,27
'4423051000,  취암동,'00,계,1998,23326,11523,11803
'4423051000,  취암동,'05,0 - 4세,1998,1521,793,728
'4423051000,  취암동,'10,5 - 9세,1998,1876,983,893
'4423051000,  취암동,'15,10 - 14세,1998,1943,999,944
'4423051000,  취암동,'20,15 - 19세,1998,2377,1192,1185
'4423051000,  취암동,'25,20 - 24세,1998,1997,1075,922
'4423051000,  취암동,'30,25 - 29세,1998,1738,883,855
'4423051000,  취암동,'35,30 - 34세,1998,1862,863,999
'4423051000,  취암동,'40,35 - 39세,1998,2130,1064,1066
'4423051000,  취암동,'45,40 - 44세,1998,1934,979,955
'4423051000,  취암동,'50,45 - 49세,1998,1347,677,670
'4423051000,  취암동,'55,50 - 54세,1998,1073,562,511
'4423051000,  취암동,'60,55 - 59세,1998,1038,477,561
'4423051000,  취암동,'65,60 - 64세,1998,841,357,484
'4423051000,  취암동,'70,65 - 69세,1998,648,274,374
'4423051000,  취암동,'75,70 - 74세,1998,434,160,274
'4423051000,  취암동,'80,75 - 79세,1998,300,101,199
'4423051000,  취암동,'85,80 - 84세,1998,162,56,106
'4423051000,  취암동,'90,85+ ,1998,105,28,77
'4423052000,  부창동,'00,계,1998,20724,10234,10490
'4423052000,  부창동,'05,0 - 4세,1998,2004,1002,1002
'4423052000,  부창동,'10,5 - 9세,1998,1802,963,839
'4423052000,  부창동,'15,10 - 14세,1998,1553,785,768
'4423052000,  부창동,'20,15 - 19세,1998,1730,895,835
'4423052000,  부창동,'25,20 - 24세,1998,1524,809,715
'4423052000,  부창동,'30,25 - 29세,1998,2046,936,1110
'4423052000,  부창동,'35,30 - 34세,1998,2079,1058,1021
'4423052000,  부창동,'40,35 - 39세,1998,2024,1066,958
'4423052000,  부창동,'45,40 - 44세,1998,1493,787,706
'4423052000,  부창동,'50,45 - 49세,1998,952,466,486
'4423052000,  부창동,'55,50 - 54세,1998,788,373,415
'4423052000,  부창동,'60,55 - 59세,1998,779,379,400
'4423052000,  부창동,'65,60 - 64세,1998,681,287,394
'4423052000,  부창동,'70,65 - 69세,1998,478,169,309
'4423052000,  부창동,'75,70 - 74세,1998,355,140,215
'4423052000,  부창동,'80,75 - 79세,1998,262,79,183
'4423052000,  부창동,'85,80 - 84세,1998,103,29,74
'4423052000,  부창동,'90,85+ ,1998,71,11,60
'44710, 금산군,'00,계,1998,67760,34188,33572
'44710, 금산군,'05,0 - 4세,1998,3634,1913,1721
'44710, 금산군,'10,5 - 9세,1998,3429,1838,1591
'44710, 금산군,'15,10 - 14세,1998,3858,1989,1869
'44710, 금산군,'20,15 - 19세,1998,6185,3169,3016
'44710, 금산군,'25,20 - 24세,1998,6539,3631,2908
'44710, 금산군,'30,25 - 29세,1998,5422,3228,2194
'44710, 금산군,'35,30 - 34세,1998,4259,2348,1911
'44710, 금산군,'40,35 - 39세,1998,4553,2441,2112
'44710, 금산군,'45,40 - 44세,1998,4314,2335,1979
'44710, 금산군,'50,45 - 49세,1998,3587,1787,1800
'44710, 금산군,'55,50 - 54세,1998,3568,1727,1841
'44710, 금산군,'60,55 - 59세,1998,4779,2148,2631
'44710, 금산군,'65,60 - 64세,1998,4766,2118,2648
'44710, 금산군,'70,65 - 69세,1998,3426,1477,1949
'44710, 금산군,'75,70 - 74세,1998,2419,1034,1385
'44710, 금산군,'80,75 - 79세,1998,1625,607,1018
'44710, 금산군,'85,80 - 84세,1998,865,285,580
'44710, 금산군,'90,85+ ,1998,532,113,419
'4471025000,  금산읍,'00,계,1998,25015,12601,12414
'4471025000,  금산읍,'05,0 - 4세,1998,1781,952,829
'4471025000,  금산읍,'10,5 - 9세,1998,1678,904,774
'4471025000,  금산읍,'15,10 - 14세,1998,1601,855,746
'4471025000,  금산읍,'20,15 - 19세,1998,2347,1221,1126
'4471025000,  금산읍,'25,20 - 24세,1998,2327,1221,1106
'4471025000,  금산읍,'30,25 - 29세,1998,2237,1194,1043
'4471025000,  금산읍,'35,30 - 34세,1998,1901,960,941
'4471025000,  금산읍,'40,35 - 39세,1998,1973,1011,962
'4471025000,  금산읍,'45,40 - 44세,1998,1784,945,839
'4471025000,  금산읍,'50,45 - 49세,1998,1415,697,718
'4471025000,  금산읍,'55,50 - 54세,1998,1297,645,652
'4471025000,  금산읍,'60,55 - 59세,1998,1417,653,764
'4471025000,  금산읍,'65,60 - 64세,1998,1136,520,616
'4471025000,  금산읍,'70,65 - 69세,1998,830,349,481
'4471025000,  금산읍,'75,70 - 74세,1998,584,245,339
'4471025000,  금산읍,'80,75 - 79세,1998,385,130,255
'4471025000,  금산읍,'85,80 - 84세,1998,212,70,142
'4471025000,  금산읍,'90,85+ ,1998,110,29,81
'4471031000,  금성면,'00,계,1998,5640,2830,2810
'4471031000,  금성면,'05,0 - 4세,1998,291,156,135
'4471031000,  금성면,'10,5 - 9세,1998,242,140,102
'4471031000,  금성면,'15,10 - 14세,1998,331,165,166
'4471031000,  금성면,'20,15 - 19세,1998,508,246,262
'4471031000,  금성면,'25,20 - 24세,1998,518,286,232
'4471031000,  금성면,'30,25 - 29세,1998,415,258,157
'4471031000,  금성면,'35,30 - 34세,1998,315,199,116
'4471031000,  금성면,'40,35 - 39세,1998,336,184,152
'4471031000,  금성면,'45,40 - 44세,1998,332,186,146
'4471031000,  금성면,'50,45 - 49세,1998,273,145,128
'4471031000,  금성면,'55,50 - 54세,1998,289,133,156
'4471031000,  금성면,'60,55 - 59세,1998,394,168,226
'4471031000,  금성면,'65,60 - 64세,1998,428,178,250
'4471031000,  금성면,'70,65 - 69세,1998,399,169,230
'4471031000,  금성면,'75,70 - 74세,1998,273,130,143
'4471031000,  금성면,'80,75 - 79세,1998,160,52,108
'4471031000,  금성면,'85,80 - 84세,1998,80,24,56
'4471031000,  금성면,'90,85+ ,1998,56,11,45
'4471032000,  제원면,'00,계,1998,4522,2278,2244
'4471032000,  제원면,'05,0 - 4세,1998,157,87,70
'4471032000,  제원면,'10,5 - 9세,1998,153,83,70
'4471032000,  제원면,'15,10 - 14세,1998,273,130,143
'4471032000,  제원면,'20,15 - 19세,1998,432,223,209
'4471032000,  제원면,'25,20 - 24세,1998,422,243,179
'4471032000,  제원면,'30,25 - 29세,1998,306,213,93
'4471032000,  제원면,'35,30 - 34세,1998,163,87,76
'4471032000,  제원면,'40,35 - 39세,1998,250,130,120
'4471032000,  제원면,'45,40 - 44세,1998,296,153,143
'4471032000,  제원면,'50,45 - 49세,1998,244,128,116
'4471032000,  제원면,'55,50 - 54세,1998,253,111,142
'4471032000,  제원면,'60,55 - 59세,1998,388,190,198
'4471032000,  제원면,'65,60 - 64세,1998,411,185,226
'4471032000,  제원면,'70,65 - 69세,1998,299,125,174
'4471032000,  제원면,'75,70 - 74세,1998,192,85,107
'4471032000,  제원면,'80,75 - 79세,1998,148,61,87
'4471032000,  제원면,'85,80 - 84세,1998,84,32,52
'4471032000,  제원면,'90,85+ ,1998,51,12,39
'4471033000,  부리면,'00,계,1998,4630,2295,2335
'4471033000,  부리면,'05,0 - 4세,1998,141,77,64
'4471033000,  부리면,'10,5 - 9세,1998,122,57,65
'4471033000,  부리면,'15,10 - 14세,1998,246,128,118
'4471033000,  부리면,'20,15 - 19세,1998,438,230,208
'4471033000,  부리면,'25,20 - 24세,1998,482,287,195
'4471033000,  부리면,'30,25 - 29세,1998,290,197,93
'4471033000,  부리면,'35,30 - 34세,1998,165,98,67
'4471033000,  부리면,'40,35 - 39세,1998,224,119,105
'4471033000,  부리면,'45,40 - 44세,1998,254,136,118
'4471033000,  부리면,'50,45 - 49세,1998,281,135,146
'4471033000,  부리면,'55,50 - 54세,1998,242,119,123
'4471033000,  부리면,'60,55 - 59세,1998,413,181,232
'4471033000,  부리면,'65,60 - 64세,1998,480,202,278
'4471033000,  부리면,'70,65 - 69세,1998,324,136,188
'4471033000,  부리면,'75,70 - 74세,1998,230,100,130
'4471033000,  부리면,'80,75 - 79세,1998,148,58,90
'4471033000,  부리면,'85,80 - 84세,1998,92,28,64
'4471033000,  부리면,'90,85+ ,1998,58,7,51
'4471034000,  군북면,'00,계,1998,3665,1821,1844
'4471034000,  군북면,'05,0 - 4세,1998,124,62,62
'4471034000,  군북면,'10,5 - 9세,1998,153,80,73
'4471034000,  군북면,'15,10 - 14세,1998,210,112,98
'4471034000,  군북면,'20,15 - 19세,1998,337,144,193
'4471034000,  군북면,'25,20 - 24세,1998,355,214,141
'4471034000,  군북면,'30,25 - 29세,1998,244,164,80
'4471034000,  군북면,'35,30 - 34세,1998,183,99,84
'4471034000,  군북면,'40,35 - 39세,1998,194,115,79
'4471034000,  군북면,'45,40 - 44세,1998,248,130,118
'4471034000,  군북면,'50,45 - 49세,1998,204,100,104
'4471034000,  군북면,'55,50 - 54세,1998,200,103,97
'4471034000,  군북면,'60,55 - 59세,1998,281,115,166
'4471034000,  군북면,'65,60 - 64세,1998,347,155,192
'4471034000,  군북면,'70,65 - 69세,1998,243,103,140
'4471034000,  군북면,'75,70 - 74세,1998,155,66,89
'4471034000,  군북면,'80,75 - 79세,1998,92,37,55
'4471034000,  군북면,'85,80 - 84세,1998,59,19,40
'4471034000,  군북면,'90,85+ ,1998,36,3,33
'4471035000,  남일면,'00,계,1998,3789,1912,1877
'4471035000,  남일면,'05,0 - 4세,1998,129,68,61
'4471035000,  남일면,'10,5 - 9세,1998,114,60,54
'4471035000,  남일면,'15,10 - 14세,1998,154,70,84
'4471035000,  남일면,'20,15 - 19세,1998,349,167,182
'4471035000,  남일면,'25,20 - 24세,1998,381,233,148
'4471035000,  남일면,'30,25 - 29세,1998,244,172,72
'4471035000,  남일면,'35,30 - 34세,1998,154,98,56
'4471035000,  남일면,'40,35 - 39세,1998,216,123,93
'4471035000,  남일면,'45,40 - 44세,1998,194,108,86
'4471035000,  남일면,'50,45 - 49세,1998,202,99,103
'4471035000,  남일면,'55,50 - 54세,1998,206,95,111
'4471035000,  남일면,'60,55 - 59세,1998,330,145,185
'4471035000,  남일면,'65,60 - 64세,1998,399,173,226
'4471035000,  남일면,'70,65 - 69세,1998,261,126,135
'4471035000,  남일면,'75,70 - 74세,1998,203,87,116
'4471035000,  남일면,'80,75 - 79세,1998,131,55,76
'4471035000,  남일면,'85,80 - 84세,1998,71,23,48
'4471035000,  남일면,'90,85+ ,1998,51,10,41
'4471036000,  남이면,'00,계,1998,3086,1596,1490
'4471036000,  남이면,'05,0 - 4세,1998,104,65,39
'4471036000,  남이면,'10,5 - 9세,1998,70,39,31
'4471036000,  남이면,'15,10 - 14세,1998,138,69,69
'4471036000,  남이면,'20,15 - 19세,1998,243,120,123
'4471036000,  남이면,'25,20 - 24세,1998,326,196,130
'4471036000,  남이면,'30,25 - 29세,1998,225,157,68
'4471036000,  남이면,'35,30 - 34세,1998,134,91,43
'4471036000,  남이면,'40,35 - 39세,1998,165,96,69
'4471036000,  남이면,'45,40 - 44세,1998,169,99,70
'4471036000,  남이면,'50,45 - 49세,1998,108,56,52
'4471036000,  남이면,'55,50 - 54세,1998,204,91,113
'4471036000,  남이면,'60,55 - 59세,1998,327,157,170
'4471036000,  남이면,'65,60 - 64세,1998,321,149,172
'4471036000,  남이면,'70,65 - 69세,1998,215,80,135
'4471036000,  남이면,'75,70 - 74세,1998,126,55,71
'4471036000,  남이면,'80,75 - 79세,1998,117,47,70
'4471036000,  남이면,'85,80 - 84세,1998,56,18,38
'4471036000,  남이면,'90,85+ ,1998,38,11,27
'4471037000,  진산면,'00,계,1998,4763,2382,2381
'4471037000,  진산면,'05,0 - 4세,1998,213,102,111
'4471037000,  진산면,'10,5 - 9세,1998,175,85,90
'4471037000,  진산면,'15,10 - 14세,1998,207,100,107
'4471037000,  진산면,'20,15 - 19세,1998,373,206,167
'4471037000,  진산면,'25,20 - 24세,1998,509,293,216
'4471037000,  진산면,'30,25 - 29세,1998,426,257,169
'4471037000,  진산면,'35,30 - 34세,1998,281,163,118
'4471037000,  진산면,'40,35 - 39세,1998,270,152,118
'4471037000,  진산면,'45,40 - 44세,1998,258,129,129
'4471037000,  진산면,'50,45 - 49세,1998,236,109,127
'4471037000,  진산면,'55,50 - 54세,1998,285,149,136
'4471037000,  진산면,'60,55 - 59세,1998,399,162,237
'4471037000,  진산면,'65,60 - 64세,1998,386,180,206
'4471037000,  진산면,'70,65 - 69세,1998,297,136,161
'4471037000,  진산면,'75,70 - 74세,1998,215,86,129
'4471037000,  진산면,'80,75 - 79세,1998,130,44,86
'4471037000,  진산면,'85,80 - 84세,1998,61,19,42
'4471037000,  진산면,'90,85+ ,1998,42,10,32
'4471038000,  복수면,'00,계,1998,4725,2442,2283
'4471038000,  복수면,'05,0 - 4세,1998,256,129,127
'4471038000,  복수면,'10,5 - 9세,1998,210,108,102
'4471038000,  복수면,'15,10 - 14세,1998,212,120,92
'4471038000,  복수면,'20,15 - 19세,1998,427,230,197
'4471038000,  복수면,'25,20 - 24세,1998,451,234,217
'4471038000,  복수면,'30,25 - 29세,1998,392,238,154
'4471038000,  복수면,'35,30 - 34세,1998,339,209,130
'4471038000,  복수면,'40,35 - 39세,1998,317,177,140
'4471038000,  복수면,'45,40 - 44세,1998,305,173,132
'4471038000,  복수면,'50,45 - 49세,1998,283,151,132
'4471038000,  복수면,'55,50 - 54세,1998,238,118,120
'4471038000,  복수면,'60,55 - 59세,1998,341,155,186
'4471038000,  복수면,'65,60 - 64세,1998,326,145,181
'4471038000,  복수면,'70,65 - 69세,1998,220,100,120
'4471038000,  복수면,'75,70 - 74세,1998,191,73,118
'4471038000,  복수면,'80,75 - 79세,1998,121,52,69
'4471038000,  복수면,'85,80 - 84세,1998,59,26,33
'4471038000,  복수면,'90,85+ ,1998,37,4,33
'4471039000,  추부면,'00,계,1998,7925,4031,3894
'4471039000,  추부면,'05,0 - 4세,1998,438,215,223
'4471039000,  추부면,'10,5 - 9세,1998,512,282,230
'4471039000,  추부면,'15,10 - 14세,1998,486,240,246
'4471039000,  추부면,'20,15 - 19세,1998,731,382,349
'4471039000,  추부면,'25,20 - 24세,1998,768,424,344
'4471039000,  추부면,'30,25 - 29세,1998,643,378,265
'4471039000,  추부면,'35,30 - 34세,1998,624,344,280
'4471039000,  추부면,'40,35 - 39세,1998,608,334,274
'4471039000,  추부면,'45,40 - 44세,1998,474,276,198
'4471039000,  추부면,'50,45 - 49세,1998,341,167,174
'4471039000,  추부면,'55,50 - 54세,1998,354,163,191
'4471039000,  추부면,'60,55 - 59세,1998,489,222,267
'4471039000,  추부면,'65,60 - 64세,1998,532,231,301
'4471039000,  추부면,'70,65 - 69세,1998,338,153,185
'4471039000,  추부면,'75,70 - 74세,1998,250,107,143
'4471039000,  추부면,'80,75 - 79세,1998,193,71,122
'4471039000,  추부면,'85,80 - 84세,1998,91,26,65
'4471039000,  추부면,'90,85+ ,1998,53,16,37
'44730, 연기군,'00,계,1998,80601,40368,40233
'44730, 연기군,'05,0 - 4세,1998,5073,2640,2433
'44730, 연기군,'10,5 - 9세,1998,5068,2620,2448
'44730, 연기군,'15,10 - 14세,1998,4895,2498,2397
'44730, 연기군,'20,15 - 19세,1998,7296,3511,3785
'44730, 연기군,'25,20 - 24세,1998,7705,4085,3620
'44730, 연기군,'30,25 - 29세,1998,7121,4067,3054
'44730, 연기군,'35,30 - 34세,1998,5881,3129,2752
'44730, 연기군,'40,35 - 39세,1998,6067,3245,2822
'44730, 연기군,'45,40 - 44세,1998,5321,2795,2526
'44730, 연기군,'50,45 - 49세,1998,4299,2201,2098
'44730, 연기군,'55,50 - 54세,1998,3645,1803,1842
'44730, 연기군,'60,55 - 59세,1998,4627,2081,2546
'44730, 연기군,'65,60 - 64세,1998,4485,2070,2415
'44730, 연기군,'70,65 - 69세,1998,3510,1436,2074
'44730, 연기군,'75,70 - 74세,1998,2429,1038,1391
'44730, 연기군,'80,75 - 79세,1998,1725,708,1017
'44730, 연기군,'85,80 - 84세,1998,924,296,628
'44730, 연기군,'90,85+ ,1998,530,145,385
'4473025000,  조치원읍,'00,계,1998,32865,16502,16363
'4473025000,  조치원읍,'05,0 - 4세,1998,2577,1332,1245
'4473025000,  조치원읍,'10,5 - 9세,1998,2534,1313,1221
'4473025000,  조치원읍,'15,10 - 14세,1998,2227,1116,1111
'4473025000,  조치원읍,'20,15 - 19세,1998,2758,1394,1364
'4473025000,  조치원읍,'25,20 - 24세,1998,3011,1557,1454
'4473025000,  조치원읍,'30,25 - 29세,1998,3332,1788,1544
'4473025000,  조치원읍,'35,30 - 34세,1998,2886,1476,1410
'4473025000,  조치원읍,'40,35 - 39세,1998,2944,1561,1383
'4473025000,  조치원읍,'45,40 - 44세,1998,2346,1219,1127
'4473025000,  조치원읍,'50,45 - 49세,1998,1696,856,840
'4473025000,  조치원읍,'55,50 - 54세,1998,1398,668,730
'4473025000,  조치원읍,'60,55 - 59세,1998,1581,748,833
'4473025000,  조치원읍,'65,60 - 64세,1998,1295,607,688
'4473025000,  조치원읍,'70,65 - 69세,1998,867,356,511
'4473025000,  조치원읍,'75,70 - 74세,1998,636,241,395
'4473025000,  조치원읍,'80,75 - 79세,1998,433,166,267
'4473025000,  조치원읍,'85,80 - 84세,1998,218,70,148
'4473025000,  조치원읍,'90,85+ ,1998,126,34,92
'4473031000,  동면,'00,계,1998,4965,2252,2713
'4473031000,  동면,'05,0 - 4세,1998,201,114,87
'4473031000,  동면,'10,5 - 9세,1998,196,89,107
'4473031000,  동면,'15,10 - 14세,1998,239,119,120
'4473031000,  동면,'20,15 - 19세,1998,670,193,477
'4473031000,  동면,'25,20 - 24세,1998,580,245,335
'4473031000,  동면,'30,25 - 29세,1998,341,213,128
'4473031000,  동면,'35,30 - 34세,1998,228,133,95
'4473031000,  동면,'40,35 - 39세,1998,261,148,113
'4473031000,  동면,'45,40 - 44세,1998,300,157,143
'4473031000,  동면,'50,45 - 49세,1998,236,117,119
'4473031000,  동면,'55,50 - 54세,1998,231,124,107
'4473031000,  동면,'60,55 - 59세,1998,302,124,178
'4473031000,  동면,'65,60 - 64세,1998,356,151,205
'4473031000,  동면,'70,65 - 69세,1998,316,130,186
'4473031000,  동면,'75,70 - 74세,1998,225,91,134
'4473031000,  동면,'80,75 - 79세,1998,154,56,98
'4473031000,  동면,'85,80 - 84세,1998,82,31,51
'4473031000,  동면,'90,85+ ,1998,47,17,30
'4473032000,  서면,'00,계,1998,8590,4332,4258
'4473032000,  서면,'05,0 - 4세,1998,478,252,226
'4473032000,  서면,'10,5 - 9세,1998,456,233,223
'4473032000,  서면,'15,10 - 14세,1998,476,238,238
'4473032000,  서면,'20,15 - 19세,1998,772,358,414
'4473032000,  서면,'25,20 - 24세,1998,822,459,363
'4473032000,  서면,'30,25 - 29세,1998,747,454,293
'4473032000,  서면,'35,30 - 34세,1998,545,310,235
'4473032000,  서면,'40,35 - 39세,1998,574,296,278
'4473032000,  서면,'45,40 - 44세,1998,560,305,255
'4473032000,  서면,'50,45 - 49세,1998,477,241,236
'4473032000,  서면,'55,50 - 54세,1998,412,210,202
'4473032000,  서면,'60,55 - 59세,1998,568,244,324
'4473032000,  서면,'65,60 - 64세,1998,585,284,301
'4473032000,  서면,'70,65 - 69세,1998,409,175,234
'4473032000,  서면,'75,70 - 74세,1998,266,122,144
'4473032000,  서면,'80,75 - 79세,1998,235,99,136
'4473032000,  서면,'85,80 - 84세,1998,137,37,100
'4473032000,  서면,'90,85+ ,1998,71,15,56
'4473033000,  남면,'00,계,1998,9114,4636,4478
'4473033000,  남면,'05,0 - 4세,1998,487,257,230
'4473033000,  남면,'10,5 - 9세,1998,514,288,226
'4473033000,  남면,'15,10 - 14세,1998,532,282,250
'4473033000,  남면,'20,15 - 19세,1998,864,447,417
'4473033000,  남면,'25,20 - 24세,1998,870,457,413
'4473033000,  남면,'30,25 - 29세,1998,729,461,268
'4473033000,  남면,'35,30 - 34세,1998,562,303,259
'4473033000,  남면,'40,35 - 39세,1998,617,321,296
'4473033000,  남면,'45,40 - 44세,1998,548,291,257
'4473033000,  남면,'50,45 - 49세,1998,550,290,260
'4473033000,  남면,'55,50 - 54세,1998,428,227,201
'4473033000,  남면,'60,55 - 59세,1998,590,251,339
'4473033000,  남면,'65,60 - 64세,1998,587,265,322
'4473033000,  남면,'70,65 - 69세,1998,469,185,284
'4473033000,  남면,'75,70 - 74세,1998,347,156,191
'4473033000,  남면,'80,75 - 79세,1998,211,96,115
'4473033000,  남면,'85,80 - 84세,1998,128,41,87
'4473033000,  남면,'90,85+ ,1998,81,18,63
'4473034000,  금남면,'00,계,1998,9489,4823,4666
'4473034000,  금남면,'05,0 - 4세,1998,369,180,189
'4473034000,  금남면,'10,5 - 9세,1998,446,221,225
'4473034000,  금남면,'15,10 - 14세,1998,557,305,252
'4473034000,  금남면,'20,15 - 19세,1998,918,474,444
'4473034000,  금남면,'25,20 - 24세,1998,936,548,388
'4473034000,  금남면,'30,25 - 29세,1998,669,435,234
'4473034000,  금남면,'35,30 - 34세,1998,529,292,237
'4473034000,  금남면,'40,35 - 39세,1998,575,322,253
'4473034000,  금남면,'45,40 - 44세,1998,595,295,300
'4473034000,  금남면,'50,45 - 49세,1998,570,311,259
'4473034000,  금남면,'55,50 - 54세,1998,477,230,247
'4473034000,  금남면,'60,55 - 59세,1998,700,316,384
'4473034000,  금남면,'65,60 - 64세,1998,647,298,349
'4473034000,  금남면,'70,65 - 69세,1998,596,242,354
'4473034000,  금남면,'75,70 - 74세,1998,383,163,220
'4473034000,  금남면,'80,75 - 79세,1998,285,117,168
'4473034000,  금남면,'85,80 - 84세,1998,153,53,100
'4473034000,  금남면,'90,85+ ,1998,84,21,63
'4473035000,  전의면,'00,계,1998,7588,3799,3789
'4473035000,  전의면,'05,0 - 4세,1998,447,238,209
'4473035000,  전의면,'10,5 - 9세,1998,470,241,229
'4473035000,  전의면,'15,10 - 14세,1998,427,214,213
'4473035000,  전의면,'20,15 - 19세,1998,645,314,331
'4473035000,  전의면,'25,20 - 24세,1998,734,407,327
'4473035000,  전의면,'30,25 - 29세,1998,631,338,293
'4473035000,  전의면,'35,30 - 34세,1998,527,275,252
'4473035000,  전의면,'40,35 - 39세,1998,550,303,247
'4473035000,  전의면,'45,40 - 44세,1998,484,253,231
'4473035000,  전의면,'50,45 - 49세,1998,365,191,174
'4473035000,  전의면,'55,50 - 54세,1998,357,167,190
'4473035000,  전의면,'60,55 - 59세,1998,447,197,250
'4473035000,  전의면,'65,60 - 64세,1998,501,242,259
'4473035000,  전의면,'70,65 - 69세,1998,379,160,219
'4473035000,  전의면,'75,70 - 74세,1998,293,130,163
'4473035000,  전의면,'80,75 - 79세,1998,190,83,107
'4473035000,  전의면,'85,80 - 84세,1998,90,26,64
'4473035000,  전의면,'90,85+ ,1998,51,20,31
'4473036000,  전동면,'00,계,1998,4642,2360,2282
'4473036000,  전동면,'05,0 - 4세,1998,236,123,113
'4473036000,  전동면,'10,5 - 9세,1998,252,130,122
'4473036000,  전동면,'15,10 - 14세,1998,270,139,131
'4473036000,  전동면,'20,15 - 19세,1998,397,196,201
'4473036000,  전동면,'25,20 - 24세,1998,429,240,189
'4473036000,  전동면,'30,25 - 29세,1998,327,205,122
'4473036000,  전동면,'35,30 - 34세,1998,336,182,154
'4473036000,  전동면,'40,35 - 39세,1998,311,170,141
'4473036000,  전동면,'45,40 - 44세,1998,292,173,119
'4473036000,  전동면,'50,45 - 49세,1998,245,116,129
'4473036000,  전동면,'55,50 - 54세,1998,201,107,94
'4473036000,  전동면,'60,55 - 59세,1998,261,124,137
'4473036000,  전동면,'65,60 - 64세,1998,332,144,188
'4473036000,  전동면,'70,65 - 69세,1998,302,116,186
'4473036000,  전동면,'75,70 - 74세,1998,180,92,88
'4473036000,  전동면,'80,75 - 79세,1998,153,64,89
'4473036000,  전동면,'85,80 - 84세,1998,70,24,46
'4473036000,  전동면,'90,85+ ,1998,48,15,33
'4473037000,  소정면,'00,계,1998,3348,1664,1684
'4473037000,  소정면,'05,0 - 4세,1998,278,144,134
'4473037000,  소정면,'10,5 - 9세,1998,200,105,95
'4473037000,  소정면,'15,10 - 14세,1998,167,85,82
'4473037000,  소정면,'20,15 - 19세,1998,272,135,137
'4473037000,  소정면,'25,20 - 24세,1998,323,172,151
'4473037000,  소정면,'30,25 - 29세,1998,345,173,172
'4473037000,  소정면,'35,30 - 34세,1998,268,158,110
'4473037000,  소정면,'40,35 - 39세,1998,235,124,111
'4473037000,  소정면,'45,40 - 44세,1998,196,102,94
'4473037000,  소정면,'50,45 - 49세,1998,160,79,81
'4473037000,  소정면,'55,50 - 54세,1998,141,70,71
'4473037000,  소정면,'60,55 - 59세,1998,178,77,101
'4473037000,  소정면,'65,60 - 64세,1998,182,79,103
'4473037000,  소정면,'70,65 - 69세,1998,172,72,100
'4473037000,  소정면,'75,70 - 74세,1998,99,43,56
'4473037000,  소정면,'80,75 - 79세,1998,64,27,37
'4473037000,  소정면,'85,80 - 84세,1998,46,14,32
'4473037000,  소정면,'90,85+ ,1998,22,5,17
'44760, 부여군,'00,계,1998,97065,48391,48674
'44760, 부여군,'05,0 - 4세,1998,4648,2426,2222
'44760, 부여군,'10,5 - 9세,1998,5160,2743,2417
'44760, 부여군,'15,10 - 14세,1998,6343,3305,3038
'44760, 부여군,'20,15 - 19세,1998,9726,4963,4763
'44760, 부여군,'25,20 - 24세,1998,9040,5201,3839
'44760, 부여군,'30,25 - 29세,1998,5989,3511,2478
'44760, 부여군,'35,30 - 34세,1998,5259,2822,2437
'44760, 부여군,'40,35 - 39세,1998,6467,3242,3225
'44760, 부여군,'45,40 - 44세,1998,6613,3350,3263
'44760, 부여군,'50,45 - 49세,1998,5448,2728,2720
'44760, 부여군,'55,50 - 54세,1998,5064,2456,2608
'44760, 부여군,'60,55 - 59세,1998,6551,2991,3560
'44760, 부여군,'65,60 - 64세,1998,6890,3081,3809
'44760, 부여군,'70,65 - 69세,1998,5325,2364,2961
'44760, 부여군,'75,70 - 74세,1998,3930,1654,2276
'44760, 부여군,'80,75 - 79세,1998,2488,947,1541
'44760, 부여군,'85,80 - 84세,1998,1311,420,891
'44760, 부여군,'90,85+ ,1998,813,187,626
'4476025000,  부여읍,'00,계,1998,29568,14754,14814
'4476025000,  부여읍,'05,0 - 4세,1998,1945,1039,906
'4476025000,  부여읍,'10,5 - 9세,1998,2178,1205,973
'4476025000,  부여읍,'15,10 - 14세,1998,2338,1213,1125
'4476025000,  부여읍,'20,15 - 19세,1998,2935,1512,1423
'4476025000,  부여읍,'25,20 - 24세,1998,2616,1403,1213
'4476025000,  부여읍,'30,25 - 29세,1998,2134,1104,1030
'4476025000,  부여읍,'35,30 - 34세,1998,2144,1104,1040
'4476025000,  부여읍,'40,35 - 39세,1998,2506,1196,1310
'4476025000,  부여읍,'45,40 - 44세,1998,2346,1166,1180
'4476025000,  부여읍,'50,45 - 49세,1998,1638,840,798
'4476025000,  부여읍,'55,50 - 54세,1998,1372,677,695
'4476025000,  부여읍,'60,55 - 59세,1998,1480,695,785
'4476025000,  부여읍,'65,60 - 64세,1998,1338,618,720
'4476025000,  부여읍,'70,65 - 69세,1998,986,423,563
'4476025000,  부여읍,'75,70 - 74세,1998,733,288,445
'4476025000,  부여읍,'80,75 - 79세,1998,449,157,292
'4476025000,  부여읍,'85,80 - 84세,1998,267,78,189
'4476025000,  부여읍,'90,85+ ,1998,163,36,127
'4476031000,  규암면,'00,계,1998,10926,5461,5465
'4476031000,  규암면,'05,0 - 4세,1998,616,333,283
'4476031000,  규암면,'10,5 - 9세,1998,553,289,264
'4476031000,  규암면,'15,10 - 14세,1998,654,346,308
'4476031000,  규암면,'20,15 - 19세,1998,1100,557,543
'4476031000,  규암면,'25,20 - 24세,1998,1003,551,452
'4476031000,  규암면,'30,25 - 29세,1998,719,421,298
'4476031000,  규암면,'35,30 - 34세,1998,642,356,286
'4476031000,  규암면,'40,35 - 39세,1998,745,390,355
'4476031000,  규암면,'45,40 - 44세,1998,724,364,360
'4476031000,  규암면,'50,45 - 49세,1998,619,312,307
'4476031000,  규암면,'55,50 - 54세,1998,540,254,286
'4476031000,  규암면,'60,55 - 59세,1998,723,334,389
'4476031000,  규암면,'65,60 - 64세,1998,761,343,418
'4476031000,  규암면,'70,65 - 69세,1998,586,253,333
'4476031000,  규암면,'75,70 - 74세,1998,462,187,275
'4476031000,  규암면,'80,75 - 79세,1998,256,109,147
'4476031000,  규암면,'85,80 - 84세,1998,138,46,92
'4476031000,  규암면,'90,85+ ,1998,85,16,69
'4476032000,  은산면,'00,계,1998,6110,3058,3052
'4476032000,  은산면,'05,0 - 4세,1998,275,137,138
'4476032000,  은산면,'10,5 - 9세,1998,285,154,131
'4476032000,  은산면,'15,10 - 14세,1998,345,183,162
'4476032000,  은산면,'20,15 - 19세,1998,617,304,313
'4476032000,  은산면,'25,20 - 24세,1998,618,362,256
'4476032000,  은산면,'30,25 - 29세,1998,363,212,151
'4476032000,  은산면,'35,30 - 34세,1998,298,163,135
'4476032000,  은산면,'40,35 - 39세,1998,345,186,159
'4476032000,  은산면,'45,40 - 44세,1998,378,186,192
'4476032000,  은산면,'50,45 - 49세,1998,337,170,167
'4476032000,  은산면,'55,50 - 54세,1998,306,157,149
'4476032000,  은산면,'60,55 - 59세,1998,437,205,232
'4476032000,  은산면,'65,60 - 64세,1998,528,225,303
'4476032000,  은산면,'70,65 - 69세,1998,355,160,195
'4476032000,  은산면,'75,70 - 74세,1998,286,127,159
'4476032000,  은산면,'80,75 - 79세,1998,193,76,117
'4476032000,  은산면,'85,80 - 84세,1998,92,32,60
'4476032000,  은산면,'90,85+ ,1998,52,19,33
'4476033000,  외산면,'00,계,1998,4128,2064,2064
'4476033000,  외산면,'05,0 - 4세,1998,127,76,51
'4476033000,  외산면,'10,5 - 9세,1998,147,78,69
'4476033000,  외산면,'15,10 - 14세,1998,277,141,136
'4476033000,  외산면,'20,15 - 19세,1998,490,226,264
'4476033000,  외산면,'25,20 - 24세,1998,428,260,168
'4476033000,  외산면,'30,25 - 29세,1998,238,148,90
'4476033000,  외산면,'35,30 - 34세,1998,166,84,82
'4476033000,  외산면,'40,35 - 39세,1998,258,134,124
'4476033000,  외산면,'45,40 - 44세,1998,264,118,146
'4476033000,  외산면,'50,45 - 49세,1998,273,135,138
'4476033000,  외산면,'55,50 - 54세,1998,261,136,125
'4476033000,  외산면,'60,55 - 59세,1998,335,166,169
'4476033000,  외산면,'65,60 - 64세,1998,294,139,155
'4476033000,  외산면,'70,65 - 69세,1998,229,103,126
'4476033000,  외산면,'75,70 - 74세,1998,150,64,86
'4476033000,  외산면,'80,75 - 79세,1998,83,28,55
'4476033000,  외산면,'85,80 - 84세,1998,71,22,49
'4476033000,  외산면,'90,85+ ,1998,37,6,31
'4476034000,  내산면,'00,계,1998,2583,1298,1285
'4476034000,  내산면,'05,0 - 4세,1998,72,41,31
'4476034000,  내산면,'10,5 - 9세,1998,102,57,45
'4476034000,  내산면,'15,10 - 14세,1998,174,89,85
'4476034000,  내산면,'20,15 - 19세,1998,239,114,125
'4476034000,  내산면,'25,20 - 24세,1998,251,153,98
'4476034000,  내산면,'30,25 - 29세,1998,138,102,36
'4476034000,  내산면,'35,30 - 34세,1998,91,52,39
'4476034000,  내산면,'40,35 - 39세,1998,140,71,69
'4476034000,  내산면,'45,40 - 44세,1998,127,69,58
'4476034000,  내산면,'50,45 - 49세,1998,161,72,89
'4476034000,  내산면,'55,50 - 54세,1998,158,77,81
'4476034000,  내산면,'60,55 - 59세,1998,192,84,108
'4476034000,  내산면,'65,60 - 64세,1998,236,103,133
'4476034000,  내산면,'70,65 - 69세,1998,201,88,113
'4476034000,  내산면,'75,70 - 74세,1998,146,66,80
'4476034000,  내산면,'80,75 - 79세,1998,96,45,51
'4476034000,  내산면,'85,80 - 84세,1998,32,8,24
'4476034000,  내산면,'90,85+ ,1998,27,7,20
'4476035000,  구룡면,'00,계,1998,4040,2047,1993
'4476035000,  구룡면,'05,0 - 4세,1998,125,68,57
'4476035000,  구룡면,'10,5 - 9세,1998,156,85,71
'4476035000,  구룡면,'15,10 - 14세,1998,247,126,121
'4476035000,  구룡면,'20,15 - 19세,1998,424,213,211
'4476035000,  구룡면,'25,20 - 24세,1998,407,255,152
'4476035000,  구룡면,'30,25 - 29세,1998,249,163,86
'4476035000,  구룡면,'35,30 - 34세,1998,158,82,76
'4476035000,  구룡면,'40,35 - 39세,1998,228,115,113
'4476035000,  구룡면,'45,40 - 44세,1998,231,113,118
'4476035000,  구룡면,'50,45 - 49세,1998,244,117,127
'4476035000,  구룡면,'55,50 - 54세,1998,250,123,127
'4476035000,  구룡면,'60,55 - 59세,1998,325,153,172
'4476035000,  구룡면,'65,60 - 64세,1998,358,160,198
'4476035000,  구룡면,'70,65 - 69세,1998,272,128,144
'4476035000,  구룡면,'75,70 - 74세,1998,170,67,103
'4476035000,  구룡면,'80,75 - 79세,1998,105,49,56
'4476035000,  구룡면,'85,80 - 84세,1998,60,23,37
'4476035000,  구룡면,'90,85+ ,1998,31,7,24
'4476036000,  홍산면,'00,계,1998,4968,2435,2533
'4476036000,  홍산면,'05,0 - 4세,1998,221,117,104
'4476036000,  홍산면,'10,5 - 9세,1998,238,131,107
'4476036000,  홍산면,'15,10 - 14세,1998,295,158,137
'4476036000,  홍산면,'20,15 - 19세,1998,515,254,261
'4476036000,  홍산면,'25,20 - 24세,1998,485,275,210
'4476036000,  홍산면,'30,25 - 29세,1998,284,158,126
'4476036000,  홍산면,'35,30 - 34세,1998,263,136,127
'4476036000,  홍산면,'40,35 - 39세,1998,256,130,126
'4476036000,  홍산면,'45,40 - 44세,1998,335,167,168
'4476036000,  홍산면,'50,45 - 49세,1998,303,147,156
'4476036000,  홍산면,'55,50 - 54세,1998,290,133,157
'4476036000,  홍산면,'60,55 - 59세,1998,369,182,187
'4476036000,  홍산면,'65,60 - 64세,1998,352,147,205
'4476036000,  홍산면,'70,65 - 69세,1998,288,127,161
'4476036000,  홍산면,'75,70 - 74세,1998,223,85,138
'4476036000,  홍산면,'80,75 - 79세,1998,143,53,90
'4476036000,  홍산면,'85,80 - 84세,1998,68,24,44
'4476036000,  홍산면,'90,85+ ,1998,40,11,29
'4476037000,  옥산면,'00,계,1998,2384,1139,1245
'4476037000,  옥산면,'05,0 - 4세,1998,84,36,48
'4476037000,  옥산면,'10,5 - 9세,1998,68,29,39
'4476037000,  옥산면,'15,10 - 14세,1998,107,56,51
'4476037000,  옥산면,'20,15 - 19세,1998,221,114,107
'4476037000,  옥산면,'25,20 - 24세,1998,233,140,93
'4476037000,  옥산면,'30,25 - 29세,1998,120,75,45
'4476037000,  옥산면,'35,30 - 34세,1998,87,45,42
'4476037000,  옥산면,'40,35 - 39세,1998,102,51,51
'4476037000,  옥산면,'45,40 - 44세,1998,128,61,67
'4476037000,  옥산면,'50,45 - 49세,1998,121,53,68
'4476037000,  옥산면,'55,50 - 54세,1998,117,53,64
'4476037000,  옥산면,'60,55 - 59세,1998,200,82,118
'4476037000,  옥산면,'65,60 - 64세,1998,236,107,129
'4476037000,  옥산면,'70,65 - 69세,1998,212,91,121
'4476037000,  옥산면,'75,70 - 74세,1998,145,65,80
'4476037000,  옥산면,'80,75 - 79세,1998,111,47,64
'4476037000,  옥산면,'85,80 - 84세,1998,67,28,39
'4476037000,  옥산면,'90,85+ ,1998,25,6,19
'4476038000,  남면,'00,계,1998,3423,1679,1744
'4476038000,  남면,'05,0 - 4세,1998,107,48,59
'4476038000,  남면,'10,5 - 9세,1998,121,64,57
'4476038000,  남면,'15,10 - 14세,1998,183,105,78
'4476038000,  남면,'20,15 - 19세,1998,330,169,161
'4476038000,  남면,'25,20 - 24세,1998,325,199,126
'4476038000,  남면,'30,25 - 29세,1998,183,117,66
'4476038000,  남면,'35,30 - 34세,1998,115,68,47
'4476038000,  남면,'40,35 - 39세,1998,163,87,76
'4476038000,  남면,'45,40 - 44세,1998,205,104,101
'4476038000,  남면,'50,45 - 49세,1998,167,83,84
'4476038000,  남면,'55,50 - 54세,1998,229,100,129
'4476038000,  남면,'60,55 - 59세,1998,281,129,152
'4476038000,  남면,'65,60 - 64세,1998,327,140,187
'4476038000,  남면,'70,65 - 69세,1998,282,123,159
'4476038000,  남면,'75,70 - 74세,1998,180,66,114
'4476038000,  남면,'80,75 - 79세,1998,126,46,80
'4476038000,  남면,'85,80 - 84세,1998,56,21,35
'4476038000,  남면,'90,85+ ,1998,43,10,33
'4476039000,  충화면,'00,계,1998,2053,1017,1036
'4476039000,  충화면,'05,0 - 4세,1998,49,25,24
'4476039000,  충화면,'10,5 - 9세,1998,82,47,35
'4476039000,  충화면,'15,10 - 14세,1998,115,61,54
'4476039000,  충화면,'20,15 - 19세,1998,194,95,99
'4476039000,  충화면,'25,20 - 24세,1998,175,106,69
'4476039000,  충화면,'30,25 - 29세,1998,91,64,27
'4476039000,  충화면,'35,30 - 34세,1998,70,42,28
'4476039000,  충화면,'40,35 - 39세,1998,116,54,62
'4476039000,  충화면,'45,40 - 44세,1998,115,66,49
'4476039000,  충화면,'50,45 - 49세,1998,110,51,59
'4476039000,  충화면,'55,50 - 54세,1998,110,57,53
'4476039000,  충화면,'60,55 - 59세,1998,169,72,97
'4476039000,  충화면,'65,60 - 64세,1998,204,99,105
'4476039000,  충화면,'70,65 - 69세,1998,152,68,84
'4476039000,  충화면,'75,70 - 74세,1998,138,53,85
'4476039000,  충화면,'80,75 - 79세,1998,85,36,49
'4476039000,  충화면,'85,80 - 84세,1998,49,12,37
'4476039000,  충화면,'90,85+ ,1998,29,9,20
'4476040000,  양화면,'00,계,1998,3249,1590,1659
'4476040000,  양화면,'05,0 - 4세,1998,97,46,51
'4476040000,  양화면,'10,5 - 9세,1998,135,63,72
'4476040000,  양화면,'15,10 - 14세,1998,180,96,84
'4476040000,  양화면,'20,15 - 19세,1998,316,163,153
'4476040000,  양화면,'25,20 - 24세,1998,318,193,125
'4476040000,  양화면,'30,25 - 29세,1998,132,86,46
'4476040000,  양화면,'35,30 - 34세,1998,118,59,59
'4476040000,  양화면,'40,35 - 39세,1998,182,100,82
'4476040000,  양화면,'45,40 - 44세,1998,174,86,88
'4476040000,  양화면,'50,45 - 49세,1998,180,85,95
'4476040000,  양화면,'55,50 - 54세,1998,188,91,97
'4476040000,  양화면,'60,55 - 59세,1998,256,121,135
'4476040000,  양화면,'65,60 - 64세,1998,317,140,177
'4476040000,  양화면,'70,65 - 69세,1998,245,107,138
'4476040000,  양화면,'75,70 - 74세,1998,188,88,100
'4476040000,  양화면,'80,75 - 79세,1998,117,34,83
'4476040000,  양화면,'85,80 - 84세,1998,59,18,41
'4476040000,  양화면,'90,85+ ,1998,47,14,33
'4476041000,  임천면,'00,계,1998,5034,2497,2537
'4476041000,  임천면,'05,0 - 4세,1998,178,86,92
'4476041000,  임천면,'10,5 - 9세,1998,211,108,103
'4476041000,  임천면,'15,10 - 14세,1998,272,132,140
'4476041000,  임천면,'20,15 - 19세,1998,496,262,234
'4476041000,  임천면,'25,20 - 24세,1998,439,265,174
'4476041000,  임천면,'30,25 - 29세,1998,287,194,93
'4476041000,  임천면,'35,30 - 34세,1998,212,114,98
'4476041000,  임천면,'40,35 - 39세,1998,235,119,116
'4476041000,  임천면,'45,40 - 44세,1998,330,181,149
'4476041000,  임천면,'50,45 - 49세,1998,298,149,149
'4476041000,  임천면,'55,50 - 54세,1998,274,126,148
'4476041000,  임천면,'60,55 - 59세,1998,427,180,247
'4476041000,  임천면,'65,60 - 64세,1998,421,193,228
'4476041000,  임천면,'70,65 - 69세,1998,354,158,196
'4476041000,  임천면,'75,70 - 74세,1998,275,119,156
'4476041000,  임천면,'80,75 - 79세,1998,199,74,125
'4476041000,  임천면,'85,80 - 84세,1998,71,22,49
'4476041000,  임천면,'90,85+ ,1998,55,15,40
'4476042000,  장암면,'00,계,1998,4582,2275,2307
'4476042000,  장암면,'05,0 - 4세,1998,166,79,87
'4476042000,  장암면,'10,5 - 9세,1998,206,97,109
'4476042000,  장암면,'15,10 - 14세,1998,223,106,117
'4476042000,  장암면,'20,15 - 19세,1998,432,225,207
'4476042000,  장암면,'25,20 - 24세,1998,467,283,184
'4476042000,  장암면,'30,25 - 29세,1998,251,156,95
'4476042000,  장암면,'35,30 - 34세,1998,189,105,84
'4476042000,  장암면,'40,35 - 39세,1998,241,130,111
'4476042000,  장암면,'45,40 - 44세,1998,268,146,122
'4476042000,  장암면,'50,45 - 49세,1998,267,136,131
'4476042000,  장암면,'55,50 - 54세,1998,250,105,145
'4476042000,  장암면,'60,55 - 59세,1998,400,176,224
'4476042000,  장암면,'65,60 - 64세,1998,438,199,239
'4476042000,  장암면,'70,65 - 69세,1998,319,142,177
'4476042000,  장암면,'75,70 - 74세,1998,218,111,107
'4476042000,  장암면,'80,75 - 79세,1998,136,54,82
'4476042000,  장암면,'85,80 - 84세,1998,66,16,50
'4476042000,  장암면,'90,85+ ,1998,45,9,36
'4476043000,  세도면,'00,계,1998,5753,2913,2840
'4476043000,  세도면,'05,0 - 4세,1998,210,103,107
'4476043000,  세도면,'10,5 - 9세,1998,295,136,159
'4476043000,  세도면,'15,10 - 14세,1998,386,202,184
'4476043000,  세도면,'20,15 - 19세,1998,605,331,274
'4476043000,  세도면,'25,20 - 24세,1998,490,297,193
'4476043000,  세도면,'30,25 - 29세,1998,291,179,112
'4476043000,  세도면,'35,30 - 34세,1998,281,165,116
'4476043000,  세도면,'40,35 - 39세,1998,403,207,196
'4476043000,  세도면,'45,40 - 44세,1998,405,199,206
'4476043000,  세도면,'50,45 - 49세,1998,308,163,145
'4476043000,  세도면,'55,50 - 54세,1998,306,159,147
'4476043000,  세도면,'60,55 - 59세,1998,403,167,236
'4476043000,  세도면,'65,60 - 64세,1998,458,216,242
'4476043000,  세도면,'70,65 - 69세,1998,346,167,179
'4476043000,  세도면,'75,70 - 74세,1998,265,127,138
'4476043000,  세도면,'80,75 - 79세,1998,148,57,91
'4476043000,  세도면,'85,80 - 84세,1998,91,28,63
'4476043000,  세도면,'90,85+ ,1998,62,10,52
'4476044000,  석성면,'00,계,1998,4581,2329,2252
'4476044000,  석성면,'05,0 - 4세,1998,236,120,116
'4476044000,  석성면,'10,5 - 9세,1998,240,129,111
'4476044000,  석성면,'15,10 - 14세,1998,295,163,132
'4476044000,  석성면,'20,15 - 19세,1998,467,237,230
'4476044000,  석성면,'25,20 - 24세,1998,451,252,199
'4476044000,  석성면,'30,25 - 29세,1998,291,186,105
'4476044000,  석성면,'35,30 - 34세,1998,273,160,113
'4476044000,  석성면,'40,35 - 39세,1998,308,158,150
'4476044000,  석성면,'45,40 - 44세,1998,316,166,150
'4476044000,  석성면,'50,45 - 49세,1998,259,128,131
'4476044000,  석성면,'55,50 - 54세,1998,230,120,110
'4476044000,  석성면,'60,55 - 59세,1998,286,133,153
'4476044000,  석성면,'65,60 - 64세,1998,320,128,192
'4476044000,  석성면,'70,65 - 69세,1998,242,110,132
'4476044000,  석성면,'75,70 - 74세,1998,162,73,89
'4476044000,  석성면,'80,75 - 79세,1998,131,47,84
'4476044000,  석성면,'85,80 - 84세,1998,51,17,34
'4476044000,  석성면,'90,85+ ,1998,23,2,21
'4476045000,  초촌면,'00,계,1998,3683,1835,1848
'4476045000,  초촌면,'05,0 - 4세,1998,140,72,68
'4476045000,  초촌면,'10,5 - 9세,1998,143,71,72
'4476045000,  초촌면,'15,10 - 14세,1998,252,128,124
'4476045000,  초촌면,'20,15 - 19세,1998,345,187,158
'4476045000,  초촌면,'25,20 - 24세,1998,334,207,127
'4476045000,  초촌면,'30,25 - 29세,1998,218,146,72
'4476045000,  초촌면,'35,30 - 34세,1998,152,87,65
'4476045000,  초촌면,'40,35 - 39세,1998,239,114,125
'4476045000,  초촌면,'45,40 - 44세,1998,267,158,109
'4476045000,  초촌면,'50,45 - 49세,1998,163,87,76
'4476045000,  초촌면,'55,50 - 54세,1998,183,88,95
'4476045000,  초촌면,'60,55 - 59세,1998,268,112,156
'4476045000,  초촌면,'65,60 - 64세,1998,302,124,178
'4476045000,  초촌면,'70,65 - 69세,1998,256,116,140
'4476045000,  초촌면,'75,70 - 74세,1998,189,68,121
'4476045000,  초촌면,'80,75 - 79세,1998,110,35,75
'4476045000,  초촌면,'85,80 - 84세,1998,73,25,48
'4476045000,  초촌면,'90,85+ ,1998,49,10,39
'44770, 서천군,'00,계,1998,80078,39876,40202
'44770, 서천군,'05,0 - 4세,1998,3865,2053,1812
'44770, 서천군,'10,5 - 9세,1998,4050,2134,1916
'44770, 서천군,'15,10 - 14세,1998,4746,2429,2317
'44770, 서천군,'20,15 - 19세,1998,7937,4055,3882
'44770, 서천군,'25,20 - 24세,1998,7314,4274,3040
'44770, 서천군,'30,25 - 29세,1998,5544,3320,2224
'44770, 서천군,'35,30 - 34세,1998,4404,2363,2041
'44770, 서천군,'40,35 - 39세,1998,5262,2717,2545
'44770, 서천군,'45,40 - 44세,1998,5190,2636,2554
'44770, 서천군,'50,45 - 49세,1998,4485,2192,2293
'44770, 서천군,'55,50 - 54세,1998,4421,2136,2285
'44770, 서천군,'60,55 - 59세,1998,5473,2422,3051
'44770, 서천군,'65,60 - 64세,1998,5408,2505,2903
'44770, 서천군,'70,65 - 69세,1998,4706,1976,2730
'44770, 서천군,'75,70 - 74세,1998,3263,1330,1933
'44770, 서천군,'80,75 - 79세,1998,2163,842,1321
'44770, 서천군,'85,80 - 84세,1998,1117,341,776
'44770, 서천군,'90,85+ ,1998,730,151,579
'4477025000,  장항읍,'00,계,1998,18815,9480,9335
'4477025000,  장항읍,'05,0 - 4세,1998,1253,640,613
'4477025000,  장항읍,'10,5 - 9세,1998,1123,595,528
'4477025000,  장항읍,'15,10 - 14세,1998,1055,533,522
'4477025000,  장항읍,'20,15 - 19세,1998,1836,957,879
'4477025000,  장항읍,'25,20 - 24세,1998,1809,996,813
'4477025000,  장항읍,'30,25 - 29세,1998,1788,1017,771
'4477025000,  장항읍,'35,30 - 34세,1998,1282,712,570
'4477025000,  장항읍,'40,35 - 39세,1998,1384,736,648
'4477025000,  장항읍,'45,40 - 44세,1998,1297,643,654
'4477025000,  장항읍,'50,45 - 49세,1998,1083,526,557
'4477025000,  장항읍,'55,50 - 54세,1998,1047,512,535
'4477025000,  장항읍,'60,55 - 59세,1998,1125,488,637
'4477025000,  장항읍,'65,60 - 64세,1998,917,450,467
'4477025000,  장항읍,'70,65 - 69세,1998,699,292,407
'4477025000,  장항읍,'75,70 - 74세,1998,517,207,310
'4477025000,  장항읍,'80,75 - 79세,1998,333,111,222
'4477025000,  장항읍,'85,80 - 84세,1998,167,46,121
'4477025000,  장항읍,'90,85+ ,1998,100,19,81
'4477025300,  서천읍,'00,계,1998,15382,7715,7667
'4477025300,  서천읍,'05,0 - 4세,1998,1049,579,470
'4477025300,  서천읍,'10,5 - 9세,1998,1143,602,541
'4477025300,  서천읍,'15,10 - 14세,1998,1097,559,538
'4477025300,  서천읍,'20,15 - 19세,1998,1450,761,689
'4477025300,  서천읍,'25,20 - 24세,1998,1240,690,550
'4477025300,  서천읍,'30,25 - 29세,1998,1125,609,516
'4477025300,  서천읍,'35,30 - 34세,1998,1138,561,577
'4477025300,  서천읍,'40,35 - 39세,1998,1275,652,623
'4477025300,  서천읍,'45,40 - 44세,1998,1115,579,536
'4477025300,  서천읍,'50,45 - 49세,1998,809,420,389
'4477025300,  서천읍,'55,50 - 54세,1998,733,368,365
'4477025300,  서천읍,'60,55 - 59세,1998,797,359,438
'4477025300,  서천읍,'65,60 - 64세,1998,794,354,440
'4477025300,  서천읍,'70,65 - 69세,1998,605,252,353
'4477025300,  서천읍,'75,70 - 74세,1998,430,180,250
'4477025300,  서천읍,'80,75 - 79세,1998,314,119,195
'4477025300,  서천읍,'85,80 - 84세,1998,168,50,118
'4477025300,  서천읍,'90,85+ ,1998,100,21,79
'4477031000,  마서면,'00,계,1998,8893,4444,4449
'4477031000,  마서면,'05,0 - 4세,1998,330,154,176
'4477031000,  마서면,'10,5 - 9세,1998,343,172,171
'4477031000,  마서면,'15,10 - 14세,1998,492,269,223
'4477031000,  마서면,'20,15 - 19세,1998,847,422,425
'4477031000,  마서면,'25,20 - 24세,1998,896,522,374
'4477031000,  마서면,'30,25 - 29세,1998,576,357,219
'4477031000,  마서면,'35,30 - 34세,1998,436,260,176
'4477031000,  마서면,'40,35 - 39세,1998,541,303,238
'4477031000,  마서면,'45,40 - 44세,1998,566,295,271
'4477031000,  마서면,'50,45 - 49세,1998,523,260,263
'4477031000,  마서면,'55,50 - 54세,1998,523,246,277
'4477031000,  마서면,'60,55 - 59세,1998,648,271,377
'4477031000,  마서면,'65,60 - 64세,1998,636,304,332
'4477031000,  마서면,'70,65 - 69세,1998,609,261,348
'4477031000,  마서면,'75,70 - 74세,1998,419,161,258
'4477031000,  마서면,'80,75 - 79세,1998,278,119,159
'4477031000,  마서면,'85,80 - 84세,1998,125,43,82
'4477031000,  마서면,'90,85+ ,1998,105,25,80
'4477032000,  화양면,'00,계,1998,4162,2023,2139
'4477032000,  화양면,'05,0 - 4세,1998,118,70,48
'4477032000,  화양면,'10,5 - 9세,1998,134,67,67
'4477032000,  화양면,'15,10 - 14세,1998,216,109,107
'4477032000,  화양면,'20,15 - 19세,1998,395,193,202
'4477032000,  화양면,'25,20 - 24세,1998,399,240,159
'4477032000,  화양면,'30,25 - 29세,1998,203,134,69
'4477032000,  화양면,'35,30 - 34세,1998,130,64,66
'4477032000,  화양면,'40,35 - 39세,1998,188,99,89
'4477032000,  화양면,'45,40 - 44세,1998,230,119,111
'4477032000,  화양면,'50,45 - 49세,1998,242,105,137
'4477032000,  화양면,'55,50 - 54세,1998,238,116,122
'4477032000,  화양면,'60,55 - 59세,1998,363,160,203
'4477032000,  화양면,'65,60 - 64세,1998,425,193,232
'4477032000,  화양면,'70,65 - 69세,1998,358,153,205
'4477032000,  화양면,'75,70 - 74세,1998,234,106,128
'4477032000,  화양면,'80,75 - 79세,1998,162,65,97
'4477032000,  화양면,'85,80 - 84세,1998,79,22,57
'4477032000,  화양면,'90,85+ ,1998,48,8,40
'4477033000,  기산면,'00,계,1998,3008,1471,1537
'4477033000,  기산면,'05,0 - 4세,1998,106,51,55
'4477033000,  기산면,'10,5 - 9세,1998,89,41,48
'4477033000,  기산면,'15,10 - 14세,1998,155,74,81
'4477033000,  기산면,'20,15 - 19세,1998,270,131,139
'4477033000,  기산면,'25,20 - 24세,1998,270,167,103
'4477033000,  기산면,'30,25 - 29세,1998,140,94,46
'4477033000,  기산면,'35,30 - 34세,1998,115,68,47
'4477033000,  기산면,'40,35 - 39세,1998,169,88,81
'4477033000,  기산면,'45,40 - 44세,1998,156,83,73
'4477033000,  기산면,'50,45 - 49세,1998,166,80,86
'4477033000,  기산면,'55,50 - 54세,1998,171,79,92
'4477033000,  기산면,'60,55 - 59세,1998,255,120,135
'4477033000,  기산면,'65,60 - 64세,1998,283,140,143
'4477033000,  기산면,'70,65 - 69세,1998,276,101,175
'4477033000,  기산면,'75,70 - 74세,1998,193,83,110
'4477033000,  기산면,'80,75 - 79세,1998,106,45,61
'4477033000,  기산면,'85,80 - 84세,1998,53,19,34
'4477033000,  기산면,'90,85+ ,1998,35,7,28
'4477034000,  한산면,'00,계,1998,4712,2311,2401
'4477034000,  한산면,'05,0 - 4세,1998,164,94,70
'4477034000,  한산면,'10,5 - 9세,1998,207,117,90
'4477034000,  한산면,'15,10 - 14세,1998,284,137,147
'4477034000,  한산면,'20,15 - 19세,1998,514,259,255
'4477034000,  한산면,'25,20 - 24세,1998,380,216,164
'4477034000,  한산면,'30,25 - 29세,1998,260,163,97
'4477034000,  한산면,'35,30 - 34세,1998,202,116,86
'4477034000,  한산면,'40,35 - 39세,1998,256,117,139
'4477034000,  한산면,'45,40 - 44세,1998,287,133,154
'4477034000,  한산면,'50,45 - 49세,1998,238,117,121
'4477034000,  한산면,'55,50 - 54세,1998,276,133,143
'4477034000,  한산면,'60,55 - 59세,1998,352,154,198
'4477034000,  한산면,'65,60 - 64세,1998,419,178,241
'4477034000,  한산면,'70,65 - 69세,1998,370,172,198
'4477034000,  한산면,'75,70 - 74세,1998,242,109,133
'4477034000,  한산면,'80,75 - 79세,1998,147,63,84
'4477034000,  한산면,'85,80 - 84세,1998,67,18,49
'4477034000,  한산면,'90,85+ ,1998,47,15,32
'4477035000,  마산면,'00,계,1998,2492,1234,1258
'4477035000,  마산면,'05,0 - 4세,1998,63,35,28
'4477035000,  마산면,'10,5 - 9세,1998,93,51,42
'4477035000,  마산면,'15,10 - 14세,1998,154,90,64
'4477035000,  마산면,'20,15 - 19세,1998,267,142,125
'4477035000,  마산면,'25,20 - 24세,1998,212,135,77
'4477035000,  마산면,'30,25 - 29세,1998,109,80,29
'4477035000,  마산면,'35,30 - 34세,1998,91,46,45
'4477035000,  마산면,'40,35 - 39세,1998,134,59,75
'4477035000,  마산면,'45,40 - 44세,1998,141,71,70
'4477035000,  마산면,'50,45 - 49세,1998,143,69,74
'4477035000,  마산면,'55,50 - 54세,1998,130,66,64
'4477035000,  마산면,'60,55 - 59세,1998,194,81,113
'4477035000,  마산면,'65,60 - 64세,1998,226,103,123
'4477035000,  마산면,'70,65 - 69세,1998,223,89,134
'4477035000,  마산면,'75,70 - 74세,1998,137,55,82
'4477035000,  마산면,'80,75 - 79세,1998,82,40,42
'4477035000,  마산면,'85,80 - 84세,1998,53,14,39
'4477035000,  마산면,'90,85+ ,1998,40,8,32
'4477036000,  시초면,'00,계,1998,2169,1064,1105
'4477036000,  시초면,'05,0 - 4세,1998,49,29,20
'4477036000,  시초면,'10,5 - 9세,1998,62,30,32
'4477036000,  시초면,'15,10 - 14세,1998,80,43,37
'4477036000,  시초면,'20,15 - 19세,1998,183,100,83
'4477036000,  시초면,'25,20 - 24세,1998,193,119,74
'4477036000,  시초면,'30,25 - 29세,1998,109,78,31
'4477036000,  시초면,'35,30 - 34세,1998,71,39,32
'4477036000,  시초면,'40,35 - 39세,1998,109,58,51
'4477036000,  시초면,'45,40 - 44세,1998,102,56,46
'4477036000,  시초면,'50,45 - 49세,1998,96,42,54
'4477036000,  시초면,'55,50 - 54세,1998,119,46,73
'4477036000,  시초면,'60,55 - 59세,1998,204,95,109
'4477036000,  시초면,'65,60 - 64세,1998,244,106,138
'4477036000,  시초면,'70,65 - 69세,1998,215,97,118
'4477036000,  시초면,'75,70 - 74세,1998,156,71,85
'4477036000,  시초면,'80,75 - 79세,1998,96,33,63
'4477036000,  시초면,'85,80 - 84세,1998,48,11,37
'4477036000,  시초면,'90,85+ ,1998,33,11,22
'4477037000,  문산면,'00,계,1998,2176,1069,1107
'4477037000,  문산면,'05,0 - 4세,1998,49,32,17
'4477037000,  문산면,'10,5 - 9세,1998,48,21,27
'4477037000,  문산면,'15,10 - 14세,1998,101,46,55
'4477037000,  문산면,'20,15 - 19세,1998,204,89,115
'4477037000,  문산면,'25,20 - 24세,1998,223,147,76
'4477037000,  문산면,'30,25 - 29세,1998,122,83,39
'4477037000,  문산면,'35,30 - 34세,1998,72,43,29
'4477037000,  문산면,'40,35 - 39세,1998,98,50,48
'4477037000,  문산면,'45,40 - 44세,1998,114,53,61
'4477037000,  문산면,'50,45 - 49세,1998,119,54,65
'4477037000,  문산면,'55,50 - 54세,1998,149,69,80
'4477037000,  문산면,'60,55 - 59세,1998,209,101,108
'4477037000,  문산면,'65,60 - 64세,1998,179,91,88
'4477037000,  문산면,'70,65 - 69세,1998,173,65,108
'4477037000,  문산면,'75,70 - 74세,1998,134,55,79
'4477037000,  문산면,'80,75 - 79세,1998,103,48,55
'4477037000,  문산면,'85,80 - 84세,1998,49,19,30
'4477037000,  문산면,'90,85+ ,1998,30,3,27
'4477038000,  판교면,'00,계,1998,3511,1747,1764
'4477038000,  판교면,'05,0 - 4세,1998,97,54,43
'4477038000,  판교면,'10,5 - 9세,1998,120,62,58
'4477038000,  판교면,'15,10 - 14세,1998,186,90,96
'4477038000,  판교면,'20,15 - 19세,1998,350,193,157
'4477038000,  판교면,'25,20 - 24세,1998,310,208,102
'4477038000,  판교면,'30,25 - 29세,1998,190,130,60
'4477038000,  판교면,'35,30 - 34세,1998,107,52,55
'4477038000,  판교면,'40,35 - 39세,1998,188,93,95
'4477038000,  판교면,'45,40 - 44세,1998,214,113,101
'4477038000,  판교면,'50,45 - 49세,1998,200,96,104
'4477038000,  판교면,'55,50 - 54세,1998,192,94,98
'4477038000,  판교면,'60,55 - 59세,1998,275,118,157
'4477038000,  판교면,'65,60 - 64세,1998,327,160,167
'4477038000,  판교면,'70,65 - 69세,1998,294,119,175
'4477038000,  판교면,'75,70 - 74세,1998,202,72,130
'4477038000,  판교면,'80,75 - 79세,1998,146,56,90
'4477038000,  판교면,'85,80 - 84세,1998,80,31,49
'4477038000,  판교면,'90,85+ ,1998,33,6,27
'4477039000,  종천면,'00,계,1998,3494,1712,1782
'4477039000,  종천면,'05,0 - 4세,1998,114,57,57
'4477039000,  종천면,'10,5 - 9세,1998,124,65,59
'4477039000,  종천면,'15,10 - 14세,1998,196,96,100
'4477039000,  종천면,'20,15 - 19세,1998,393,196,197
'4477039000,  종천면,'25,20 - 24세,1998,370,219,151
'4477039000,  종천면,'30,25 - 29세,1998,209,137,72
'4477039000,  종천면,'35,30 - 34세,1998,146,89,57
'4477039000,  종천면,'40,35 - 39세,1998,171,82,89
'4477039000,  종천면,'45,40 - 44세,1998,215,101,114
'4477039000,  종천면,'50,45 - 49세,1998,208,99,109
'4477039000,  종천면,'55,50 - 54세,1998,209,105,104
'4477039000,  종천면,'60,55 - 59세,1998,262,121,141
'4477039000,  종천면,'65,60 - 64세,1998,248,114,134
'4477039000,  종천면,'70,65 - 69세,1998,253,101,152
'4477039000,  종천면,'75,70 - 74세,1998,160,55,105
'4477039000,  종천면,'80,75 - 79세,1998,104,44,60
'4477039000,  종천면,'85,80 - 84세,1998,71,25,46
'4477039000,  종천면,'90,85+ ,1998,41,6,35
'4477040000,  비인면,'00,계,1998,5126,2527,2599
'4477040000,  비인면,'05,0 - 4세,1998,208,119,89
'4477040000,  비인면,'10,5 - 9세,1998,259,147,112
'4477040000,  비인면,'15,10 - 14세,1998,339,177,162
'4477040000,  비인면,'20,15 - 19세,1998,508,256,252
'4477040000,  비인면,'25,20 - 24세,1998,449,272,177
'4477040000,  비인면,'30,25 - 29세,1998,330,201,129
'4477040000,  비인면,'35,30 - 34세,1998,260,130,130
'4477040000,  비인면,'40,35 - 39세,1998,341,172,169
'4477040000,  비인면,'45,40 - 44세,1998,334,169,165
'4477040000,  비인면,'50,45 - 49세,1998,261,128,133
'4477040000,  비인면,'55,50 - 54세,1998,275,131,144
'4477040000,  비인면,'60,55 - 59세,1998,362,148,214
'4477040000,  비인면,'65,60 - 64세,1998,346,147,199
'4477040000,  비인면,'70,65 - 69세,1998,357,161,196
'4477040000,  비인면,'75,70 - 74세,1998,235,96,139
'4477040000,  비인면,'80,75 - 79세,1998,137,44,93
'4477040000,  비인면,'85,80 - 84세,1998,68,19,49
'4477040000,  비인면,'90,85+ ,1998,57,10,47
'4477041000,  서면,'00,계,1998,6138,3079,3059
'4477041000,  서면,'05,0 - 4세,1998,265,139,126
'4477041000,  서면,'10,5 - 9세,1998,305,164,141
'4477041000,  서면,'15,10 - 14세,1998,391,206,185
'4477041000,  서면,'20,15 - 19세,1998,720,356,364
'4477041000,  서면,'25,20 - 24세,1998,563,343,220
'4477041000,  서면,'30,25 - 29세,1998,383,237,146
'4477041000,  서면,'35,30 - 34세,1998,354,183,171
'4477041000,  서면,'40,35 - 39세,1998,408,208,200
'4477041000,  서면,'45,40 - 44세,1998,419,221,198
'4477041000,  서면,'50,45 - 49세,1998,397,196,201
'4477041000,  서면,'55,50 - 54세,1998,359,171,188
'4477041000,  서면,'60,55 - 59세,1998,427,206,221
'4477041000,  서면,'65,60 - 64세,1998,364,165,199
'4477041000,  서면,'70,65 - 69세,1998,274,113,161
'4477041000,  서면,'75,70 - 74세,1998,204,80,124
'4477041000,  서면,'80,75 - 79세,1998,155,55,100
'4477041000,  서면,'85,80 - 84세,1998,89,24,65
'4477041000,  서면,'90,85+ ,1998,61,12,49
'44790, 청양군,'00,계,1998,42920,21583,21337
'44790, 청양군,'05,0 - 4세,1998,2000,1055,945
'44790, 청양군,'10,5 - 9세,1998,2127,1143,984
'44790, 청양군,'15,10 - 14세,1998,2622,1346,1276
'44790, 청양군,'20,15 - 19세,1998,3841,1973,1868
'44790, 청양군,'25,20 - 24세,1998,3979,2318,1661
'44790, 청양군,'30,25 - 29세,1998,2871,1804,1067
'44790, 청양군,'35,30 - 34세,1998,2369,1295,1074
'44790, 청양군,'40,35 - 39세,1998,2617,1377,1240
'44790, 청양군,'45,40 - 44세,1998,2569,1313,1256
'44790, 청양군,'50,45 - 49세,1998,2239,1137,1102
'44790, 청양군,'55,50 - 54세,1998,2201,1043,1158
'44790, 청양군,'60,55 - 59세,1998,3067,1337,1730
'44790, 청양군,'65,60 - 64세,1998,3672,1639,2033
'44790, 청양군,'70,65 - 69세,1998,2712,1227,1485
'44790, 청양군,'75,70 - 74세,1998,1828,812,1016
'44790, 청양군,'80,75 - 79세,1998,1167,458,709
'44790, 청양군,'85,80 - 84세,1998,636,208,428
'44790, 청양군,'90,85+ ,1998,403,98,305
'4479025000,  청양읍,'00,계,1998,11741,5904,5837
'4479025000,  청양읍,'05,0 - 4세,1998,904,475,429
'4479025000,  청양읍,'10,5 - 9세,1998,886,475,411
'4479025000,  청양읍,'15,10 - 14세,1998,877,440,437
'4479025000,  청양읍,'20,15 - 19세,1998,965,502,463
'4479025000,  청양읍,'25,20 - 24세,1998,944,515,429
'4479025000,  청양읍,'30,25 - 29세,1998,967,507,460
'4479025000,  청양읍,'35,30 - 34세,1998,980,506,474
'4479025000,  청양읍,'40,35 - 39세,1998,976,501,475
'4479025000,  청양읍,'45,40 - 44세,1998,794,422,372
'4479025000,  청양읍,'50,45 - 49세,1998,623,333,290
'4479025000,  청양읍,'55,50 - 54세,1998,517,275,242
'4479025000,  청양읍,'60,55 - 59세,1998,552,249,303
'4479025000,  청양읍,'65,60 - 64세,1998,642,262,380
'4479025000,  청양읍,'70,65 - 69세,1998,439,190,249
'4479025000,  청양읍,'75,70 - 74세,1998,312,124,188
'4479025000,  청양읍,'80,75 - 79세,1998,201,79,122
'4479025000,  청양읍,'85,80 - 84세,1998,105,30,75
'4479025000,  청양읍,'90,85+ ,1998,57,19,38
'4479031000,  운곡면,'00,계,1998,3107,1553,1554
'4479031000,  운곡면,'05,0 - 4세,1998,86,36,50
'4479031000,  운곡면,'10,5 - 9세,1998,111,58,53
'4479031000,  운곡면,'15,10 - 14세,1998,169,86,83
'4479031000,  운곡면,'20,15 - 19세,1998,248,135,113
'4479031000,  운곡면,'25,20 - 24세,1998,324,182,142
'4479031000,  운곡면,'30,25 - 29세,1998,190,142,48
'4479031000,  운곡면,'35,30 - 34세,1998,116,66,50
'4479031000,  운곡면,'40,35 - 39세,1998,154,88,66
'4479031000,  운곡면,'45,40 - 44세,1998,144,77,67
'4479031000,  운곡면,'50,45 - 49세,1998,160,72,88
'4479031000,  운곡면,'55,50 - 54세,1998,160,69,91
'4479031000,  운곡면,'60,55 - 59세,1998,284,123,161
'4479031000,  운곡면,'65,60 - 64세,1998,344,147,197
'4479031000,  운곡면,'70,65 - 69세,1998,248,122,126
'4479031000,  운곡면,'75,70 - 74세,1998,153,71,82
'4479031000,  운곡면,'80,75 - 79세,1998,107,41,66
'4479031000,  운곡면,'85,80 - 84세,1998,62,27,35
'4479031000,  운곡면,'90,85+ ,1998,47,11,36
'4479032000,  대치면,'00,계,1998,3102,1565,1537
'4479032000,  대치면,'05,0 - 4세,1998,112,59,53
'4479032000,  대치면,'10,5 - 9세,1998,115,59,56
'4479032000,  대치면,'15,10 - 14세,1998,157,82,75
'4479032000,  대치면,'20,15 - 19세,1998,265,137,128
'4479032000,  대치면,'25,20 - 24세,1998,294,179,115
'4479032000,  대치면,'30,25 - 29세,1998,204,138,66
'4479032000,  대치면,'35,30 - 34세,1998,157,100,57
'4479032000,  대치면,'40,35 - 39세,1998,183,100,83
'4479032000,  대치면,'45,40 - 44세,1998,155,81,74
'4479032000,  대치면,'50,45 - 49세,1998,159,85,74
'4479032000,  대치면,'55,50 - 54세,1998,161,71,90
'4479032000,  대치면,'60,55 - 59세,1998,244,99,145
'4479032000,  대치면,'65,60 - 64세,1998,294,132,162
'4479032000,  대치면,'70,65 - 69세,1998,265,104,161
'4479032000,  대치면,'75,70 - 74세,1998,148,74,74
'4479032000,  대치면,'80,75 - 79세,1998,93,40,53
'4479032000,  대치면,'85,80 - 84세,1998,58,19,39
'4479032000,  대치면,'90,85+ ,1998,38,6,32
'4479033000,  정산면,'00,계,1998,5086,2584,2502
'4479033000,  정산면,'05,0 - 4세,1998,280,155,125
'4479033000,  정산면,'10,5 - 9세,1998,296,171,125
'4479033000,  정산면,'15,10 - 14세,1998,348,174,174
'4479033000,  정산면,'20,15 - 19세,1998,451,239,212
'4479033000,  정산면,'25,20 - 24세,1998,470,279,191
'4479033000,  정산면,'30,25 - 29세,1998,370,219,151
'4479033000,  정산면,'35,30 - 34세,1998,309,161,148
'4479033000,  정산면,'40,35 - 39세,1998,344,182,162
'4479033000,  정산면,'45,40 - 44세,1998,321,165,156
'4479033000,  정산면,'50,45 - 49세,1998,249,122,127
'4479033000,  정산면,'55,50 - 54세,1998,241,120,121
'4479033000,  정산면,'60,55 - 59세,1998,303,137,166
'4479033000,  정산면,'65,60 - 64세,1998,377,173,204
'4479033000,  정산면,'70,65 - 69세,1998,282,117,165
'4479033000,  정산면,'75,70 - 74세,1998,191,90,101
'4479033000,  정산면,'80,75 - 79세,1998,133,44,89
'4479033000,  정산면,'85,80 - 84세,1998,72,24,48
'4479033000,  정산면,'90,85+ ,1998,49,12,37
'4479034000,  목면,'00,계,1998,2384,1197,1187
'4479034000,  목면,'05,0 - 4세,1998,87,45,42
'4479034000,  목면,'10,5 - 9세,1998,101,50,51
'4479034000,  목면,'15,10 - 14세,1998,126,68,58
'4479034000,  목면,'20,15 - 19세,1998,200,92,108
'4479034000,  목면,'25,20 - 24세,1998,251,146,105
'4479034000,  목면,'30,25 - 29세,1998,173,122,51
'4479034000,  목면,'35,30 - 34세,1998,110,69,41
'4479034000,  목면,'40,35 - 39세,1998,121,62,59
'4479034000,  목면,'45,40 - 44세,1998,127,66,61
'4479034000,  목면,'50,45 - 49세,1998,104,50,54
'4479034000,  목면,'55,50 - 54세,1998,124,62,62
'4479034000,  목면,'60,55 - 59세,1998,211,96,115
'4479034000,  목면,'65,60 - 64세,1998,219,93,126
'4479034000,  목면,'70,65 - 69세,1998,177,77,100
'4479034000,  목면,'75,70 - 74세,1998,110,49,61
'4479034000,  목면,'80,75 - 79세,1998,76,28,48
'4479034000,  목면,'85,80 - 84세,1998,44,16,28
'4479034000,  목면,'90,85+ ,1998,23,6,17
'4479035000,  청남면,'00,계,1998,3123,1521,1602
'4479035000,  청남면,'05,0 - 4세,1998,91,47,44
'4479035000,  청남면,'10,5 - 9세,1998,117,63,54
'4479035000,  청남면,'15,10 - 14세,1998,193,93,100
'4479035000,  청남면,'20,15 - 19세,1998,292,124,168
'4479035000,  청남면,'25,20 - 24세,1998,311,185,126
'4479035000,  청남면,'30,25 - 29세,1998,152,106,46
'4479035000,  청남면,'35,30 - 34세,1998,103,63,40
'4479035000,  청남면,'40,35 - 39세,1998,143,65,78
'4479035000,  청남면,'45,40 - 44세,1998,197,95,102
'4479035000,  청남면,'50,45 - 49세,1998,175,94,81
'4479035000,  청남면,'55,50 - 54세,1998,183,87,96
'4479035000,  청남면,'60,55 - 59세,1998,257,110,147
'4479035000,  청남면,'65,60 - 64세,1998,297,137,160
'4479035000,  청남면,'70,65 - 69세,1998,230,108,122
'4479035000,  청남면,'75,70 - 74세,1998,181,73,108
'4479035000,  청남면,'80,75 - 79세,1998,103,46,57
'4479035000,  청남면,'85,80 - 84세,1998,64,19,45
'4479035000,  청남면,'90,85+ ,1998,34,6,28
'4479036000,  장평면,'00,계,1998,3589,1833,1756
'4479036000,  장평면,'05,0 - 4세,1998,93,58,35
'4479036000,  장평면,'10,5 - 9세,1998,105,56,49
'4479036000,  장평면,'15,10 - 14세,1998,193,112,81
'4479036000,  장평면,'20,15 - 19세,1998,409,228,181
'4479036000,  장평면,'25,20 - 24세,1998,375,230,145
'4479036000,  장평면,'30,25 - 29세,1998,189,132,57
'4479036000,  장평면,'35,30 - 34세,1998,143,80,63
'4479036000,  장평면,'40,35 - 39세,1998,160,82,78
'4479036000,  장평면,'45,40 - 44세,1998,222,101,121
'4479036000,  장평면,'50,45 - 49세,1998,201,102,99
'4479036000,  장평면,'55,50 - 54세,1998,228,101,127
'4479036000,  장평면,'60,55 - 59세,1998,300,129,171
'4479036000,  장평면,'65,60 - 64세,1998,352,164,188
'4479036000,  장평면,'70,65 - 69세,1998,257,129,128
'4479036000,  장평면,'75,70 - 74세,1998,174,68,106
'4479036000,  장평면,'80,75 - 79세,1998,105,38,67
'4479036000,  장평면,'85,80 - 84세,1998,51,13,38
'4479036000,  장평면,'90,85+ ,1998,32,10,22
'4479037000,  남양면,'00,계,1998,4222,2168,2054
'4479037000,  남양면,'05,0 - 4세,1998,151,75,76
'4479037000,  남양면,'10,5 - 9세,1998,147,80,67
'4479037000,  남양면,'15,10 - 14세,1998,202,106,96
'4479037000,  남양면,'20,15 - 19세,1998,374,191,183
'4479037000,  남양면,'25,20 - 24세,1998,405,258,147
'4479037000,  남양면,'30,25 - 29세,1998,273,196,77
'4479037000,  남양면,'35,30 - 34세,1998,180,105,75
'4479037000,  남양면,'40,35 - 39세,1998,191,107,84
'4479037000,  남양면,'45,40 - 44세,1998,220,114,106
'4479037000,  남양면,'50,45 - 49세,1998,221,104,117
'4479037000,  남양면,'55,50 - 54세,1998,226,98,128
'4479037000,  남양면,'60,55 - 59세,1998,402,178,224
'4479037000,  남양면,'65,60 - 64세,1998,446,211,235
'4479037000,  남양면,'70,65 - 69세,1998,344,163,181
'4479037000,  남양면,'75,70 - 74세,1998,203,100,103
'4479037000,  남양면,'80,75 - 79세,1998,126,49,77
'4479037000,  남양면,'85,80 - 84세,1998,69,22,47
'4479037000,  남양면,'90,85+ ,1998,42,11,31
'4479038000,  화성면,'00,계,1998,3355,1662,1693
'4479038000,  화성면,'05,0 - 4세,1998,103,60,43
'4479038000,  화성면,'10,5 - 9세,1998,139,74,65
'4479038000,  화성면,'15,10 - 14세,1998,193,97,96
'4479038000,  화성면,'20,15 - 19세,1998,307,151,156
'4479038000,  화성면,'25,20 - 24세,1998,300,169,131
'4479038000,  화성면,'30,25 - 29세,1998,192,128,64
'4479038000,  화성면,'35,30 - 34세,1998,132,69,63
'4479038000,  화성면,'40,35 - 39세,1998,174,95,79
'4479038000,  화성면,'45,40 - 44세,1998,195,95,100
'4479038000,  화성면,'50,45 - 49세,1998,180,90,90
'4479038000,  화성면,'55,50 - 54세,1998,168,83,85
'4479038000,  화성면,'60,55 - 59세,1998,266,111,155
'4479038000,  화성면,'65,60 - 64세,1998,348,163,185
'4479038000,  화성면,'70,65 - 69세,1998,243,108,135
'4479038000,  화성면,'75,70 - 74세,1998,193,95,98
'4479038000,  화성면,'80,75 - 79세,1998,117,47,70
'4479038000,  화성면,'85,80 - 84세,1998,66,20,46
'4479038000,  화성면,'90,85+ ,1998,39,7,32
'4479039000,  비봉면,'00,계,1998,3211,1596,1615
'4479039000,  비봉면,'05,0 - 4세,1998,93,45,48
'4479039000,  비봉면,'10,5 - 9세,1998,110,57,53
'4479039000,  비봉면,'15,10 - 14세,1998,164,88,76
'4479039000,  비봉면,'20,15 - 19세,1998,330,174,156
'4479039000,  비봉면,'25,20 - 24세,1998,305,175,130
'4479039000,  비봉면,'30,25 - 29세,1998,161,114,47
'4479039000,  비봉면,'35,30 - 34세,1998,139,76,63
'4479039000,  비봉면,'40,35 - 39세,1998,171,95,76
'4479039000,  비봉면,'45,40 - 44세,1998,194,97,97
'4479039000,  비봉면,'50,45 - 49세,1998,167,85,82
'4479039000,  비봉면,'55,50 - 54세,1998,193,77,116
'4479039000,  비봉면,'60,55 - 59세,1998,248,105,143
'4479039000,  비봉면,'65,60 - 64세,1998,353,157,196
'4479039000,  비봉면,'70,65 - 69세,1998,227,109,118
'4479039000,  비봉면,'75,70 - 74세,1998,163,68,95
'4479039000,  비봉면,'80,75 - 79세,1998,106,46,60
'4479039000,  비봉면,'85,80 - 84세,1998,45,18,27
'4479039000,  비봉면,'90,85+ ,1998,42,10,32
'44800, 홍성군,'00,계,1998,98920,49290,49630
'44800, 홍성군,'05,0 - 4세,1998,5281,2779,2502
'44800, 홍성군,'10,5 - 9세,1998,5899,3089,2810
'44800, 홍성군,'15,10 - 14세,1998,6492,3339,3153
'44800, 홍성군,'20,15 - 19세,1998,9202,4609,4593
'44800, 홍성군,'25,20 - 24세,1998,9019,5003,4016
'44800, 홍성군,'30,25 - 29세,1998,7344,4160,3184
'44800, 홍성군,'35,30 - 34세,1998,6481,3375,3106
'44800, 홍성군,'40,35 - 39세,1998,7341,3772,3569
'44800, 홍성군,'45,40 - 44세,1998,6739,3445,3294
'44800, 홍성군,'50,45 - 49세,1998,5585,2737,2848
'44800, 홍성군,'55,50 - 54세,1998,4936,2449,2487
'44800, 홍성군,'60,55 - 59세,1998,6166,2781,3385
'44800, 홍성군,'65,60 - 64세,1998,6600,3038,3562
'44800, 홍성군,'70,65 - 69세,1998,4718,2101,2617
'44800, 홍성군,'75,70 - 74세,1998,2930,1176,1754
'44800, 홍성군,'80,75 - 79세,1998,2234,846,1388
'44800, 홍성군,'85,80 - 84세,1998,1204,418,786
'44800, 홍성군,'90,85+ ,1998,749,173,576
'4480025000,  홍성읍,'00,계,1998,37057,18406,18651
'4480025000,  홍성읍,'05,0 - 4세,1998,2945,1571,1374
'4480025000,  홍성읍,'10,5 - 9세,1998,3045,1572,1473
'4480025000,  홍성읍,'15,10 - 14세,1998,2783,1433,1350
'4480025000,  홍성읍,'20,15 - 19세,1998,3239,1643,1596
'4480025000,  홍성읍,'25,20 - 24세,1998,3034,1581,1453
'4480025000,  홍성읍,'30,25 - 29세,1998,3348,1642,1706
'4480025000,  홍성읍,'35,30 - 34세,1998,3379,1677,1702
'4480025000,  홍성읍,'40,35 - 39세,1998,3494,1775,1719
'4480025000,  홍성읍,'45,40 - 44세,1998,2850,1439,1411
'4480025000,  홍성읍,'50,45 - 49세,1998,2004,1001,1003
'4480025000,  홍성읍,'55,50 - 54세,1998,1570,789,781
'4480025000,  홍성읍,'60,55 - 59세,1998,1527,722,805
'4480025000,  홍성읍,'65,60 - 64세,1998,1377,639,738
'4480025000,  홍성읍,'70,65 - 69세,1998,931,392,539
'4480025000,  홍성읍,'75,70 - 74세,1998,649,244,405
'4480025000,  홍성읍,'80,75 - 79세,1998,473,164,309
'4480025000,  홍성읍,'85,80 - 84세,1998,264,83,181
'4480025000,  홍성읍,'90,85+ ,1998,145,39,106
'4480025300,  광천읍,'00,계,1998,16242,8059,8183
'4480025300,  광천읍,'05,0 - 4세,1998,773,381,392
'4480025300,  광천읍,'10,5 - 9세,1998,924,510,414
'4480025300,  광천읍,'15,10 - 14세,1998,1014,538,476
'4480025300,  광천읍,'20,15 - 19세,1998,1624,806,818
'4480025300,  광천읍,'25,20 - 24세,1998,1534,848,686
'4480025300,  광천읍,'30,25 - 29세,1998,1136,642,494
'4480025300,  광천읍,'35,30 - 34세,1998,963,488,475
'4480025300,  광천읍,'40,35 - 39세,1998,1158,619,539
'4480025300,  광천읍,'45,40 - 44세,1998,1129,576,553
'4480025300,  광천읍,'50,45 - 49세,1998,954,453,501
'4480025300,  광천읍,'55,50 - 54세,1998,926,450,476
'4480025300,  광천읍,'60,55 - 59세,1998,1098,482,616
'4480025300,  광천읍,'65,60 - 64세,1998,1078,497,581
'4480025300,  광천읍,'70,65 - 69세,1998,754,345,409
'4480025300,  광천읍,'75,70 - 74세,1998,512,197,315
'4480025300,  광천읍,'80,75 - 79세,1998,378,152,226
'4480025300,  광천읍,'85,80 - 84세,1998,162,48,114
'4480025300,  광천읍,'90,85+ ,1998,125,27,98
'4480031000,  홍북면,'00,계,1998,6340,3167,3173
'4480031000,  홍북면,'05,0 - 4세,1998,273,149,124
'4480031000,  홍북면,'10,5 - 9세,1998,285,146,139
'4480031000,  홍북면,'15,10 - 14세,1998,375,170,205
'4480031000,  홍북면,'20,15 - 19세,1998,611,299,312
'4480031000,  홍북면,'25,20 - 24세,1998,584,321,263
'4480031000,  홍북면,'30,25 - 29세,1998,497,313,184
'4480031000,  홍북면,'35,30 - 34세,1998,369,208,161
'4480031000,  홍북면,'40,35 - 39세,1998,389,196,193
'4480031000,  홍북면,'45,40 - 44세,1998,431,227,204
'4480031000,  홍북면,'50,45 - 49세,1998,359,186,173
'4480031000,  홍북면,'55,50 - 54세,1998,315,165,150
'4480031000,  홍북면,'60,55 - 59세,1998,450,193,257
'4480031000,  홍북면,'65,60 - 64세,1998,521,234,287
'4480031000,  홍북면,'70,65 - 69세,1998,364,160,204
'4480031000,  홍북면,'75,70 - 74세,1998,218,95,123
'4480031000,  홍북면,'80,75 - 79세,1998,167,62,105
'4480031000,  홍북면,'85,80 - 84세,1998,78,32,46
'4480031000,  홍북면,'90,85+ ,1998,54,11,43
'4480032000,  금마면,'00,계,1998,5482,2757,2725
'4480032000,  금마면,'05,0 - 4세,1998,164,95,69
'4480032000,  금마면,'10,5 - 9세,1998,228,129,99
'4480032000,  금마면,'15,10 - 14세,1998,307,152,155
'4480032000,  금마면,'20,15 - 19세,1998,575,267,308
'4480032000,  금마면,'25,20 - 24세,1998,540,327,213
'4480032000,  금마면,'30,25 - 29세,1998,367,243,124
'4480032000,  금마면,'35,30 - 34세,1998,239,129,110
'4480032000,  금마면,'40,35 - 39세,1998,313,164,149
'4480032000,  금마면,'45,40 - 44세,1998,319,162,157
'4480032000,  금마면,'50,45 - 49세,1998,342,178,164
'4480032000,  금마면,'55,50 - 54세,1998,296,150,146
'4480032000,  금마면,'60,55 - 59세,1998,426,183,243
'4480032000,  금마면,'65,60 - 64세,1998,479,212,267
'4480032000,  금마면,'70,65 - 69세,1998,370,176,194
'4480032000,  금마면,'75,70 - 74세,1998,205,91,114
'4480032000,  금마면,'80,75 - 79세,1998,154,54,100
'4480032000,  금마면,'85,80 - 84세,1998,97,35,62
'4480032000,  금마면,'90,85+ ,1998,61,10,51
'4480033000,  홍동면,'00,계,1998,5418,2739,2679
'4480033000,  홍동면,'05,0 - 4세,1998,174,80,94
'4480033000,  홍동면,'10,5 - 9세,1998,240,124,116
'4480033000,  홍동면,'15,10 - 14세,1998,352,184,168
'4480033000,  홍동면,'20,15 - 19세,1998,525,270,255
'4480033000,  홍동면,'25,20 - 24세,1998,522,310,212
'4480033000,  홍동면,'30,25 - 29세,1998,348,223,125
'4480033000,  홍동면,'35,30 - 34세,1998,232,142,90
'4480033000,  홍동면,'40,35 - 39세,1998,347,179,168
'4480033000,  홍동면,'45,40 - 44세,1998,323,172,151
'4480033000,  홍동면,'50,45 - 49세,1998,307,147,160
'4480033000,  홍동면,'55,50 - 54세,1998,272,134,138
'4480033000,  홍동면,'60,55 - 59세,1998,394,189,205
'4480033000,  홍동면,'65,60 - 64세,1998,475,223,252
'4480033000,  홍동면,'70,65 - 69세,1998,358,151,207
'4480033000,  홍동면,'75,70 - 74세,1998,209,88,121
'4480033000,  홍동면,'80,75 - 79세,1998,182,73,109
'4480033000,  홍동면,'85,80 - 84세,1998,98,36,62
'4480033000,  홍동면,'90,85+ ,1998,60,14,46
'4480034000,  장곡면,'00,계,1998,5113,2532,2581
'4480034000,  장곡면,'05,0 - 4세,1998,145,60,85
'4480034000,  장곡면,'10,5 - 9세,1998,167,107,60
'4480034000,  장곡면,'15,10 - 14세,1998,267,143,124
'4480034000,  장곡면,'20,15 - 19세,1998,457,218,239
'4480034000,  장곡면,'25,20 - 24세,1998,499,300,199
'4480034000,  장곡면,'30,25 - 29세,1998,289,201,88
'4480034000,  장곡면,'35,30 - 34세,1998,197,118,79
'4480034000,  장곡면,'40,35 - 39세,1998,227,124,103
'4480034000,  장곡면,'45,40 - 44세,1998,269,134,135
'4480034000,  장곡면,'50,45 - 49세,1998,279,129,150
'4480034000,  장곡면,'55,50 - 54세,1998,296,134,162
'4480034000,  장곡면,'60,55 - 59세,1998,466,210,256
'4480034000,  장곡면,'65,60 - 64세,1998,576,260,316
'4480034000,  장곡면,'70,65 - 69세,1998,390,169,221
'4480034000,  장곡면,'75,70 - 74세,1998,226,104,122
'4480034000,  장곡면,'80,75 - 79세,1998,187,71,116
'4480034000,  장곡면,'85,80 - 84세,1998,109,35,74
'4480034000,  장곡면,'90,85+ ,1998,67,15,52
'4480035000,  은하면,'00,계,1998,3909,1951,1958
'4480035000,  은하면,'05,0 - 4세,1998,121,65,56
'4480035000,  은하면,'10,5 - 9세,1998,160,81,79
'4480035000,  은하면,'15,10 - 14세,1998,220,106,114
'4480035000,  은하면,'20,15 - 19세,1998,343,188,155
'4480035000,  은하면,'25,20 - 24세,1998,384,229,155
'4480035000,  은하면,'30,25 - 29세,1998,185,114,71
'4480035000,  은하면,'35,30 - 34세,1998,169,99,70
'4480035000,  은하면,'40,35 - 39세,1998,223,116,107
'4480035000,  은하면,'45,40 - 44세,1998,229,118,111
'4480035000,  은하면,'50,45 - 49세,1998,248,123,125
'4480035000,  은하면,'55,50 - 54세,1998,205,114,91
'4480035000,  은하면,'60,55 - 59세,1998,305,137,168
'4480035000,  은하면,'65,60 - 64세,1998,361,158,203
'4480035000,  은하면,'70,65 - 69세,1998,277,125,152
'4480035000,  은하면,'75,70 - 74세,1998,188,70,118
'4480035000,  은하면,'80,75 - 79세,1998,147,59,88
'4480035000,  은하면,'85,80 - 84세,1998,78,35,43
'4480035000,  은하면,'90,85+ ,1998,66,14,52
'4480036000,  결성면,'00,계,1998,3612,1832,1780
'4480036000,  결성면,'05,0 - 4세,1998,94,59,35
'4480036000,  결성면,'10,5 - 9세,1998,147,78,69
'4480036000,  결성면,'15,10 - 14세,1998,253,133,120
'4480036000,  결성면,'20,15 - 19세,1998,311,159,152
'4480036000,  결성면,'25,20 - 24세,1998,345,214,131
'4480036000,  결성면,'30,25 - 29세,1998,180,126,54
'4480036000,  결성면,'35,30 - 34세,1998,162,91,71
'4480036000,  결성면,'40,35 - 39세,1998,224,107,117
'4480036000,  결성면,'45,40 - 44세,1998,220,121,99
'4480036000,  결성면,'50,45 - 49세,1998,176,84,92
'4480036000,  결성면,'55,50 - 54세,1998,220,107,113
'4480036000,  결성면,'60,55 - 59세,1998,297,129,168
'4480036000,  결성면,'65,60 - 64세,1998,353,169,184
'4480036000,  결성면,'70,65 - 69세,1998,260,123,137
'4480036000,  결성면,'75,70 - 74세,1998,143,52,91
'4480036000,  결성면,'80,75 - 79세,1998,116,48,68
'4480036000,  결성면,'85,80 - 84세,1998,78,27,51
'4480036000,  결성면,'90,85+ ,1998,33,5,28
'4480037000,  서부면,'00,계,1998,4787,2356,2431
'4480037000,  서부면,'05,0 - 4세,1998,158,85,73
'4480037000,  서부면,'10,5 - 9세,1998,231,120,111
'4480037000,  서부면,'15,10 - 14세,1998,278,144,134
'4480037000,  서부면,'20,15 - 19세,1998,444,220,224
'4480037000,  서부면,'25,20 - 24세,1998,472,270,202
'4480037000,  서부면,'30,25 - 29세,1998,243,164,79
'4480037000,  서부면,'35,30 - 34세,1998,231,118,113
'4480037000,  서부면,'40,35 - 39세,1998,288,147,141
'4480037000,  서부면,'45,40 - 44세,1998,296,145,151
'4480037000,  서부면,'50,45 - 49세,1998,284,128,156
'4480037000,  서부면,'55,50 - 54세,1998,274,125,149
'4480037000,  서부면,'60,55 - 59세,1998,406,197,209
'4480037000,  서부면,'65,60 - 64세,1998,392,174,218
'4480037000,  서부면,'70,65 - 69세,1998,332,152,180
'4480037000,  서부면,'75,70 - 74세,1998,194,77,117
'4480037000,  서부면,'80,75 - 79세,1998,140,52,88
'4480037000,  서부면,'85,80 - 84세,1998,76,26,50
'4480037000,  서부면,'90,85+ ,1998,48,12,36
'4480038000,  갈산면,'00,계,1998,5821,2863,2958
'4480038000,  갈산면,'05,0 - 4세,1998,188,104,84
'4480038000,  갈산면,'10,5 - 9세,1998,258,118,140
'4480038000,  갈산면,'15,10 - 14세,1998,357,181,176
'4480038000,  갈산면,'20,15 - 19세,1998,574,288,286
'4480038000,  갈산면,'25,20 - 24세,1998,590,308,282
'4480038000,  갈산면,'30,25 - 29세,1998,332,223,109
'4480038000,  갈산면,'35,30 - 34세,1998,262,140,122
'4480038000,  갈산면,'40,35 - 39세,1998,364,179,185
'4480038000,  갈산면,'45,40 - 44세,1998,364,188,176
'4480038000,  갈산면,'50,45 - 49세,1998,360,174,186
'4480038000,  갈산면,'55,50 - 54세,1998,300,149,151
'4480038000,  갈산면,'60,55 - 59세,1998,448,189,259
'4480038000,  갈산면,'65,60 - 64세,1998,554,266,288
'4480038000,  갈산면,'70,65 - 69세,1998,371,166,205
'4480038000,  갈산면,'75,70 - 74세,1998,205,89,116
'4480038000,  갈산면,'80,75 - 79세,1998,155,56,99
'4480038000,  갈산면,'85,80 - 84세,1998,82,29,53
'4480038000,  갈산면,'90,85+ ,1998,57,16,41
'4480039000,  구항면,'00,계,1998,5139,2628,2511
'4480039000,  구항면,'05,0 - 4세,1998,246,130,116
'4480039000,  구항면,'10,5 - 9세,1998,214,104,110
'4480039000,  구항면,'15,10 - 14세,1998,286,155,131
'4480039000,  구항면,'20,15 - 19세,1998,499,251,248
'4480039000,  구항면,'25,20 - 24세,1998,515,295,220
'4480039000,  구항면,'30,25 - 29세,1998,419,269,150
'4480039000,  구항면,'35,30 - 34세,1998,278,165,113
'4480039000,  구항면,'40,35 - 39세,1998,314,166,148
'4480039000,  구항면,'45,40 - 44세,1998,309,163,146
'4480039000,  구항면,'50,45 - 49세,1998,272,134,138
'4480039000,  구항면,'55,50 - 54세,1998,262,132,130
'4480039000,  구항면,'60,55 - 59세,1998,349,150,199
'4480039000,  구항면,'65,60 - 64세,1998,434,206,228
'4480039000,  구항면,'70,65 - 69세,1998,311,142,169
'4480039000,  구항면,'75,70 - 74세,1998,181,69,112
'4480039000,  구항면,'80,75 - 79세,1998,135,55,80
'4480039000,  구항면,'85,80 - 84세,1998,82,32,50
'4480039000,  구항면,'90,85+ ,1998,33,10,23
'44810, 예산군,'00,계,1998,105346,52662,52684
'44810, 예산군,'05,0 - 4세,1998,5455,2818,2637
'44810, 예산군,'10,5 - 9세,1998,5743,3026,2717
'44810, 예산군,'15,10 - 14세,1998,6852,3432,3420
'44810, 예산군,'20,15 - 19세,1998,9900,5003,4897
'44810, 예산군,'25,20 - 24세,1998,9792,5438,4354
'44810, 예산군,'30,25 - 29세,1998,7836,4587,3249
'44810, 예산군,'35,30 - 34세,1998,6406,3372,3034
'44810, 예산군,'40,35 - 39세,1998,7811,3952,3859
'44810, 예산군,'45,40 - 44세,1998,7235,3722,3513
'44810, 예산군,'50,45 - 49세,1998,5998,3009,2989
'44810, 예산군,'55,50 - 54세,1998,5427,2637,2790
'44810, 예산군,'60,55 - 59세,1998,6691,3073,3618
'44810, 예산군,'65,60 - 64세,1998,7183,3342,3841
'44810, 예산군,'70,65 - 69세,1998,5137,2262,2875
'44810, 예산군,'75,70 - 74세,1998,3463,1489,1974
'44810, 예산군,'80,75 - 79세,1998,2323,867,1456
'44810, 예산군,'85,80 - 84세,1998,1308,432,876
'44810, 예산군,'90,85+ ,1998,786,201,585
'4481025000,  예산읍,'00,계,1998,40449,20023,20426
'4481025000,  예산읍,'05,0 - 4세,1998,2847,1449,1398
'4481025000,  예산읍,'10,5 - 9세,1998,2902,1497,1405
'4481025000,  예산읍,'15,10 - 14세,1998,3019,1500,1519
'4481025000,  예산읍,'20,15 - 19세,1998,3797,1942,1855
'4481025000,  예산읍,'25,20 - 24세,1998,3433,1842,1591
'4481025000,  예산읍,'30,25 - 29세,1998,3344,1681,1663
'4481025000,  예산읍,'35,30 - 34세,1998,3169,1590,1579
'4481025000,  예산읍,'40,35 - 39세,1998,3740,1854,1886
'4481025000,  예산읍,'45,40 - 44세,1998,3160,1608,1552
'4481025000,  예산읍,'50,45 - 49세,1998,2323,1186,1137
'4481025000,  예산읍,'55,50 - 54세,1998,1870,946,924
'4481025000,  예산읍,'60,55 - 59세,1998,1868,889,979
'4481025000,  예산읍,'65,60 - 64세,1998,1714,800,914
'4481025000,  예산읍,'70,65 - 69세,1998,1261,545,716
'4481025000,  예산읍,'75,70 - 74세,1998,867,347,520
'4481025000,  예산읍,'80,75 - 79세,1998,597,189,408
'4481025000,  예산읍,'85,80 - 84세,1998,344,107,237
'4481025000,  예산읍,'90,85+ ,1998,194,51,143
'4481025300,  삽교읍,'00,계,1998,12179,6079,6100
'4481025300,  삽교읍,'05,0 - 4세,1998,507,278,229
'4481025300,  삽교읍,'10,5 - 9세,1998,565,321,244
'4481025300,  삽교읍,'15,10 - 14세,1998,761,366,395
'4481025300,  삽교읍,'20,15 - 19세,1998,1160,569,591
'4481025300,  삽교읍,'25,20 - 24세,1998,1206,666,540
'4481025300,  삽교읍,'30,25 - 29세,1998,861,536,325
'4481025300,  삽교읍,'35,30 - 34세,1998,615,322,293
'4481025300,  삽교읍,'40,35 - 39세,1998,787,410,377
'4481025300,  삽교읍,'45,40 - 44세,1998,788,406,382
'4481025300,  삽교읍,'50,45 - 49세,1998,711,347,364
'4481025300,  삽교읍,'55,50 - 54세,1998,658,319,339
'4481025300,  삽교읍,'60,55 - 59세,1998,860,375,485
'4481025300,  삽교읍,'65,60 - 64세,1998,1004,486,518
'4481025300,  삽교읍,'70,65 - 69세,1998,659,298,361
'4481025300,  삽교읍,'75,70 - 74세,1998,464,191,273
'4481025300,  삽교읍,'80,75 - 79세,1998,302,112,190
'4481025300,  삽교읍,'85,80 - 84세,1998,182,50,132
'4481025300,  삽교읍,'90,85+ ,1998,89,27,62
'4481031000,  대술면,'00,계,1998,4144,2120,2024
'4481031000,  대술면,'05,0 - 4세,1998,146,78,68
'4481031000,  대술면,'10,5 - 9세,1998,158,84,74
'4481031000,  대술면,'15,10 - 14세,1998,237,125,112
'4481031000,  대술면,'20,15 - 19세,1998,410,209,201
'4481031000,  대술면,'25,20 - 24세,1998,443,259,184
'4481031000,  대술면,'30,25 - 29세,1998,273,182,91
'4481031000,  대술면,'35,30 - 34세,1998,165,97,68
'4481031000,  대술면,'40,35 - 39세,1998,254,127,127
'4481031000,  대술면,'45,40 - 44세,1998,246,133,113
'4481031000,  대술면,'50,45 - 49세,1998,222,125,97
'4481031000,  대술면,'55,50 - 54세,1998,231,103,128
'4481031000,  대술면,'60,55 - 59세,1998,316,136,180
'4481031000,  대술면,'65,60 - 64세,1998,361,167,194
'4481031000,  대술면,'70,65 - 69세,1998,261,122,139
'4481031000,  대술면,'75,70 - 74세,1998,185,83,102
'4481031000,  대술면,'80,75 - 79세,1998,122,48,74
'4481031000,  대술면,'85,80 - 84세,1998,76,26,50
'4481031000,  대술면,'90,85+ ,1998,38,16,22
'4481032000,  신양면,'00,계,1998,5048,2477,2571
'4481032000,  신양면,'05,0 - 4세,1998,153,87,66
'4481032000,  신양면,'10,5 - 9세,1998,199,103,96
'4481032000,  신양면,'15,10 - 14세,1998,303,145,158
'4481032000,  신양면,'20,15 - 19세,1998,473,245,228
'4481032000,  신양면,'25,20 - 24세,1998,556,303,253
'4481032000,  신양면,'30,25 - 29세,1998,291,188,103
'4481032000,  신양면,'35,30 - 34세,1998,212,126,86
'4481032000,  신양면,'40,35 - 39세,1998,257,128,129
'4481032000,  신양면,'45,40 - 44세,1998,317,162,155
'4481032000,  신양면,'50,45 - 49세,1998,277,128,149
'4481032000,  신양면,'55,50 - 54세,1998,271,131,140
'4481032000,  신양면,'60,55 - 59세,1998,419,193,226
'4481032000,  신양면,'65,60 - 64세,1998,482,223,259
'4481032000,  신양면,'70,65 - 69세,1998,344,136,208
'4481032000,  신양면,'75,70 - 74세,1998,213,85,128
'4481032000,  신양면,'80,75 - 79세,1998,143,55,88
'4481032000,  신양면,'85,80 - 84세,1998,83,29,54
'4481032000,  신양면,'90,85+ ,1998,55,10,45
'4481033000,  광시면,'00,계,1998,4987,2514,2473
'4481033000,  광시면,'05,0 - 4세,1998,197,94,103
'4481033000,  광시면,'10,5 - 9세,1998,164,92,72
'4481033000,  광시면,'15,10 - 14세,1998,244,138,106
'4481033000,  광시면,'20,15 - 19세,1998,444,211,233
'4481033000,  광시면,'25,20 - 24세,1998,479,286,193
'4481033000,  광시면,'30,25 - 29세,1998,305,215,90
'4481033000,  광시면,'35,30 - 34세,1998,211,118,93
'4481033000,  광시면,'40,35 - 39세,1998,283,154,129
'4481033000,  광시면,'45,40 - 44세,1998,254,137,117
'4481033000,  광시면,'50,45 - 49세,1998,239,108,131
'4481033000,  광시면,'55,50 - 54세,1998,285,141,144
'4481033000,  광시면,'60,55 - 59세,1998,432,177,255
'4481033000,  광시면,'65,60 - 64세,1998,540,253,287
'4481033000,  광시면,'70,65 - 69세,1998,374,178,196
'4481033000,  광시면,'75,70 - 74세,1998,214,94,120
'4481033000,  광시면,'80,75 - 79세,1998,163,66,97
'4481033000,  광시면,'85,80 - 84세,1998,92,33,59
'4481033000,  광시면,'90,85+ ,1998,67,19,48
'4481034000,  대흥면,'00,계,1998,2677,1324,1353
'4481034000,  대흥면,'05,0 - 4세,1998,79,45,34
'4481034000,  대흥면,'10,5 - 9세,1998,76,34,42
'4481034000,  대흥면,'15,10 - 14세,1998,139,66,73
'4481034000,  대흥면,'20,15 - 19세,1998,259,139,120
'4481034000,  대흥면,'25,20 - 24세,1998,245,139,106
'4481034000,  대흥면,'30,25 - 29세,1998,175,124,51
'4481034000,  대흥면,'35,30 - 34세,1998,103,55,48
'4481034000,  대흥면,'40,35 - 39세,1998,157,71,86
'4481034000,  대흥면,'45,40 - 44세,1998,180,91,89
'4481034000,  대흥면,'50,45 - 49세,1998,163,84,79
'4481034000,  대흥면,'55,50 - 54세,1998,147,68,79
'4481034000,  대흥면,'60,55 - 59세,1998,183,88,95
'4481034000,  대흥면,'65,60 - 64세,1998,253,106,147
'4481034000,  대흥면,'70,65 - 69세,1998,199,85,114
'4481034000,  대흥면,'75,70 - 74세,1998,151,68,83
'4481034000,  대흥면,'80,75 - 79세,1998,92,33,59
'4481034000,  대흥면,'85,80 - 84세,1998,45,20,25
'4481034000,  대흥면,'90,85+ ,1998,31,8,23
'4481035000,  응봉면,'00,계,1998,3632,1852,1780
'4481035000,  응봉면,'05,0 - 4세,1998,149,87,62
'4481035000,  응봉면,'10,5 - 9세,1998,167,106,61
'4481035000,  응봉면,'15,10 - 14세,1998,227,111,116
'4481035000,  응봉면,'20,15 - 19세,1998,313,149,164
'4481035000,  응봉면,'25,20 - 24세,1998,351,195,156
'4481035000,  응봉면,'30,25 - 29세,1998,246,161,85
'4481035000,  응봉면,'35,30 - 34세,1998,201,115,86
'4481035000,  응봉면,'40,35 - 39세,1998,246,131,115
'4481035000,  응봉면,'45,40 - 44세,1998,242,129,113
'4481035000,  응봉면,'50,45 - 49세,1998,195,103,92
'4481035000,  응봉면,'55,50 - 54세,1998,169,74,95
'4481035000,  응봉면,'60,55 - 59세,1998,261,114,147
'4481035000,  응봉면,'65,60 - 64세,1998,288,142,146
'4481035000,  응봉면,'70,65 - 69세,1998,247,107,140
'4481035000,  응봉면,'75,70 - 74세,1998,150,65,85
'4481035000,  응봉면,'80,75 - 79세,1998,90,37,53
'4481035000,  응봉면,'85,80 - 84세,1998,55,18,37
'4481035000,  응봉면,'90,85+ ,1998,35,8,27
'4481036000,  덕산면,'00,계,1998,7388,3613,3775
'4481036000,  덕산면,'05,0 - 4세,1998,348,159,189
'4481036000,  덕산면,'10,5 - 9세,1998,415,205,210
'4481036000,  덕산면,'15,10 - 14세,1998,469,242,227
'4481036000,  덕산면,'20,15 - 19세,1998,664,333,331
'4481036000,  덕산면,'25,20 - 24세,1998,662,367,295
'4481036000,  덕산면,'30,25 - 29세,1998,541,317,224
'4481036000,  덕산면,'35,30 - 34세,1998,488,253,235
'4481036000,  덕산면,'40,35 - 39세,1998,525,244,281
'4481036000,  덕산면,'45,40 - 44세,1998,522,266,256
'4481036000,  덕산면,'50,45 - 49세,1998,430,217,213
'4481036000,  덕산면,'55,50 - 54세,1998,385,181,204
'4481036000,  덕산면,'60,55 - 59세,1998,468,213,255
'4481036000,  덕산면,'65,60 - 64세,1998,507,222,285
'4481036000,  덕산면,'70,65 - 69세,1998,372,160,212
'4481036000,  덕산면,'75,70 - 74세,1998,263,124,139
'4481036000,  덕산면,'80,75 - 79세,1998,152,59,93
'4481036000,  덕산면,'85,80 - 84세,1998,101,33,68
'4481036000,  덕산면,'90,85+ ,1998,76,18,58
'4481037000,  봉산면,'00,계,1998,3520,1808,1712
'4481037000,  봉산면,'05,0 - 4세,1998,125,69,56
'4481037000,  봉산면,'10,5 - 9세,1998,140,77,63
'4481037000,  봉산면,'15,10 - 14세,1998,189,89,100
'4481037000,  봉산면,'20,15 - 19세,1998,310,162,148
'4481037000,  봉산면,'25,20 - 24세,1998,327,191,136
'4481037000,  봉산면,'30,25 - 29세,1998,205,143,62
'4481037000,  봉산면,'35,30 - 34세,1998,138,74,64
'4481037000,  봉산면,'40,35 - 39세,1998,195,109,86
'4481037000,  봉산면,'45,40 - 44세,1998,219,124,95
'4481037000,  봉산면,'50,45 - 49세,1998,188,97,91
'4481037000,  봉산면,'55,50 - 54세,1998,188,90,98
'4481037000,  봉산면,'60,55 - 59세,1998,299,146,153
'4481037000,  봉산면,'65,60 - 64세,1998,308,133,175
'4481037000,  봉산면,'70,65 - 69세,1998,258,122,136
'4481037000,  봉산면,'75,70 - 74세,1998,203,92,111
'4481037000,  봉산면,'80,75 - 79세,1998,133,54,79
'4481037000,  봉산면,'85,80 - 84세,1998,55,27,28
'4481037000,  봉산면,'90,85+ ,1998,40,9,31
'4481038000,  고덕면,'00,계,1998,7944,4022,3922
'4481038000,  고덕면,'05,0 - 4세,1998,305,147,158
'4481038000,  고덕면,'10,5 - 9세,1998,368,203,165
'4481038000,  고덕면,'15,10 - 14세,1998,474,247,227
'4481038000,  고덕면,'20,15 - 19세,1998,820,413,407
'4481038000,  고덕면,'25,20 - 24세,1998,774,443,331
'4481038000,  고덕면,'30,25 - 29세,1998,542,371,171
'4481038000,  고덕면,'35,30 - 34세,1998,362,204,158
'4481038000,  고덕면,'40,35 - 39세,1998,508,264,244
'4481038000,  고덕면,'45,40 - 44세,1998,466,225,241
'4481038000,  고덕면,'50,45 - 49세,1998,464,230,234
'4481038000,  고덕면,'55,50 - 54세,1998,451,218,233
'4481038000,  고덕면,'60,55 - 59세,1998,587,281,306
'4481038000,  고덕면,'65,60 - 64세,1998,690,318,372
'4481038000,  고덕면,'70,65 - 69세,1998,449,185,264
'4481038000,  고덕면,'75,70 - 74세,1998,289,136,153
'4481038000,  고덕면,'80,75 - 79세,1998,227,88,139
'4481038000,  고덕면,'85,80 - 84세,1998,108,33,75
'4481038000,  고덕면,'90,85+ ,1998,60,16,44
'4481039000,  신암면,'00,계,1998,5716,2880,2836
'4481039000,  신암면,'05,0 - 4세,1998,227,119,108
'4481039000,  신암면,'10,5 - 9세,1998,229,116,113
'4481039000,  신암면,'15,10 - 14세,1998,326,167,159
'4481039000,  신암면,'20,15 - 19세,1998,533,260,273
'4481039000,  신암면,'25,20 - 24세,1998,575,326,249
'4481039000,  신암면,'30,25 - 29세,1998,381,254,127
'4481039000,  신암면,'35,30 - 34세,1998,284,156,128
'4481039000,  신암면,'40,35 - 39세,1998,353,190,163
'4481039000,  신암면,'45,40 - 44세,1998,367,187,180
'4481039000,  신암면,'50,45 - 49세,1998,342,159,183
'4481039000,  신암면,'55,50 - 54세,1998,340,157,183
'4481039000,  신암면,'60,55 - 59세,1998,487,226,261
'4481039000,  신암면,'65,60 - 64세,1998,507,236,271
'4481039000,  신암면,'70,65 - 69세,1998,318,153,165
'4481039000,  신암면,'75,70 - 74세,1998,188,86,102
'4481039000,  신암면,'80,75 - 79세,1998,130,55,75
'4481039000,  신암면,'85,80 - 84세,1998,83,27,56
'4481039000,  신암면,'90,85+ ,1998,46,6,40
'4481040000,  오가면,'00,계,1998,7662,3950,3712
'4481040000,  오가면,'05,0 - 4세,1998,372,206,166
'4481040000,  오가면,'10,5 - 9세,1998,360,188,172
'4481040000,  오가면,'15,10 - 14세,1998,464,236,228
'4481040000,  오가면,'20,15 - 19세,1998,717,371,346
'4481040000,  오가면,'25,20 - 24세,1998,741,421,320
'4481040000,  오가면,'30,25 - 29세,1998,672,415,257
'4481040000,  오가면,'35,30 - 34세,1998,458,262,196
'4481040000,  오가면,'40,35 - 39세,1998,506,270,236
'4481040000,  오가면,'45,40 - 44세,1998,474,254,220
'4481040000,  오가면,'50,45 - 49세,1998,444,225,219
'4481040000,  오가면,'55,50 - 54세,1998,432,209,223
'4481040000,  오가면,'60,55 - 59세,1998,511,235,276
'4481040000,  오가면,'65,60 - 64세,1998,529,256,273
'4481040000,  오가면,'70,65 - 69세,1998,395,171,224
'4481040000,  오가면,'75,70 - 74세,1998,276,118,158
'4481040000,  오가면,'80,75 - 79세,1998,172,71,101
'4481040000,  오가면,'85,80 - 84세,1998,84,29,55
'4481040000,  오가면,'90,85+ ,1998,55,13,42
'44825, 태안군,'00,계,1998,70056,35242,34814
'44825, 태안군,'05,0 - 4세,1998,3546,1894,1652
'44825, 태안군,'10,5 - 9세,1998,3799,1958,1841
'44825, 태안군,'15,10 - 14세,1998,4442,2315,2127
'44825, 태안군,'20,15 - 19세,1998,7168,3619,3549
'44825, 태안군,'25,20 - 24세,1998,6593,3736,2857
'44825, 태안군,'30,25 - 29세,1998,4909,2913,1996
'44825, 태안군,'35,30 - 34세,1998,4383,2376,2007
'44825, 태안군,'40,35 - 39세,1998,5064,2610,2454
'44825, 태안군,'45,40 - 44세,1998,4669,2323,2346
'44825, 태안군,'50,45 - 49세,1998,4257,2160,2097
'44825, 태안군,'55,50 - 54세,1998,4128,2079,2049
'44825, 태안군,'60,55 - 59세,1998,4682,2175,2507
'44825, 태안군,'65,60 - 64세,1998,4371,2010,2361
'44825, 태안군,'70,65 - 69세,1998,3212,1388,1824
'44825, 태안군,'75,70 - 74세,1998,2170,856,1314
'44825, 태안군,'80,75 - 79세,1998,1383,497,886
'44825, 태안군,'85,80 - 84세,1998,743,218,525
'44825, 태안군,'90,85+ ,1998,537,115,422
'4482525000,  태안읍,'00,계,1998,27001,13631,13370
'4482525000,  태안읍,'05,0 - 4세,1998,1806,990,816
'4482525000,  태안읍,'10,5 - 9세,1998,1955,1010,945
'4482525000,  태안읍,'15,10 - 14세,1998,1947,1016,931
'4482525000,  태안읍,'20,15 - 19세,1998,2721,1421,1300
'4482525000,  태안읍,'25,20 - 24세,1998,2494,1347,1147
'4482525000,  태안읍,'30,25 - 29세,1998,2226,1217,1009
'4482525000,  태안읍,'35,30 - 34세,1998,2145,1096,1049
'4482525000,  태안읍,'40,35 - 39세,1998,2362,1195,1167
'4482525000,  태안읍,'45,40 - 44세,1998,1870,943,927
'4482525000,  태안읍,'50,45 - 49세,1998,1604,807,797
'4482525000,  태안읍,'55,50 - 54세,1998,1359,708,651
'4482525000,  태안읍,'60,55 - 59세,1998,1247,580,667
'4482525000,  태안읍,'65,60 - 64세,1998,1203,537,666
'4482525000,  태안읍,'70,65 - 69세,1998,858,374,484
'4482525000,  태안읍,'75,70 - 74세,1998,514,190,324
'4482525000,  태안읍,'80,75 - 79세,1998,375,136,239
'4482525000,  태안읍,'85,80 - 84세,1998,176,40,136
'4482525000,  태안읍,'90,85+ ,1998,139,24,115
'4482525300,  안면읍,'00,계,1998,10326,5128,5198
'4482525300,  안면읍,'05,0 - 4세,1998,425,235,190
'4482525300,  안면읍,'10,5 - 9세,1998,515,265,250
'4482525300,  안면읍,'15,10 - 14세,1998,616,302,314
'4482525300,  안면읍,'20,15 - 19세,1998,1088,544,544
'4482525300,  안면읍,'25,20 - 24세,1998,994,559,435
'4482525300,  안면읍,'30,25 - 29세,1998,580,336,244
'4482525300,  안면읍,'35,30 - 34세,1998,551,311,240
'4482525300,  안면읍,'40,35 - 39세,1998,664,349,315
'4482525300,  안면읍,'45,40 - 44세,1998,701,326,375
'4482525300,  안면읍,'50,45 - 49세,1998,687,345,342
'4482525300,  안면읍,'55,50 - 54세,1998,717,352,365
'4482525300,  안면읍,'60,55 - 59세,1998,783,358,425
'4482525300,  안면읍,'65,60 - 64세,1998,620,297,323
'4482525300,  안면읍,'70,65 - 69세,1998,502,211,291
'4482525300,  안면읍,'75,70 - 74세,1998,402,170,232
'4482525300,  안면읍,'80,75 - 79세,1998,256,98,158
'4482525300,  안면읍,'85,80 - 84세,1998,131,46,85
'4482525300,  안면읍,'90,85+ ,1998,94,24,70
'4482531000,  고남면,'00,계,1998,3329,1648,1681
'4482531000,  고남면,'05,0 - 4세,1998,123,62,61
'4482531000,  고남면,'10,5 - 9세,1998,117,62,55
'4482531000,  고남면,'15,10 - 14세,1998,208,97,111
'4482531000,  고남면,'20,15 - 19세,1998,361,171,190
'4482531000,  고남면,'25,20 - 24세,1998,292,178,114
'4482531000,  고남면,'30,25 - 29세,1998,173,107,66
'4482531000,  고남면,'35,30 - 34세,1998,151,91,60
'4482531000,  고남면,'40,35 - 39세,1998,211,106,105
'4482531000,  고남면,'45,40 - 44세,1998,216,114,102
'4482531000,  고남면,'50,45 - 49세,1998,189,99,90
'4482531000,  고남면,'55,50 - 54세,1998,218,104,114
'4482531000,  고남면,'60,55 - 59세,1998,266,121,145
'4482531000,  고남면,'65,60 - 64세,1998,279,121,158
'4482531000,  고남면,'70,65 - 69세,1998,215,96,119
'4482531000,  고남면,'75,70 - 74세,1998,132,59,73
'4482531000,  고남면,'80,75 - 79세,1998,98,33,65
'4482531000,  고남면,'85,80 - 84세,1998,56,22,34
'4482531000,  고남면,'90,85+ ,1998,24,5,19
'4482532000,  남면,'00,계,1998,5602,2822,2780
'4482532000,  남면,'05,0 - 4세,1998,216,121,95
'4482532000,  남면,'10,5 - 9세,1998,204,105,99
'4482532000,  남면,'15,10 - 14세,1998,370,193,177
'4482532000,  남면,'20,15 - 19세,1998,586,279,307
'4482532000,  남면,'25,20 - 24세,1998,557,308,249
'4482532000,  남면,'30,25 - 29세,1998,360,238,122
'4482532000,  남면,'35,30 - 34세,1998,265,146,119
'4482532000,  남면,'40,35 - 39세,1998,360,180,180
'4482532000,  남면,'45,40 - 44세,1998,382,199,183
'4482532000,  남면,'50,45 - 49세,1998,335,186,149
'4482532000,  남면,'55,50 - 54세,1998,350,170,180
'4482532000,  남면,'60,55 - 59세,1998,473,225,248
'4482532000,  남면,'65,60 - 64세,1998,427,192,235
'4482532000,  남면,'70,65 - 69세,1998,310,129,181
'4482532000,  남면,'75,70 - 74세,1998,190,85,105
'4482532000,  남면,'80,75 - 79세,1998,112,43,69
'4482532000,  남면,'85,80 - 84세,1998,62,14,48
'4482532000,  남면,'90,85+ ,1998,43,9,34
'4482533000,  근흥면,'00,계,1998,7220,3691,3529
'4482533000,  근흥면,'05,0 - 4세,1998,310,152,158
'4482533000,  근흥면,'10,5 - 9세,1998,327,168,159
'4482533000,  근흥면,'15,10 - 14세,1998,430,230,200
'4482533000,  근흥면,'20,15 - 19세,1998,730,366,364
'4482533000,  근흥면,'25,20 - 24세,1998,681,430,251
'4482533000,  근흥면,'30,25 - 29세,1998,463,291,172
'4482533000,  근흥면,'35,30 - 34세,1998,416,241,175
'4482533000,  근흥면,'40,35 - 39세,1998,510,277,233
'4482533000,  근흥면,'45,40 - 44세,1998,481,244,237
'4482533000,  근흥면,'50,45 - 49세,1998,456,227,229
'4482533000,  근흥면,'55,50 - 54세,1998,438,219,219
'4482533000,  근흥면,'60,55 - 59세,1998,527,259,268
'4482533000,  근흥면,'65,60 - 64세,1998,509,227,282
'4482533000,  근흥면,'70,65 - 69세,1998,371,156,215
'4482533000,  근흥면,'75,70 - 74세,1998,265,111,154
'4482533000,  근흥면,'80,75 - 79세,1998,156,59,97
'4482533000,  근흥면,'85,80 - 84세,1998,89,21,68
'4482533000,  근흥면,'90,85+ ,1998,61,13,48
'4482534000,  소원면,'00,계,1998,7701,3837,3864
'4482534000,  소원면,'05,0 - 4세,1998,264,122,142
'4482534000,  소원면,'10,5 - 9세,1998,275,130,145
'4482534000,  소원면,'15,10 - 14세,1998,431,226,205
'4482534000,  소원면,'20,15 - 19세,1998,872,423,449
'4482534000,  소원면,'25,20 - 24세,1998,792,464,328
'4482534000,  소원면,'30,25 - 29세,1998,473,309,164
'4482534000,  소원면,'35,30 - 34세,1998,351,206,145
'4482534000,  소원면,'40,35 - 39세,1998,447,231,216
'4482534000,  소원면,'45,40 - 44세,1998,524,257,267
'4482534000,  소원면,'50,45 - 49세,1998,489,244,245
'4482534000,  소원면,'55,50 - 54세,1998,490,243,247
'4482534000,  소원면,'60,55 - 59세,1998,656,299,357
'4482534000,  소원면,'65,60 - 64세,1998,595,281,314
'4482534000,  소원면,'70,65 - 69세,1998,432,205,227
'4482534000,  소원면,'75,70 - 74세,1998,270,98,172
'4482534000,  소원면,'80,75 - 79세,1998,175,59,116
'4482534000,  소원면,'85,80 - 84세,1998,90,27,63
'4482534000,  소원면,'90,85+ ,1998,75,13,62
'4482535000,  원북면,'00,계,1998,6136,3128,3008
'4482535000,  원북면,'05,0 - 4세,1998,316,171,145
'4482535000,  원북면,'10,5 - 9세,1998,309,167,142
'4482535000,  원북면,'15,10 - 14세,1998,299,177,122
'4482535000,  원북면,'20,15 - 19세,1998,539,272,267
'4482535000,  원북면,'25,20 - 24세,1998,567,326,241
'4482535000,  원북면,'30,25 - 29세,1998,475,303,172
'4482535000,  원북면,'35,30 - 34세,1998,416,228,188
'4482535000,  원북면,'40,35 - 39세,1998,343,188,155
'4482535000,  원북면,'45,40 - 44세,1998,338,159,179
'4482535000,  원북면,'50,45 - 49세,1998,344,182,162
'4482535000,  원북면,'55,50 - 54세,1998,374,182,192
'4482535000,  원북면,'60,55 - 59세,1998,456,212,244
'4482535000,  원북면,'65,60 - 64세,1998,469,218,251
'4482535000,  원북면,'70,65 - 69세,1998,343,153,190
'4482535000,  원북면,'75,70 - 74세,1998,257,91,166
'4482535000,  원북면,'80,75 - 79세,1998,138,48,90
'4482535000,  원북면,'85,80 - 84세,1998,87,31,56
'4482535000,  원북면,'90,85+ ,1998,66,20,46
'4482536000,  이원면,'00,계,1998,2741,1357,1384
'4482536000,  이원면,'05,0 - 4세,1998,86,41,45
'4482536000,  이원면,'10,5 - 9세,1998,97,51,46
'4482536000,  이원면,'15,10 - 14세,1998,141,74,67
'4482536000,  이원면,'20,15 - 19세,1998,271,143,128
'4482536000,  이원면,'25,20 - 24세,1998,216,124,92
'4482536000,  이원면,'30,25 - 29세,1998,159,112,47
'4482536000,  이원면,'35,30 - 34세,1998,88,57,31
'4482536000,  이원면,'40,35 - 39세,1998,167,84,83
'4482536000,  이원면,'45,40 - 44세,1998,157,81,76
'4482536000,  이원면,'50,45 - 49세,1998,153,70,83
'4482536000,  이원면,'55,50 - 54세,1998,182,101,81
'4482536000,  이원면,'60,55 - 59세,1998,274,121,153
'4482536000,  이원면,'65,60 - 64세,1998,269,137,132
'4482536000,  이원면,'70,65 - 69세,1998,181,64,117
'4482536000,  이원면,'75,70 - 74세,1998,140,52,88
'4482536000,  이원면,'80,75 - 79세,1998,73,21,52
'4482536000,  이원면,'85,80 - 84세,1998,52,17,35
'4482536000,  이원면,'90,85+ ,1998,35,7,28
'44830, 당진군,'00,계,1998,125360,63193,62167
'44830, 당진군,'05,0 - 4세,1998,8260,4310,3950
'44830, 당진군,'10,5 - 9세,1998,8118,4234,3884
'44830, 당진군,'15,10 - 14세,1998,7820,3997,3823
'44830, 당진군,'20,15 - 19세,1998,11078,5473,5605
'44830, 당진군,'25,20 - 24세,1998,11014,6142,4872
'44830, 당진군,'30,25 - 29세,1998,10287,5751,4536
'44830, 당진군,'35,30 - 34세,1998,9467,5090,4377
'44830, 당진군,'40,35 - 39세,1998,9544,5039,4505
'44830, 당진군,'45,40 - 44세,1998,8220,4229,3991
'44830, 당진군,'50,45 - 49세,1998,6764,3426,3338
'44830, 당진군,'55,50 - 54세,1998,6093,3118,2975
'44830, 당진군,'60,55 - 59세,1998,7417,3456,3961
'44830, 당진군,'65,60 - 64세,1998,7870,3574,4296
'44830, 당진군,'70,65 - 69세,1998,5247,2289,2958
'44830, 당진군,'75,70 - 74세,1998,3466,1443,2023
'44830, 당진군,'80,75 - 79세,1998,2447,943,1504
'44830, 당진군,'85,80 - 84세,1998,1333,465,868
'44830, 당진군,'90,85+ ,1998,915,214,701
'4483025000,  당진읍,'00,계,1998,31491,15678,15813
'4483025000,  당진읍,'05,0 - 4세,1998,2748,1395,1353
'4483025000,  당진읍,'10,5 - 9세,1998,2776,1482,1294
'4483025000,  당진읍,'15,10 - 14세,1998,2258,1166,1092
'4483025000,  당진읍,'20,15 - 19세,1998,2688,1309,1379
'4483025000,  당진읍,'25,20 - 24세,1998,2450,1288,1162
'4483025000,  당진읍,'30,25 - 29세,1998,2926,1417,1509
'4483025000,  당진읍,'35,30 - 34세,1998,3074,1555,1519
'4483025000,  당진읍,'40,35 - 39세,1998,2912,1451,1461
'4483025000,  당진읍,'45,40 - 44세,1998,2232,1163,1069
'4483025000,  당진읍,'50,45 - 49세,1998,1627,860,767
'4483025000,  당진읍,'55,50 - 54세,1998,1247,637,610
'4483025000,  당진읍,'60,55 - 59세,1998,1267,617,650
'4483025000,  당진읍,'65,60 - 64세,1998,1207,564,643
'4483025000,  당진읍,'70,65 - 69세,1998,761,313,448
'4483025000,  당진읍,'75,70 - 74세,1998,558,216,342
'4483025000,  당진읍,'80,75 - 79세,1998,394,128,266
'4483025000,  당진읍,'85,80 - 84세,1998,225,80,145
'4483025000,  당진읍,'90,85+ ,1998,141,37,104
'4483025300,  합덕읍,'00,계,1998,14400,7208,7192
'4483025300,  합덕읍,'05,0 - 4세,1998,696,395,301
'4483025300,  합덕읍,'10,5 - 9세,1998,884,461,423
'4483025300,  합덕읍,'15,10 - 14세,1998,1048,547,501
'4483025300,  합덕읍,'20,15 - 19세,1998,1466,710,756
'4483025300,  합덕읍,'25,20 - 24세,1998,1374,747,627
'4483025300,  합덕읍,'30,25 - 29세,1998,939,549,390
'4483025300,  합덕읍,'35,30 - 34세,1998,878,430,448
'4483025300,  합덕읍,'40,35 - 39세,1998,1082,553,529
'4483025300,  합덕읍,'45,40 - 44세,1998,1048,536,512
'4483025300,  합덕읍,'50,45 - 49세,1998,872,410,462
'4483025300,  합덕읍,'55,50 - 54세,1998,782,407,375
'4483025300,  합덕읍,'60,55 - 59세,1998,954,450,504
'4483025300,  합덕읍,'65,60 - 64세,1998,894,425,469
'4483025300,  합덕읍,'70,65 - 69세,1998,583,256,327
'4483025300,  합덕읍,'75,70 - 74세,1998,401,172,229
'4483025300,  합덕읍,'80,75 - 79세,1998,268,100,168
'4483025300,  합덕읍,'85,80 - 84세,1998,135,40,95
'4483025300,  합덕읍,'90,85+ ,1998,96,20,76
'4483031000,  고대면,'00,계,1998,7348,3714,3634
'4483031000,  고대면,'05,0 - 4세,1998,308,168,140
'4483031000,  고대면,'10,5 - 9세,1998,358,167,191
'4483031000,  고대면,'15,10 - 14세,1998,384,179,205
'4483031000,  고대면,'20,15 - 19세,1998,638,333,305
'4483031000,  고대면,'25,20 - 24세,1998,674,394,280
'4483031000,  고대면,'30,25 - 29세,1998,516,332,184
'4483031000,  고대면,'35,30 - 34세,1998,432,258,174
'4483031000,  고대면,'40,35 - 39세,1998,435,243,192
'4483031000,  고대면,'45,40 - 44세,1998,451,226,225
'4483031000,  고대면,'50,45 - 49세,1998,404,214,190
'4483031000,  고대면,'55,50 - 54세,1998,409,208,201
'4483031000,  고대면,'60,55 - 59세,1998,544,250,294
'4483031000,  고대면,'65,60 - 64세,1998,691,321,370
'4483031000,  고대면,'70,65 - 69세,1998,417,170,247
'4483031000,  고대면,'75,70 - 74세,1998,279,117,162
'4483031000,  고대면,'80,75 - 79세,1998,200,77,123
'4483031000,  고대면,'85,80 - 84세,1998,120,40,80
'4483031000,  고대면,'90,85+ ,1998,88,17,71
'4483032000,  석문면,'00,계,1998,8552,4337,4215
'4483032000,  석문면,'05,0 - 4세,1998,453,229,224
'4483032000,  석문면,'10,5 - 9세,1998,429,225,204
'4483032000,  석문면,'15,10 - 14세,1998,509,276,233
'4483032000,  석문면,'20,15 - 19세,1998,741,364,377
'4483032000,  석문면,'25,20 - 24세,1998,795,461,334
'4483032000,  석문면,'30,25 - 29세,1998,623,385,238
'4483032000,  석문면,'35,30 - 34세,1998,591,313,278
'4483032000,  석문면,'40,35 - 39세,1998,640,330,310
'4483032000,  석문면,'45,40 - 44세,1998,581,303,278
'4483032000,  석문면,'50,45 - 49세,1998,460,236,224
'4483032000,  석문면,'55,50 - 54세,1998,455,241,214
'4483032000,  석문면,'60,55 - 59세,1998,641,279,362
'4483032000,  석문면,'65,60 - 64세,1998,629,293,336
'4483032000,  석문면,'70,65 - 69세,1998,389,171,218
'4483032000,  석문면,'75,70 - 74세,1998,279,122,157
'4483032000,  석문면,'80,75 - 79세,1998,170,60,110
'4483032000,  석문면,'85,80 - 84세,1998,95,33,62
'4483032000,  석문면,'90,85+ ,1998,72,16,56
'4483033000,  대호지면,'00,계,1998,3822,1915,1907
'4483033000,  대호지면,'05,0 - 4세,1998,114,66,48
'4483033000,  대호지면,'10,5 - 9세,1998,168,88,80
'4483033000,  대호지면,'15,10 - 14세,1998,226,98,128
'4483033000,  대호지면,'20,15 - 19세,1998,392,191,201
'4483033000,  대호지면,'25,20 - 24세,1998,371,234,137
'4483033000,  대호지면,'30,25 - 29세,1998,224,160,64
'4483033000,  대호지면,'35,30 - 34세,1998,145,80,65
'4483033000,  대호지면,'40,35 - 39세,1998,208,98,110
'4483033000,  대호지면,'45,40 - 44세,1998,245,130,115
'4483033000,  대호지면,'50,45 - 49세,1998,240,122,118
'4483033000,  대호지면,'55,50 - 54세,1998,218,107,111
'4483033000,  대호지면,'60,55 - 59세,1998,289,128,161
'4483033000,  대호지면,'65,60 - 64세,1998,321,138,183
'4483033000,  대호지면,'70,65 - 69세,1998,266,123,143
'4483033000,  대호지면,'75,70 - 74세,1998,158,74,84
'4483033000,  대호지면,'80,75 - 79세,1998,124,45,79
'4483033000,  대호지면,'85,80 - 84세,1998,63,25,38
'4483033000,  대호지면,'90,85+ ,1998,50,8,42
'4483034000,  정미면,'00,계,1998,4544,2284,2260
'4483034000,  정미면,'05,0 - 4세,1998,158,77,81
'4483034000,  정미면,'10,5 - 9세,1998,150,83,67
'4483034000,  정미면,'15,10 - 14세,1998,211,94,117
'4483034000,  정미면,'20,15 - 19세,1998,407,195,212
'4483034000,  정미면,'25,20 - 24세,1998,464,269,195
'4483034000,  정미면,'30,25 - 29세,1998,309,224,85
'4483034000,  정미면,'35,30 - 34세,1998,166,99,67
'4483034000,  정미면,'40,35 - 39세,1998,242,138,104
'4483034000,  정미면,'45,40 - 44세,1998,248,123,125
'4483034000,  정미면,'50,45 - 49세,1998,270,128,142
'4483034000,  정미면,'55,50 - 54세,1998,279,135,144
'4483034000,  정미면,'60,55 - 59세,1998,368,176,192
'4483034000,  정미면,'65,60 - 64세,1998,440,188,252
'4483034000,  정미면,'70,65 - 69세,1998,320,148,172
'4483034000,  정미면,'75,70 - 74세,1998,202,86,116
'4483034000,  정미면,'80,75 - 79세,1998,155,78,77
'4483034000,  정미면,'85,80 - 84세,1998,88,33,55
'4483034000,  정미면,'90,85+ ,1998,67,10,57
'4483035000,  면천면,'00,계,1998,5002,2502,2500
'4483035000,  면천면,'05,0 - 4세,1998,226,105,121
'4483035000,  면천면,'10,5 - 9세,1998,229,118,111
'4483035000,  면천면,'15,10 - 14세,1998,318,168,150
'4483035000,  면천면,'20,15 - 19세,1998,508,261,247
'4483035000,  면천면,'25,20 - 24세,1998,508,293,215
'4483035000,  면천면,'30,25 - 29세,1998,299,194,105
'4483035000,  면천면,'35,30 - 34세,1998,259,142,117
'4483035000,  면천면,'40,35 - 39세,1998,329,170,159
'4483035000,  면천면,'45,40 - 44세,1998,314,156,158
'4483035000,  면천면,'50,45 - 49세,1998,286,136,150
'4483035000,  면천면,'55,50 - 54세,1998,257,144,113
'4483035000,  면천면,'60,55 - 59세,1998,319,154,165
'4483035000,  면천면,'65,60 - 64세,1998,393,163,230
'4483035000,  면천면,'70,65 - 69세,1998,293,139,154
'4483035000,  면천면,'75,70 - 74세,1998,207,84,123
'4483035000,  면천면,'80,75 - 79세,1998,138,44,94
'4483035000,  면천면,'85,80 - 84세,1998,74,21,53
'4483035000,  면천면,'90,85+ ,1998,45,10,35
'4483036000,  순성면,'00,계,1998,7677,3903,3774
'4483036000,  순성면,'05,0 - 4세,1998,619,345,274
'4483036000,  순성면,'10,5 - 9세,1998,469,227,242
'4483036000,  순성면,'15,10 - 14세,1998,405,200,205
'4483036000,  순성면,'20,15 - 19세,1998,594,303,291
'4483036000,  순성면,'25,20 - 24세,1998,636,368,268
'4483036000,  순성면,'30,25 - 29세,1998,709,387,322
'4483036000,  순성면,'35,30 - 34세,1998,657,374,283
'4483036000,  순성면,'40,35 - 39세,1998,505,284,221
'4483036000,  순성면,'45,40 - 44세,1998,381,194,187
'4483036000,  순성면,'50,45 - 49세,1998,395,190,205
'4483036000,  순성면,'55,50 - 54세,1998,347,182,165
'4483036000,  순성면,'60,55 - 59세,1998,485,227,258
'4483036000,  순성면,'65,60 - 64세,1998,547,235,312
'4483036000,  순성면,'70,65 - 69세,1998,366,168,198
'4483036000,  순성면,'75,70 - 74세,1998,239,95,144
'4483036000,  순성면,'80,75 - 79세,1998,177,77,100
'4483036000,  순성면,'85,80 - 84세,1998,90,32,58
'4483036000,  순성면,'90,85+ ,1998,56,15,41
'4483037000,  우강면,'00,계,1998,7747,3918,3829
'4483037000,  우강면,'05,0 - 4세,1998,412,230,182
'4483037000,  우강면,'10,5 - 9세,1998,432,218,214
'4483037000,  우강면,'15,10 - 14세,1998,497,267,230
'4483037000,  우강면,'20,15 - 19세,1998,765,353,412
'4483037000,  우강면,'25,20 - 24세,1998,737,401,336
'4483037000,  우강면,'30,25 - 29세,1998,555,327,228
'4483037000,  우강면,'35,30 - 34세,1998,487,262,225
'4483037000,  우강면,'40,35 - 39세,1998,557,304,253
'4483037000,  우강면,'45,40 - 44세,1998,533,273,260
'4483037000,  우강면,'50,45 - 49세,1998,474,254,220
'4483037000,  우강면,'55,50 - 54세,1998,419,206,213
'4483037000,  우강면,'60,55 - 59세,1998,504,233,271
'4483037000,  우강면,'65,60 - 64세,1998,513,237,276
'4483037000,  우강면,'70,65 - 69세,1998,355,154,201
'4483037000,  우강면,'75,70 - 74세,1998,214,82,132
'4483037000,  우강면,'80,75 - 79세,1998,158,73,85
'4483037000,  우강면,'85,80 - 84세,1998,71,28,43
'4483037000,  우강면,'90,85+ ,1998,64,16,48
'4483038000,  신평면,'00,계,1998,13454,6793,6661
'4483038000,  신평면,'05,0 - 4세,1998,954,500,454
'4483038000,  신평면,'10,5 - 9세,1998,940,488,452
'4483038000,  신평면,'15,10 - 14세,1998,921,468,453
'4483038000,  신평면,'20,15 - 19세,1998,1165,603,562
'4483038000,  신평면,'25,20 - 24세,1998,1114,632,482
'4483038000,  신평면,'30,25 - 29세,1998,1045,533,512
'4483038000,  신평면,'35,30 - 34세,1998,1059,570,489
'4483038000,  신평면,'40,35 - 39세,1998,1173,634,539
'4483038000,  신평면,'45,40 - 44세,1998,917,485,432
'4483038000,  신평면,'50,45 - 49세,1998,709,346,363
'4483038000,  신평면,'55,50 - 54세,1998,678,343,335
'4483038000,  신평면,'60,55 - 59세,1998,702,328,374
'4483038000,  신평면,'65,60 - 64세,1998,780,363,417
'4483038000,  신평면,'70,65 - 69세,1998,513,209,304
'4483038000,  신평면,'75,70 - 74세,1998,332,136,196
'4483038000,  신평면,'80,75 - 79세,1998,250,101,149
'4483038000,  신평면,'85,80 - 84세,1998,121,39,82
'4483038000,  신평면,'90,85+ ,1998,81,15,66
'4483039000,  송악면,'00,계,1998,13395,6833,6562
'4483039000,  송악면,'05,0 - 4세,1998,1058,541,517
'4483039000,  송악면,'10,5 - 9세,1998,828,441,387
'4483039000,  송악면,'15,10 - 14세,1998,641,327,314
'4483039000,  송악면,'20,15 - 19세,1998,1037,508,529
'4483039000,  송악면,'25,20 - 24세,1998,1137,619,518
'4483039000,  송악면,'30,25 - 29세,1998,1352,741,611
'4483039000,  송악면,'35,30 - 34세,1998,1113,654,459
'4483039000,  송악면,'40,35 - 39세,1998,929,533,396
'4483039000,  송악면,'45,40 - 44세,1998,786,400,386
'4483039000,  송악면,'50,45 - 49세,1998,661,329,332
'4483039000,  송악면,'55,50 - 54세,1998,619,320,299
'4483039000,  송악면,'60,55 - 59세,1998,846,382,464
'4483039000,  송악면,'65,60 - 64세,1998,929,425,504
'4483039000,  송악면,'70,65 - 69세,1998,596,274,322
'4483039000,  송악면,'75,70 - 74세,1998,347,152,195
'4483039000,  송악면,'80,75 - 79세,1998,260,100,160
'4483039000,  송악면,'85,80 - 84세,1998,162,57,105
'4483039000,  송악면,'90,85+ ,1998,94,30,64
'4483040000,  송산면,'00,계,1998,7928,4108,3820
'4483040000,  송산면,'05,0 - 4세,1998,514,259,255
'4483040000,  송산면,'10,5 - 9세,1998,455,236,219
'4483040000,  송산면,'15,10 - 14세,1998,402,207,195
'4483040000,  송산면,'20,15 - 19세,1998,677,343,334
'4483040000,  송산면,'25,20 - 24세,1998,754,436,318
'4483040000,  송산면,'30,25 - 29세,1998,790,502,288
'4483040000,  송산면,'35,30 - 34세,1998,606,353,253
'4483040000,  송산면,'40,35 - 39세,1998,532,301,231
'4483040000,  송산면,'45,40 - 44세,1998,484,240,244
'4483040000,  송산면,'50,45 - 49세,1998,366,201,165
'4483040000,  송산면,'55,50 - 54세,1998,383,188,195
'4483040000,  송산면,'60,55 - 59세,1998,498,232,266
'4483040000,  송산면,'65,60 - 64세,1998,526,222,304
'4483040000,  송산면,'70,65 - 69세,1998,388,164,224
'4483040000,  송산면,'75,70 - 74세,1998,250,107,143
'4483040000,  송산면,'80,75 - 79세,1998,153,60,93
'4483040000,  송산면,'85,80 - 84세,1998,89,37,52
'4483040000,  송산면,'90,85+ ,1998,61,20,41
'45,전라북도,'00,계,1998,2009250,999878,1009372
'45,전라북도,'05,0 - 4세,1998,134862,70316,64546
'45,전라북도,'10,5 - 9세,1998,133512,69608,63904
'45,전라북도,'15,10 - 14세,1998,136189,69569,66620
'45,전라북도,'20,15 - 19세,1998,190029,97074,92955
'45,전라북도,'25,20 - 24세,1998,190917,102057,88860
'45,전라북도,'30,25 - 29세,1998,175356,94437,80919
'45,전라북도,'35,30 - 34세,1998,153103,79989,73114
'45,전라북도,'40,35 - 39세,1998,159882,81784,78098
'45,전라북도,'45,40 - 44세,1998,137796,70428,67368
'45,전라북도,'50,45 - 49세,1998,108224,54241,53983
'45,전라북도,'55,50 - 54세,1998,96923,47805,49118
'45,전라북도,'60,55 - 59세,1998,106468,48714,57754
'45,전라북도,'65,60 - 64세,1998,96377,42691,53686
'45,전라북도,'70,65 - 69세,1998,72313,29766,42547
'45,전라북도,'75,70 - 74세,1998,50895,20632,30263
'45,전라북도,'80,75 - 79세,1998,36195,12905,23290
'45,전라북도,'85,80 - 84세,1998,18546,5492,13054
'45,전라북도,'90,85+ ,1998,11663,2370,9293
'45110, 전주시,'00,계,1998,599196,296422,302774
'45110, 전주시,'05,0 - 4세,1998,45382,23743,21639
'45110, 전주시,'10,5 - 9세,1998,46035,24081,21954
'45110, 전주시,'15,10 - 14세,1998,46587,24001,22586
'45110, 전주시,'20,15 - 19세,1998,59543,30704,28839
'45110, 전주시,'25,20 - 24세,1998,56718,28801,27917
'45110, 전주시,'30,25 - 29세,1998,56558,28570,27988
'45110, 전주시,'35,30 - 34세,1998,51036,25560,25476
'45110, 전주시,'40,35 - 39세,1998,54394,26391,28003
'45110, 전주시,'45,40 - 44세,1998,45742,22523,23219
'45110, 전주시,'50,45 - 49세,1998,33852,16700,17152
'45110, 전주시,'55,50 - 54세,1998,26851,13384,13467
'45110, 전주시,'60,55 - 59세,1998,23906,11629,12277
'45110, 전주시,'65,60 - 64세,1998,18583,8534,10049
'45110, 전주시,'70,65 - 69세,1998,12588,5106,7482
'45110, 전주시,'75,70 - 74세,1998,9023,3362,5661
'45110, 전주시,'80,75 - 79세,1998,6619,2054,4565
'45110, 전주시,'85,80 - 84세,1998,3519,870,2649
'45110, 전주시,'90,85+ ,1998,2260,409,1851
'45111, 완산구,'00,계,1998,322399,158674,163725
'45111, 완산구,'05,0 - 4세,1998,24142,12632,11510
'45111, 완산구,'10,5 - 9세,1998,24867,13110,11757
'45111, 완산구,'15,10 - 14세,1998,26067,13472,12595
'45111, 완산구,'20,15 - 19세,1998,32751,16814,15937
'45111, 완산구,'25,20 - 24세,1998,29878,15181,14697
'45111, 완산구,'30,25 - 29세,1998,29285,14642,14643
'45111, 완산구,'35,30 - 34세,1998,27151,13475,13676
'45111, 완산구,'40,35 - 39세,1998,29535,14077,15458
'45111, 완산구,'45,40 - 44세,1998,25553,12536,13017
'45111, 완산구,'50,45 - 49세,1998,18477,9076,9401
'45111, 완산구,'55,50 - 54세,1998,14231,7155,7076
'45111, 완산구,'60,55 - 59세,1998,12382,6007,6375
'45111, 완산구,'65,60 - 64세,1998,9606,4271,5335
'45111, 완산구,'70,65 - 69세,1998,6769,2610,4159
'45111, 완산구,'75,70 - 74세,1998,4958,1816,3142
'45111, 완산구,'80,75 - 79세,1998,3646,1120,2526
'45111, 완산구,'85,80 - 84세,1998,1895,463,1432
'45111, 완산구,'90,85+ ,1998,1206,217,989
'4511151000,  중앙동,'00,계,1998,6942,3450,3492
'4511151000,  중앙동,'05,0 - 4세,1998,292,143,149
'4511151000,  중앙동,'10,5 - 9세,1998,335,196,139
'4511151000,  중앙동,'15,10 - 14세,1998,410,237,173
'4511151000,  중앙동,'20,15 - 19세,1998,650,339,311
'4511151000,  중앙동,'25,20 - 24세,1998,820,440,380
'4511151000,  중앙동,'30,25 - 29세,1998,708,391,317
'4511151000,  중앙동,'35,30 - 34세,1998,422,205,217
'4511151000,  중앙동,'40,35 - 39세,1998,504,230,274
'4511151000,  중앙동,'45,40 - 44세,1998,551,241,310
'4511151000,  중앙동,'50,45 - 49세,1998,499,217,282
'4511151000,  중앙동,'55,50 - 54세,1998,479,218,261
'4511151000,  중앙동,'60,55 - 59세,1998,409,208,201
'4511151000,  중앙동,'65,60 - 64세,1998,309,171,138
'4511151000,  중앙동,'70,65 - 69세,1998,204,74,130
'4511151000,  중앙동,'75,70 - 74세,1998,148,74,74
'4511151000,  중앙동,'80,75 - 79세,1998,112,37,75
'4511151000,  중앙동,'85,80 - 84세,1998,51,19,32
'4511151000,  중앙동,'90,85+ ,1998,39,10,29
'4511153000,  풍남동,'00,계,1998,8520,4185,4335
'4511153000,  풍남동,'05,0 - 4세,1998,393,201,192
'4511153000,  풍남동,'10,5 - 9세,1998,418,212,206
'4511153000,  풍남동,'15,10 - 14세,1998,519,263,256
'4511153000,  풍남동,'20,15 - 19세,1998,873,431,442
'4511153000,  풍남동,'25,20 - 24세,1998,1045,539,506
'4511153000,  풍남동,'30,25 - 29세,1998,839,489,350
'4511153000,  풍남동,'35,30 - 34세,1998,505,264,241
'4511153000,  풍남동,'40,35 - 39세,1998,585,265,320
'4511153000,  풍남동,'45,40 - 44세,1998,604,266,338
'4511153000,  풍남동,'50,45 - 49세,1998,564,266,298
'4511153000,  풍남동,'55,50 - 54세,1998,520,243,277
'4511153000,  풍남동,'60,55 - 59세,1998,532,274,258
'4511153000,  풍남동,'65,60 - 64세,1998,393,185,208
'4511153000,  풍남동,'70,65 - 69세,1998,285,127,158
'4511153000,  풍남동,'75,70 - 74세,1998,200,79,121
'4511153000,  풍남동,'80,75 - 79세,1998,120,47,73
'4511153000,  풍남동,'85,80 - 84세,1998,82,19,63
'4511153000,  풍남동,'90,85+ ,1998,43,15,28
'4511157000,  교동,'00,계,1998,5966,2935,3031
'4511157000,  교동,'05,0 - 4세,1998,346,176,170
'4511157000,  교동,'10,5 - 9세,1998,307,152,155
'4511157000,  교동,'15,10 - 14세,1998,335,150,185
'4511157000,  교동,'20,15 - 19세,1998,594,309,285
'4511157000,  교동,'25,20 - 24세,1998,704,359,345
'4511157000,  교동,'30,25 - 29세,1998,638,372,266
'4511157000,  교동,'35,30 - 34세,1998,411,221,190
'4511157000,  교동,'40,35 - 39세,1998,379,200,179
'4511157000,  교동,'45,40 - 44세,1998,389,181,208
'4511157000,  교동,'50,45 - 49세,1998,359,182,177
'4511157000,  교동,'55,50 - 54세,1998,334,140,194
'4511157000,  교동,'60,55 - 59세,1998,364,175,189
'4511157000,  교동,'65,60 - 64세,1998,304,137,167
'4511157000,  교동,'70,65 - 69세,1998,201,90,111
'4511157000,  교동,'75,70 - 74세,1998,137,52,85
'4511157000,  교동,'80,75 - 79세,1998,99,29,70
'4511157000,  교동,'85,80 - 84세,1998,40,7,33
'4511157000,  교동,'90,85+ ,1998,25,3,22
'4511158500,  태평동,'00,계,1998,7432,3703,3729
'4511158500,  태평동,'05,0 - 4세,1998,368,208,160
'4511158500,  태평동,'10,5 - 9세,1998,401,208,193
'4511158500,  태평동,'15,10 - 14세,1998,447,235,212
'4511158500,  태평동,'20,15 - 19세,1998,719,354,365
'4511158500,  태평동,'25,20 - 24세,1998,874,453,421
'4511158500,  태평동,'30,25 - 29세,1998,784,454,330
'4511158500,  태평동,'35,30 - 34세,1998,488,251,237
'4511158500,  태평동,'40,35 - 39세,1998,487,249,238
'4511158500,  태평동,'45,40 - 44세,1998,491,206,285
'4511158500,  태평동,'50,45 - 49세,1998,502,212,290
'4511158500,  태평동,'55,50 - 54세,1998,467,240,227
'4511158500,  태평동,'60,55 - 59세,1998,441,210,231
'4511158500,  태평동,'65,60 - 64세,1998,391,190,201
'4511158500,  태평동,'70,65 - 69세,1998,221,101,120
'4511158500,  태평동,'75,70 - 74세,1998,182,81,101
'4511158500,  태평동,'80,75 - 79세,1998,87,28,59
'4511158500,  태평동,'85,80 - 84세,1998,54,16,38
'4511158500,  태평동,'90,85+ ,1998,28,7,21
'4511160000,  중노송1동,'00,계,1998,8598,4231,4367
'4511160000,  중노송1동,'05,0 - 4세,1998,458,248,210
'4511160000,  중노송1동,'10,5 - 9세,1998,456,247,209
'4511160000,  중노송1동,'15,10 - 14세,1998,574,298,276
'4511160000,  중노송1동,'20,15 - 19세,1998,924,477,447
'4511160000,  중노송1동,'25,20 - 24세,1998,978,512,466
'4511160000,  중노송1동,'30,25 - 29세,1998,840,470,370
'4511160000,  중노송1동,'35,30 - 34세,1998,551,305,246
'4511160000,  중노송1동,'40,35 - 39세,1998,624,289,335
'4511160000,  중노송1동,'45,40 - 44세,1998,596,272,324
'4511160000,  중노송1동,'50,45 - 49세,1998,531,238,293
'4511160000,  중노송1동,'55,50 - 54세,1998,508,260,248
'4511160000,  중노송1동,'60,55 - 59세,1998,500,216,284
'4511160000,  중노송1동,'65,60 - 64세,1998,406,175,231
'4511160000,  중노송1동,'70,65 - 69세,1998,241,107,134
'4511160000,  중노송1동,'75,70 - 74세,1998,169,57,112
'4511160000,  중노송1동,'80,75 - 79세,1998,116,33,83
'4511160000,  중노송1동,'85,80 - 84세,1998,76,20,56
'4511160000,  중노송1동,'90,85+ ,1998,50,7,43
'4511161000,  중노송2동,'00,계,1998,5106,2533,2573
'4511161000,  중노송2동,'05,0 - 4세,1998,293,147,146
'4511161000,  중노송2동,'10,5 - 9세,1998,273,146,127
'4511161000,  중노송2동,'15,10 - 14세,1998,275,154,121
'4511161000,  중노송2동,'20,15 - 19세,1998,518,269,249
'4511161000,  중노송2동,'25,20 - 24세,1998,636,328,308
'4511161000,  중노송2동,'30,25 - 29세,1998,578,312,266
'4511161000,  중노송2동,'35,30 - 34세,1998,363,204,159
'4511161000,  중노송2동,'40,35 - 39세,1998,329,162,167
'4511161000,  중노송2동,'45,40 - 44세,1998,326,142,184
'4511161000,  중노송2동,'50,45 - 49세,1998,281,132,149
'4511161000,  중노송2동,'55,50 - 54세,1998,293,130,163
'4511161000,  중노송2동,'60,55 - 59세,1998,301,136,165
'4511161000,  중노송2동,'65,60 - 64세,1998,258,117,141
'4511161000,  중노송2동,'70,65 - 69세,1998,156,67,89
'4511161000,  중노송2동,'75,70 - 74세,1998,106,47,59
'4511161000,  중노송2동,'80,75 - 79세,1998,76,26,50
'4511161000,  중노송2동,'85,80 - 84세,1998,28,8,20
'4511161000,  중노송2동,'90,85+ ,1998,16,6,10
'4511162000,  남노송동,'00,계,1998,6306,3110,3196
'4511162000,  남노송동,'05,0 - 4세,1998,344,176,168
'4511162000,  남노송동,'10,5 - 9세,1998,350,194,156
'4511162000,  남노송동,'15,10 - 14세,1998,419,208,211
'4511162000,  남노송동,'20,15 - 19세,1998,638,320,318
'4511162000,  남노송동,'25,20 - 24세,1998,743,394,349
'4511162000,  남노송동,'30,25 - 29세,1998,596,339,257
'4511162000,  남노송동,'35,30 - 34세,1998,406,232,174
'4511162000,  남노송동,'40,35 - 39세,1998,443,206,237
'4511162000,  남노송동,'45,40 - 44세,1998,418,199,219
'4511162000,  남노송동,'50,45 - 49세,1998,355,150,205
'4511162000,  남노송동,'55,50 - 54세,1998,379,175,204
'4511162000,  남노송동,'60,55 - 59세,1998,351,168,183
'4511162000,  남노송동,'65,60 - 64세,1998,303,134,169
'4511162000,  남노송동,'70,65 - 69세,1998,227,95,132
'4511162000,  남노송동,'75,70 - 74세,1998,136,66,70
'4511162000,  남노송동,'80,75 - 79세,1998,112,36,76
'4511162000,  남노송동,'85,80 - 84세,1998,55,16,39
'4511162000,  남노송동,'90,85+ ,1998,31,2,29
'4511163000,  동완산동,'00,계,1998,5259,2568,2691
'4511163000,  동완산동,'05,0 - 4세,1998,302,159,143
'4511163000,  동완산동,'10,5 - 9세,1998,287,150,137
'4511163000,  동완산동,'15,10 - 14세,1998,299,150,149
'4511163000,  동완산동,'20,15 - 19세,1998,523,262,261
'4511163000,  동완산동,'25,20 - 24세,1998,659,335,324
'4511163000,  동완산동,'30,25 - 29세,1998,538,289,249
'4511163000,  동완산동,'35,30 - 34세,1998,360,195,165
'4511163000,  동완산동,'40,35 - 39세,1998,354,171,183
'4511163000,  동완산동,'45,40 - 44세,1998,369,171,198
'4511163000,  동완산동,'50,45 - 49세,1998,333,149,184
'4511163000,  동완산동,'55,50 - 54세,1998,302,140,162
'4511163000,  동완산동,'60,55 - 59세,1998,290,137,153
'4511163000,  동완산동,'65,60 - 64세,1998,234,108,126
'4511163000,  동완산동,'70,65 - 69세,1998,162,72,90
'4511163000,  동완산동,'75,70 - 74세,1998,112,45,67
'4511163000,  동완산동,'80,75 - 79세,1998,78,26,52
'4511163000,  동완산동,'85,80 - 84세,1998,33,7,26
'4511163000,  동완산동,'90,85+ ,1998,24,2,22
'4511164000,  서완산동,'00,계,1998,6972,3456,3516
'4511164000,  서완산동,'05,0 - 4세,1998,339,163,176
'4511164000,  서완산동,'10,5 - 9세,1998,318,156,162
'4511164000,  서완산동,'15,10 - 14세,1998,418,226,192
'4511164000,  서완산동,'20,15 - 19세,1998,734,384,350
'4511164000,  서완산동,'25,20 - 24세,1998,927,456,471
'4511164000,  서완산동,'30,25 - 29세,1998,737,418,319
'4511164000,  서완산동,'35,30 - 34세,1998,443,250,193
'4511164000,  서완산동,'40,35 - 39세,1998,454,227,227
'4511164000,  서완산동,'45,40 - 44세,1998,449,219,230
'4511164000,  서완산동,'50,45 - 49세,1998,407,193,214
'4511164000,  서완산동,'55,50 - 54세,1998,438,197,241
'4511164000,  서완산동,'60,55 - 59세,1998,431,198,233
'4511164000,  서완산동,'65,60 - 64세,1998,337,160,177
'4511164000,  서완산동,'70,65 - 69세,1998,216,101,115
'4511164000,  서완산동,'75,70 - 74세,1998,138,50,88
'4511164000,  서완산동,'80,75 - 79세,1998,104,35,69
'4511164000,  서완산동,'85,80 - 84세,1998,52,14,38
'4511164000,  서완산동,'90,85+ ,1998,30,9,21
'4511165000,  동서학동,'00,계,1998,13329,6595,6734
'4511165000,  동서학동,'05,0 - 4세,1998,841,453,388
'4511165000,  동서학동,'10,5 - 9세,1998,920,475,445
'4511165000,  동서학동,'15,10 - 14세,1998,980,521,459
'4511165000,  동서학동,'20,15 - 19세,1998,1332,672,660
'4511165000,  동서학동,'25,20 - 24세,1998,1274,610,664
'4511165000,  동서학동,'30,25 - 29세,1998,1261,672,589
'4511165000,  동서학동,'35,30 - 34세,1998,1025,549,476
'4511165000,  동서학동,'40,35 - 39세,1998,1123,546,577
'4511165000,  동서학동,'45,40 - 44세,1998,1006,508,498
'4511165000,  동서학동,'50,45 - 49세,1998,747,377,370
'4511165000,  동서학동,'55,50 - 54세,1998,631,310,321
'4511165000,  동서학동,'60,55 - 59세,1998,699,332,367
'4511165000,  동서학동,'65,60 - 64세,1998,520,208,312
'4511165000,  동서학동,'70,65 - 69세,1998,380,166,214
'4511165000,  동서학동,'75,70 - 74세,1998,240,95,145
'4511165000,  동서학동,'80,75 - 79세,1998,171,60,111
'4511165000,  동서학동,'85,80 - 84세,1998,115,26,89
'4511165000,  동서학동,'90,85+ ,1998,64,15,49
'4511166000,  서서학동,'00,계,1998,15975,7884,8091
'4511166000,  서서학동,'05,0 - 4세,1998,1090,577,513
'4511166000,  서서학동,'10,5 - 9세,1998,1014,524,490
'4511166000,  서서학동,'15,10 - 14세,1998,1022,508,514
'4511166000,  서서학동,'20,15 - 19세,1998,1565,825,740
'4511166000,  서서학동,'25,20 - 24세,1998,1774,866,908
'4511166000,  서서학동,'30,25 - 29세,1998,1793,972,821
'4511166000,  서서학동,'35,30 - 34세,1998,1244,656,588
'4511166000,  서서학동,'40,35 - 39세,1998,1207,609,598
'4511166000,  서서학동,'45,40 - 44세,1998,1096,516,580
'4511166000,  서서학동,'50,45 - 49세,1998,894,411,483
'4511166000,  서서학동,'55,50 - 54세,1998,851,397,454
'4511166000,  서서학동,'60,55 - 59세,1998,852,388,464
'4511166000,  서서학동,'65,60 - 64세,1998,639,301,338
'4511166000,  서서학동,'70,65 - 69세,1998,362,159,203
'4511166000,  서서학동,'75,70 - 74세,1998,243,95,148
'4511166000,  서서학동,'80,75 - 79세,1998,169,57,112
'4511166000,  서서학동,'85,80 - 84세,1998,100,19,81
'4511166000,  서서학동,'90,85+ ,1998,60,4,56
'4511167100,  중화산1동,'00,계,1998,17304,8398,8906
'4511167100,  중화산1동,'05,0 - 4세,1998,1418,727,691
'4511167100,  중화산1동,'10,5 - 9세,1998,1372,721,651
'4511167100,  중화산1동,'15,10 - 14세,1998,1417,755,662
'4511167100,  중화산1동,'20,15 - 19세,1998,1754,873,881
'4511167100,  중화산1동,'25,20 - 24세,1998,1489,734,755
'4511167100,  중화산1동,'30,25 - 29세,1998,1522,711,811
'4511167100,  중화산1동,'35,30 - 34세,1998,1515,747,768
'4511167100,  중화산1동,'40,35 - 39세,1998,1630,743,887
'4511167100,  중화산1동,'45,40 - 44세,1998,1425,712,713
'4511167100,  중화산1동,'50,45 - 49세,1998,996,473,523
'4511167100,  중화산1동,'55,50 - 54세,1998,756,367,389
'4511167100,  중화산1동,'60,55 - 59세,1998,626,335,291
'4511167100,  중화산1동,'65,60 - 64세,1998,420,169,251
'4511167100,  중화산1동,'70,65 - 69세,1998,350,141,209
'4511167100,  중화산1동,'75,70 - 74세,1998,257,94,163
'4511167100,  중화산1동,'80,75 - 79세,1998,179,52,127
'4511167100,  중화산1동,'85,80 - 84세,1998,96,23,73
'4511167100,  중화산1동,'90,85+ ,1998,82,21,61
'4511167200,  중화산2동,'00,계,1998,10099,4949,5150
'4511167200,  중화산2동,'05,0 - 4세,1998,806,431,375
'4511167200,  중화산2동,'10,5 - 9세,1998,1075,574,501
'4511167200,  중화산2동,'15,10 - 14세,1998,973,521,452
'4511167200,  중화산2동,'20,15 - 19세,1998,932,431,501
'4511167200,  중화산2동,'25,20 - 24세,1998,662,313,349
'4511167200,  중화산2동,'30,25 - 29세,1998,825,382,443
'4511167200,  중화산2동,'35,30 - 34세,1998,951,433,518
'4511167200,  중화산2동,'40,35 - 39세,1998,1143,544,599
'4511167200,  중화산2동,'45,40 - 44세,1998,932,495,437
'4511167200,  중화산2동,'50,45 - 49세,1998,488,257,231
'4511167200,  중화산2동,'55,50 - 54세,1998,349,187,162
'4511167200,  중화산2동,'60,55 - 59세,1998,252,128,124
'4511167200,  중화산2동,'65,60 - 64세,1998,223,98,125
'4511167200,  중화산2동,'70,65 - 69세,1998,183,64,119
'4511167200,  중화산2동,'75,70 - 74세,1998,117,43,74
'4511167200,  중화산2동,'80,75 - 79세,1998,97,30,67
'4511167200,  중화산2동,'85,80 - 84세,1998,58,14,44
'4511167200,  중화산2동,'90,85+ ,1998,33,4,29
'4511168000,  서신동,'00,계,1998,39130,19437,19693
'4511168000,  서신동,'05,0 - 4세,1998,3968,2078,1890
'4511168000,  서신동,'10,5 - 9세,1998,3951,2093,1858
'4511168000,  서신동,'15,10 - 14세,1998,3372,1742,1630
'4511168000,  서신동,'20,15 - 19세,1998,3282,1643,1639
'4511168000,  서신동,'25,20 - 24세,1998,2749,1380,1369
'4511168000,  서신동,'30,25 - 29세,1998,3699,1682,2017
'4511168000,  서신동,'35,30 - 34세,1998,4272,2043,2229
'4511168000,  서신동,'40,35 - 39세,1998,4343,2151,2192
'4511168000,  서신동,'45,40 - 44세,1998,2995,1612,1383
'4511168000,  서신동,'50,45 - 49세,1998,1838,962,876
'4511168000,  서신동,'55,50 - 54세,1998,1255,663,592
'4511168000,  서신동,'60,55 - 59세,1998,1096,547,549
'4511168000,  서신동,'65,60 - 64세,1998,765,358,407
'4511168000,  서신동,'70,65 - 69세,1998,560,195,365
'4511168000,  서신동,'75,70 - 74세,1998,415,140,275
'4511168000,  서신동,'80,75 - 79세,1998,314,98,216
'4511168000,  서신동,'85,80 - 84세,1998,161,37,124
'4511168000,  서신동,'90,85+ ,1998,95,13,82
'4511169100,  평화1동,'00,계,1998,18297,8872,9425
'4511169100,  평화1동,'05,0 - 4세,1998,1298,672,626
'4511169100,  평화1동,'10,5 - 9세,1998,1304,660,644
'4511169100,  평화1동,'15,10 - 14세,1998,1400,708,692
'4511169100,  평화1동,'20,15 - 19세,1998,2038,1062,976
'4511169100,  평화1동,'25,20 - 24세,1998,1992,1053,939
'4511169100,  평화1동,'30,25 - 29세,1998,1700,854,846
'4511169100,  평화1동,'35,30 - 34세,1998,1504,737,767
'4511169100,  평화1동,'40,35 - 39세,1998,1648,802,846
'4511169100,  평화1동,'45,40 - 44세,1998,1369,652,717
'4511169100,  평화1동,'50,45 - 49세,1998,1121,503,618
'4511169100,  평화1동,'55,50 - 54세,1998,818,379,439
'4511169100,  평화1동,'60,55 - 59세,1998,663,308,355
'4511169100,  평화1동,'65,60 - 64세,1998,492,190,302
'4511169100,  평화1동,'70,65 - 69세,1998,325,118,207
'4511169100,  평화1동,'75,70 - 74세,1998,281,94,187
'4511169100,  평화1동,'80,75 - 79세,1998,202,54,148
'4511169100,  평화1동,'85,80 - 84세,1998,91,22,69
'4511169100,  평화1동,'90,85+ ,1998,51,4,47
'4511169200,  평화2동,'00,계,1998,27631,13570,14061
'4511169200,  평화2동,'05,0 - 4세,1998,2216,1138,1078
'4511169200,  평화2동,'10,5 - 9세,1998,2600,1407,1193
'4511169200,  평화2동,'15,10 - 14세,1998,2564,1320,1244
'4511169200,  평화2동,'20,15 - 19세,1998,2971,1518,1453
'4511169200,  평화2동,'25,20 - 24세,1998,2005,1027,978
'4511169200,  평화2동,'30,25 - 29세,1998,2128,970,1158
'4511169200,  평화2동,'35,30 - 34세,1998,2531,1221,1310
'4511169200,  평화2동,'40,35 - 39세,1998,2976,1435,1541
'4511169200,  평화2동,'45,40 - 44세,1998,2384,1208,1176
'4511169200,  평화2동,'50,45 - 49세,1998,1446,781,665
'4511169200,  평화2동,'55,50 - 54세,1998,928,484,444
'4511169200,  평화2동,'60,55 - 59세,1998,802,365,437
'4511169200,  평화2동,'65,60 - 64세,1998,652,265,387
'4511169200,  평화2동,'70,65 - 69세,1998,503,167,336
'4511169200,  평화2동,'75,70 - 74세,1998,394,136,258
'4511169200,  평화2동,'80,75 - 79세,1998,307,90,217
'4511169200,  평화2동,'85,80 - 84세,1998,130,28,102
'4511169200,  평화2동,'90,85+ ,1998,94,10,84
'4511170100,  삼천1동,'00,계,1998,18468,9027,9441
'4511170100,  삼천1동,'05,0 - 4세,1998,1696,906,790
'4511170100,  삼천1동,'10,5 - 9세,1998,1493,794,699
'4511170100,  삼천1동,'15,10 - 14세,1998,1523,742,781
'4511170100,  삼천1동,'20,15 - 19세,1998,1761,944,817
'4511170100,  삼천1동,'25,20 - 24세,1998,1494,773,721
'4511170100,  삼천1동,'30,25 - 29세,1998,1811,830,981
'4511170100,  삼천1동,'35,30 - 34세,1998,1825,888,937
'4511170100,  삼천1동,'40,35 - 39세,1998,1816,861,955
'4511170100,  삼천1동,'45,40 - 44세,1998,1473,712,761
'4511170100,  삼천1동,'50,45 - 49세,1998,1005,507,498
'4511170100,  삼천1동,'55,50 - 54세,1998,753,388,365
'4511170100,  삼천1동,'60,55 - 59세,1998,498,237,261
'4511170100,  삼천1동,'65,60 - 64세,1998,408,166,242
'4511170100,  삼천1동,'70,65 - 69세,1998,348,118,230
'4511170100,  삼천1동,'75,70 - 74세,1998,247,76,171
'4511170100,  삼천1동,'80,75 - 79세,1998,175,53,122
'4511170100,  삼천1동,'85,80 - 84세,1998,95,23,72
'4511170100,  삼천1동,'90,85+ ,1998,47,9,38
'4511170200,  삼천2동,'00,계,1998,24923,12224,12699
'4511170200,  삼천2동,'05,0 - 4세,1998,2373,1239,1134
'4511170200,  삼천2동,'10,5 - 9세,1998,2294,1197,1097
'4511170200,  삼천2동,'15,10 - 14세,1998,2493,1313,1180
'4511170200,  삼천2동,'20,15 - 19세,1998,2446,1231,1215
'4511170200,  삼천2동,'25,20 - 24세,1998,1869,902,967
'4511170200,  삼천2동,'30,25 - 29세,1998,2113,938,1175
'4511170200,  삼천2동,'35,30 - 34세,1998,2436,1174,1262
'4511170200,  삼천2동,'40,35 - 39세,1998,2619,1222,1397
'4511170200,  삼천2동,'45,40 - 44세,1998,2222,1110,1112
'4511170200,  삼천2동,'50,45 - 49세,1998,1349,721,628
'4511170200,  삼천2동,'55,50 - 54세,1998,816,480,336
'4511170200,  삼천2동,'60,55 - 59세,1998,547,272,275
'4511170200,  삼천2동,'65,60 - 64세,1998,405,163,242
'4511170200,  삼천2동,'70,65 - 69세,1998,287,92,195
'4511170200,  삼천2동,'75,70 - 74세,1998,265,73,192
'4511170200,  삼천2동,'80,75 - 79세,1998,219,62,157
'4511170200,  삼천2동,'85,80 - 84세,1998,94,20,74
'4511170200,  삼천2동,'90,85+ ,1998,76,15,61
'4511170300,  삼천3동,'00,계,1998,14084,7040,7044
'4511170300,  삼천3동,'05,0 - 4세,1998,1407,724,683
'4511170300,  삼천3동,'10,5 - 9세,1998,1290,688,602
'4511170300,  삼천3동,'15,10 - 14세,1998,1228,646,582
'4511170300,  삼천3동,'20,15 - 19세,1998,1108,552,556
'4511170300,  삼천3동,'25,20 - 24세,1998,944,491,453
'4511170300,  삼천3동,'30,25 - 29세,1998,1229,582,647
'4511170300,  삼천3동,'35,30 - 34세,1998,1539,788,751
'4511170300,  삼천3동,'40,35 - 39세,1998,1453,713,740
'4511170300,  삼천3동,'45,40 - 44세,1998,1085,607,478
'4511170300,  삼천3동,'50,45 - 49세,1998,591,321,270
'4511170300,  삼천3동,'55,50 - 54세,1998,446,232,214
'4511170300,  삼천3동,'60,55 - 59세,1998,473,225,248
'4511170300,  삼천3동,'65,60 - 64세,1998,422,178,244
'4511170300,  삼천3동,'70,65 - 69세,1998,315,112,203
'4511170300,  삼천3동,'75,70 - 74세,1998,226,88,138
'4511170300,  삼천3동,'80,75 - 79세,1998,177,56,121
'4511170300,  삼천3동,'85,80 - 84세,1998,91,24,67
'4511170300,  삼천3동,'90,85+ ,1998,60,13,47
'4511171100,  효자1동,'00,계,1998,16202,7846,8356
'4511171100,  효자1동,'05,0 - 4세,1998,988,532,456
'4511171100,  효자1동,'10,5 - 9세,1998,974,521,453
'4511171100,  효자1동,'15,10 - 14세,1998,1261,652,609
'4511171100,  효자1동,'20,15 - 19세,1998,1934,1023,911
'4511171100,  효자1동,'25,20 - 24세,1998,1823,882,941
'4511171100,  효자1동,'30,25 - 29세,1998,1465,733,732
'4511171100,  효자1동,'35,30 - 34세,1998,1136,586,550
'4511171100,  효자1동,'40,35 - 39세,1998,1217,541,676
'4511171100,  효자1동,'45,40 - 44세,1998,1269,545,724
'4511171100,  효자1동,'50,45 - 49세,1998,1118,520,598
'4511171100,  효자1동,'55,50 - 54세,1998,832,399,433
'4511171100,  효자1동,'60,55 - 59세,1998,705,353,352
'4511171100,  효자1동,'65,60 - 64세,1998,481,230,251
'4511171100,  효자1동,'70,65 - 69세,1998,361,140,221
'4511171100,  효자1동,'75,70 - 74세,1998,257,101,156
'4511171100,  효자1동,'80,75 - 79세,1998,197,54,143
'4511171100,  효자1동,'85,80 - 84세,1998,105,22,83
'4511171100,  효자1동,'90,85+ ,1998,79,12,67
'4511171200,  효자2동,'00,계,1998,18761,9206,9555
'4511171200,  효자2동,'05,0 - 4세,1998,1177,625,552
'4511171200,  효자2동,'10,5 - 9세,1998,1338,694,644
'4511171200,  효자2동,'15,10 - 14세,1998,1541,759,782
'4511171200,  효자2동,'20,15 - 19세,1998,2250,1174,1076
'4511171200,  효자2동,'25,20 - 24세,1998,2083,1107,976
'4511171200,  효자2동,'30,25 - 29세,1998,1559,783,776
'4511171200,  효자2동,'35,30 - 34세,1998,1320,627,693
'4511171200,  효자2동,'40,35 - 39세,1998,1585,720,865
'4511171200,  효자2동,'45,40 - 44세,1998,1549,713,836
'4511171200,  효자2동,'50,45 - 49세,1998,1326,613,713
'4511171200,  효자2동,'55,50 - 54세,1998,964,524,440
'4511171200,  효자2동,'60,55 - 59세,1998,662,356,306
'4511171200,  효자2동,'65,60 - 64세,1998,471,226,245
'4511171200,  효자2동,'70,65 - 69세,1998,309,113,196
'4511171200,  효자2동,'75,70 - 74세,1998,232,72,160
'4511171200,  효자2동,'80,75 - 79세,1998,200,53,147
'4511171200,  효자2동,'85,80 - 84세,1998,122,33,89
'4511171200,  효자2동,'90,85+ ,1998,73,14,59
'4511171300,  효자3동,'00,계,1998,19438,9579,9859
'4511171300,  효자3동,'05,0 - 4세,1998,1265,680,585
'4511171300,  효자3동,'10,5 - 9세,1998,1690,881,809
'4511171300,  효자3동,'15,10 - 14세,1998,2105,1107,998
'4511171300,  효자3동,'20,15 - 19세,1998,2335,1270,1065
'4511171300,  효자3동,'25,20 - 24세,1998,1453,776,677
'4511171300,  효자3동,'30,25 - 29세,1998,1155,539,616
'4511171300,  효자3동,'35,30 - 34세,1998,1411,627,784
'4511171300,  효자3동,'40,35 - 39세,1998,2053,891,1162
'4511171300,  효자3동,'45,40 - 44세,1998,2041,983,1058
'4511171300,  효자3동,'50,45 - 49세,1998,1285,669,616
'4511171300,  효자3동,'55,50 - 54세,1998,746,423,323
'4511171300,  효자3동,'60,55 - 59세,1998,478,242,236
'4511171300,  효자3동,'65,60 - 64세,1998,412,185,227
'4511171300,  효자3동,'70,65 - 69세,1998,321,110,211
'4511171300,  효자3동,'75,70 - 74세,1998,300,93,207
'4511171300,  효자3동,'80,75 - 79세,1998,215,63,152
'4511171300,  효자3동,'85,80 - 84세,1998,99,27,72
'4511171300,  효자3동,'90,85+ ,1998,74,13,61
'4511171400,  효자4동,'00,계,1998,7657,3876,3781
'4511171400,  효자4동,'05,0 - 4세,1998,464,229,235
'4511171400,  효자4동,'10,5 - 9세,1998,407,220,187
'4511171400,  효자4동,'15,10 - 14세,1998,492,257,235
'4511171400,  효자4동,'20,15 - 19세,1998,870,451,419
'4511171400,  효자4동,'25,20 - 24세,1998,881,451,430
'4511171400,  효자4동,'30,25 - 29세,1998,767,460,307
'4511171400,  효자4동,'35,30 - 34세,1998,493,272,221
'4511171400,  효자4동,'40,35 - 39세,1998,563,300,263
'4511171400,  효자4동,'45,40 - 44세,1998,514,266,248
'4511171400,  효자4동,'50,45 - 49세,1998,442,222,220
'4511171400,  효자4동,'55,50 - 54세,1998,366,179,187
'4511171400,  효자4동,'60,55 - 59세,1998,410,197,213
'4511171400,  효자4동,'65,60 - 64세,1998,361,157,204
'4511171400,  효자4동,'70,65 - 69세,1998,252,81,171
'4511171400,  효자4동,'75,70 - 74세,1998,156,65,91
'4511171400,  효자4동,'80,75 - 79세,1998,120,41,79
'4511171400,  효자4동,'85,80 - 84세,1998,67,19,48
'4511171400,  효자4동,'90,85+ ,1998,32,9,23
'45113, 덕진구,'00,계,1998,276797,137748,139049
'45113, 덕진구,'05,0 - 4세,1998,21240,11111,10129
'45113, 덕진구,'10,5 - 9세,1998,21168,10971,10197
'45113, 덕진구,'15,10 - 14세,1998,20520,10529,9991
'45113, 덕진구,'20,15 - 19세,1998,26792,13890,12902
'45113, 덕진구,'25,20 - 24세,1998,26840,13620,13220
'45113, 덕진구,'30,25 - 29세,1998,27273,13928,13345
'45113, 덕진구,'35,30 - 34세,1998,23885,12085,11800
'45113, 덕진구,'40,35 - 39세,1998,24859,12314,12545
'45113, 덕진구,'45,40 - 44세,1998,20189,9987,10202
'45113, 덕진구,'50,45 - 49세,1998,15375,7624,7751
'45113, 덕진구,'55,50 - 54세,1998,12620,6229,6391
'45113, 덕진구,'60,55 - 59세,1998,11524,5622,5902
'45113, 덕진구,'65,60 - 64세,1998,8977,4263,4714
'45113, 덕진구,'70,65 - 69세,1998,5819,2496,3323
'45113, 덕진구,'75,70 - 74세,1998,4065,1546,2519
'45113, 덕진구,'80,75 - 79세,1998,2973,934,2039
'45113, 덕진구,'85,80 - 84세,1998,1624,407,1217
'45113, 덕진구,'90,85+ ,1998,1054,192,862
'4511351000,  서노송동,'00,계,1998,4841,2434,2407
'4511351000,  서노송동,'05,0 - 4세,1998,218,120,98
'4511351000,  서노송동,'10,5 - 9세,1998,204,120,84
'4511351000,  서노송동,'15,10 - 14세,1998,264,141,123
'4511351000,  서노송동,'20,15 - 19세,1998,460,250,210
'4511351000,  서노송동,'25,20 - 24세,1998,636,317,319
'4511351000,  서노송동,'30,25 - 29세,1998,499,266,233
'4511351000,  서노송동,'35,30 - 34세,1998,306,173,133
'4511351000,  서노송동,'40,35 - 39세,1998,312,145,167
'4511351000,  서노송동,'45,40 - 44세,1998,370,175,195
'4511351000,  서노송동,'50,45 - 49세,1998,351,164,187
'4511351000,  서노송동,'55,50 - 54세,1998,324,148,176
'4511351000,  서노송동,'60,55 - 59세,1998,292,144,148
'4511351000,  서노송동,'65,60 - 64세,1998,250,131,119
'4511351000,  서노송동,'70,65 - 69세,1998,142,65,77
'4511351000,  서노송동,'75,70 - 74세,1998,92,37,55
'4511351000,  서노송동,'80,75 - 79세,1998,69,27,42
'4511351000,  서노송동,'85,80 - 84세,1998,38,9,29
'4511351000,  서노송동,'90,85+ ,1998,14,2,12
'4511352000,  진북1동,'00,계,1998,6169,2965,3204
'4511352000,  진북1동,'05,0 - 4세,1998,395,191,204
'4511352000,  진북1동,'10,5 - 9세,1998,281,143,138
'4511352000,  진북1동,'15,10 - 14세,1998,318,151,167
'4511352000,  진북1동,'20,15 - 19세,1998,588,313,275
'4511352000,  진북1동,'25,20 - 24세,1998,782,364,418
'4511352000,  진북1동,'30,25 - 29세,1998,687,364,323
'4511352000,  진북1동,'35,30 - 34세,1998,457,266,191
'4511352000,  진북1동,'40,35 - 39세,1998,389,182,207
'4511352000,  진북1동,'45,40 - 44세,1998,381,161,220
'4511352000,  진북1동,'50,45 - 49세,1998,379,162,217
'4511352000,  진북1동,'55,50 - 54세,1998,352,162,190
'4511352000,  진북1동,'60,55 - 59세,1998,418,189,229
'4511352000,  진북1동,'65,60 - 64세,1998,293,144,149
'4511352000,  진북1동,'70,65 - 69세,1998,173,77,96
'4511352000,  진북1동,'75,70 - 74세,1998,115,46,69
'4511352000,  진북1동,'80,75 - 79세,1998,98,36,62
'4511352000,  진북1동,'85,80 - 84세,1998,34,8,26
'4511352000,  진북1동,'90,85+ ,1998,29,6,23
'4511353000,  진북2동,'00,계,1998,20140,9958,10182
'4511353000,  진북2동,'05,0 - 4세,1998,1330,682,648
'4511353000,  진북2동,'10,5 - 9세,1998,1480,776,704
'4511353000,  진북2동,'15,10 - 14세,1998,1490,761,729
'4511353000,  진북2동,'20,15 - 19세,1998,1949,1092,857
'4511353000,  진북2동,'25,20 - 24세,1998,1879,951,928
'4511353000,  진북2동,'30,25 - 29세,1998,1860,955,905
'4511353000,  진북2동,'35,30 - 34세,1998,1528,759,769
'4511353000,  진북2동,'40,35 - 39세,1998,1752,798,954
'4511353000,  진북2동,'45,40 - 44세,1998,1500,734,766
'4511353000,  진북2동,'50,45 - 49세,1998,1170,574,596
'4511353000,  진북2동,'55,50 - 54세,1998,1017,451,566
'4511353000,  진북2동,'60,55 - 59세,1998,1023,499,524
'4511353000,  진북2동,'65,60 - 64세,1998,824,428,396
'4511353000,  진북2동,'70,65 - 69세,1998,526,237,289
'4511353000,  진북2동,'75,70 - 74세,1998,317,132,185
'4511353000,  진북2동,'80,75 - 79세,1998,252,81,171
'4511353000,  진북2동,'85,80 - 84세,1998,141,28,113
'4511353000,  진북2동,'90,85+ ,1998,102,20,82
'4511354000,  인후1동,'00,계,1998,19198,9341,9857
'4511354000,  인후1동,'05,0 - 4세,1998,1373,745,628
'4511354000,  인후1동,'10,5 - 9세,1998,1420,709,711
'4511354000,  인후1동,'15,10 - 14세,1998,1436,757,679
'4511354000,  인후1동,'20,15 - 19세,1998,2081,1026,1055
'4511354000,  인후1동,'25,20 - 24세,1998,1982,956,1026
'4511354000,  인후1동,'30,25 - 29세,1998,1837,897,940
'4511354000,  인후1동,'35,30 - 34세,1998,1472,721,751
'4511354000,  인후1동,'40,35 - 39세,1998,1566,767,799
'4511354000,  인후1동,'45,40 - 44세,1998,1490,683,807
'4511354000,  인후1동,'50,45 - 49세,1998,1157,550,607
'4511354000,  인후1동,'55,50 - 54세,1998,945,486,459
'4511354000,  인후1동,'60,55 - 59세,1998,766,364,402
'4511354000,  인후1동,'65,60 - 64세,1998,570,273,297
'4511354000,  인후1동,'70,65 - 69세,1998,384,153,231
'4511354000,  인후1동,'75,70 - 74세,1998,299,120,179
'4511354000,  인후1동,'80,75 - 79세,1998,226,77,149
'4511354000,  인후1동,'85,80 - 84세,1998,124,41,83
'4511354000,  인후1동,'90,85+ ,1998,70,16,54
'4511355000,  인후2동,'00,계,1998,19881,9932,9949
'4511355000,  인후2동,'05,0 - 4세,1998,1211,662,549
'4511355000,  인후2동,'10,5 - 9세,1998,1223,636,587
'4511355000,  인후2동,'15,10 - 14세,1998,1265,635,630
'4511355000,  인후2동,'20,15 - 19세,1998,2184,1147,1037
'4511355000,  인후2동,'25,20 - 24세,1998,2423,1291,1132
'4511355000,  인후2동,'30,25 - 29세,1998,2088,1135,953
'4511355000,  인후2동,'35,30 - 34세,1998,1394,724,670
'4511355000,  인후2동,'40,35 - 39세,1998,1406,682,724
'4511355000,  인후2동,'45,40 - 44세,1998,1387,605,782
'4511355000,  인후2동,'50,45 - 49세,1998,1303,615,688
'4511355000,  인후2동,'55,50 - 54세,1998,1125,522,603
'4511355000,  인후2동,'60,55 - 59세,1998,1029,521,508
'4511355000,  인후2동,'65,60 - 64세,1998,717,347,370
'4511355000,  인후2동,'70,65 - 69세,1998,436,201,235
'4511355000,  인후2동,'75,70 - 74세,1998,269,108,161
'4511355000,  인후2동,'80,75 - 79세,1998,194,49,145
'4511355000,  인후2동,'85,80 - 84세,1998,130,37,93
'4511355000,  인후2동,'90,85+ ,1998,97,15,82
'4511356000,  인후3동,'00,계,1998,16451,8058,8393
'4511356000,  인후3동,'05,0 - 4세,1998,1472,780,692
'4511356000,  인후3동,'10,5 - 9세,1998,1547,796,751
'4511356000,  인후3동,'15,10 - 14세,1998,1273,660,613
'4511356000,  인후3동,'20,15 - 19세,1998,1472,718,754
'4511356000,  인후3동,'25,20 - 24세,1998,1386,696,690
'4511356000,  인후3동,'30,25 - 29세,1998,1334,609,725
'4511356000,  인후3동,'35,30 - 34세,1998,1621,761,860
'4511356000,  인후3동,'40,35 - 39세,1998,1683,863,820
'4511356000,  인후3동,'45,40 - 44세,1998,1177,586,591
'4511356000,  인후3동,'50,45 - 49세,1998,852,432,420
'4511356000,  인후3동,'55,50 - 54세,1998,685,339,346
'4511356000,  인후3동,'60,55 - 59세,1998,587,287,300
'4511356000,  인후3동,'65,60 - 64세,1998,483,220,263
'4511356000,  인후3동,'70,65 - 69세,1998,343,141,202
'4511356000,  인후3동,'75,70 - 74세,1998,238,98,140
'4511356000,  인후3동,'80,75 - 79세,1998,136,47,89
'4511356000,  인후3동,'85,80 - 84세,1998,98,18,80
'4511356000,  인후3동,'90,85+ ,1998,64,7,57
'4511357000,  덕진동,'00,계,1998,19937,10051,9886
'4511357000,  덕진동,'05,0 - 4세,1998,1174,606,568
'4511357000,  덕진동,'10,5 - 9세,1998,1181,645,536
'4511357000,  덕진동,'15,10 - 14세,1998,1311,697,614
'4511357000,  덕진동,'20,15 - 19세,1998,2059,1081,978
'4511357000,  덕진동,'25,20 - 24세,1998,2368,1262,1106
'4511357000,  덕진동,'30,25 - 29세,1998,2222,1210,1012
'4511357000,  덕진동,'35,30 - 34세,1998,1422,758,664
'4511357000,  덕진동,'40,35 - 39세,1998,1472,699,773
'4511357000,  덕진동,'45,40 - 44세,1998,1402,681,721
'4511357000,  덕진동,'50,45 - 49세,1998,1200,542,658
'4511357000,  덕진동,'55,50 - 54세,1998,1128,531,597
'4511357000,  덕진동,'60,55 - 59세,1998,993,507,486
'4511357000,  덕진동,'65,60 - 64세,1998,757,374,383
'4511357000,  덕진동,'70,65 - 69세,1998,473,220,253
'4511357000,  덕진동,'75,70 - 74세,1998,320,117,203
'4511357000,  덕진동,'80,75 - 79세,1998,244,64,180
'4511357000,  덕진동,'85,80 - 84세,1998,143,43,100
'4511357000,  덕진동,'90,85+ ,1998,68,14,54
'4511358000,  금암1동,'00,계,1998,10919,5530,5389
'4511358000,  금암1동,'05,0 - 4세,1998,545,288,257
'4511358000,  금암1동,'10,5 - 9세,1998,525,271,254
'4511358000,  금암1동,'15,10 - 14세,1998,582,301,281
'4511358000,  금암1동,'20,15 - 19세,1998,1165,656,509
'4511358000,  금암1동,'25,20 - 24세,1998,1495,776,719
'4511358000,  금암1동,'30,25 - 29세,1998,1304,739,565
'4511358000,  금암1동,'35,30 - 34세,1998,695,388,307
'4511358000,  금암1동,'40,35 - 39세,1998,713,333,380
'4511358000,  금암1동,'45,40 - 44세,1998,714,321,393
'4511358000,  금암1동,'50,45 - 49세,1998,676,283,393
'4511358000,  금암1동,'55,50 - 54세,1998,722,320,402
'4511358000,  금암1동,'60,55 - 59세,1998,684,350,334
'4511358000,  금암1동,'65,60 - 64세,1998,437,226,211
'4511358000,  금암1동,'70,65 - 69세,1998,278,146,132
'4511358000,  금암1동,'75,70 - 74세,1998,155,63,92
'4511358000,  금암1동,'80,75 - 79세,1998,109,38,71
'4511358000,  금암1동,'85,80 - 84세,1998,63,15,48
'4511358000,  금암1동,'90,85+ ,1998,57,16,41
'4511359000,  금암2동,'00,계,1998,16000,7866,8134
'4511359000,  금암2동,'05,0 - 4세,1998,955,521,434
'4511359000,  금암2동,'10,5 - 9세,1998,842,428,414
'4511359000,  금암2동,'15,10 - 14세,1998,960,485,475
'4511359000,  금암2동,'20,15 - 19세,1998,1751,892,859
'4511359000,  금암2동,'25,20 - 24세,1998,2071,1036,1035
'4511359000,  금암2동,'30,25 - 29세,1998,1760,940,820
'4511359000,  금암2동,'35,30 - 34세,1998,1143,596,547
'4511359000,  금암2동,'40,35 - 39세,1998,1082,528,554
'4511359000,  금암2동,'45,40 - 44세,1998,1009,445,564
'4511359000,  금암2동,'50,45 - 49세,1998,992,431,561
'4511359000,  금암2동,'55,50 - 54세,1998,972,463,509
'4511359000,  금암2동,'60,55 - 59세,1998,904,437,467
'4511359000,  금암2동,'65,60 - 64세,1998,605,307,298
'4511359000,  금암2동,'70,65 - 69세,1998,374,186,188
'4511359000,  금암2동,'75,70 - 74세,1998,228,89,139
'4511359000,  금암2동,'80,75 - 79세,1998,176,54,122
'4511359000,  금암2동,'85,80 - 84세,1998,99,17,82
'4511359000,  금암2동,'90,85+ ,1998,77,11,66
'4511360000,  팔복동,'00,계,1998,15661,8123,7538
'4511360000,  팔복동,'05,0 - 4세,1998,1179,612,567
'4511360000,  팔복동,'10,5 - 9세,1998,1047,525,522
'4511360000,  팔복동,'15,10 - 14세,1998,1060,557,503
'4511360000,  팔복동,'20,15 - 19세,1998,1585,840,745
'4511360000,  팔복동,'25,20 - 24세,1998,1799,949,850
'4511360000,  팔복동,'30,25 - 29세,1998,1763,1036,727
'4511360000,  팔복동,'35,30 - 34세,1998,1204,651,553
'4511360000,  팔복동,'40,35 - 39세,1998,1213,640,573
'4511360000,  팔복동,'45,40 - 44세,1998,1085,552,533
'4511360000,  팔복동,'50,45 - 49세,1998,916,473,443
'4511360000,  팔복동,'55,50 - 54세,1998,799,423,376
'4511360000,  팔복동,'60,55 - 59세,1998,696,354,342
'4511360000,  팔복동,'65,60 - 64세,1998,488,238,250
'4511360000,  팔복동,'70,65 - 69세,1998,299,129,170
'4511360000,  팔복동,'75,70 - 74세,1998,214,87,127
'4511360000,  팔복동,'80,75 - 79세,1998,160,37,123
'4511360000,  팔복동,'85,80 - 84세,1998,77,11,66
'4511360000,  팔복동,'90,85+ ,1998,77,9,68
'4511361100,  우아1동,'00,계,1998,16955,8355,8600
'4511361100,  우아1동,'05,0 - 4세,1998,1395,715,680
'4511361100,  우아1동,'10,5 - 9세,1998,1379,746,633
'4511361100,  우아1동,'15,10 - 14세,1998,1365,690,675
'4511361100,  우아1동,'20,15 - 19세,1998,1728,882,846
'4511361100,  우아1동,'25,20 - 24세,1998,1518,758,760
'4511361100,  우아1동,'30,25 - 29세,1998,1717,828,889
'4511361100,  우아1동,'35,30 - 34세,1998,1545,768,777
'4511361100,  우아1동,'40,35 - 39세,1998,1572,761,811
'4511361100,  우아1동,'45,40 - 44세,1998,1233,584,649
'4511361100,  우아1동,'50,45 - 49세,1998,981,499,482
'4511361100,  우아1동,'55,50 - 54세,1998,708,375,333
'4511361100,  우아1동,'60,55 - 59세,1998,597,302,295
'4511361100,  우아1동,'65,60 - 64세,1998,421,175,246
'4511361100,  우아1동,'70,65 - 69세,1998,276,127,149
'4511361100,  우아1동,'75,70 - 74세,1998,199,69,130
'4511361100,  우아1동,'80,75 - 79세,1998,170,50,120
'4511361100,  우아1동,'85,80 - 84세,1998,95,16,79
'4511361100,  우아1동,'90,85+ ,1998,56,10,46
'4511361200,  우아2동,'00,계,1998,9727,4862,4865
'4511361200,  우아2동,'05,0 - 4세,1998,876,470,406
'4511361200,  우아2동,'10,5 - 9세,1998,788,396,392
'4511361200,  우아2동,'15,10 - 14세,1998,661,344,317
'4511361200,  우아2동,'20,15 - 19세,1998,916,467,449
'4511361200,  우아2동,'25,20 - 24세,1998,849,434,415
'4511361200,  우아2동,'30,25 - 29세,1998,961,473,488
'4511361200,  우아2동,'35,30 - 34세,1998,976,492,484
'4511361200,  우아2동,'40,35 - 39세,1998,899,475,424
'4511361200,  우아2동,'45,40 - 44세,1998,643,330,313
'4511361200,  우아2동,'50,45 - 49세,1998,496,266,230
'4511361200,  우아2동,'55,50 - 54세,1998,360,176,184
'4511361200,  우아2동,'60,55 - 59세,1998,383,188,195
'4511361200,  우아2동,'65,60 - 64세,1998,335,149,186
'4511361200,  우아2동,'70,65 - 69세,1998,205,75,130
'4511361200,  우아2동,'75,70 - 74세,1998,172,68,104
'4511361200,  우아2동,'80,75 - 79세,1998,121,39,82
'4511361200,  우아2동,'85,80 - 84세,1998,60,13,47
'4511361200,  우아2동,'90,85+ ,1998,26,7,19
'4511362000,  호성동,'00,계,1998,21325,10418,10907
'4511362000,  호성동,'05,0 - 4세,1998,1879,988,891
'4511362000,  호성동,'10,5 - 9세,1998,1967,1022,945
'4511362000,  호성동,'15,10 - 14세,1998,1996,1011,985
'4511362000,  호성동,'20,15 - 19세,1998,1964,990,974
'4511362000,  호성동,'25,20 - 24세,1998,1472,702,770
'4511362000,  호성동,'30,25 - 29세,1998,1743,779,964
'4511362000,  호성동,'35,30 - 34세,1998,2054,1014,1040
'4511362000,  호성동,'40,35 - 39세,1998,2411,1156,1255
'4511362000,  호성동,'45,40 - 44세,1998,1839,941,898
'4511362000,  호성동,'50,45 - 49세,1998,1101,590,511
'4511362000,  호성동,'55,50 - 54세,1998,681,346,335
'4511362000,  호성동,'60,55 - 59세,1998,623,289,334
'4511362000,  호성동,'65,60 - 64세,1998,550,232,318
'4511362000,  호성동,'70,65 - 69세,1998,369,148,221
'4511362000,  호성동,'75,70 - 74세,1998,287,94,193
'4511362000,  호성동,'80,75 - 79세,1998,195,59,136
'4511362000,  호성동,'85,80 - 84세,1998,116,35,81
'4511362000,  호성동,'90,85+ ,1998,78,22,56
'4511364100,  송천1동,'00,계,1998,24717,12363,12354
'4511364100,  송천1동,'05,0 - 4세,1998,2590,1328,1262
'4511364100,  송천1동,'10,5 - 9세,1998,2651,1386,1265
'4511364100,  송천1동,'15,10 - 14세,1998,2185,1136,1049
'4511364100,  송천1동,'20,15 - 19세,1998,2037,1051,986
'4511364100,  송천1동,'25,20 - 24세,1998,1633,832,801
'4511364100,  송천1동,'30,25 - 29세,1998,2214,997,1217
'4511364100,  송천1동,'35,30 - 34세,1998,2748,1330,1418
'4511364100,  송천1동,'40,35 - 39세,1998,2993,1505,1488
'4511364100,  송천1동,'45,40 - 44세,1998,1884,1052,832
'4511364100,  송천1동,'50,45 - 49세,1998,1068,575,493
'4511364100,  송천1동,'55,50 - 54세,1998,709,384,325
'4511364100,  송천1동,'60,55 - 59세,1998,531,279,252
'4511364100,  송천1동,'65,60 - 64세,1998,487,215,272
'4511364100,  송천1동,'70,65 - 69세,1998,323,112,211
'4511364100,  송천1동,'75,70 - 74세,1998,290,84,206
'4511364100,  송천1동,'80,75 - 79세,1998,217,61,156
'4511364100,  송천1동,'85,80 - 84세,1998,97,30,67
'4511364100,  송천1동,'90,85+ ,1998,60,6,54
'4511364200,  송천2동,'00,계,1998,24422,12162,12260
'4511364200,  송천2동,'05,0 - 4세,1998,2098,1090,1008
'4511364200,  송천2동,'10,5 - 9세,1998,2295,1164,1131
'4511364200,  송천2동,'15,10 - 14세,1998,2169,1114,1055
'4511364200,  송천2동,'20,15 - 19세,1998,2202,1146,1056
'4511364200,  송천2동,'25,20 - 24세,1998,1882,933,949
'4511364200,  송천2동,'30,25 - 29세,1998,2105,1034,1071
'4511364200,  송천2동,'35,30 - 34세,1998,2320,1117,1203
'4511364200,  송천2동,'40,35 - 39세,1998,2580,1287,1293
'4511364200,  송천2동,'45,40 - 44세,1998,2018,1048,970
'4511364200,  송천2동,'50,45 - 49세,1998,1221,642,579
'4511364200,  송천2동,'55,50 - 54세,1998,909,494,415
'4511364200,  송천2동,'60,55 - 59세,1998,812,392,420
'4511364200,  송천2동,'65,60 - 64세,1998,624,280,344
'4511364200,  송천2동,'70,65 - 69세,1998,440,173,267
'4511364200,  송천2동,'75,70 - 74세,1998,323,119,204
'4511364200,  송천2동,'80,75 - 79세,1998,231,90,141
'4511364200,  송천2동,'85,80 - 84세,1998,133,29,104
'4511364200,  송천2동,'90,85+ ,1998,60,10,50
'4511365000,  조촌동,'00,계,1998,11937,5968,5969
'4511365000,  조촌동,'05,0 - 4세,1998,1035,517,518
'4511365000,  조촌동,'10,5 - 9세,1998,839,428,411
'4511365000,  조촌동,'15,10 - 14세,1998,727,359,368
'4511365000,  조촌동,'20,15 - 19세,1998,908,453,455
'4511365000,  조촌동,'25,20 - 24세,1998,1092,530,562
'4511365000,  조촌동,'30,25 - 29세,1998,1477,789,688
'4511365000,  조촌동,'35,30 - 34세,1998,1212,660,552
'4511365000,  조촌동,'40,35 - 39세,1998,1010,567,443
'4511365000,  조촌동,'45,40 - 44세,1998,725,368,357
'4511365000,  조촌동,'50,45 - 49세,1998,560,304,256
'4511365000,  조촌동,'55,50 - 54세,1998,437,217,220
'4511365000,  조촌동,'60,55 - 59세,1998,511,217,294
'4511365000,  조촌동,'65,60 - 64세,1998,499,233,266
'4511365000,  조촌동,'70,65 - 69세,1998,382,144,238
'4511365000,  조촌동,'75,70 - 74세,1998,229,97,132
'4511365000,  조촌동,'80,75 - 79세,1998,164,54,110
'4511365000,  조촌동,'85,80 - 84세,1998,81,24,57
'4511365000,  조촌동,'90,85+ ,1998,49,7,42
'4511366000,  동산동,'00,계,1998,18517,9362,9155
'4511366000,  동산동,'05,0 - 4세,1998,1515,796,719
'4511366000,  동산동,'10,5 - 9세,1998,1499,780,719
'4511366000,  동산동,'15,10 - 14세,1998,1458,730,728
'4511366000,  동산동,'20,15 - 19세,1998,1743,886,857
'4511366000,  동산동,'25,20 - 24세,1998,1573,833,740
'4511366000,  동산동,'30,25 - 29세,1998,1702,877,825
'4511366000,  동산동,'35,30 - 34세,1998,1788,907,881
'4511366000,  동산동,'40,35 - 39세,1998,1806,926,880
'4511366000,  동산동,'45,40 - 44세,1998,1332,721,611
'4511366000,  동산동,'50,45 - 49세,1998,952,522,430
'4511366000,  동산동,'55,50 - 54세,1998,747,392,355
'4511366000,  동산동,'60,55 - 59세,1998,675,303,372
'4511366000,  동산동,'65,60 - 64세,1998,637,291,346
'4511366000,  동산동,'70,65 - 69세,1998,396,162,234
'4511366000,  동산동,'75,70 - 74세,1998,318,118,200
'4511366000,  동산동,'80,75 - 79세,1998,211,71,140
'4511366000,  동산동,'85,80 - 84세,1998,95,33,62
'4511366000,  동산동,'90,85+ ,1998,70,14,56
'45130, 군산시,'00,계,1998,280666,141262,139404
'45130, 군산시,'05,0 - 4세,1998,20065,10471,9594
'45130, 군산시,'10,5 - 9세,1998,19496,10209,9287
'45130, 군산시,'15,10 - 14세,1998,19129,9862,9267
'45130, 군산시,'20,15 - 19세,1998,26459,13637,12822
'45130, 군산시,'25,20 - 24세,1998,25886,13541,12345
'45130, 군산시,'30,25 - 29세,1998,26701,14297,12404
'45130, 군산시,'35,30 - 34세,1998,22979,12007,10972
'45130, 군산시,'40,35 - 39세,1998,24219,12359,11860
'45130, 군산시,'45,40 - 44세,1998,21251,10884,10367
'45130, 군산시,'50,45 - 49세,1998,16053,8281,7772
'45130, 군산시,'55,50 - 54세,1998,13902,7072,6830
'45130, 군산시,'60,55 - 59세,1998,13114,6347,6767
'45130, 군산시,'65,60 - 64세,1998,10385,4740,5645
'45130, 군산시,'70,65 - 69세,1998,8281,3326,4955
'45130, 군산시,'75,70 - 74세,1998,5416,2041,3375
'45130, 군산시,'80,75 - 79세,1998,3922,1363,2559
'45130, 군산시,'85,80 - 84세,1998,2071,565,1506
'45130, 군산시,'90,85+ ,1998,1337,260,1077
'4513025000,  옥구읍,'00,계,1998,5278,2717,2561
'4513025000,  옥구읍,'05,0 - 4세,1998,220,116,104
'4513025000,  옥구읍,'10,5 - 9세,1998,209,113,96
'4513025000,  옥구읍,'15,10 - 14세,1998,237,134,103
'4513025000,  옥구읍,'20,15 - 19세,1998,462,249,213
'4513025000,  옥구읍,'25,20 - 24세,1998,573,309,264
'4513025000,  옥구읍,'30,25 - 29세,1998,425,247,178
'4513025000,  옥구읍,'35,30 - 34세,1998,299,190,109
'4513025000,  옥구읍,'40,35 - 39세,1998,319,195,124
'4513025000,  옥구읍,'45,40 - 44세,1998,319,174,145
'4513025000,  옥구읍,'50,45 - 49세,1998,319,168,151
'4513025000,  옥구읍,'55,50 - 54세,1998,312,152,160
'4513025000,  옥구읍,'60,55 - 59세,1998,392,180,212
'4513025000,  옥구읍,'65,60 - 64세,1998,357,163,194
'4513025000,  옥구읍,'70,65 - 69세,1998,344,133,211
'4513025000,  옥구읍,'75,70 - 74세,1998,228,101,127
'4513025000,  옥구읍,'80,75 - 79세,1998,137,59,78
'4513025000,  옥구읍,'85,80 - 84세,1998,77,25,52
'4513025000,  옥구읍,'90,85+ ,1998,49,9,40
'4513031000,  옥산면,'00,계,1998,3511,1780,1731
'4513031000,  옥산면,'05,0 - 4세,1998,162,89,73
'4513031000,  옥산면,'10,5 - 9세,1998,132,70,62
'4513031000,  옥산면,'15,10 - 14세,1998,159,80,79
'4513031000,  옥산면,'20,15 - 19세,1998,324,174,150
'4513031000,  옥산면,'25,20 - 24세,1998,368,203,165
'4513031000,  옥산면,'30,25 - 29세,1998,289,194,95
'4513031000,  옥산면,'35,30 - 34세,1998,208,127,81
'4513031000,  옥산면,'40,35 - 39세,1998,211,127,84
'4513031000,  옥산면,'45,40 - 44세,1998,219,109,110
'4513031000,  옥산면,'50,45 - 49세,1998,199,107,92
'4513031000,  옥산면,'55,50 - 54세,1998,194,99,95
'4513031000,  옥산면,'60,55 - 59세,1998,253,106,147
'4513031000,  옥산면,'65,60 - 64세,1998,215,96,119
'4513031000,  옥산면,'70,65 - 69세,1998,207,72,135
'4513031000,  옥산면,'75,70 - 74세,1998,154,62,92
'4513031000,  옥산면,'80,75 - 79세,1998,123,36,87
'4513031000,  옥산면,'85,80 - 84세,1998,67,27,40
'4513031000,  옥산면,'90,85+ ,1998,27,2,25
'4513032000,  회현면,'00,계,1998,4796,2426,2370
'4513032000,  회현면,'05,0 - 4세,1998,226,110,116
'4513032000,  회현면,'10,5 - 9세,1998,205,113,92
'4513032000,  회현면,'15,10 - 14세,1998,218,93,125
'4513032000,  회현면,'20,15 - 19세,1998,433,212,221
'4513032000,  회현면,'25,20 - 24세,1998,519,315,204
'4513032000,  회현면,'30,25 - 29세,1998,365,220,145
'4513032000,  회현면,'35,30 - 34세,1998,313,199,114
'4513032000,  회현면,'40,35 - 39세,1998,264,154,110
'4513032000,  회현면,'45,40 - 44세,1998,275,150,125
'4513032000,  회현면,'50,45 - 49세,1998,263,131,132
'4513032000,  회현면,'55,50 - 54세,1998,234,114,120
'4513032000,  회현면,'60,55 - 59세,1998,341,149,192
'4513032000,  회현면,'65,60 - 64세,1998,316,144,172
'4513032000,  회현면,'70,65 - 69세,1998,339,137,202
'4513032000,  회현면,'75,70 - 74세,1998,216,99,117
'4513032000,  회현면,'80,75 - 79세,1998,131,48,83
'4513032000,  회현면,'85,80 - 84세,1998,78,27,51
'4513032000,  회현면,'90,85+ ,1998,60,11,49
'4513033000,  임피면,'00,계,1998,4652,2366,2286
'4513033000,  임피면,'05,0 - 4세,1998,200,110,90
'4513033000,  임피면,'10,5 - 9세,1998,202,111,91
'4513033000,  임피면,'15,10 - 14세,1998,228,107,121
'4513033000,  임피면,'20,15 - 19세,1998,449,218,231
'4513033000,  임피면,'25,20 - 24세,1998,462,268,194
'4513033000,  임피면,'30,25 - 29세,1998,385,232,153
'4513033000,  임피면,'35,30 - 34세,1998,270,170,100
'4513033000,  임피면,'40,35 - 39세,1998,289,153,136
'4513033000,  임피면,'45,40 - 44세,1998,303,170,133
'4513033000,  임피면,'50,45 - 49세,1998,232,116,116
'4513033000,  임피면,'55,50 - 54세,1998,269,127,142
'4513033000,  임피면,'60,55 - 59세,1998,285,134,151
'4513033000,  임피면,'65,60 - 64세,1998,320,133,187
'4513033000,  임피면,'70,65 - 69세,1998,301,121,180
'4513033000,  임피면,'75,70 - 74세,1998,219,99,120
'4513033000,  임피면,'80,75 - 79세,1998,133,59,74
'4513033000,  임피면,'85,80 - 84세,1998,70,31,39
'4513033000,  임피면,'90,85+ ,1998,35,7,28
'4513034000,  서수면,'00,계,1998,4260,2134,2126
'4513034000,  서수면,'05,0 - 4세,1998,165,83,82
'4513034000,  서수면,'10,5 - 9세,1998,168,97,71
'4513034000,  서수면,'15,10 - 14세,1998,192,93,99
'4513034000,  서수면,'20,15 - 19세,1998,359,180,179
'4513034000,  서수면,'25,20 - 24세,1998,424,249,175
'4513034000,  서수면,'30,25 - 29세,1998,317,197,120
'4513034000,  서수면,'35,30 - 34세,1998,236,150,86
'4513034000,  서수면,'40,35 - 39세,1998,258,145,113
'4513034000,  서수면,'45,40 - 44세,1998,243,126,117
'4513034000,  서수면,'50,45 - 49세,1998,239,132,107
'4513034000,  서수면,'55,50 - 54세,1998,228,114,114
'4513034000,  서수면,'60,55 - 59세,1998,310,133,177
'4513034000,  서수면,'65,60 - 64세,1998,328,136,192
'4513034000,  서수면,'70,65 - 69세,1998,307,138,169
'4513034000,  서수면,'75,70 - 74세,1998,199,93,106
'4513034000,  서수면,'80,75 - 79세,1998,137,40,97
'4513034000,  서수면,'85,80 - 84세,1998,94,23,71
'4513034000,  서수면,'90,85+ ,1998,56,5,51
'4513035000,  대야면,'00,계,1998,9654,4810,4844
'4513035000,  대야면,'05,0 - 4세,1998,420,220,200
'4513035000,  대야면,'10,5 - 9세,1998,447,251,196
'4513035000,  대야면,'15,10 - 14세,1998,560,291,269
'4513035000,  대야면,'20,15 - 19세,1998,897,465,432
'4513035000,  대야면,'25,20 - 24세,1998,1025,542,483
'4513035000,  대야면,'30,25 - 29세,1998,794,468,326
'4513035000,  대야면,'35,30 - 34세,1998,524,312,212
'4513035000,  대야면,'40,35 - 39세,1998,611,326,285
'4513035000,  대야면,'45,40 - 44세,1998,641,302,339
'4513035000,  대야면,'50,45 - 49세,1998,596,297,299
'4513035000,  대야면,'55,50 - 54세,1998,560,281,279
'4513035000,  대야면,'60,55 - 59세,1998,620,274,346
'4513035000,  대야면,'65,60 - 64세,1998,606,266,340
'4513035000,  대야면,'70,65 - 69세,1998,563,237,326
'4513035000,  대야면,'75,70 - 74세,1998,349,131,218
'4513035000,  대야면,'80,75 - 79세,1998,227,88,139
'4513035000,  대야면,'85,80 - 84세,1998,132,44,88
'4513035000,  대야면,'90,85+ ,1998,82,15,67
'4513036000,  개정면,'00,계,1998,5361,2731,2630
'4513036000,  개정면,'05,0 - 4세,1998,260,132,128
'4513036000,  개정면,'10,5 - 9세,1998,263,135,128
'4513036000,  개정면,'15,10 - 14세,1998,316,160,156
'4513036000,  개정면,'20,15 - 19세,1998,546,304,242
'4513036000,  개정면,'25,20 - 24세,1998,537,299,238
'4513036000,  개정면,'30,25 - 29세,1998,426,256,170
'4513036000,  개정면,'35,30 - 34세,1998,334,193,141
'4513036000,  개정면,'40,35 - 39세,1998,356,199,157
'4513036000,  개정면,'45,40 - 44세,1998,315,168,147
'4513036000,  개정면,'50,45 - 49세,1998,344,183,161
'4513036000,  개정면,'55,50 - 54세,1998,308,157,151
'4513036000,  개정면,'60,55 - 59세,1998,301,134,167
'4513036000,  개정면,'65,60 - 64세,1998,287,122,165
'4513036000,  개정면,'70,65 - 69세,1998,301,118,183
'4513036000,  개정면,'75,70 - 74세,1998,194,79,115
'4513036000,  개정면,'80,75 - 79세,1998,144,55,89
'4513036000,  개정면,'85,80 - 84세,1998,76,25,51
'4513036000,  개정면,'90,85+ ,1998,53,12,41
'4513037000,  성산면,'00,계,1998,4385,2233,2152
'4513037000,  성산면,'05,0 - 4세,1998,234,129,105
'4513037000,  성산면,'10,5 - 9세,1998,196,107,89
'4513037000,  성산면,'15,10 - 14세,1998,232,116,116
'4513037000,  성산면,'20,15 - 19세,1998,418,214,204
'4513037000,  성산면,'25,20 - 24세,1998,433,238,195
'4513037000,  성산면,'30,25 - 29세,1998,346,212,134
'4513037000,  성산면,'35,30 - 34세,1998,273,172,101
'4513037000,  성산면,'40,35 - 39세,1998,269,144,125
'4513037000,  성산면,'45,40 - 44세,1998,259,132,127
'4513037000,  성산면,'50,45 - 49세,1998,269,152,117
'4513037000,  성산면,'55,50 - 54세,1998,246,126,120
'4513037000,  성산면,'60,55 - 59세,1998,297,136,161
'4513037000,  성산면,'65,60 - 64세,1998,241,105,136
'4513037000,  성산면,'70,65 - 69세,1998,275,105,170
'4513037000,  성산면,'75,70 - 74세,1998,164,68,96
'4513037000,  성산면,'80,75 - 79세,1998,133,54,79
'4513037000,  성산면,'85,80 - 84세,1998,60,17,43
'4513037000,  성산면,'90,85+ ,1998,40,6,34
'4513038000,  나포면,'00,계,1998,3807,1938,1869
'4513038000,  나포면,'05,0 - 4세,1998,188,100,88
'4513038000,  나포면,'10,5 - 9세,1998,159,91,68
'4513038000,  나포면,'15,10 - 14세,1998,182,98,84
'4513038000,  나포면,'20,15 - 19세,1998,336,156,180
'4513038000,  나포면,'25,20 - 24세,1998,400,233,167
'4513038000,  나포면,'30,25 - 29세,1998,314,201,113
'4513038000,  나포면,'35,30 - 34세,1998,226,129,97
'4513038000,  나포면,'40,35 - 39세,1998,240,149,91
'4513038000,  나포면,'45,40 - 44세,1998,213,110,103
'4513038000,  나포면,'50,45 - 49세,1998,194,95,99
'4513038000,  나포면,'55,50 - 54세,1998,210,102,108
'4513038000,  나포면,'60,55 - 59세,1998,286,140,146
'4513038000,  나포면,'65,60 - 64세,1998,262,110,152
'4513038000,  나포면,'70,65 - 69세,1998,231,98,133
'4513038000,  나포면,'75,70 - 74세,1998,154,62,92
'4513038000,  나포면,'80,75 - 79세,1998,113,41,72
'4513038000,  나포면,'85,80 - 84세,1998,65,18,47
'4513038000,  나포면,'90,85+ ,1998,34,5,29
'4513039000,  옥도면,'00,계,1998,4795,2546,2249
'4513039000,  옥도면,'05,0 - 4세,1998,273,144,129
'4513039000,  옥도면,'10,5 - 9세,1998,197,110,87
'4513039000,  옥도면,'15,10 - 14세,1998,269,150,119
'4513039000,  옥도면,'20,15 - 19세,1998,507,249,258
'4513039000,  옥도면,'25,20 - 24세,1998,479,253,226
'4513039000,  옥도면,'30,25 - 29세,1998,409,251,158
'4513039000,  옥도면,'35,30 - 34세,1998,393,243,150
'4513039000,  옥도면,'40,35 - 39세,1998,392,204,188
'4513039000,  옥도면,'45,40 - 44세,1998,390,244,146
'4513039000,  옥도면,'50,45 - 49세,1998,321,188,133
'4513039000,  옥도면,'55,50 - 54세,1998,255,140,115
'4513039000,  옥도면,'60,55 - 59세,1998,245,130,115
'4513039000,  옥도면,'65,60 - 64세,1998,218,92,126
'4513039000,  옥도면,'70,65 - 69세,1998,188,79,109
'4513039000,  옥도면,'75,70 - 74세,1998,100,31,69
'4513039000,  옥도면,'80,75 - 79세,1998,85,25,60
'4513039000,  옥도면,'85,80 - 84세,1998,46,11,35
'4513039000,  옥도면,'90,85+ ,1998,28,2,26
'4513040000,  옥서면,'00,계,1998,7868,3976,3892
'4513040000,  옥서면,'05,0 - 4세,1998,427,228,199
'4513040000,  옥서면,'10,5 - 9세,1998,360,188,172
'4513040000,  옥서면,'15,10 - 14세,1998,364,181,183
'4513040000,  옥서면,'20,15 - 19세,1998,775,387,388
'4513040000,  옥서면,'25,20 - 24세,1998,946,499,447
'4513040000,  옥서면,'30,25 - 29세,1998,805,466,339
'4513040000,  옥서면,'35,30 - 34세,1998,539,310,229
'4513040000,  옥서면,'40,35 - 39세,1998,491,278,213
'4513040000,  옥서면,'45,40 - 44세,1998,497,253,244
'4513040000,  옥서면,'50,45 - 49세,1998,475,224,251
'4513040000,  옥서면,'55,50 - 54세,1998,486,241,245
'4513040000,  옥서면,'60,55 - 59세,1998,555,261,294
'4513040000,  옥서면,'65,60 - 64세,1998,474,224,250
'4513040000,  옥서면,'70,65 - 69세,1998,281,115,166
'4513040000,  옥서면,'75,70 - 74세,1998,178,73,105
'4513040000,  옥서면,'80,75 - 79세,1998,115,30,85
'4513040000,  옥서면,'85,80 - 84세,1998,62,15,47
'4513040000,  옥서면,'90,85+ ,1998,38,3,35
'4513051500,  해신동,'00,계,1998,8253,4224,4029
'4513051500,  해신동,'05,0 - 4세,1998,386,208,178
'4513051500,  해신동,'10,5 - 9세,1998,372,198,174
'4513051500,  해신동,'15,10 - 14세,1998,499,256,243
'4513051500,  해신동,'20,15 - 19세,1998,875,441,434
'4513051500,  해신동,'25,20 - 24세,1998,914,505,409
'4513051500,  해신동,'30,25 - 29세,1998,760,461,299
'4513051500,  해신동,'35,30 - 34세,1998,514,293,221
'4513051500,  해신동,'40,35 - 39세,1998,540,284,256
'4513051500,  해신동,'45,40 - 44세,1998,599,329,270
'4513051500,  해신동,'50,45 - 49세,1998,540,275,265
'4513051500,  해신동,'55,50 - 54세,1998,553,253,300
'4513051500,  해신동,'60,55 - 59세,1998,552,253,299
'4513051500,  해신동,'65,60 - 64세,1998,428,206,222
'4513051500,  해신동,'70,65 - 69세,1998,276,109,167
'4513051500,  해신동,'75,70 - 74세,1998,189,66,123
'4513051500,  해신동,'80,75 - 79세,1998,133,52,81
'4513051500,  해신동,'85,80 - 84세,1998,73,24,49
'4513051500,  해신동,'90,85+ ,1998,50,11,39
'4513053000,  월명동,'00,계,1998,5989,2953,3036
'4513053000,  월명동,'05,0 - 4세,1998,292,156,136
'4513053000,  월명동,'10,5 - 9세,1998,348,166,182
'4513053000,  월명동,'15,10 - 14세,1998,368,196,172
'4513053000,  월명동,'20,15 - 19세,1998,568,303,265
'4513053000,  월명동,'25,20 - 24세,1998,593,322,271
'4513053000,  월명동,'30,25 - 29세,1998,544,294,250
'4513053000,  월명동,'35,30 - 34세,1998,403,200,203
'4513053000,  월명동,'40,35 - 39세,1998,437,223,214
'4513053000,  월명동,'45,40 - 44세,1998,479,223,256
'4513053000,  월명동,'50,45 - 49세,1998,391,171,220
'4513053000,  월명동,'55,50 - 54세,1998,402,194,208
'4513053000,  월명동,'60,55 - 59세,1998,367,171,196
'4513053000,  월명동,'65,60 - 64세,1998,270,125,145
'4513053000,  월명동,'70,65 - 69세,1998,198,96,102
'4513053000,  월명동,'75,70 - 74세,1998,115,39,76
'4513053000,  월명동,'80,75 - 79세,1998,126,48,78
'4513053000,  월명동,'85,80 - 84세,1998,55,21,34
'4513053000,  월명동,'90,85+ ,1998,33,5,28
'4513054000,  오룡동,'00,계,1998,4852,2450,2402
'4513054000,  오룡동,'05,0 - 4세,1998,229,120,109
'4513054000,  오룡동,'10,5 - 9세,1998,232,124,108
'4513054000,  오룡동,'15,10 - 14세,1998,310,161,149
'4513054000,  오룡동,'20,15 - 19세,1998,498,258,240
'4513054000,  오룡동,'25,20 - 24세,1998,532,284,248
'4513054000,  오룡동,'30,25 - 29세,1998,433,255,178
'4513054000,  오룡동,'35,30 - 34세,1998,266,152,114
'4513054000,  오룡동,'40,35 - 39세,1998,343,169,174
'4513054000,  오룡동,'45,40 - 44세,1998,334,170,164
'4513054000,  오룡동,'50,45 - 49세,1998,299,136,163
'4513054000,  오룡동,'55,50 - 54세,1998,354,179,175
'4513054000,  오룡동,'60,55 - 59세,1998,334,150,184
'4513054000,  오룡동,'65,60 - 64세,1998,243,135,108
'4513054000,  오룡동,'70,65 - 69세,1998,170,71,99
'4513054000,  오룡동,'75,70 - 74세,1998,117,38,79
'4513054000,  오룡동,'80,75 - 79세,1998,85,28,57
'4513054000,  오룡동,'85,80 - 84세,1998,35,11,24
'4513054000,  오룡동,'90,85+ ,1998,38,9,29
'4513055000,  신풍동,'00,계,1998,13037,6513,6524
'4513055000,  신풍동,'05,0 - 4세,1998,753,385,368
'4513055000,  신풍동,'10,5 - 9세,1998,834,440,394
'4513055000,  신풍동,'15,10 - 14세,1998,929,471,458
'4513055000,  신풍동,'20,15 - 19세,1998,1326,678,648
'4513055000,  신풍동,'25,20 - 24세,1998,1397,718,679
'4513055000,  신풍동,'30,25 - 29세,1998,1256,723,533
'4513055000,  신풍동,'35,30 - 34세,1998,849,426,423
'4513055000,  신풍동,'40,35 - 39세,1998,1030,489,541
'4513055000,  신풍동,'45,40 - 44세,1998,1019,485,534
'4513055000,  신풍동,'50,45 - 49세,1998,863,415,448
'4513055000,  신풍동,'55,50 - 54세,1998,794,384,410
'4513055000,  신풍동,'60,55 - 59세,1998,686,365,321
'4513055000,  신풍동,'65,60 - 64세,1998,482,229,253
'4513055000,  신풍동,'70,65 - 69세,1998,311,144,167
'4513055000,  신풍동,'75,70 - 74세,1998,192,77,115
'4513055000,  신풍동,'80,75 - 79세,1998,161,50,111
'4513055000,  신풍동,'85,80 - 84세,1998,93,17,76
'4513055000,  신풍동,'90,85+ ,1998,62,17,45
'4513056000,  삼학동,'00,계,1998,6935,3471,3464
'4513056000,  삼학동,'05,0 - 4세,1998,385,191,194
'4513056000,  삼학동,'10,5 - 9세,1998,401,213,188
'4513056000,  삼학동,'15,10 - 14세,1998,431,229,202
'4513056000,  삼학동,'20,15 - 19세,1998,693,353,340
'4513056000,  삼학동,'25,20 - 24세,1998,762,418,344
'4513056000,  삼학동,'30,25 - 29세,1998,671,371,300
'4513056000,  삼학동,'35,30 - 34세,1998,463,240,223
'4513056000,  삼학동,'40,35 - 39세,1998,564,282,282
'4513056000,  삼학동,'45,40 - 44세,1998,499,242,257
'4513056000,  삼학동,'50,45 - 49세,1998,470,222,248
'4513056000,  삼학동,'55,50 - 54세,1998,418,191,227
'4513056000,  삼학동,'60,55 - 59세,1998,411,206,205
'4513056000,  삼학동,'65,60 - 64세,1998,278,141,137
'4513056000,  삼학동,'70,65 - 69세,1998,187,73,114
'4513056000,  삼학동,'75,70 - 74세,1998,121,39,82
'4513056000,  삼학동,'80,75 - 79세,1998,83,32,51
'4513056000,  삼학동,'85,80 - 84세,1998,52,15,37
'4513056000,  삼학동,'90,85+ ,1998,46,13,33
'4513057000,  선양동,'00,계,1998,6047,3008,3039
'4513057000,  선양동,'05,0 - 4세,1998,290,149,141
'4513057000,  선양동,'10,5 - 9세,1998,303,162,141
'4513057000,  선양동,'15,10 - 14세,1998,367,188,179
'4513057000,  선양동,'20,15 - 19세,1998,627,306,321
'4513057000,  선양동,'25,20 - 24세,1998,647,359,288
'4513057000,  선양동,'30,25 - 29세,1998,561,317,244
'4513057000,  선양동,'35,30 - 34세,1998,345,193,152
'4513057000,  선양동,'40,35 - 39세,1998,424,218,206
'4513057000,  선양동,'45,40 - 44세,1998,452,217,235
'4513057000,  선양동,'50,45 - 49세,1998,407,198,209
'4513057000,  선양동,'55,50 - 54세,1998,384,184,200
'4513057000,  선양동,'60,55 - 59세,1998,374,177,197
'4513057000,  선양동,'65,60 - 64세,1998,317,146,171
'4513057000,  선양동,'70,65 - 69세,1998,242,96,146
'4513057000,  선양동,'75,70 - 74세,1998,131,46,85
'4513057000,  선양동,'80,75 - 79세,1998,112,38,74
'4513057000,  선양동,'85,80 - 84세,1998,42,10,32
'4513057000,  선양동,'90,85+ ,1998,22,4,18
'4513060500,  중앙동,'00,계,1998,8015,4083,3932
'4513060500,  중앙동,'05,0 - 4세,1998,311,190,121
'4513060500,  중앙동,'10,5 - 9세,1998,389,209,180
'4513060500,  중앙동,'15,10 - 14세,1998,487,263,224
'4513060500,  중앙동,'20,15 - 19세,1998,880,450,430
'4513060500,  중앙동,'25,20 - 24세,1998,912,496,416
'4513060500,  중앙동,'30,25 - 29세,1998,709,417,292
'4513060500,  중앙동,'35,30 - 34세,1998,443,235,208
'4513060500,  중앙동,'40,35 - 39세,1998,560,251,309
'4513060500,  중앙동,'45,40 - 44세,1998,642,341,301
'4513060500,  중앙동,'50,45 - 49세,1998,564,256,308
'4513060500,  중앙동,'55,50 - 54세,1998,545,299,246
'4513060500,  중앙동,'60,55 - 59세,1998,511,253,258
'4513060500,  중앙동,'65,60 - 64세,1998,371,176,195
'4513060500,  중앙동,'70,65 - 69세,1998,254,93,161
'4513060500,  중앙동,'75,70 - 74세,1998,183,59,124
'4513060500,  중앙동,'80,75 - 79세,1998,154,63,91
'4513060500,  중앙동,'85,80 - 84세,1998,56,18,38
'4513060500,  중앙동,'90,85+ ,1998,44,14,30
'4513061500,  중미동,'00,계,1998,5349,2622,2727
'4513061500,  중미동,'05,0 - 4세,1998,256,115,141
'4513061500,  중미동,'10,5 - 9세,1998,323,174,149
'4513061500,  중미동,'15,10 - 14세,1998,339,191,148
'4513061500,  중미동,'20,15 - 19세,1998,542,270,272
'4513061500,  중미동,'25,20 - 24세,1998,596,302,294
'4513061500,  중미동,'30,25 - 29세,1998,466,236,230
'4513061500,  중미동,'35,30 - 34세,1998,327,167,160
'4513061500,  중미동,'40,35 - 39세,1998,440,210,230
'4513061500,  중미동,'45,40 - 44세,1998,406,199,207
'4513061500,  중미동,'50,45 - 49세,1998,359,165,194
'4513061500,  중미동,'55,50 - 54세,1998,377,183,194
'4513061500,  중미동,'60,55 - 59세,1998,336,168,168
'4513061500,  중미동,'65,60 - 64세,1998,218,103,115
'4513061500,  중미동,'70,65 - 69세,1998,157,71,86
'4513061500,  중미동,'75,70 - 74세,1998,80,32,48
'4513061500,  중미동,'80,75 - 79세,1998,68,26,42
'4513061500,  중미동,'85,80 - 84세,1998,34,6,28
'4513061500,  중미동,'90,85+ ,1998,25,4,21
'4513064000,  흥남동,'00,계,1998,7578,3799,3779
'4513064000,  흥남동,'05,0 - 4세,1998,377,196,181
'4513064000,  흥남동,'10,5 - 9세,1998,381,207,174
'4513064000,  흥남동,'15,10 - 14세,1998,470,229,241
'4513064000,  흥남동,'20,15 - 19세,1998,855,416,439
'4513064000,  흥남동,'25,20 - 24세,1998,915,498,417
'4513064000,  흥남동,'30,25 - 29세,1998,719,411,308
'4513064000,  흥남동,'35,30 - 34세,1998,474,246,228
'4513064000,  흥남동,'40,35 - 39세,1998,513,255,258
'4513064000,  흥남동,'45,40 - 44세,1998,540,236,304
'4513064000,  흥남동,'50,45 - 49세,1998,556,269,287
'4513064000,  흥남동,'55,50 - 54세,1998,496,256,240
'4513064000,  흥남동,'60,55 - 59세,1998,460,229,231
'4513064000,  흥남동,'65,60 - 64세,1998,316,157,159
'4513064000,  흥남동,'70,65 - 69세,1998,192,99,93
'4513064000,  흥남동,'75,70 - 74세,1998,131,46,85
'4513064000,  흥남동,'80,75 - 79세,1998,89,28,61
'4513064000,  흥남동,'85,80 - 84세,1998,67,16,51
'4513064000,  흥남동,'90,85+ ,1998,27,5,22
'4513065000,  조촌동,'00,계,1998,17439,8772,8667
'4513065000,  조촌동,'05,0 - 4세,1998,1266,648,618
'4513065000,  조촌동,'10,5 - 9세,1998,1238,652,586
'4513065000,  조촌동,'15,10 - 14세,1998,1284,666,618
'4513065000,  조촌동,'20,15 - 19세,1998,1760,928,832
'4513065000,  조촌동,'25,20 - 24세,1998,1649,843,806
'4513065000,  조촌동,'30,25 - 29세,1998,1718,871,847
'4513065000,  조촌동,'35,30 - 34세,1998,1479,739,740
'4513065000,  조촌동,'40,35 - 39세,1998,1563,742,821
'4513065000,  조촌동,'45,40 - 44세,1998,1483,752,731
'4513065000,  조촌동,'50,45 - 49세,1998,1062,536,526
'4513065000,  조촌동,'55,50 - 54세,1998,912,515,397
'4513065000,  조촌동,'60,55 - 59세,1998,678,355,323
'4513065000,  조촌동,'65,60 - 64세,1998,492,224,268
'4513065000,  조촌동,'70,65 - 69세,1998,329,140,189
'4513065000,  조촌동,'75,70 - 74세,1998,210,67,143
'4513065000,  조촌동,'80,75 - 79세,1998,170,57,113
'4513065000,  조촌동,'85,80 - 84세,1998,80,19,61
'4513065000,  조촌동,'90,85+ ,1998,66,18,48
'4513066000,  경암동,'00,계,1998,11621,5834,5787
'4513066000,  경암동,'05,0 - 4세,1998,726,377,349
'4513066000,  경암동,'10,5 - 9세,1998,684,351,333
'4513066000,  경암동,'15,10 - 14세,1998,763,397,366
'4513066000,  경암동,'20,15 - 19세,1998,1345,694,651
'4513066000,  경암동,'25,20 - 24세,1998,1343,665,678
'4513066000,  경암동,'30,25 - 29세,1998,1129,640,489
'4513066000,  경암동,'35,30 - 34세,1998,805,419,386
'4513066000,  경암동,'40,35 - 39세,1998,865,390,475
'4513066000,  경암동,'45,40 - 44세,1998,884,416,468
'4513066000,  경암동,'50,45 - 49세,1998,754,373,381
'4513066000,  경암동,'55,50 - 54세,1998,701,350,351
'4513066000,  경암동,'60,55 - 59세,1998,606,335,271
'4513066000,  경암동,'65,60 - 64세,1998,368,186,182
'4513066000,  경암동,'70,65 - 69세,1998,234,101,133
'4513066000,  경암동,'75,70 - 74세,1998,199,73,126
'4513066000,  경암동,'80,75 - 79세,1998,117,45,72
'4513066000,  경암동,'85,80 - 84세,1998,60,17,43
'4513066000,  경암동,'90,85+ ,1998,38,5,33
'4513067000,  구암동,'00,계,1998,8483,4282,4201
'4513067000,  구암동,'05,0 - 4세,1998,658,360,298
'4513067000,  구암동,'10,5 - 9세,1998,629,314,315
'4513067000,  구암동,'15,10 - 14세,1998,667,341,326
'4513067000,  구암동,'20,15 - 19세,1998,783,414,369
'4513067000,  구암동,'25,20 - 24세,1998,712,365,347
'4513067000,  구암동,'30,25 - 29세,1998,767,398,369
'4513067000,  구암동,'35,30 - 34세,1998,697,331,366
'4513067000,  구암동,'40,35 - 39세,1998,849,428,421
'4513067000,  구암동,'45,40 - 44세,1998,696,367,329
'4513067000,  구암동,'50,45 - 49세,1998,482,254,228
'4513067000,  구암동,'55,50 - 54세,1998,385,198,187
'4513067000,  구암동,'60,55 - 59세,1998,379,200,179
'4513067000,  구암동,'65,60 - 64세,1998,259,133,126
'4513067000,  구암동,'70,65 - 69세,1998,227,94,133
'4513067000,  구암동,'75,70 - 74세,1998,112,42,70
'4513067000,  구암동,'80,75 - 79세,1998,99,30,69
'4513067000,  구암동,'85,80 - 84세,1998,43,8,35
'4513067000,  구암동,'90,85+ ,1998,39,5,34
'4513068000,  개정동,'00,계,1998,4985,2501,2484
'4513068000,  개정동,'05,0 - 4세,1998,403,218,185
'4513068000,  개정동,'10,5 - 9세,1998,349,177,172
'4513068000,  개정동,'15,10 - 14세,1998,329,161,168
'4513068000,  개정동,'20,15 - 19세,1998,455,226,229
'4513068000,  개정동,'25,20 - 24세,1998,386,202,184
'4513068000,  개정동,'30,25 - 29세,1998,465,242,223
'4513068000,  개정동,'35,30 - 34세,1998,450,250,200
'4513068000,  개정동,'40,35 - 39세,1998,418,211,207
'4513068000,  개정동,'45,40 - 44세,1998,397,199,198
'4513068000,  개정동,'50,45 - 49세,1998,276,150,126
'4513068000,  개정동,'55,50 - 54세,1998,250,133,117
'4513068000,  개정동,'60,55 - 59세,1998,237,116,121
'4513068000,  개정동,'65,60 - 64세,1998,171,78,93
'4513068000,  개정동,'70,65 - 69세,1998,152,57,95
'4513068000,  개정동,'75,70 - 74세,1998,96,40,56
'4513068000,  개정동,'80,75 - 79세,1998,88,26,62
'4513068000,  개정동,'85,80 - 84세,1998,31,8,23
'4513068000,  개정동,'90,85+ ,1998,32,7,25
'4513069000,  수송동,'00,계,1998,11833,6049,5784
'4513069000,  수송동,'05,0 - 4세,1998,971,542,429
'4513069000,  수송동,'10,5 - 9세,1998,901,468,433
'4513069000,  수송동,'15,10 - 14세,1998,842,427,415
'4513069000,  수송동,'20,15 - 19세,1998,1126,599,527
'4513069000,  수송동,'25,20 - 24세,1998,1016,528,488
'4513069000,  수송동,'30,25 - 29세,1998,1194,615,579
'4513069000,  수송동,'35,30 - 34세,1998,1050,558,492
'4513069000,  수송동,'40,35 - 39세,1998,1155,597,558
'4513069000,  수송동,'45,40 - 44세,1998,934,475,459
'4513069000,  수송동,'50,45 - 49세,1998,671,338,333
'4513069000,  수송동,'55,50 - 54세,1998,524,274,250
'4513069000,  수송동,'60,55 - 59세,1998,461,238,223
'4513069000,  수송동,'65,60 - 64세,1998,331,158,173
'4513069000,  수송동,'70,65 - 69세,1998,255,109,146
'4513069000,  수송동,'75,70 - 74세,1998,168,62,106
'4513069000,  수송동,'80,75 - 79세,1998,113,34,79
'4513069000,  수송동,'85,80 - 84세,1998,72,17,55
'4513069000,  수송동,'90,85+ ,1998,49,10,39
'4513070100,  나운1동,'00,계,1998,21840,10884,10956
'4513070100,  나운1동,'05,0 - 4세,1998,1899,1015,884
'4513070100,  나운1동,'10,5 - 9세,1998,2037,1063,974
'4513070100,  나운1동,'15,10 - 14세,1998,1847,937,910
'4513070100,  나운1동,'20,15 - 19세,1998,1964,1021,943
'4513070100,  나운1동,'25,20 - 24세,1998,1685,841,844
'4513070100,  나운1동,'30,25 - 29세,1998,2053,976,1077
'4513070100,  나운1동,'35,30 - 34세,1998,2100,1028,1072
'4513070100,  나운1동,'40,35 - 39세,1998,2349,1143,1206
'4513070100,  나운1동,'45,40 - 44세,1998,1922,1002,920
'4513070100,  나운1동,'50,45 - 49세,1998,1155,628,527
'4513070100,  나운1동,'55,50 - 54세,1998,823,426,397
'4513070100,  나운1동,'60,55 - 59세,1998,601,310,291
'4513070100,  나운1동,'65,60 - 64세,1998,440,187,253
'4513070100,  나운1동,'70,65 - 69세,1998,385,138,247
'4513070100,  나운1동,'75,70 - 74세,1998,280,83,197
'4513070100,  나운1동,'80,75 - 79세,1998,167,57,110
'4513070100,  나운1동,'85,80 - 84세,1998,81,13,68
'4513070100,  나운1동,'90,85+ ,1998,52,16,36
'4513070200,  나운2동,'00,계,1998,50166,24908,25258
'4513070200,  나운2동,'05,0 - 4세,1998,5223,2666,2557
'4513070200,  나운2동,'10,5 - 9세,1998,5205,2718,2487
'4513070200,  나운2동,'15,10 - 14세,1998,4109,2094,2015
'4513070200,  나운2동,'20,15 - 19세,1998,4202,2236,1966
'4513070200,  나운2동,'25,20 - 24세,1998,3172,1573,1599
'4513070200,  나운2동,'30,25 - 29세,1998,4829,2208,2621
'4513070200,  나운2동,'35,30 - 34세,1998,5724,2749,2975
'4513070200,  나운2동,'40,35 - 39세,1998,5630,2900,2730
'4513070200,  나운2동,'45,40 - 44세,1998,4060,2088,1972
'4513070200,  나운2동,'50,45 - 49세,1998,2331,1291,1040
'4513070200,  나운2동,'55,50 - 54세,1998,1525,804,721
'4513070200,  나운2동,'60,55 - 59세,1998,1199,570,629
'4513070200,  나운2동,'65,60 - 64세,1998,990,407,583
'4513070200,  나운2동,'70,65 - 69세,1998,743,253,490
'4513070200,  나운2동,'75,70 - 74세,1998,522,182,340
'4513070200,  나운2동,'80,75 - 79세,1998,365,102,263
'4513070200,  나운2동,'85,80 - 84세,1998,221,46,175
'4513070200,  나운2동,'90,85+ ,1998,116,21,95
'4513071000,  소룡동,'00,계,1998,13506,6875,6631
'4513071000,  소룡동,'05,0 - 4세,1998,1247,626,621
'4513071000,  소룡동,'10,5 - 9세,1998,1129,582,547
'4513071000,  소룡동,'15,10 - 14세,1998,1111,585,526
'4513071000,  소룡동,'20,15 - 19세,1998,1244,620,624
'4513071000,  소룡동,'25,20 - 24세,1998,1066,527,539
'4513071000,  소룡동,'30,25 - 29세,1998,1356,730,626
'4513071000,  소룡동,'35,30 - 34세,1998,1344,685,659
'4513071000,  소룡동,'40,35 - 39세,1998,1436,736,700
'4513071000,  소룡동,'45,40 - 44세,1998,1117,618,499
'4513071000,  소룡동,'50,45 - 49세,1998,650,375,275
'4513071000,  소룡동,'55,50 - 54세,1998,521,275,246
'4513071000,  소룡동,'60,55 - 59세,1998,382,185,197
'4513071000,  소룡동,'65,60 - 64세,1998,279,136,143
'4513071000,  소룡동,'70,65 - 69세,1998,233,71,162
'4513071000,  소룡동,'75,70 - 74세,1998,161,56,105
'4513071000,  소룡동,'80,75 - 79세,1998,115,37,78
'4513071000,  소룡동,'85,80 - 84세,1998,71,19,52
'4513071000,  소룡동,'90,85+ ,1998,44,12,32
'4513072000,  미성동,'00,계,1998,16371,8377,7994
'4513072000,  미성동,'05,0 - 4세,1998,1618,848,770
'4513072000,  미성동,'10,5 - 9세,1998,1203,605,598
'4513072000,  미성동,'15,10 - 14세,1998,1020,567,453
'4513072000,  미성동,'20,15 - 19세,1998,1210,616,594
'4513072000,  미성동,'25,20 - 24세,1998,1423,687,736
'4513072000,  미성동,'30,25 - 29세,1998,2196,1188,1008
'4513072000,  미성동,'35,30 - 34세,1998,1631,901,730
'4513072000,  미성동,'40,35 - 39세,1998,1403,757,646
'4513072000,  미성동,'45,40 - 44세,1998,1114,587,527
'4513072000,  미성동,'50,45 - 49세,1998,772,436,336
'4513072000,  미성동,'55,50 - 54세,1998,636,321,315
'4513072000,  미성동,'60,55 - 59세,1998,655,289,366
'4513072000,  미성동,'65,60 - 64세,1998,508,222,286
'4513072000,  미성동,'70,65 - 69세,1998,399,158,241
'4513072000,  미성동,'75,70 - 74세,1998,254,96,158
'4513072000,  미성동,'80,75 - 79세,1998,199,75,124
'4513072000,  미성동,'85,80 - 84세,1998,78,17,61
'4513072000,  미성동,'90,85+ ,1998,52,7,45
'45140, 익산시,'00,계,1998,333788,165995,167793
'45140, 익산시,'05,0 - 4세,1998,25469,13235,12234
'45140, 익산시,'10,5 - 9세,1998,25153,13060,12093
'45140, 익산시,'15,10 - 14세,1998,23558,12038,11520
'45140, 익산시,'20,15 - 19세,1998,30327,15335,14992
'45140, 익산시,'25,20 - 24세,1998,30109,15725,14384
'45140, 익산시,'30,25 - 29세,1998,30935,15986,14949
'45140, 익산시,'35,30 - 34세,1998,28929,14827,14102
'45140, 익산시,'40,35 - 39세,1998,29334,15103,14231
'45140, 익산시,'45,40 - 44세,1998,23922,12364,11558
'45140, 익산시,'50,45 - 49세,1998,17389,8840,8549
'45140, 익산시,'55,50 - 54세,1998,14313,7147,7166
'45140, 익산시,'60,55 - 59세,1998,14773,6847,7926
'45140, 익산시,'65,60 - 64세,1998,13154,5857,7297
'45140, 익산시,'70,65 - 69세,1998,10285,4142,6143
'45140, 익산시,'75,70 - 74세,1998,7103,2793,4310
'45140, 익산시,'80,75 - 79세,1998,4932,1673,3259
'45140, 익산시,'85,80 - 84세,1998,2590,747,1843
'45140, 익산시,'90,85+ ,1998,1513,276,1237
'4514025000,  함열읍,'00,계,1998,10327,5173,5154
'4514025000,  함열읍,'05,0 - 4세,1998,608,308,300
'4514025000,  함열읍,'10,5 - 9세,1998,789,401,388
'4514025000,  함열읍,'15,10 - 14세,1998,790,406,384
'4514025000,  함열읍,'20,15 - 19세,1998,1042,524,518
'4514025000,  함열읍,'25,20 - 24세,1998,923,509,414
'4514025000,  함열읍,'30,25 - 29세,1998,774,430,344
'4514025000,  함열읍,'35,30 - 34세,1998,721,346,375
'4514025000,  함열읍,'40,35 - 39세,1998,904,463,441
'4514025000,  함열읍,'45,40 - 44세,1998,804,443,361
'4514025000,  함열읍,'50,45 - 49세,1998,524,271,253
'4514025000,  함열읍,'55,50 - 54세,1998,493,240,253
'4514025000,  함열읍,'60,55 - 59세,1998,528,246,282
'4514025000,  함열읍,'65,60 - 64세,1998,489,216,273
'4514025000,  함열읍,'70,65 - 69세,1998,356,150,206
'4514025000,  함열읍,'75,70 - 74세,1998,272,108,164
'4514025000,  함열읍,'80,75 - 79세,1998,186,76,110
'4514025000,  함열읍,'85,80 - 84세,1998,88,27,61
'4514025000,  함열읍,'90,85+ ,1998,36,9,27
'4514031000,  오산면,'00,계,1998,7082,3567,3515
'4514031000,  오산면,'05,0 - 4세,1998,326,165,161
'4514031000,  오산면,'10,5 - 9세,1998,318,162,156
'4514031000,  오산면,'15,10 - 14세,1998,393,206,187
'4514031000,  오산면,'20,15 - 19세,1998,653,326,327
'4514031000,  오산면,'25,20 - 24세,1998,710,402,308
'4514031000,  오산면,'30,25 - 29세,1998,577,352,225
'4514031000,  오산면,'35,30 - 34세,1998,429,245,184
'4514031000,  오산면,'40,35 - 39세,1998,458,243,215
'4514031000,  오산면,'45,40 - 44세,1998,467,257,210
'4514031000,  오산면,'50,45 - 49세,1998,406,198,208
'4514031000,  오산면,'55,50 - 54세,1998,371,186,185
'4514031000,  오산면,'60,55 - 59세,1998,477,208,269
'4514031000,  오산면,'65,60 - 64세,1998,481,210,271
'4514031000,  오산면,'70,65 - 69세,1998,417,174,243
'4514031000,  오산면,'75,70 - 74세,1998,280,116,164
'4514031000,  오산면,'80,75 - 79세,1998,177,75,102
'4514031000,  오산면,'85,80 - 84세,1998,96,33,63
'4514031000,  오산면,'90,85+ ,1998,46,9,37
'4514032000,  황등면,'00,계,1998,12090,6115,5975
'4514032000,  황등면,'05,0 - 4세,1998,732,398,334
'4514032000,  황등면,'10,5 - 9세,1998,744,397,347
'4514032000,  황등면,'15,10 - 14세,1998,740,373,367
'4514032000,  황등면,'20,15 - 19세,1998,1110,561,549
'4514032000,  황등면,'25,20 - 24세,1998,1178,645,533
'4514032000,  황등면,'30,25 - 29세,1998,1076,616,460
'4514032000,  황등면,'35,30 - 34세,1998,868,497,371
'4514032000,  황등면,'40,35 - 39세,1998,903,490,413
'4514032000,  황등면,'45,40 - 44세,1998,826,438,388
'4514032000,  황등면,'50,45 - 49세,1998,626,316,310
'4514032000,  황등면,'55,50 - 54세,1998,572,279,293
'4514032000,  황등면,'60,55 - 59세,1998,659,288,371
'4514032000,  황등면,'65,60 - 64세,1998,650,280,370
'4514032000,  황등면,'70,65 - 69세,1998,537,225,312
'4514032000,  황등면,'75,70 - 74세,1998,351,136,215
'4514032000,  황등면,'80,75 - 79세,1998,284,106,178
'4514032000,  황등면,'85,80 - 84세,1998,151,51,100
'4514032000,  황등면,'90,85+ ,1998,83,19,64
'4514033000,  함라면,'00,계,1998,3641,1828,1813
'4514033000,  함라면,'05,0 - 4세,1998,169,89,80
'4514033000,  함라면,'10,5 - 9세,1998,124,60,64
'4514033000,  함라면,'15,10 - 14세,1998,180,87,93
'4514033000,  함라면,'20,15 - 19세,1998,323,158,165
'4514033000,  함라면,'25,20 - 24세,1998,373,200,173
'4514033000,  함라면,'30,25 - 29세,1998,295,190,105
'4514033000,  함라면,'35,30 - 34세,1998,187,109,78
'4514033000,  함라면,'40,35 - 39세,1998,235,140,95
'4514033000,  함라면,'45,40 - 44세,1998,191,111,80
'4514033000,  함라면,'50,45 - 49세,1998,192,91,101
'4514033000,  함라면,'55,50 - 54세,1998,197,95,102
'4514033000,  함라면,'60,55 - 59세,1998,314,132,182
'4514033000,  함라면,'65,60 - 64세,1998,280,128,152
'4514033000,  함라면,'70,65 - 69세,1998,221,93,128
'4514033000,  함라면,'75,70 - 74세,1998,163,78,85
'4514033000,  함라면,'80,75 - 79세,1998,105,39,66
'4514033000,  함라면,'85,80 - 84세,1998,68,23,45
'4514033000,  함라면,'90,85+ ,1998,24,5,19
'4514034000,  웅포면,'00,계,1998,2771,1419,1352
'4514034000,  웅포면,'05,0 - 4세,1998,102,47,55
'4514034000,  웅포면,'10,5 - 9세,1998,104,60,44
'4514034000,  웅포면,'15,10 - 14세,1998,134,66,68
'4514034000,  웅포면,'20,15 - 19세,1998,221,106,115
'4514034000,  웅포면,'25,20 - 24세,1998,274,174,100
'4514034000,  웅포면,'30,25 - 29세,1998,179,119,60
'4514034000,  웅포면,'35,30 - 34세,1998,157,90,67
'4514034000,  웅포면,'40,35 - 39세,1998,151,86,65
'4514034000,  웅포면,'45,40 - 44세,1998,173,97,76
'4514034000,  웅포면,'50,45 - 49세,1998,138,83,55
'4514034000,  웅포면,'55,50 - 54세,1998,137,65,72
'4514034000,  웅포면,'60,55 - 59세,1998,194,75,119
'4514034000,  웅포면,'65,60 - 64세,1998,246,120,126
'4514034000,  웅포면,'70,65 - 69세,1998,209,88,121
'4514034000,  웅포면,'75,70 - 74세,1998,158,64,94
'4514034000,  웅포면,'80,75 - 79세,1998,117,53,64
'4514034000,  웅포면,'85,80 - 84세,1998,49,19,30
'4514034000,  웅포면,'90,85+ ,1998,28,7,21
'4514035000,  성당면,'00,계,1998,3583,1822,1761
'4514035000,  성당면,'05,0 - 4세,1998,126,66,60
'4514035000,  성당면,'10,5 - 9세,1998,128,68,60
'4514035000,  성당면,'15,10 - 14세,1998,196,100,96
'4514035000,  성당면,'20,15 - 19세,1998,334,165,169
'4514035000,  성당면,'25,20 - 24세,1998,359,197,162
'4514035000,  성당면,'30,25 - 29세,1998,280,194,86
'4514035000,  성당면,'35,30 - 34세,1998,168,100,68
'4514035000,  성당면,'40,35 - 39세,1998,232,144,88
'4514035000,  성당면,'45,40 - 44세,1998,196,107,89
'4514035000,  성당면,'50,45 - 49세,1998,180,87,93
'4514035000,  성당면,'55,50 - 54세,1998,184,96,88
'4514035000,  성당면,'60,55 - 59세,1998,266,107,159
'4514035000,  성당면,'65,60 - 64세,1998,259,121,138
'4514035000,  성당면,'70,65 - 69세,1998,261,111,150
'4514035000,  성당면,'75,70 - 74세,1998,195,87,108
'4514035000,  성당면,'80,75 - 79세,1998,127,50,77
'4514035000,  성당면,'85,80 - 84세,1998,67,17,50
'4514035000,  성당면,'90,85+ ,1998,25,5,20
'4514036000,  용안면,'00,계,1998,5210,2618,2592
'4514036000,  용안면,'05,0 - 4세,1998,169,97,72
'4514036000,  용안면,'10,5 - 9세,1998,209,115,94
'4514036000,  용안면,'15,10 - 14세,1998,290,139,151
'4514036000,  용안면,'20,15 - 19세,1998,567,281,286
'4514036000,  용안면,'25,20 - 24세,1998,606,359,247
'4514036000,  용안면,'30,25 - 29세,1998,333,217,116
'4514036000,  용안면,'35,30 - 34세,1998,222,134,88
'4514036000,  용안면,'40,35 - 39세,1998,273,127,146
'4514036000,  용안면,'45,40 - 44세,1998,372,198,174
'4514036000,  용안면,'50,45 - 49세,1998,308,141,167
'4514036000,  용안면,'55,50 - 54세,1998,275,132,143
'4514036000,  용안면,'60,55 - 59세,1998,383,188,195
'4514036000,  용안면,'65,60 - 64세,1998,340,147,193
'4514036000,  용안면,'70,65 - 69세,1998,321,140,181
'4514036000,  용안면,'75,70 - 74세,1998,232,94,138
'4514036000,  용안면,'80,75 - 79세,1998,174,67,107
'4514036000,  용안면,'85,80 - 84세,1998,85,32,53
'4514036000,  용안면,'90,85+ ,1998,51,10,41
'4514037000,  낭산면,'00,계,1998,5623,2881,2742
'4514037000,  낭산면,'05,0 - 4세,1998,285,153,132
'4514037000,  낭산면,'10,5 - 9세,1998,208,101,107
'4514037000,  낭산면,'15,10 - 14세,1998,307,160,147
'4514037000,  낭산면,'20,15 - 19세,1998,547,291,256
'4514037000,  낭산면,'25,20 - 24세,1998,598,329,269
'4514037000,  낭산면,'30,25 - 29세,1998,455,296,159
'4514037000,  낭산면,'35,30 - 34세,1998,313,187,126
'4514037000,  낭산면,'40,35 - 39세,1998,331,182,149
'4514037000,  낭산면,'45,40 - 44세,1998,330,179,151
'4514037000,  낭산면,'50,45 - 49세,1998,299,157,142
'4514037000,  낭산면,'55,50 - 54세,1998,315,143,172
'4514037000,  낭산면,'60,55 - 59세,1998,405,184,221
'4514037000,  낭산면,'65,60 - 64세,1998,427,212,215
'4514037000,  낭산면,'70,65 - 69세,1998,330,139,191
'4514037000,  낭산면,'75,70 - 74세,1998,201,78,123
'4514037000,  낭산면,'80,75 - 79세,1998,149,56,93
'4514037000,  낭산면,'85,80 - 84세,1998,75,26,49
'4514037000,  낭산면,'90,85+ ,1998,48,8,40
'4514038000,  망성면,'00,계,1998,5732,2867,2865
'4514038000,  망성면,'05,0 - 4세,1998,160,77,83
'4514038000,  망성면,'10,5 - 9세,1998,188,99,89
'4514038000,  망성면,'15,10 - 14세,1998,358,181,177
'4514038000,  망성면,'20,15 - 19세,1998,626,310,316
'4514038000,  망성면,'25,20 - 24세,1998,586,341,245
'4514038000,  망성면,'30,25 - 29세,1998,324,213,111
'4514038000,  망성면,'35,30 - 34세,1998,227,141,86
'4514038000,  망성면,'40,35 - 39세,1998,330,166,164
'4514038000,  망성면,'45,40 - 44세,1998,401,215,186
'4514038000,  망성면,'50,45 - 49세,1998,317,166,151
'4514038000,  망성면,'55,50 - 54세,1998,327,159,168
'4514038000,  망성면,'60,55 - 59세,1998,436,180,256
'4514038000,  망성면,'65,60 - 64세,1998,464,219,245
'4514038000,  망성면,'70,65 - 69세,1998,367,156,211
'4514038000,  망성면,'75,70 - 74세,1998,281,127,154
'4514038000,  망성면,'80,75 - 79세,1998,192,70,122
'4514038000,  망성면,'85,80 - 84세,1998,93,32,61
'4514038000,  망성면,'90,85+ ,1998,55,15,40
'4514039000,  여산면,'00,계,1998,5748,2888,2860
'4514039000,  여산면,'05,0 - 4세,1998,286,148,138
'4514039000,  여산면,'10,5 - 9세,1998,296,160,136
'4514039000,  여산면,'15,10 - 14세,1998,298,149,149
'4514039000,  여산면,'20,15 - 19세,1998,568,293,275
'4514039000,  여산면,'25,20 - 24세,1998,550,305,245
'4514039000,  여산면,'30,25 - 29세,1998,452,283,169
'4514039000,  여산면,'35,30 - 34세,1998,398,226,172
'4514039000,  여산면,'40,35 - 39세,1998,399,219,180
'4514039000,  여산면,'45,40 - 44세,1998,341,179,162
'4514039000,  여산면,'50,45 - 49세,1998,313,166,147
'4514039000,  여산면,'55,50 - 54세,1998,274,128,146
'4514039000,  여산면,'60,55 - 59세,1998,381,166,215
'4514039000,  여산면,'65,60 - 64세,1998,388,173,215
'4514039000,  여산면,'70,65 - 69세,1998,325,118,207
'4514039000,  여산면,'75,70 - 74세,1998,217,90,127
'4514039000,  여산면,'80,75 - 79세,1998,133,53,80
'4514039000,  여산면,'85,80 - 84세,1998,69,22,47
'4514039000,  여산면,'90,85+ ,1998,60,10,50
'4514040000,  금마면,'00,계,1998,7594,3849,3745
'4514040000,  금마면,'05,0 - 4세,1998,438,232,206
'4514040000,  금마면,'10,5 - 9세,1998,513,272,241
'4514040000,  금마면,'15,10 - 14세,1998,522,277,245
'4514040000,  금마면,'20,15 - 19세,1998,693,341,352
'4514040000,  금마면,'25,20 - 24세,1998,800,408,392
'4514040000,  금마면,'30,25 - 29세,1998,728,427,301
'4514040000,  금마면,'35,30 - 34세,1998,518,272,246
'4514040000,  금마면,'40,35 - 39세,1998,592,307,285
'4514040000,  금마면,'45,40 - 44세,1998,532,285,247
'4514040000,  금마면,'50,45 - 49세,1998,420,206,214
'4514040000,  금마면,'55,50 - 54세,1998,373,190,183
'4514040000,  금마면,'60,55 - 59세,1998,403,208,195
'4514040000,  금마면,'65,60 - 64세,1998,366,159,207
'4514040000,  금마면,'70,65 - 69세,1998,282,118,164
'4514040000,  금마면,'75,70 - 74세,1998,183,78,105
'4514040000,  금마면,'80,75 - 79세,1998,124,41,83
'4514040000,  금마면,'85,80 - 84세,1998,67,20,47
'4514040000,  금마면,'90,85+ ,1998,40,8,32
'4514041000,  왕궁면,'00,계,1998,8651,4388,4263
'4514041000,  왕궁면,'05,0 - 4세,1998,328,163,165
'4514041000,  왕궁면,'10,5 - 9세,1998,352,177,175
'4514041000,  왕궁면,'15,10 - 14세,1998,448,240,208
'4514041000,  왕궁면,'20,15 - 19세,1998,906,477,429
'4514041000,  왕궁면,'25,20 - 24세,1998,828,469,359
'4514041000,  왕궁면,'30,25 - 29세,1998,613,397,216
'4514041000,  왕궁면,'35,30 - 34세,1998,419,256,163
'4514041000,  왕궁면,'40,35 - 39세,1998,492,268,224
'4514041000,  왕궁면,'45,40 - 44세,1998,553,297,256
'4514041000,  왕궁면,'50,45 - 49세,1998,489,250,239
'4514041000,  왕궁면,'55,50 - 54세,1998,488,222,266
'4514041000,  왕궁면,'60,55 - 59세,1998,619,311,308
'4514041000,  왕궁면,'65,60 - 64세,1998,671,293,378
'4514041000,  왕궁면,'70,65 - 69세,1998,536,224,312
'4514041000,  왕궁면,'75,70 - 74세,1998,410,165,245
'4514041000,  왕궁면,'80,75 - 79세,1998,287,112,175
'4514041000,  왕궁면,'85,80 - 84세,1998,134,50,84
'4514041000,  왕궁면,'90,85+ ,1998,78,17,61
'4514042000,  춘포면,'00,계,1998,7580,3783,3797
'4514042000,  춘포면,'05,0 - 4세,1998,499,244,255
'4514042000,  춘포면,'10,5 - 9세,1998,322,165,157
'4514042000,  춘포면,'15,10 - 14세,1998,373,194,179
'4514042000,  춘포면,'20,15 - 19세,1998,609,297,312
'4514042000,  춘포면,'25,20 - 24세,1998,768,400,368
'4514042000,  춘포면,'30,25 - 29세,1998,809,502,307
'4514042000,  춘포면,'35,30 - 34세,1998,577,334,243
'4514042000,  춘포면,'40,35 - 39세,1998,479,278,201
'4514042000,  춘포면,'45,40 - 44세,1998,442,227,215
'4514042000,  춘포면,'50,45 - 49세,1998,397,190,207
'4514042000,  춘포면,'55,50 - 54세,1998,321,151,170
'4514042000,  춘포면,'60,55 - 59세,1998,472,209,263
'4514042000,  춘포면,'65,60 - 64세,1998,517,191,326
'4514042000,  춘포면,'70,65 - 69세,1998,403,171,232
'4514042000,  춘포면,'75,70 - 74세,1998,272,122,150
'4514042000,  춘포면,'80,75 - 79세,1998,188,68,120
'4514042000,  춘포면,'85,80 - 84세,1998,91,31,60
'4514042000,  춘포면,'90,85+ ,1998,41,9,32
'4514043000,  삼기면,'00,계,1998,4133,2105,2028
'4514043000,  삼기면,'05,0 - 4세,1998,196,104,92
'4514043000,  삼기면,'10,5 - 9세,1998,182,88,94
'4514043000,  삼기면,'15,10 - 14세,1998,228,116,112
'4514043000,  삼기면,'20,15 - 19세,1998,366,190,176
'4514043000,  삼기면,'25,20 - 24세,1998,454,259,195
'4514043000,  삼기면,'30,25 - 29세,1998,355,227,128
'4514043000,  삼기면,'35,30 - 34세,1998,234,145,89
'4514043000,  삼기면,'40,35 - 39세,1998,250,134,116
'4514043000,  삼기면,'45,40 - 44세,1998,236,124,112
'4514043000,  삼기면,'50,45 - 49세,1998,227,111,116
'4514043000,  삼기면,'55,50 - 54세,1998,234,114,120
'4514043000,  삼기면,'60,55 - 59세,1998,308,144,164
'4514043000,  삼기면,'65,60 - 64세,1998,286,126,160
'4514043000,  삼기면,'70,65 - 69세,1998,241,100,141
'4514043000,  삼기면,'75,70 - 74세,1998,140,70,70
'4514043000,  삼기면,'80,75 - 79세,1998,102,34,68
'4514043000,  삼기면,'85,80 - 84세,1998,56,10,46
'4514043000,  삼기면,'90,85+ ,1998,38,9,29
'4514044000,  용동면,'00,계,1998,2918,1458,1460
'4514044000,  용동면,'05,0 - 4세,1998,94,48,46
'4514044000,  용동면,'10,5 - 9세,1998,126,64,62
'4514044000,  용동면,'15,10 - 14세,1998,162,76,86
'4514044000,  용동면,'20,15 - 19세,1998,264,133,131
'4514044000,  용동면,'25,20 - 24세,1998,298,181,117
'4514044000,  용동면,'30,25 - 29세,1998,206,141,65
'4514044000,  용동면,'35,30 - 34세,1998,139,85,54
'4514044000,  용동면,'40,35 - 39세,1998,160,82,78
'4514044000,  용동면,'45,40 - 44세,1998,179,93,86
'4514044000,  용동면,'50,45 - 49세,1998,178,87,91
'4514044000,  용동면,'55,50 - 54세,1998,164,74,90
'4514044000,  용동면,'60,55 - 59세,1998,241,110,131
'4514044000,  용동면,'65,60 - 64세,1998,209,95,114
'4514044000,  용동면,'70,65 - 69세,1998,207,89,118
'4514044000,  용동면,'75,70 - 74세,1998,129,54,75
'4514044000,  용동면,'80,75 - 79세,1998,86,28,58
'4514044000,  용동면,'85,80 - 84세,1998,52,11,41
'4514044000,  용동면,'90,85+ ,1998,24,7,17
'4514052000,  중앙동,'00,계,1998,7943,3926,4017
'4514052000,  중앙동,'05,0 - 4세,1998,377,188,189
'4514052000,  중앙동,'10,5 - 9세,1998,439,229,210
'4514052000,  중앙동,'15,10 - 14세,1998,492,248,244
'4514052000,  중앙동,'20,15 - 19세,1998,783,419,364
'4514052000,  중앙동,'25,20 - 24세,1998,886,464,422
'4514052000,  중앙동,'30,25 - 29세,1998,676,379,297
'4514052000,  중앙동,'35,30 - 34세,1998,517,272,245
'4514052000,  중앙동,'40,35 - 39세,1998,549,252,297
'4514052000,  중앙동,'45,40 - 44세,1998,648,321,327
'4514052000,  중앙동,'50,45 - 49세,1998,554,256,298
'4514052000,  중앙동,'55,50 - 54세,1998,503,221,282
'4514052000,  중앙동,'60,55 - 59세,1998,462,228,234
'4514052000,  중앙동,'65,60 - 64세,1998,378,179,199
'4514052000,  중앙동,'70,65 - 69세,1998,284,123,161
'4514052000,  중앙동,'75,70 - 74세,1998,196,82,114
'4514052000,  중앙동,'80,75 - 79세,1998,95,34,61
'4514052000,  중앙동,'85,80 - 84세,1998,60,24,36
'4514052000,  중앙동,'90,85+ ,1998,44,7,37
'4514053000,  평화동,'00,계,1998,5565,2769,2796
'4514053000,  평화동,'05,0 - 4세,1998,341,170,171
'4514053000,  평화동,'10,5 - 9세,1998,326,155,171
'4514053000,  평화동,'15,10 - 14세,1998,331,174,157
'4514053000,  평화동,'20,15 - 19세,1998,561,304,257
'4514053000,  평화동,'25,20 - 24세,1998,611,313,298
'4514053000,  평화동,'30,25 - 29세,1998,517,271,246
'4514053000,  평화동,'35,30 - 34세,1998,395,217,178
'4514053000,  평화동,'40,35 - 39세,1998,407,206,201
'4514053000,  평화동,'45,40 - 44세,1998,425,216,209
'4514053000,  평화동,'50,45 - 49세,1998,364,170,194
'4514053000,  평화동,'55,50 - 54세,1998,300,162,138
'4514053000,  평화동,'60,55 - 59세,1998,285,130,155
'4514053000,  평화동,'65,60 - 64세,1998,257,117,140
'4514053000,  평화동,'70,65 - 69세,1998,176,72,104
'4514053000,  평화동,'75,70 - 74세,1998,139,60,79
'4514053000,  평화동,'80,75 - 79세,1998,69,20,49
'4514053000,  평화동,'85,80 - 84세,1998,38,8,30
'4514053000,  평화동,'90,85+ ,1998,23,4,19
'4514056000,  인화동,'00,계,1998,11945,5832,6113
'4514056000,  인화동,'05,0 - 4세,1998,749,381,368
'4514056000,  인화동,'10,5 - 9세,1998,695,335,360
'4514056000,  인화동,'15,10 - 14세,1998,787,404,383
'4514056000,  인화동,'20,15 - 19세,1998,1276,640,636
'4514056000,  인화동,'25,20 - 24세,1998,1248,630,618
'4514056000,  인화동,'30,25 - 29세,1998,1094,577,517
'4514056000,  인화동,'35,30 - 34세,1998,838,420,418
'4514056000,  인화동,'40,35 - 39세,1998,870,445,425
'4514056000,  인화동,'45,40 - 44세,1998,898,427,471
'4514056000,  인화동,'50,45 - 49세,1998,785,367,418
'4514056000,  인화동,'55,50 - 54세,1998,671,336,335
'4514056000,  인화동,'60,55 - 59세,1998,650,311,339
'4514056000,  인화동,'65,60 - 64세,1998,498,227,271
'4514056000,  인화동,'70,65 - 69세,1998,346,162,184
'4514056000,  인화동,'75,70 - 74세,1998,226,82,144
'4514056000,  인화동,'80,75 - 79세,1998,171,57,114
'4514056000,  인화동,'85,80 - 84세,1998,89,23,66
'4514056000,  인화동,'90,85+ ,1998,54,8,46
'4514057000,  동산동,'00,계,1998,28992,14284,14708
'4514057000,  동산동,'05,0 - 4세,1998,2485,1277,1208
'4514057000,  동산동,'10,5 - 9세,1998,2435,1282,1153
'4514057000,  동산동,'15,10 - 14세,1998,2410,1249,1161
'4514057000,  동산동,'20,15 - 19세,1998,2717,1372,1345
'4514057000,  동산동,'25,20 - 24세,1998,2478,1246,1232
'4514057000,  동산동,'30,25 - 29세,1998,2712,1336,1376
'4514057000,  동산동,'35,30 - 34세,1998,2644,1315,1329
'4514057000,  동산동,'40,35 - 39세,1998,2897,1434,1463
'4514057000,  동산동,'45,40 - 44세,1998,2198,1109,1089
'4514057000,  동산동,'50,45 - 49세,1998,1505,780,725
'4514057000,  동산동,'55,50 - 54세,1998,1070,552,518
'4514057000,  동산동,'60,55 - 59세,1998,1001,454,547
'4514057000,  동산동,'65,60 - 64세,1998,850,367,483
'4514057000,  동산동,'70,65 - 69세,1998,660,251,409
'4514057000,  동산동,'75,70 - 74세,1998,398,126,272
'4514057000,  동산동,'80,75 - 79세,1998,289,91,198
'4514057000,  동산동,'85,80 - 84세,1998,150,30,120
'4514057000,  동산동,'90,85+ ,1998,93,13,80
'4514058000,  마동,'00,계,1998,15669,7785,7884
'4514058000,  마동,'05,0 - 4세,1998,1349,712,637
'4514058000,  마동,'10,5 - 9세,1998,1175,593,582
'4514058000,  마동,'15,10 - 14세,1998,1151,596,555
'4514058000,  마동,'20,15 - 19세,1998,1604,801,803
'4514058000,  마동,'25,20 - 24세,1998,1384,726,658
'4514058000,  마동,'30,25 - 29세,1998,1513,736,777
'4514058000,  마동,'35,30 - 34세,1998,1450,733,717
'4514058000,  마동,'40,35 - 39세,1998,1468,723,745
'4514058000,  마동,'45,40 - 44세,1998,1289,654,635
'4514058000,  마동,'50,45 - 49세,1998,816,433,383
'4514058000,  마동,'55,50 - 54세,1998,640,336,304
'4514058000,  마동,'60,55 - 59세,1998,609,291,318
'4514058000,  마동,'65,60 - 64세,1998,455,206,249
'4514058000,  마동,'70,65 - 69세,1998,291,109,182
'4514058000,  마동,'75,70 - 74세,1998,215,78,137
'4514058000,  마동,'80,75 - 79세,1998,154,37,117
'4514058000,  마동,'85,80 - 84세,1998,57,13,44
'4514058000,  마동,'90,85+ ,1998,49,8,41
'4514059500,  남중동,'00,계,1998,22059,10923,11136
'4514059500,  남중동,'05,0 - 4세,1998,1269,680,589
'4514059500,  남중동,'10,5 - 9세,1998,1341,715,626
'4514059500,  남중동,'15,10 - 14세,1998,1430,715,715
'4514059500,  남중동,'20,15 - 19세,1998,2272,1193,1079
'4514059500,  남중동,'25,20 - 24세,1998,2605,1310,1295
'4514059500,  남중동,'30,25 - 29세,1998,2120,1130,990
'4514059500,  남중동,'35,30 - 34세,1998,1463,759,704
'4514059500,  남중동,'40,35 - 39세,1998,1507,723,784
'4514059500,  남중동,'45,40 - 44세,1998,1591,729,862
'4514059500,  남중동,'50,45 - 49세,1998,1449,673,776
'4514059500,  남중동,'55,50 - 54세,1998,1305,619,686
'4514059500,  남중동,'60,55 - 59세,1998,1285,661,624
'4514059500,  남중동,'65,60 - 64세,1998,894,466,428
'4514059500,  남중동,'70,65 - 69세,1998,569,256,313
'4514059500,  남중동,'75,70 - 74세,1998,402,159,243
'4514059500,  남중동,'80,75 - 79세,1998,294,79,215
'4514059500,  남중동,'85,80 - 84세,1998,148,37,111
'4514059500,  남중동,'90,85+ ,1998,115,19,96
'4514061000,  모현동,'00,계,1998,34638,17021,17617
'4514061000,  모현동,'05,0 - 4세,1998,3119,1651,1468
'4514061000,  모현동,'10,5 - 9세,1998,3235,1657,1578
'4514061000,  모현동,'15,10 - 14세,1998,2691,1328,1363
'4514061000,  모현동,'20,15 - 19세,1998,3014,1503,1511
'4514061000,  모현동,'25,20 - 24세,1998,2676,1399,1277
'4514061000,  모현동,'30,25 - 29세,1998,3001,1394,1607
'4514061000,  모현동,'35,30 - 34세,1998,3381,1604,1777
'4514061000,  모현동,'40,35 - 39세,1998,3710,1901,1809
'4514061000,  모현동,'45,40 - 44세,1998,2701,1389,1312
'4514061000,  모현동,'50,45 - 49세,1998,1774,935,839
'4514061000,  모현동,'55,50 - 54세,1998,1266,647,619
'4514061000,  모현동,'60,55 - 59세,1998,1137,502,635
'4514061000,  모현동,'65,60 - 64세,1998,1019,462,557
'4514061000,  모현동,'70,65 - 69세,1998,754,280,474
'4514061000,  모현동,'75,70 - 74세,1998,489,180,309
'4514061000,  모현동,'80,75 - 79세,1998,396,120,276
'4514061000,  모현동,'85,80 - 84세,1998,185,52,133
'4514061000,  모현동,'90,85+ ,1998,90,17,73
'4514062000,  송학동,'00,계,1998,7623,3812,3811
'4514062000,  송학동,'05,0 - 4세,1998,465,252,213
'4514062000,  송학동,'10,5 - 9세,1998,554,300,254
'4514062000,  송학동,'15,10 - 14세,1998,563,279,284
'4514062000,  송학동,'20,15 - 19세,1998,741,369,372
'4514062000,  송학동,'25,20 - 24세,1998,732,393,339
'4514062000,  송학동,'30,25 - 29세,1998,665,357,308
'4514062000,  송학동,'35,30 - 34세,1998,566,292,274
'4514062000,  송학동,'40,35 - 39세,1998,682,334,348
'4514062000,  송학동,'45,40 - 44세,1998,579,297,282
'4514062000,  송학동,'50,45 - 49세,1998,421,211,210
'4514062000,  송학동,'55,50 - 54세,1998,398,195,203
'4514062000,  송학동,'60,55 - 59세,1998,393,200,193
'4514062000,  송학동,'65,60 - 64세,1998,280,127,153
'4514062000,  송학동,'70,65 - 69세,1998,226,89,137
'4514062000,  송학동,'75,70 - 74세,1998,163,67,96
'4514062000,  송학동,'80,75 - 79세,1998,92,28,64
'4514062000,  송학동,'85,80 - 84세,1998,65,17,48
'4514062000,  송학동,'90,85+ ,1998,38,5,33
'4514064500,  영등동,'00,계,1998,51720,25717,26003
'4514064500,  영등동,'05,0 - 4세,1998,5633,2928,2705
'4514064500,  영등동,'10,5 - 9세,1998,5516,2921,2595
'4514064500,  영등동,'15,10 - 14세,1998,4406,2277,2129
'4514064500,  영등동,'20,15 - 19세,1998,4080,2065,2015
'4514064500,  영등동,'25,20 - 24세,1998,3329,1576,1753
'4514064500,  영등동,'30,25 - 29세,1998,5310,2361,2949
'4514064500,  영등동,'35,30 - 34세,1998,6063,2983,3080
'4514064500,  영등동,'40,35 - 39세,1998,5904,3028,2876
'4514064500,  영등동,'45,40 - 44세,1998,4010,2161,1849
'4514064500,  영등동,'50,45 - 49세,1998,2194,1209,985
'4514064500,  영등동,'55,50 - 54세,1998,1441,780,661
'4514064500,  영등동,'60,55 - 59세,1998,1068,508,560
'4514064500,  영등동,'65,60 - 64세,1998,863,335,528
'4514064500,  영등동,'70,65 - 69세,1998,735,245,490
'4514064500,  영등동,'75,70 - 74세,1998,525,184,341
'4514064500,  영등동,'80,75 - 79세,1998,346,91,255
'4514064500,  영등동,'85,80 - 84세,1998,195,51,144
'4514064500,  영등동,'90,85+ ,1998,102,14,88
'4514065600,  신동,'00,계,1998,21776,10758,11018
'4514065600,  신동,'05,0 - 4세,1998,1298,683,615
'4514065600,  신동,'10,5 - 9세,1998,1357,723,634
'4514065600,  신동,'15,10 - 14세,1998,1501,778,723
'4514065600,  신동,'20,15 - 19세,1998,2181,1118,1063
'4514065600,  신동,'25,20 - 24세,1998,2681,1393,1288
'4514065600,  신동,'30,25 - 29세,1998,2260,1245,1015
'4514065600,  신동,'35,30 - 34세,1998,1632,820,812
'4514065600,  신동,'40,35 - 39세,1998,1667,790,877
'4514065600,  신동,'45,40 - 44세,1998,1556,731,825
'4514065600,  신동,'50,45 - 49세,1998,1272,598,674
'4514065600,  신동,'55,50 - 54세,1998,1114,563,551
'4514065600,  신동,'60,55 - 59세,1998,931,438,493
'4514065600,  신동,'65,60 - 64세,1998,780,377,403
'4514065600,  신동,'70,65 - 69세,1998,555,222,333
'4514065600,  신동,'75,70 - 74세,1998,393,141,252
'4514065600,  신동,'80,75 - 79세,1998,292,84,208
'4514065600,  신동,'85,80 - 84세,1998,183,34,149
'4514065600,  신동,'90,85+ ,1998,123,20,103
'4514067000,  팔봉동,'00,계,1998,5364,2694,2670
'4514067000,  팔봉동,'05,0 - 4세,1998,305,154,151
'4514067000,  팔봉동,'10,5 - 9세,1998,290,159,131
'4514067000,  팔봉동,'15,10 - 14세,1998,346,174,172
'4514067000,  팔봉동,'20,15 - 19세,1998,551,248,303
'4514067000,  팔봉동,'25,20 - 24세,1998,542,302,240
'4514067000,  팔봉동,'30,25 - 29세,1998,529,312,217
'4514067000,  팔봉동,'35,30 - 34세,1998,392,227,165
'4514067000,  팔봉동,'40,35 - 39세,1998,384,213,171
'4514067000,  팔봉동,'45,40 - 44세,1998,325,170,155
'4514067000,  팔봉동,'50,45 - 49세,1998,274,156,118
'4514067000,  팔봉동,'55,50 - 54세,1998,248,126,122
'4514067000,  팔봉동,'60,55 - 59세,1998,300,140,160
'4514067000,  팔봉동,'65,60 - 64세,1998,267,115,152
'4514067000,  팔봉동,'70,65 - 69세,1998,235,80,155
'4514067000,  팔봉동,'75,70 - 74세,1998,166,61,105
'4514067000,  팔봉동,'80,75 - 79세,1998,106,34,72
'4514067000,  팔봉동,'85,80 - 84세,1998,63,16,47
'4514067000,  팔봉동,'90,85+ ,1998,41,7,34
'4514069000,  삼성동,'00,계,1998,27811,13713,14098
'4514069000,  삼성동,'05,0 - 4세,1998,3561,1820,1741
'4514069000,  삼성동,'10,5 - 9세,1998,3187,1602,1585
'4514069000,  삼성동,'15,10 - 14세,1998,2031,1046,985
'4514069000,  삼성동,'20,15 - 19세,1998,1718,850,868
'4514069000,  삼성동,'25,20 - 24세,1998,1632,795,837
'4514069000,  삼성동,'30,25 - 29세,1998,3082,1284,1798
'4514069000,  삼성동,'35,30 - 34세,1998,4011,2018,1993
'4514069000,  삼성동,'40,35 - 39세,1998,3100,1725,1375
'4514069000,  삼성동,'45,40 - 44세,1998,1659,910,749
'4514069000,  삼성동,'50,45 - 49세,1998,967,532,435
'4514069000,  삼성동,'55,50 - 54세,1998,632,336,296
'4514069000,  삼성동,'60,55 - 59세,1998,566,228,338
'4514069000,  삼성동,'65,60 - 64세,1998,540,189,351
'4514069000,  삼성동,'70,65 - 69세,1998,441,157,284
'4514069000,  삼성동,'75,70 - 74세,1998,307,106,201
'4514069000,  삼성동,'80,75 - 79세,1998,197,70,127
'4514069000,  삼성동,'85,80 - 84세,1998,116,38,78
'4514069000,  삼성동,'90,85+ ,1998,64,7,57
'45180, 정읍시,'00,계,1998,150505,74241,76264
'45180, 정읍시,'05,0 - 4세,1998,9455,4879,4576
'45180, 정읍시,'10,5 - 9세,1998,8944,4688,4256
'45180, 정읍시,'15,10 - 14세,1998,9407,4770,4637
'45180, 정읍시,'20,15 - 19세,1998,14219,7162,7057
'45180, 정읍시,'25,20 - 24세,1998,14855,8085,6770
'45180, 정읍시,'30,25 - 29세,1998,12249,6819,5430
'45180, 정읍시,'35,30 - 34세,1998,10205,5431,4774
'45180, 정읍시,'40,35 - 39세,1998,10426,5519,4907
'45180, 정읍시,'45,40 - 44세,1998,9287,4816,4471
'45180, 정읍시,'50,45 - 49세,1998,7406,3611,3795
'45180, 정읍시,'55,50 - 54세,1998,7487,3653,3834
'45180, 정읍시,'60,55 - 59세,1998,9204,4065,5139
'45180, 정읍시,'65,60 - 64세,1998,8941,3816,5125
'45180, 정읍시,'70,65 - 69세,1998,6968,2847,4121
'45180, 정읍시,'75,70 - 74세,1998,4889,2024,2865
'45180, 정읍시,'80,75 - 79세,1998,3655,1295,2360
'45180, 정읍시,'85,80 - 84세,1998,1758,523,1235
'45180, 정읍시,'90,85+ ,1998,1150,238,912
'4518025000,  신태인읍,'00,계,1998,10404,5160,5244
'4518025000,  신태인읍,'05,0 - 4세,1998,488,250,238
'4518025000,  신태인읍,'10,5 - 9세,1998,541,281,260
'4518025000,  신태인읍,'15,10 - 14세,1998,603,320,283
'4518025000,  신태인읍,'20,15 - 19세,1998,1037,540,497
'4518025000,  신태인읍,'25,20 - 24세,1998,1039,573,466
'4518025000,  신태인읍,'30,25 - 29세,1998,769,480,289
'4518025000,  신태인읍,'35,30 - 34세,1998,580,301,279
'4518025000,  신태인읍,'40,35 - 39세,1998,667,361,306
'4518025000,  신태인읍,'45,40 - 44세,1998,601,319,282
'4518025000,  신태인읍,'50,45 - 49세,1998,523,252,271
'4518025000,  신태인읍,'55,50 - 54세,1998,562,263,299
'4518025000,  신태인읍,'60,55 - 59세,1998,735,326,409
'4518025000,  신태인읍,'65,60 - 64세,1998,723,292,431
'4518025000,  신태인읍,'70,65 - 69세,1998,614,266,348
'4518025000,  신태인읍,'75,70 - 74세,1998,413,173,240
'4518025000,  신태인읍,'80,75 - 79세,1998,295,105,190
'4518025000,  신태인읍,'85,80 - 84세,1998,127,42,85
'4518025000,  신태인읍,'90,85+ ,1998,87,16,71
'4518031000,  북면,'00,계,1998,7059,3446,3613
'4518031000,  북면,'05,0 - 4세,1998,570,282,288
'4518031000,  북면,'10,5 - 9세,1998,382,209,173
'4518031000,  북면,'15,10 - 14세,1998,444,203,241
'4518031000,  북면,'20,15 - 19세,1998,633,290,343
'4518031000,  북면,'25,20 - 24세,1998,648,336,312
'4518031000,  북면,'30,25 - 29세,1998,629,330,299
'4518031000,  북면,'35,30 - 34세,1998,534,316,218
'4518031000,  북면,'40,35 - 39세,1998,468,251,217
'4518031000,  북면,'45,40 - 44세,1998,404,219,185
'4518031000,  북면,'50,45 - 49세,1998,307,150,157
'4518031000,  북면,'55,50 - 54세,1998,296,142,154
'4518031000,  북면,'60,55 - 59세,1998,422,192,230
'4518031000,  북면,'65,60 - 64세,1998,453,187,266
'4518031000,  북면,'70,65 - 69세,1998,329,140,189
'4518031000,  북면,'75,70 - 74세,1998,248,103,145
'4518031000,  북면,'80,75 - 79세,1998,166,63,103
'4518031000,  북면,'85,80 - 84세,1998,77,20,57
'4518031000,  북면,'90,85+ ,1998,49,13,36
'4518032000,  입암면,'00,계,1998,5131,2553,2578
'4518032000,  입암면,'05,0 - 4세,1998,214,117,97
'4518032000,  입암면,'10,5 - 9세,1998,242,130,112
'4518032000,  입암면,'15,10 - 14세,1998,283,152,131
'4518032000,  입암면,'20,15 - 19세,1998,489,243,246
'4518032000,  입암면,'25,20 - 24세,1998,529,289,240
'4518032000,  입암면,'30,25 - 29세,1998,333,226,107
'4518032000,  입암면,'35,30 - 34세,1998,260,149,111
'4518032000,  입암면,'40,35 - 39세,1998,295,166,129
'4518032000,  입암면,'45,40 - 44세,1998,294,151,143
'4518032000,  입암면,'50,45 - 49세,1998,252,128,124
'4518032000,  입암면,'55,50 - 54세,1998,268,120,148
'4518032000,  입암면,'60,55 - 59세,1998,403,182,221
'4518032000,  입암면,'65,60 - 64세,1998,432,176,256
'4518032000,  입암면,'70,65 - 69세,1998,294,128,166
'4518032000,  입암면,'75,70 - 74세,1998,247,102,145
'4518032000,  입암면,'80,75 - 79세,1998,168,62,106
'4518032000,  입암면,'85,80 - 84세,1998,84,25,59
'4518032000,  입암면,'90,85+ ,1998,44,7,37
'4518033000,  소성면,'00,계,1998,3712,1838,1874
'4518033000,  소성면,'05,0 - 4세,1998,127,71,56
'4518033000,  소성면,'10,5 - 9세,1998,128,67,61
'4518033000,  소성면,'15,10 - 14세,1998,144,77,67
'4518033000,  소성면,'20,15 - 19세,1998,306,148,158
'4518033000,  소성면,'25,20 - 24세,1998,414,251,163
'4518033000,  소성면,'30,25 - 29세,1998,289,193,96
'4518033000,  소성면,'35,30 - 34세,1998,171,108,63
'4518033000,  소성면,'40,35 - 39세,1998,173,99,74
'4518033000,  소성면,'45,40 - 44세,1998,173,87,86
'4518033000,  소성면,'50,45 - 49세,1998,173,80,93
'4518033000,  소성면,'55,50 - 54세,1998,224,113,111
'4518033000,  소성면,'60,55 - 59세,1998,322,132,190
'4518033000,  소성면,'65,60 - 64세,1998,355,153,202
'4518033000,  소성면,'70,65 - 69세,1998,273,106,167
'4518033000,  소성면,'75,70 - 74세,1998,172,70,102
'4518033000,  소성면,'80,75 - 79세,1998,139,48,91
'4518033000,  소성면,'85,80 - 84세,1998,75,23,52
'4518033000,  소성면,'90,85+ ,1998,54,12,42
'4518034000,  고부면,'00,계,1998,5177,2584,2593
'4518034000,  고부면,'05,0 - 4세,1998,187,100,87
'4518034000,  고부면,'10,5 - 9세,1998,176,94,82
'4518034000,  고부면,'15,10 - 14세,1998,271,137,134
'4518034000,  고부면,'20,15 - 19세,1998,494,272,222
'4518034000,  고부면,'25,20 - 24세,1998,541,322,219
'4518034000,  고부면,'30,25 - 29세,1998,387,244,143
'4518034000,  고부면,'35,30 - 34세,1998,223,138,85
'4518034000,  고부면,'40,35 - 39세,1998,250,137,113
'4518034000,  고부면,'45,40 - 44세,1998,267,148,119
'4518034000,  고부면,'50,45 - 49세,1998,243,106,137
'4518034000,  고부면,'55,50 - 54세,1998,337,167,170
'4518034000,  고부면,'60,55 - 59세,1998,419,167,252
'4518034000,  고부면,'65,60 - 64세,1998,429,189,240
'4518034000,  고부면,'70,65 - 69세,1998,356,140,216
'4518034000,  고부면,'75,70 - 74세,1998,257,111,146
'4518034000,  고부면,'80,75 - 79세,1998,178,68,110
'4518034000,  고부면,'85,80 - 84세,1998,96,33,63
'4518034000,  고부면,'90,85+ ,1998,66,11,55
'4518035000,  영원면,'00,계,1998,3377,1642,1735
'4518035000,  영원면,'05,0 - 4세,1998,106,52,54
'4518035000,  영원면,'10,5 - 9세,1998,111,66,45
'4518035000,  영원면,'15,10 - 14세,1998,182,93,89
'4518035000,  영원면,'20,15 - 19세,1998,306,156,150
'4518035000,  영원면,'25,20 - 24세,1998,334,194,140
'4518035000,  영원면,'30,25 - 29세,1998,213,129,84
'4518035000,  영원면,'35,30 - 34세,1998,140,86,54
'4518035000,  영원면,'40,35 - 39세,1998,160,79,81
'4518035000,  영원면,'45,40 - 44세,1998,177,99,78
'4518035000,  영원면,'50,45 - 49세,1998,186,99,87
'4518035000,  영원면,'55,50 - 54세,1998,201,92,109
'4518035000,  영원면,'60,55 - 59세,1998,287,126,161
'4518035000,  영원면,'65,60 - 64세,1998,304,126,178
'4518035000,  영원면,'70,65 - 69세,1998,281,106,175
'4518035000,  영원면,'75,70 - 74세,1998,149,55,94
'4518035000,  영원면,'80,75 - 79세,1998,133,51,82
'4518035000,  영원면,'85,80 - 84세,1998,60,17,43
'4518035000,  영원면,'90,85+ ,1998,47,16,31
'4518036000,  덕천면,'00,계,1998,3273,1621,1652
'4518036000,  덕천면,'05,0 - 4세,1998,138,77,61
'4518036000,  덕천면,'10,5 - 9세,1998,137,78,59
'4518036000,  덕천면,'15,10 - 14세,1998,198,94,104
'4518036000,  덕천면,'20,15 - 19세,1998,267,135,132
'4518036000,  덕천면,'25,20 - 24세,1998,350,197,153
'4518036000,  덕천면,'30,25 - 29세,1998,223,136,87
'4518036000,  덕천면,'35,30 - 34세,1998,192,114,78
'4518036000,  덕천면,'40,35 - 39세,1998,183,99,84
'4518036000,  덕천면,'45,40 - 44세,1998,169,97,72
'4518036000,  덕천면,'50,45 - 49세,1998,163,80,83
'4518036000,  덕천면,'55,50 - 54세,1998,190,84,106
'4518036000,  덕천면,'60,55 - 59세,1998,234,97,137
'4518036000,  덕천면,'65,60 - 64세,1998,273,116,157
'4518036000,  덕천면,'70,65 - 69세,1998,220,91,129
'4518036000,  덕천면,'75,70 - 74세,1998,138,64,74
'4518036000,  덕천면,'80,75 - 79세,1998,99,38,61
'4518036000,  덕천면,'85,80 - 84세,1998,57,21,36
'4518036000,  덕천면,'90,85+ ,1998,42,3,39
'4518037000,  이평면,'00,계,1998,4336,2164,2172
'4518037000,  이평면,'05,0 - 4세,1998,169,92,77
'4518037000,  이평면,'10,5 - 9세,1998,171,90,81
'4518037000,  이평면,'15,10 - 14세,1998,193,101,92
'4518037000,  이평면,'20,15 - 19세,1998,384,181,203
'4518037000,  이평면,'25,20 - 24세,1998,445,282,163
'4518037000,  이평면,'30,25 - 29세,1998,297,199,98
'4518037000,  이평면,'35,30 - 34세,1998,199,118,81
'4518037000,  이평면,'40,35 - 39세,1998,207,123,84
'4518037000,  이평면,'45,40 - 44세,1998,209,111,98
'4518037000,  이평면,'50,45 - 49세,1998,176,85,91
'4518037000,  이평면,'55,50 - 54세,1998,241,105,136
'4518037000,  이평면,'60,55 - 59세,1998,375,157,218
'4518037000,  이평면,'65,60 - 64세,1998,405,177,228
'4518037000,  이평면,'70,65 - 69세,1998,339,140,199
'4518037000,  이평면,'75,70 - 74세,1998,222,113,109
'4518037000,  이평면,'80,75 - 79세,1998,171,60,111
'4518037000,  이평면,'85,80 - 84세,1998,68,17,51
'4518037000,  이평면,'90,85+ ,1998,65,13,52
'4518038000,  정우면,'00,계,1998,4686,2331,2355
'4518038000,  정우면,'05,0 - 4세,1998,190,101,89
'4518038000,  정우면,'10,5 - 9세,1998,187,89,98
'4518038000,  정우면,'15,10 - 14세,1998,246,115,131
'4518038000,  정우면,'20,15 - 19세,1998,450,251,199
'4518038000,  정우면,'25,20 - 24세,1998,460,265,195
'4518038000,  정우면,'30,25 - 29세,1998,331,207,124
'4518038000,  정우면,'35,30 - 34세,1998,206,128,78
'4518038000,  정우면,'40,35 - 39세,1998,244,130,114
'4518038000,  정우면,'45,40 - 44세,1998,281,160,121
'4518038000,  정우면,'50,45 - 49세,1998,226,107,119
'4518038000,  정우면,'55,50 - 54세,1998,258,126,132
'4518038000,  정우면,'60,55 - 59세,1998,392,166,226
'4518038000,  정우면,'65,60 - 64세,1998,387,168,219
'4518038000,  정우면,'70,65 - 69세,1998,305,126,179
'4518038000,  정우면,'75,70 - 74세,1998,217,91,126
'4518038000,  정우면,'80,75 - 79세,1998,175,63,112
'4518038000,  정우면,'85,80 - 84세,1998,87,27,60
'4518038000,  정우면,'90,85+ ,1998,44,11,33
'4518039000,  태인면,'00,계,1998,6411,3167,3244
'4518039000,  태인면,'05,0 - 4세,1998,269,145,124
'4518039000,  태인면,'10,5 - 9세,1998,258,130,128
'4518039000,  태인면,'15,10 - 14세,1998,335,176,159
'4518039000,  태인면,'20,15 - 19세,1998,622,300,322
'4518039000,  태인면,'25,20 - 24세,1998,707,413,294
'4518039000,  태인면,'30,25 - 29세,1998,426,262,164
'4518039000,  태인면,'35,30 - 34세,1998,317,178,139
'4518039000,  태인면,'40,35 - 39세,1998,341,201,140
'4518039000,  태인면,'45,40 - 44세,1998,354,184,170
'4518039000,  태인면,'50,45 - 49세,1998,328,154,174
'4518039000,  태인면,'55,50 - 54세,1998,347,158,189
'4518039000,  태인면,'60,55 - 59세,1998,502,227,275
'4518039000,  태인면,'65,60 - 64세,1998,525,230,295
'4518039000,  태인면,'70,65 - 69세,1998,397,165,232
'4518039000,  태인면,'75,70 - 74세,1998,281,126,155
'4518039000,  태인면,'80,75 - 79세,1998,213,74,139
'4518039000,  태인면,'85,80 - 84세,1998,120,31,89
'4518039000,  태인면,'90,85+ ,1998,69,13,56
'4518040000,  감곡면,'00,계,1998,5394,2657,2737
'4518040000,  감곡면,'05,0 - 4세,1998,154,77,77
'4518040000,  감곡면,'10,5 - 9세,1998,157,78,79
'4518040000,  감곡면,'15,10 - 14세,1998,280,134,146
'4518040000,  감곡면,'20,15 - 19세,1998,534,272,262
'4518040000,  감곡면,'25,20 - 24세,1998,544,317,227
'4518040000,  감곡면,'30,25 - 29세,1998,339,237,102
'4518040000,  감곡면,'35,30 - 34세,1998,183,118,65
'4518040000,  감곡면,'40,35 - 39세,1998,257,134,123
'4518040000,  감곡면,'45,40 - 44세,1998,310,148,162
'4518040000,  감곡면,'50,45 - 49세,1998,311,151,160
'4518040000,  감곡면,'55,50 - 54세,1998,326,169,157
'4518040000,  감곡면,'60,55 - 59세,1998,425,181,244
'4518040000,  감곡면,'65,60 - 64세,1998,494,210,284
'4518040000,  감곡면,'70,65 - 69세,1998,396,172,224
'4518040000,  감곡면,'75,70 - 74세,1998,339,150,189
'4518040000,  감곡면,'80,75 - 79세,1998,200,67,133
'4518040000,  감곡면,'85,80 - 84세,1998,88,32,56
'4518040000,  감곡면,'90,85+ ,1998,57,10,47
'4518041000,  옹동면,'00,계,1998,3120,1548,1572
'4518041000,  옹동면,'05,0 - 4세,1998,90,47,43
'4518041000,  옹동면,'10,5 - 9세,1998,118,60,58
'4518041000,  옹동면,'15,10 - 14세,1998,152,72,80
'4518041000,  옹동면,'20,15 - 19세,1998,303,169,134
'4518041000,  옹동면,'25,20 - 24세,1998,356,198,158
'4518041000,  옹동면,'30,25 - 29세,1998,189,132,57
'4518041000,  옹동면,'35,30 - 34세,1998,118,60,58
'4518041000,  옹동면,'40,35 - 39세,1998,146,84,62
'4518041000,  옹동면,'45,40 - 44세,1998,178,87,91
'4518041000,  옹동면,'50,45 - 49세,1998,161,80,81
'4518041000,  옹동면,'55,50 - 54세,1998,194,97,97
'4518041000,  옹동면,'60,55 - 59세,1998,251,115,136
'4518041000,  옹동면,'65,60 - 64세,1998,254,111,143
'4518041000,  옹동면,'70,65 - 69세,1998,226,91,135
'4518041000,  옹동면,'75,70 - 74세,1998,159,61,98
'4518041000,  옹동면,'80,75 - 79세,1998,132,51,81
'4518041000,  옹동면,'85,80 - 84세,1998,59,24,35
'4518041000,  옹동면,'90,85+ ,1998,34,9,25
'4518042000,  칠보면,'00,계,1998,4084,2031,2053
'4518042000,  칠보면,'05,0 - 4세,1998,176,96,80
'4518042000,  칠보면,'10,5 - 9세,1998,165,83,82
'4518042000,  칠보면,'15,10 - 14세,1998,204,107,97
'4518042000,  칠보면,'20,15 - 19세,1998,356,193,163
'4518042000,  칠보면,'25,20 - 24세,1998,425,243,182
'4518042000,  칠보면,'30,25 - 29세,1998,299,188,111
'4518042000,  칠보면,'35,30 - 34세,1998,203,120,83
'4518042000,  칠보면,'40,35 - 39세,1998,229,126,103
'4518042000,  칠보면,'45,40 - 44세,1998,220,119,101
'4518042000,  칠보면,'50,45 - 49세,1998,156,74,82
'4518042000,  칠보면,'55,50 - 54세,1998,241,115,126
'4518042000,  칠보면,'60,55 - 59세,1998,348,154,194
'4518042000,  칠보면,'65,60 - 64세,1998,358,145,213
'4518042000,  칠보면,'70,65 - 69세,1998,257,107,150
'4518042000,  칠보면,'75,70 - 74세,1998,181,75,106
'4518042000,  칠보면,'80,75 - 79세,1998,162,66,96
'4518042000,  칠보면,'85,80 - 84세,1998,59,10,49
'4518042000,  칠보면,'90,85+ ,1998,45,10,35
'4518043000,  산내면,'00,계,1998,2169,1068,1101
'4518043000,  산내면,'05,0 - 4세,1998,79,36,43
'4518043000,  산내면,'10,5 - 9세,1998,60,31,29
'4518043000,  산내면,'15,10 - 14세,1998,101,47,54
'4518043000,  산내면,'20,15 - 19세,1998,204,107,97
'4518043000,  산내면,'25,20 - 24세,1998,250,145,105
'4518043000,  산내면,'30,25 - 29세,1998,152,107,45
'4518043000,  산내면,'35,30 - 34세,1998,101,64,37
'4518043000,  산내면,'40,35 - 39세,1998,94,52,42
'4518043000,  산내면,'45,40 - 44세,1998,101,51,50
'4518043000,  산내면,'50,45 - 49세,1998,92,43,49
'4518043000,  산내면,'55,50 - 54세,1998,129,64,65
'4518043000,  산내면,'60,55 - 59세,1998,207,93,114
'4518043000,  산내면,'65,60 - 64세,1998,183,69,114
'4518043000,  산내면,'70,65 - 69세,1998,135,59,76
'4518043000,  산내면,'75,70 - 74세,1998,121,45,76
'4518043000,  산내면,'80,75 - 79세,1998,89,33,56
'4518043000,  산내면,'85,80 - 84세,1998,51,18,33
'4518043000,  산내면,'90,85+ ,1998,20,4,16
'4518044000,  산외면,'00,계,1998,3818,1890,1928
'4518044000,  산외면,'05,0 - 4세,1998,161,90,71
'4518044000,  산외면,'10,5 - 9세,1998,136,66,70
'4518044000,  산외면,'15,10 - 14세,1998,184,95,89
'4518044000,  산외면,'20,15 - 19세,1998,345,170,175
'4518044000,  산외면,'25,20 - 24세,1998,399,219,180
'4518044000,  산외면,'30,25 - 29세,1998,285,189,96
'4518044000,  산외면,'35,30 - 34세,1998,192,113,79
'4518044000,  산외면,'40,35 - 39세,1998,174,100,74
'4518044000,  산외면,'45,40 - 44세,1998,170,95,75
'4518044000,  산외면,'50,45 - 49세,1998,193,93,100
'4518044000,  산외면,'55,50 - 54세,1998,215,100,115
'4518044000,  산외면,'60,55 - 59세,1998,318,129,189
'4518044000,  산외면,'65,60 - 64세,1998,331,141,190
'4518044000,  산외면,'70,65 - 69세,1998,233,94,139
'4518044000,  산외면,'75,70 - 74세,1998,219,99,120
'4518044000,  산외면,'80,75 - 79세,1998,152,62,90
'4518044000,  산외면,'85,80 - 84세,1998,57,25,32
'4518044000,  산외면,'90,85+ ,1998,54,10,44
'4518051000,  수성동,'00,계,1998,13000,6361,6639
'4518051000,  수성동,'05,0 - 4세,1998,1097,559,538
'4518051000,  수성동,'10,5 - 9세,1998,1081,565,516
'4518051000,  수성동,'15,10 - 14세,1998,989,494,495
'4518051000,  수성동,'20,15 - 19세,1998,1259,628,631
'4518051000,  수성동,'25,20 - 24세,1998,1170,593,577
'4518051000,  수성동,'30,25 - 29세,1998,1180,569,611
'4518051000,  수성동,'35,30 - 34세,1998,1223,591,632
'4518051000,  수성동,'40,35 - 39세,1998,1190,642,548
'4518051000,  수성동,'45,40 - 44세,1998,895,438,457
'4518051000,  수성동,'50,45 - 49세,1998,621,316,305
'4518051000,  수성동,'55,50 - 54세,1998,543,275,268
'4518051000,  수성동,'60,55 - 59세,1998,491,218,273
'4518051000,  수성동,'65,60 - 64세,1998,399,157,242
'4518051000,  수성동,'70,65 - 69세,1998,326,138,188
'4518051000,  수성동,'75,70 - 74세,1998,221,88,133
'4518051000,  수성동,'80,75 - 79세,1998,191,67,124
'4518051000,  수성동,'85,80 - 84세,1998,80,17,63
'4518051000,  수성동,'90,85+ ,1998,44,6,38
'4518052000,  장명동,'00,계,1998,5364,2579,2785
'4518052000,  장명동,'05,0 - 4세,1998,518,263,255
'4518052000,  장명동,'10,5 - 9세,1998,394,188,206
'4518052000,  장명동,'15,10 - 14세,1998,309,155,154
'4518052000,  장명동,'20,15 - 19세,1998,456,197,259
'4518052000,  장명동,'25,20 - 24세,1998,540,272,268
'4518052000,  장명동,'30,25 - 29세,1998,625,307,318
'4518052000,  장명동,'35,30 - 34세,1998,481,271,210
'4518052000,  장명동,'40,35 - 39세,1998,377,184,193
'4518052000,  장명동,'45,40 - 44세,1998,313,168,145
'4518052000,  장명동,'50,45 - 49세,1998,221,102,119
'4518052000,  장명동,'55,50 - 54세,1998,253,115,138
'4518052000,  장명동,'60,55 - 59세,1998,239,113,126
'4518052000,  장명동,'65,60 - 64세,1998,228,111,117
'4518052000,  장명동,'70,65 - 69세,1998,179,68,111
'4518052000,  장명동,'75,70 - 74세,1998,87,30,57
'4518052000,  장명동,'80,75 - 79세,1998,77,17,60
'4518052000,  장명동,'85,80 - 84세,1998,45,13,32
'4518052000,  장명동,'90,85+ ,1998,22,5,17
'4518053500,  내장상동,'00,계,1998,20498,10073,10425
'4518053500,  내장상동,'05,0 - 4세,1998,1780,883,897
'4518053500,  내장상동,'10,5 - 9세,1998,1696,893,803
'4518053500,  내장상동,'15,10 - 14세,1998,1600,819,781
'4518053500,  내장상동,'20,15 - 19세,1998,1969,1003,966
'4518053500,  내장상동,'25,20 - 24세,1998,1776,906,870
'4518053500,  내장상동,'30,25 - 29세,1998,1821,901,920
'4518053500,  내장상동,'35,30 - 34세,1998,1771,883,888
'4518053500,  내장상동,'40,35 - 39세,1998,1856,929,927
'4518053500,  내장상동,'45,40 - 44세,1998,1527,802,725
'4518053500,  내장상동,'50,45 - 49세,1998,970,484,486
'4518053500,  내장상동,'55,50 - 54세,1998,788,422,366
'4518053500,  내장상동,'60,55 - 59세,1998,825,370,455
'4518053500,  내장상동,'65,60 - 64세,1998,716,300,416
'4518053500,  내장상동,'70,65 - 69세,1998,508,193,315
'4518053500,  내장상동,'75,70 - 74세,1998,369,137,232
'4518053500,  내장상동,'80,75 - 79세,1998,290,89,201
'4518053500,  내장상동,'85,80 - 84세,1998,138,35,103
'4518053500,  내장상동,'90,85+ ,1998,98,24,74
'4518054500,  시기동,'00,계,1998,7444,3613,3831
'4518054500,  시기동,'05,0 - 4세,1998,484,257,227
'4518054500,  시기동,'10,5 - 9세,1998,489,260,229
'4518054500,  시기동,'15,10 - 14세,1998,468,254,214
'4518054500,  시기동,'20,15 - 19세,1998,766,369,397
'4518054500,  시기동,'25,20 - 24세,1998,817,422,395
'4518054500,  시기동,'30,25 - 29세,1998,632,324,308
'4518054500,  시기동,'35,30 - 34세,1998,545,265,280
'4518054500,  시기동,'40,35 - 39세,1998,566,274,292
'4518054500,  시기동,'45,40 - 44세,1998,502,234,268
'4518054500,  시기동,'50,45 - 49세,1998,415,200,215
'4518054500,  시기동,'55,50 - 54세,1998,402,180,222
'4518054500,  시기동,'60,55 - 59세,1998,432,208,224
'4518054500,  시기동,'65,60 - 64세,1998,334,155,179
'4518054500,  시기동,'70,65 - 69세,1998,239,96,143
'4518054500,  시기동,'75,70 - 74세,1998,164,70,94
'4518054500,  시기동,'80,75 - 79세,1998,88,23,65
'4518054500,  시기동,'85,80 - 84세,1998,61,12,49
'4518054500,  시기동,'90,85+ ,1998,40,10,30
'4518056000,  시기3동,'00,계,1998,10276,5114,5162
'4518056000,  시기3동,'05,0 - 4세,1998,929,489,440
'4518056000,  시기3동,'10,5 - 9세,1998,857,464,393
'4518056000,  시기3동,'15,10 - 14세,1998,827,448,379
'4518056000,  시기3동,'20,15 - 19세,1998,1006,508,498
'4518056000,  시기3동,'25,20 - 24세,1998,916,481,435
'4518056000,  시기3동,'30,25 - 29세,1998,900,427,473
'4518056000,  시기3동,'35,30 - 34세,1998,925,459,466
'4518056000,  시기3동,'40,35 - 39세,1998,929,478,451
'4518056000,  시기3동,'45,40 - 44세,1998,762,401,361
'4518056000,  시기3동,'50,45 - 49세,1998,502,232,270
'4518056000,  시기3동,'55,50 - 54세,1998,410,223,187
'4518056000,  시기3동,'60,55 - 59세,1998,390,171,219
'4518056000,  시기3동,'65,60 - 64세,1998,301,132,169
'4518056000,  시기3동,'70,65 - 69세,1998,236,86,150
'4518056000,  시기3동,'75,70 - 74세,1998,175,58,117
'4518056000,  시기3동,'80,75 - 79세,1998,121,32,89
'4518056000,  시기3동,'85,80 - 84세,1998,56,18,38
'4518056000,  시기3동,'90,85+ ,1998,34,7,27
'4518057000,  연지동,'00,계,1998,9902,4903,4999
'4518057000,  연지동,'05,0 - 4세,1998,721,392,329
'4518057000,  연지동,'10,5 - 9세,1998,752,394,358
'4518057000,  연지동,'15,10 - 14세,1998,715,366,349
'4518057000,  연지동,'20,15 - 19세,1998,958,485,473
'4518057000,  연지동,'25,20 - 24세,1998,1024,513,511
'4518057000,  연지동,'30,25 - 29세,1998,917,463,454
'4518057000,  연지동,'35,30 - 34세,1998,784,386,398
'4518057000,  연지동,'40,35 - 39세,1998,786,399,387
'4518057000,  연지동,'45,40 - 44세,1998,691,350,341
'4518057000,  연지동,'50,45 - 49세,1998,606,301,305
'4518057000,  연지동,'55,50 - 54세,1998,505,257,248
'4518057000,  연지동,'60,55 - 59세,1998,456,217,239
'4518057000,  연지동,'65,60 - 64세,1998,352,162,190
'4518057000,  연지동,'70,65 - 69세,1998,256,99,157
'4518057000,  연지동,'75,70 - 74세,1998,159,59,100
'4518057000,  연지동,'80,75 - 79세,1998,123,39,84
'4518057000,  연지동,'85,80 - 84세,1998,56,17,39
'4518057000,  연지동,'90,85+ ,1998,41,4,37
'4518058000,  농소동,'00,계,1998,5691,2823,2868
'4518058000,  농소동,'05,0 - 4세,1998,420,216,204
'4518058000,  농소동,'10,5 - 9세,1998,389,208,181
'4518058000,  농소동,'15,10 - 14세,1998,350,151,199
'4518058000,  농소동,'20,15 - 19세,1998,540,272,268
'4518058000,  농소동,'25,20 - 24세,1998,534,297,237
'4518058000,  농소동,'30,25 - 29세,1998,496,278,218
'4518058000,  농소동,'35,30 - 34세,1998,437,216,221
'4518058000,  농소동,'40,35 - 39세,1998,435,250,185
'4518058000,  농소동,'45,40 - 44세,1998,367,182,185
'4518058000,  농소동,'50,45 - 49세,1998,276,145,131
'4518058000,  농소동,'55,50 - 54세,1998,248,119,129
'4518058000,  농소동,'60,55 - 59세,1998,319,130,189
'4518058000,  농소동,'65,60 - 64세,1998,297,135,162
'4518058000,  농소동,'70,65 - 69세,1998,240,100,140
'4518058000,  농소동,'75,70 - 74세,1998,141,59,82
'4518058000,  농소동,'80,75 - 79세,1998,116,41,75
'4518058000,  농소동,'85,80 - 84세,1998,54,16,38
'4518058000,  농소동,'90,85+ ,1998,32,8,24
'4518059500,  상교동,'00,계,1998,6179,3075,3104
'4518059500,  상교동,'05,0 - 4세,1998,388,187,201
'4518059500,  상교동,'10,5 - 9세,1998,317,164,153
'4518059500,  상교동,'15,10 - 14세,1998,329,160,169
'4518059500,  상교동,'20,15 - 19세,1998,535,273,262
'4518059500,  상교동,'25,20 - 24세,1998,637,357,280
'4518059500,  상교동,'30,25 - 29세,1998,517,291,226
'4518059500,  상교동,'35,30 - 34세,1998,420,249,171
'4518059500,  상교동,'40,35 - 39세,1998,399,221,178
'4518059500,  상교동,'45,40 - 44세,1998,322,166,156
'4518059500,  상교동,'50,45 - 49세,1998,305,149,156
'4518059500,  상교동,'55,50 - 54세,1998,309,147,162
'4518059500,  상교동,'60,55 - 59세,1998,412,194,218
'4518059500,  상교동,'65,60 - 64세,1998,408,174,234
'4518059500,  상교동,'70,65 - 69세,1998,329,136,193
'4518059500,  상교동,'75,70 - 74세,1998,210,85,125
'4518059500,  상교동,'80,75 - 79세,1998,177,76,101
'4518059500,  상교동,'85,80 - 84세,1998,103,30,73
'4518059500,  상교동,'90,85+ ,1998,62,16,46
'45190, 남원시,'00,계,1998,106300,52615,53685
'45190, 남원시,'05,0 - 4세,1998,6655,3472,3183
'45190, 남원시,'10,5 - 9세,1998,6595,3421,3174
'45190, 남원시,'15,10 - 14세,1998,6855,3480,3375
'45190, 남원시,'20,15 - 19세,1998,9909,5057,4852
'45190, 남원시,'25,20 - 24세,1998,9915,5380,4535
'45190, 남원시,'30,25 - 29세,1998,8446,4693,3753
'45190, 남원시,'35,30 - 34세,1998,7288,3765,3523
'45190, 남원시,'40,35 - 39세,1998,7663,3988,3675
'45190, 남원시,'45,40 - 44세,1998,6392,3303,3089
'45190, 남원시,'50,45 - 49세,1998,5408,2766,2642
'45190, 남원시,'55,50 - 54세,1998,5333,2473,2860
'45190, 남원시,'60,55 - 59세,1998,6413,2777,3636
'45190, 남원시,'65,60 - 64세,1998,6461,2795,3666
'45190, 남원시,'70,65 - 69세,1998,4632,1987,2645
'45190, 남원시,'75,70 - 74세,1998,3707,1646,2061
'45190, 남원시,'80,75 - 79세,1998,2492,1000,1492
'45190, 남원시,'85,80 - 84세,1998,1292,438,854
'45190, 남원시,'90,85+ ,1998,844,174,670
'4519025000,  운봉읍,'00,계,1998,6127,3031,3096
'4519025000,  운봉읍,'05,0 - 4세,1998,260,135,125
'4519025000,  운봉읍,'10,5 - 9세,1998,282,130,152
'4519025000,  운봉읍,'15,10 - 14세,1998,335,161,174
'4519025000,  운봉읍,'20,15 - 19세,1998,562,282,280
'4519025000,  운봉읍,'25,20 - 24세,1998,660,382,278
'4519025000,  운봉읍,'30,25 - 29세,1998,401,266,135
'4519025000,  운봉읍,'35,30 - 34세,1998,337,176,161
'4519025000,  운봉읍,'40,35 - 39세,1998,331,192,139
'4519025000,  운봉읍,'45,40 - 44세,1998,323,180,143
'4519025000,  운봉읍,'50,45 - 49세,1998,332,152,180
'4519025000,  운봉읍,'55,50 - 54세,1998,339,142,197
'4519025000,  운봉읍,'60,55 - 59세,1998,489,205,284
'4519025000,  운봉읍,'65,60 - 64세,1998,489,215,274
'4519025000,  운봉읍,'70,65 - 69세,1998,357,155,202
'4519025000,  운봉읍,'75,70 - 74세,1998,260,125,135
'4519025000,  운봉읍,'80,75 - 79세,1998,195,77,118
'4519025000,  운봉읍,'85,80 - 84세,1998,95,35,60
'4519025000,  운봉읍,'90,85+ ,1998,80,21,59
'4519031000,  주천면,'00,계,1998,3272,1639,1633
'4519031000,  주천면,'05,0 - 4세,1998,134,66,68
'4519031000,  주천면,'10,5 - 9세,1998,135,77,58
'4519031000,  주천면,'15,10 - 14세,1998,164,80,84
'4519031000,  주천면,'20,15 - 19세,1998,314,173,141
'4519031000,  주천면,'25,20 - 24세,1998,355,192,163
'4519031000,  주천면,'30,25 - 29세,1998,248,160,88
'4519031000,  주천면,'35,30 - 34세,1998,149,89,60
'4519031000,  주천면,'40,35 - 39세,1998,171,89,82
'4519031000,  주천면,'45,40 - 44세,1998,191,98,93
'4519031000,  주천면,'50,45 - 49세,1998,170,92,78
'4519031000,  주천면,'55,50 - 54세,1998,195,89,106
'4519031000,  주천면,'60,55 - 59세,1998,254,102,152
'4519031000,  주천면,'65,60 - 64세,1998,247,103,144
'4519031000,  주천면,'70,65 - 69세,1998,200,86,114
'4519031000,  주천면,'75,70 - 74세,1998,152,70,82
'4519031000,  주천면,'80,75 - 79세,1998,103,47,56
'4519031000,  주천면,'85,80 - 84세,1998,52,20,32
'4519031000,  주천면,'90,85+ ,1998,38,6,32
'4519032000,  수지면,'00,계,1998,1808,858,950
'4519032000,  수지면,'05,0 - 4세,1998,53,28,25
'4519032000,  수지면,'10,5 - 9세,1998,55,28,27
'4519032000,  수지면,'15,10 - 14세,1998,98,41,57
'4519032000,  수지면,'20,15 - 19세,1998,168,83,85
'4519032000,  수지면,'25,20 - 24세,1998,151,83,68
'4519032000,  수지면,'30,25 - 29세,1998,103,62,41
'4519032000,  수지면,'35,30 - 34세,1998,67,36,31
'4519032000,  수지면,'40,35 - 39세,1998,90,50,40
'4519032000,  수지면,'45,40 - 44세,1998,85,44,41
'4519032000,  수지면,'50,45 - 49세,1998,84,41,43
'4519032000,  수지면,'55,50 - 54세,1998,104,52,52
'4519032000,  수지면,'60,55 - 59세,1998,146,63,83
'4519032000,  수지면,'65,60 - 64세,1998,170,68,102
'4519032000,  수지면,'70,65 - 69세,1998,159,59,100
'4519032000,  수지면,'75,70 - 74세,1998,136,75,61
'4519032000,  수지면,'80,75 - 79세,1998,79,30,49
'4519032000,  수지면,'85,80 - 84세,1998,38,10,28
'4519032000,  수지면,'90,85+ ,1998,22,5,17
'4519033000,  송동면,'00,계,1998,3254,1611,1643
'4519033000,  송동면,'05,0 - 4세,1998,115,57,58
'4519033000,  송동면,'10,5 - 9세,1998,133,73,60
'4519033000,  송동면,'15,10 - 14세,1998,185,94,91
'4519033000,  송동면,'20,15 - 19세,1998,298,154,144
'4519033000,  송동면,'25,20 - 24세,1998,314,184,130
'4519033000,  송동면,'30,25 - 29세,1998,187,127,60
'4519033000,  송동면,'35,30 - 34세,1998,141,84,57
'4519033000,  송동면,'40,35 - 39세,1998,162,101,61
'4519033000,  송동면,'45,40 - 44세,1998,153,78,75
'4519033000,  송동면,'50,45 - 49세,1998,147,73,74
'4519033000,  송동면,'55,50 - 54세,1998,179,86,93
'4519033000,  송동면,'60,55 - 59세,1998,270,104,166
'4519033000,  송동면,'65,60 - 64세,1998,301,114,187
'4519033000,  송동면,'70,65 - 69세,1998,230,102,128
'4519033000,  송동면,'75,70 - 74세,1998,188,93,95
'4519033000,  송동면,'80,75 - 79세,1998,121,48,73
'4519033000,  송동면,'85,80 - 84세,1998,79,30,49
'4519033000,  송동면,'90,85+ ,1998,51,9,42
'4519034000,  주생면,'00,계,1998,2888,1396,1492
'4519034000,  주생면,'05,0 - 4세,1998,115,59,56
'4519034000,  주생면,'10,5 - 9세,1998,83,42,41
'4519034000,  주생면,'15,10 - 14세,1998,132,67,65
'4519034000,  주생면,'20,15 - 19세,1998,262,124,138
'4519034000,  주생면,'25,20 - 24세,1998,270,148,122
'4519034000,  주생면,'30,25 - 29세,1998,202,137,65
'4519034000,  주생면,'35,30 - 34세,1998,132,75,57
'4519034000,  주생면,'40,35 - 39세,1998,134,74,60
'4519034000,  주생면,'45,40 - 44세,1998,127,57,70
'4519034000,  주생면,'50,45 - 49세,1998,141,78,63
'4519034000,  주생면,'55,50 - 54세,1998,192,78,114
'4519034000,  주생면,'60,55 - 59세,1998,221,86,135
'4519034000,  주생면,'65,60 - 64세,1998,290,132,158
'4519034000,  주생면,'70,65 - 69세,1998,224,94,130
'4519034000,  주생면,'75,70 - 74세,1998,155,68,87
'4519034000,  주생면,'80,75 - 79세,1998,110,50,60
'4519034000,  주생면,'85,80 - 84세,1998,61,19,42
'4519034000,  주생면,'90,85+ ,1998,37,8,29
'4519035000,  금지면,'00,계,1998,3897,1886,2011
'4519035000,  금지면,'05,0 - 4세,1998,132,75,57
'4519035000,  금지면,'10,5 - 9세,1998,134,62,72
'4519035000,  금지면,'15,10 - 14세,1998,218,112,106
'4519035000,  금지면,'20,15 - 19세,1998,408,208,200
'4519035000,  금지면,'25,20 - 24세,1998,411,242,169
'4519035000,  금지면,'30,25 - 29세,1998,220,155,65
'4519035000,  금지면,'35,30 - 34세,1998,138,75,63
'4519035000,  금지면,'40,35 - 39세,1998,182,89,93
'4519035000,  금지면,'45,40 - 44세,1998,230,115,115
'4519035000,  금지면,'50,45 - 49세,1998,225,113,112
'4519035000,  금지면,'55,50 - 54세,1998,242,111,131
'4519035000,  금지면,'60,55 - 59세,1998,298,117,181
'4519035000,  금지면,'65,60 - 64세,1998,365,165,200
'4519035000,  금지면,'70,65 - 69세,1998,245,98,147
'4519035000,  금지면,'75,70 - 74세,1998,208,81,127
'4519035000,  금지면,'80,75 - 79세,1998,129,40,89
'4519035000,  금지면,'85,80 - 84세,1998,66,19,47
'4519035000,  금지면,'90,85+ ,1998,46,9,37
'4519036000,  대강면,'00,계,1998,2995,1444,1551
'4519036000,  대강면,'05,0 - 4세,1998,76,39,37
'4519036000,  대강면,'10,5 - 9세,1998,105,50,55
'4519036000,  대강면,'15,10 - 14세,1998,156,80,76
'4519036000,  대강면,'20,15 - 19세,1998,276,137,139
'4519036000,  대강면,'25,20 - 24세,1998,292,173,119
'4519036000,  대강면,'30,25 - 29세,1998,166,114,52
'4519036000,  대강면,'35,30 - 34세,1998,102,58,44
'4519036000,  대강면,'40,35 - 39세,1998,141,74,67
'4519036000,  대강면,'45,40 - 44세,1998,143,72,71
'4519036000,  대강면,'50,45 - 49세,1998,136,71,65
'4519036000,  대강면,'55,50 - 54세,1998,168,72,96
'4519036000,  대강면,'60,55 - 59세,1998,241,104,137
'4519036000,  대강면,'65,60 - 64세,1998,323,131,192
'4519036000,  대강면,'70,65 - 69세,1998,262,111,151
'4519036000,  대강면,'75,70 - 74세,1998,186,78,108
'4519036000,  대강면,'80,75 - 79세,1998,131,56,75
'4519036000,  대강면,'85,80 - 84세,1998,51,18,33
'4519036000,  대강면,'90,85+ ,1998,40,6,34
'4519037000,  대산면,'00,계,1998,2201,1078,1123
'4519037000,  대산면,'05,0 - 4세,1998,81,32,49
'4519037000,  대산면,'10,5 - 9세,1998,70,39,31
'4519037000,  대산면,'15,10 - 14세,1998,122,56,66
'4519037000,  대산면,'20,15 - 19세,1998,184,87,97
'4519037000,  대산면,'25,20 - 24세,1998,226,137,89
'4519037000,  대산면,'30,25 - 29세,1998,161,106,55
'4519037000,  대산면,'35,30 - 34세,1998,92,55,37
'4519037000,  대산면,'40,35 - 39세,1998,120,62,58
'4519037000,  대산면,'45,40 - 44세,1998,103,55,48
'4519037000,  대산면,'50,45 - 49세,1998,131,65,66
'4519037000,  대산면,'55,50 - 54세,1998,117,55,62
'4519037000,  대산면,'60,55 - 59세,1998,210,105,105
'4519037000,  대산면,'65,60 - 64세,1998,195,79,116
'4519037000,  대산면,'70,65 - 69세,1998,141,61,80
'4519037000,  대산면,'75,70 - 74세,1998,103,42,61
'4519037000,  대산면,'80,75 - 79세,1998,74,28,46
'4519037000,  대산면,'85,80 - 84세,1998,43,12,31
'4519037000,  대산면,'90,85+ ,1998,28,2,26
'4519038000,  사매면,'00,계,1998,2392,1186,1206
'4519038000,  사매면,'05,0 - 4세,1998,81,43,38
'4519038000,  사매면,'10,5 - 9세,1998,81,36,45
'4519038000,  사매면,'15,10 - 14세,1998,139,68,71
'4519038000,  사매면,'20,15 - 19세,1998,221,104,117
'4519038000,  사매면,'25,20 - 24세,1998,221,132,89
'4519038000,  사매면,'30,25 - 29세,1998,163,112,51
'4519038000,  사매면,'35,30 - 34세,1998,91,57,34
'4519038000,  사매면,'40,35 - 39세,1998,118,61,57
'4519038000,  사매면,'45,40 - 44세,1998,105,50,55
'4519038000,  사매면,'50,45 - 49세,1998,111,56,55
'4519038000,  사매면,'55,50 - 54세,1998,125,68,57
'4519038000,  사매면,'60,55 - 59세,1998,223,83,140
'4519038000,  사매면,'65,60 - 64세,1998,220,102,118
'4519038000,  사매면,'70,65 - 69세,1998,162,68,94
'4519038000,  사매면,'75,70 - 74세,1998,132,61,71
'4519038000,  사매면,'80,75 - 79세,1998,105,49,56
'4519038000,  사매면,'85,80 - 84세,1998,57,25,32
'4519038000,  사매면,'90,85+ ,1998,37,11,26
'4519039000,  덕과면,'00,계,1998,1604,810,794
'4519039000,  덕과면,'05,0 - 4세,1998,56,29,27
'4519039000,  덕과면,'10,5 - 9세,1998,45,22,23
'4519039000,  덕과면,'15,10 - 14세,1998,67,33,34
'4519039000,  덕과면,'20,15 - 19세,1998,173,90,83
'4519039000,  덕과면,'25,20 - 24세,1998,168,87,81
'4519039000,  덕과면,'30,25 - 29세,1998,83,63,20
'4519039000,  덕과면,'35,30 - 34세,1998,69,40,29
'4519039000,  덕과면,'40,35 - 39세,1998,70,38,32
'4519039000,  덕과면,'45,40 - 44세,1998,93,48,45
'4519039000,  덕과면,'50,45 - 49세,1998,71,45,26
'4519039000,  덕과면,'55,50 - 54세,1998,94,38,56
'4519039000,  덕과면,'60,55 - 59세,1998,146,68,78
'4519039000,  덕과면,'65,60 - 64세,1998,149,60,89
'4519039000,  덕과면,'70,65 - 69세,1998,119,56,63
'4519039000,  덕과면,'75,70 - 74세,1998,91,47,44
'4519039000,  덕과면,'80,75 - 79세,1998,63,32,31
'4519039000,  덕과면,'85,80 - 84세,1998,29,13,16
'4519039000,  덕과면,'90,85+ ,1998,18,1,17
'4519040000,  보절면,'00,계,1998,2442,1261,1181
'4519040000,  보절면,'05,0 - 4세,1998,89,47,42
'4519040000,  보절면,'10,5 - 9세,1998,67,36,31
'4519040000,  보절면,'15,10 - 14세,1998,112,69,43
'4519040000,  보절면,'20,15 - 19세,1998,224,112,112
'4519040000,  보절면,'25,20 - 24세,1998,262,166,96
'4519040000,  보절면,'30,25 - 29세,1998,176,124,52
'4519040000,  보절면,'35,30 - 34세,1998,93,56,37
'4519040000,  보절면,'40,35 - 39세,1998,90,49,41
'4519040000,  보절면,'45,40 - 44세,1998,93,45,48
'4519040000,  보절면,'50,45 - 49세,1998,124,60,64
'4519040000,  보절면,'55,50 - 54세,1998,143,71,72
'4519040000,  보절면,'60,55 - 59세,1998,236,103,133
'4519040000,  보절면,'65,60 - 64세,1998,245,113,132
'4519040000,  보절면,'70,65 - 69세,1998,166,82,84
'4519040000,  보절면,'75,70 - 74세,1998,138,59,79
'4519040000,  보절면,'80,75 - 79세,1998,87,36,51
'4519040000,  보절면,'85,80 - 84세,1998,56,25,31
'4519040000,  보절면,'90,85+ ,1998,41,8,33
'4519041000,  산동면,'00,계,1998,2940,1493,1447
'4519041000,  산동면,'05,0 - 4세,1998,92,59,33
'4519041000,  산동면,'10,5 - 9세,1998,101,54,47
'4519041000,  산동면,'15,10 - 14세,1998,150,81,69
'4519041000,  산동면,'20,15 - 19세,1998,314,164,150
'4519041000,  산동면,'25,20 - 24세,1998,348,200,148
'4519041000,  산동면,'30,25 - 29세,1998,175,127,48
'4519041000,  산동면,'35,30 - 34세,1998,136,81,55
'4519041000,  산동면,'40,35 - 39세,1998,135,82,53
'4519041000,  산동면,'45,40 - 44세,1998,136,61,75
'4519041000,  산동면,'50,45 - 49세,1998,134,66,68
'4519041000,  산동면,'55,50 - 54세,1998,181,78,103
'4519041000,  산동면,'60,55 - 59세,1998,260,118,142
'4519041000,  산동면,'65,60 - 64세,1998,257,96,161
'4519041000,  산동면,'70,65 - 69세,1998,178,87,91
'4519041000,  산동면,'75,70 - 74세,1998,142,65,77
'4519041000,  산동면,'80,75 - 79세,1998,109,50,59
'4519041000,  산동면,'85,80 - 84세,1998,51,16,35
'4519041000,  산동면,'90,85+ ,1998,41,8,33
'4519042000,  이백면,'00,계,1998,3092,1581,1511
'4519042000,  이백면,'05,0 - 4세,1998,117,68,49
'4519042000,  이백면,'10,5 - 9세,1998,123,76,47
'4519042000,  이백면,'15,10 - 14세,1998,176,95,81
'4519042000,  이백면,'20,15 - 19세,1998,284,146,138
'4519042000,  이백면,'25,20 - 24세,1998,288,164,124
'4519042000,  이백면,'30,25 - 29세,1998,222,147,75
'4519042000,  이백면,'35,30 - 34세,1998,161,101,60
'4519042000,  이백면,'40,35 - 39세,1998,201,113,88
'4519042000,  이백면,'45,40 - 44세,1998,163,90,73
'4519042000,  이백면,'50,45 - 49세,1998,139,75,64
'4519042000,  이백면,'55,50 - 54세,1998,167,68,99
'4519042000,  이백면,'60,55 - 59세,1998,253,106,147
'4519042000,  이백면,'65,60 - 64세,1998,274,129,145
'4519042000,  이백면,'70,65 - 69세,1998,189,75,114
'4519042000,  이백면,'75,70 - 74세,1998,161,78,83
'4519042000,  이백면,'80,75 - 79세,1998,87,32,55
'4519042000,  이백면,'85,80 - 84세,1998,51,13,38
'4519042000,  이백면,'90,85+ ,1998,36,5,31
'4519045000,  아영면,'00,계,1998,3015,1497,1518
'4519045000,  아영면,'05,0 - 4세,1998,93,48,45
'4519045000,  아영면,'10,5 - 9세,1998,111,50,61
'4519045000,  아영면,'15,10 - 14세,1998,182,100,82
'4519045000,  아영면,'20,15 - 19세,1998,318,179,139
'4519045000,  아영면,'25,20 - 24세,1998,307,165,142
'4519045000,  아영면,'30,25 - 29세,1998,165,118,47
'4519045000,  아영면,'35,30 - 34세,1998,124,68,56
'4519045000,  아영면,'40,35 - 39세,1998,139,66,73
'4519045000,  아영면,'45,40 - 44세,1998,170,88,82
'4519045000,  아영면,'50,45 - 49세,1998,178,96,82
'4519045000,  아영면,'55,50 - 54세,1998,193,78,115
'4519045000,  아영면,'60,55 - 59세,1998,236,97,139
'4519045000,  아영면,'65,60 - 64세,1998,246,100,146
'4519045000,  아영면,'70,65 - 69세,1998,193,83,110
'4519045000,  아영면,'75,70 - 74세,1998,172,87,85
'4519045000,  아영면,'80,75 - 79세,1998,110,51,59
'4519045000,  아영면,'85,80 - 84세,1998,51,17,34
'4519045000,  아영면,'90,85+ ,1998,27,6,21
'4519046000,  산내면,'00,계,1998,2453,1264,1189
'4519046000,  산내면,'05,0 - 4세,1998,112,59,53
'4519046000,  산내면,'10,5 - 9세,1998,96,40,56
'4519046000,  산내면,'15,10 - 14세,1998,111,62,49
'4519046000,  산내면,'20,15 - 19세,1998,217,108,109
'4519046000,  산내면,'25,20 - 24세,1998,232,145,87
'4519046000,  산내면,'30,25 - 29세,1998,189,123,66
'4519046000,  산내면,'35,30 - 34세,1998,160,98,62
'4519046000,  산내면,'40,35 - 39세,1998,168,109,59
'4519046000,  산내면,'45,40 - 44세,1998,126,64,62
'4519046000,  산내면,'50,45 - 49세,1998,132,74,58
'4519046000,  산내면,'55,50 - 54세,1998,146,71,75
'4519046000,  산내면,'60,55 - 59세,1998,197,71,126
'4519046000,  산내면,'65,60 - 64세,1998,215,100,115
'4519046000,  산내면,'70,65 - 69세,1998,117,47,70
'4519046000,  산내면,'75,70 - 74세,1998,102,44,58
'4519046000,  산내면,'80,75 - 79세,1998,72,23,49
'4519046000,  산내면,'85,80 - 84세,1998,39,17,22
'4519046000,  산내면,'90,85+ ,1998,22,9,13
'4519047000,  인월면,'00,계,1998,4058,2084,1974
'4519047000,  인월면,'05,0 - 4세,1998,211,118,93
'4519047000,  인월면,'10,5 - 9세,1998,243,124,119
'4519047000,  인월면,'15,10 - 14세,1998,224,116,108
'4519047000,  인월면,'20,15 - 19세,1998,380,211,169
'4519047000,  인월면,'25,20 - 24세,1998,403,243,160
'4519047000,  인월면,'30,25 - 29세,1998,284,153,131
'4519047000,  인월면,'35,30 - 34세,1998,266,147,119
'4519047000,  인월면,'40,35 - 39세,1998,298,157,141
'4519047000,  인월면,'45,40 - 44세,1998,255,142,113
'4519047000,  인월면,'50,45 - 49세,1998,225,118,107
'4519047000,  인월면,'55,50 - 54세,1998,222,97,125
'4519047000,  인월면,'60,55 - 59세,1998,263,121,142
'4519047000,  인월면,'65,60 - 64세,1998,248,106,142
'4519047000,  인월면,'70,65 - 69세,1998,195,88,107
'4519047000,  인월면,'75,70 - 74세,1998,160,78,82
'4519047000,  인월면,'80,75 - 79세,1998,107,43,64
'4519047000,  인월면,'85,80 - 84세,1998,43,15,28
'4519047000,  인월면,'90,85+ ,1998,31,7,24
'4519051000,  동충동,'00,계,1998,6012,2987,3025
'4519051000,  동충동,'05,0 - 4세,1998,518,262,256
'4519051000,  동충동,'10,5 - 9세,1998,474,266,208
'4519051000,  동충동,'15,10 - 14세,1998,459,241,218
'4519051000,  동충동,'20,15 - 19세,1998,500,259,241
'4519051000,  동충동,'25,20 - 24세,1998,500,266,234
'4519051000,  동충동,'30,25 - 29세,1998,565,287,278
'4519051000,  동충동,'35,30 - 34세,1998,552,266,286
'4519051000,  동충동,'40,35 - 39세,1998,517,256,261
'4519051000,  동충동,'45,40 - 44세,1998,387,206,181
'4519051000,  동충동,'50,45 - 49세,1998,301,153,148
'4519051000,  동충동,'55,50 - 54세,1998,285,137,148
'4519051000,  동충동,'60,55 - 59세,1998,275,116,159
'4519051000,  동충동,'65,60 - 64세,1998,229,106,123
'4519051000,  동충동,'70,65 - 69세,1998,173,77,96
'4519051000,  동충동,'75,70 - 74세,1998,139,49,90
'4519051000,  동충동,'80,75 - 79세,1998,69,25,44
'4519051000,  동충동,'85,80 - 84세,1998,40,10,30
'4519051000,  동충동,'90,85+ ,1998,29,5,24
'4519052000,  죽항동,'00,계,1998,7151,3409,3742
'4519052000,  죽항동,'05,0 - 4세,1998,557,295,262
'4519052000,  죽항동,'10,5 - 9세,1998,538,284,254
'4519052000,  죽항동,'15,10 - 14세,1998,475,215,260
'4519052000,  죽항동,'20,15 - 19세,1998,600,291,309
'4519052000,  죽항동,'25,20 - 24세,1998,654,325,329
'4519052000,  죽항동,'30,25 - 29세,1998,677,324,353
'4519052000,  죽항동,'35,30 - 34세,1998,599,276,323
'4519052000,  죽항동,'40,35 - 39세,1998,569,284,285
'4519052000,  죽항동,'45,40 - 44세,1998,470,227,243
'4519052000,  죽항동,'50,45 - 49세,1998,379,174,205
'4519052000,  죽항동,'55,50 - 54세,1998,384,183,201
'4519052000,  죽항동,'60,55 - 59세,1998,375,168,207
'4519052000,  죽항동,'65,60 - 64세,1998,280,128,152
'4519052000,  죽항동,'70,65 - 69세,1998,215,85,130
'4519052000,  죽항동,'75,70 - 74세,1998,165,73,92
'4519052000,  죽항동,'80,75 - 79세,1998,126,52,74
'4519052000,  죽항동,'85,80 - 84세,1998,51,17,34
'4519052000,  죽항동,'90,85+ ,1998,37,8,29
'4519054000,  노암동,'00,계,1998,7503,3677,3826
'4519054000,  노암동,'05,0 - 4세,1998,774,410,364
'4519054000,  노암동,'10,5 - 9세,1998,716,364,352
'4519054000,  노암동,'15,10 - 14세,1998,511,254,257
'4519054000,  노암동,'20,15 - 19세,1998,613,308,305
'4519054000,  노암동,'25,20 - 24세,1998,563,274,289
'4519054000,  노암동,'30,25 - 29세,1998,753,350,403
'4519054000,  노암동,'35,30 - 34세,1998,783,399,384
'4519054000,  노암동,'40,35 - 39세,1998,731,394,337
'4519054000,  노암동,'45,40 - 44세,1998,424,240,184
'4519054000,  노암동,'50,45 - 49세,1998,304,136,168
'4519054000,  노암동,'55,50 - 54세,1998,268,112,156
'4519054000,  노암동,'60,55 - 59세,1998,291,144,147
'4519054000,  노암동,'65,60 - 64세,1998,262,104,158
'4519054000,  노암동,'70,65 - 69세,1998,188,81,107
'4519054000,  노암동,'75,70 - 74세,1998,132,49,83
'4519054000,  노암동,'80,75 - 79세,1998,103,36,67
'4519054000,  노암동,'85,80 - 84세,1998,53,16,37
'4519054000,  노암동,'90,85+ ,1998,34,6,28
'4519055000,  금동,'00,계,1998,6484,3157,3327
'4519055000,  금동,'05,0 - 4세,1998,452,214,238
'4519055000,  금동,'10,5 - 9세,1998,394,205,189
'4519055000,  금동,'15,10 - 14세,1998,453,233,220
'4519055000,  금동,'20,15 - 19세,1998,707,350,357
'4519055000,  금동,'25,20 - 24세,1998,643,320,323
'4519055000,  금동,'30,25 - 29세,1998,557,305,252
'4519055000,  금동,'35,30 - 34세,1998,448,224,224
'4519055000,  금동,'40,35 - 39세,1998,498,248,250
'4519055000,  금동,'45,40 - 44세,1998,435,218,217
'4519055000,  금동,'50,45 - 49세,1998,364,176,188
'4519055000,  금동,'55,50 - 54세,1998,344,153,191
'4519055000,  금동,'60,55 - 59세,1998,358,175,183
'4519055000,  금동,'65,60 - 64세,1998,310,132,178
'4519055000,  금동,'70,65 - 69세,1998,195,87,108
'4519055000,  금동,'75,70 - 74세,1998,157,66,91
'4519055000,  금동,'80,75 - 79세,1998,97,28,69
'4519055000,  금동,'85,80 - 84세,1998,55,18,37
'4519055000,  금동,'90,85+ ,1998,17,5,12
'4519056000,  왕정동,'00,계,1998,7054,3497,3557
'4519056000,  왕정동,'05,0 - 4세,1998,466,232,234
'4519056000,  왕정동,'10,5 - 9세,1998,590,309,281
'4519056000,  왕정동,'15,10 - 14세,1998,577,292,285
'4519056000,  왕정동,'20,15 - 19세,1998,704,353,351
'4519056000,  왕정동,'25,20 - 24세,1998,646,355,291
'4519056000,  왕정동,'30,25 - 29세,1998,532,276,256
'4519056000,  왕정동,'35,30 - 34세,1998,547,262,285
'4519056000,  왕정동,'40,35 - 39세,1998,605,298,307
'4519056000,  왕정동,'45,40 - 44세,1998,491,249,242
'4519056000,  왕정동,'50,45 - 49세,1998,393,203,190
'4519056000,  왕정동,'55,50 - 54세,1998,328,169,159
'4519056000,  왕정동,'60,55 - 59세,1998,314,141,173
'4519056000,  왕정동,'65,60 - 64세,1998,312,137,175
'4519056000,  왕정동,'70,65 - 69세,1998,177,80,97
'4519056000,  왕정동,'75,70 - 74세,1998,160,69,91
'4519056000,  왕정동,'80,75 - 79세,1998,106,39,67
'4519056000,  왕정동,'85,80 - 84세,1998,68,23,45
'4519056000,  왕정동,'90,85+ ,1998,38,10,28
'4519057000,  향교동,'00,계,1998,11802,5884,5918
'4519057000,  향교동,'05,0 - 4세,1998,843,439,404
'4519057000,  향교동,'10,5 - 9세,1998,930,470,460
'4519057000,  향교동,'15,10 - 14세,1998,902,471,431
'4519057000,  향교동,'20,15 - 19세,1998,1146,607,539
'4519057000,  향교동,'25,20 - 24세,1998,1088,557,531
'4519057000,  향교동,'30,25 - 29세,1998,1063,558,505
'4519057000,  향교동,'35,30 - 34세,1998,906,455,451
'4519057000,  향교동,'40,35 - 39세,1998,1017,490,527
'4519057000,  향교동,'45,40 - 44세,1998,819,403,416
'4519057000,  향교동,'50,45 - 49세,1998,625,337,288
'4519057000,  향교동,'55,50 - 54세,1998,533,267,266
'4519057000,  향교동,'60,55 - 59세,1998,487,222,265
'4519057000,  향교동,'65,60 - 64세,1998,478,213,265
'4519057000,  향교동,'70,65 - 69세,1998,331,142,189
'4519057000,  향교동,'75,70 - 74세,1998,281,124,157
'4519057000,  향교동,'80,75 - 79세,1998,194,77,117
'4519057000,  향교동,'85,80 - 84세,1998,95,36,59
'4519057000,  향교동,'90,85+ ,1998,64,16,48
'4519059000,  도통동,'00,계,1998,11856,5885,5971
'4519059000,  도통동,'05,0 - 4세,1998,1228,658,570
'4519059000,  도통동,'10,5 - 9세,1998,1089,584,505
'4519059000,  도통동,'15,10 - 14세,1998,907,459,448
'4519059000,  도통동,'20,15 - 19세,1998,1036,527,509
'4519059000,  도통동,'25,20 - 24세,1998,913,440,473
'4519059000,  도통동,'30,25 - 29세,1998,1154,499,655
'4519059000,  도통동,'35,30 - 34세,1998,1195,587,608
'4519059000,  도통동,'40,35 - 39세,1998,1176,612,564
'4519059000,  도통동,'45,40 - 44세,1998,870,473,397
'4519059000,  도통동,'50,45 - 49세,1998,562,312,250
'4519059000,  도통동,'55,50 - 54세,1998,384,198,186
'4519059000,  도통동,'60,55 - 59세,1998,370,158,212
'4519059000,  도통동,'65,60 - 64세,1998,356,162,194
'4519059000,  도통동,'70,65 - 69세,1998,216,83,133
'4519059000,  도통동,'75,70 - 74세,1998,187,65,122
'4519059000,  도통동,'80,75 - 79세,1998,115,51,64
'4519059000,  도통동,'85,80 - 84세,1998,68,14,54
'4519059000,  도통동,'90,85+ ,1998,30,3,27
'45210, 김제시,'00,계,1998,121636,60838,60798
'45210, 김제시,'05,0 - 4세,1998,6501,3410,3091
'45210, 김제시,'10,5 - 9세,1998,6424,3249,3175
'45210, 김제시,'15,10 - 14세,1998,6998,3608,3390
'45210, 김제시,'20,15 - 19세,1998,10950,5613,5337
'45210, 김제시,'25,20 - 24세,1998,12232,6801,5431
'45210, 김제시,'30,25 - 29세,1998,9869,5832,4037
'45210, 김제시,'35,30 - 34세,1998,7847,4379,3468
'45210, 김제시,'40,35 - 39세,1998,7997,4286,3711
'45210, 김제시,'45,40 - 44세,1998,7520,3993,3527
'45210, 김제시,'50,45 - 49세,1998,6526,3241,3285
'45210, 김제시,'55,50 - 54세,1998,6215,3056,3159
'45210, 김제시,'60,55 - 59세,1998,8068,3550,4518
'45210, 김제시,'65,60 - 64세,1998,7946,3426,4520
'45210, 김제시,'70,65 - 69세,1998,6717,2765,3952
'45210, 김제시,'75,70 - 74세,1998,4419,1880,2539
'45210, 김제시,'80,75 - 79세,1998,2961,1102,1859
'45210, 김제시,'85,80 - 84세,1998,1553,471,1082
'45210, 김제시,'90,85+ ,1998,893,176,717
'4521025000,  만경읍,'00,계,1998,5007,2517,2490
'4521025000,  만경읍,'05,0 - 4세,1998,223,131,92
'4521025000,  만경읍,'10,5 - 9세,1998,229,124,105
'4521025000,  만경읍,'15,10 - 14세,1998,278,159,119
'4521025000,  만경읍,'20,15 - 19세,1998,469,230,239
'4521025000,  만경읍,'25,20 - 24세,1998,525,298,227
'4521025000,  만경읍,'30,25 - 29세,1998,377,232,145
'4521025000,  만경읍,'35,30 - 34세,1998,271,150,121
'4521025000,  만경읍,'40,35 - 39세,1998,293,144,149
'4521025000,  만경읍,'45,40 - 44세,1998,324,184,140
'4521025000,  만경읍,'50,45 - 49세,1998,282,154,128
'4521025000,  만경읍,'55,50 - 54세,1998,257,128,129
'4521025000,  만경읍,'60,55 - 59세,1998,362,158,204
'4521025000,  만경읍,'65,60 - 64세,1998,330,131,199
'4521025000,  만경읍,'70,65 - 69세,1998,317,120,197
'4521025000,  만경읍,'75,70 - 74세,1998,209,86,123
'4521025000,  만경읍,'80,75 - 79세,1998,159,57,102
'4521025000,  만경읍,'85,80 - 84세,1998,66,24,42
'4521025000,  만경읍,'90,85+ ,1998,36,7,29
'4521032000,  죽산면,'00,계,1998,5107,2585,2522
'4521032000,  죽산면,'05,0 - 4세,1998,171,80,91
'4521032000,  죽산면,'10,5 - 9세,1998,152,73,79
'4521032000,  죽산면,'15,10 - 14세,1998,243,131,112
'4521032000,  죽산면,'20,15 - 19세,1998,482,243,239
'4521032000,  죽산면,'25,20 - 24세,1998,552,317,235
'4521032000,  죽산면,'30,25 - 29세,1998,324,232,92
'4521032000,  죽산면,'35,30 - 34세,1998,244,139,105
'4521032000,  죽산면,'40,35 - 39세,1998,272,162,110
'4521032000,  죽산면,'45,40 - 44세,1998,323,165,158
'4521032000,  죽산면,'50,45 - 49세,1998,296,165,131
'4521032000,  죽산면,'55,50 - 54세,1998,304,161,143
'4521032000,  죽산면,'60,55 - 59세,1998,433,184,249
'4521032000,  죽산면,'65,60 - 64세,1998,429,187,242
'4521032000,  죽산면,'70,65 - 69세,1998,384,154,230
'4521032000,  죽산면,'75,70 - 74세,1998,225,93,132
'4521032000,  죽산면,'80,75 - 79세,1998,135,55,80
'4521032000,  죽산면,'85,80 - 84세,1998,94,32,62
'4521032000,  죽산면,'90,85+ ,1998,44,12,32
'4521033000,  백산면,'00,계,1998,4701,2385,2316
'4521033000,  백산면,'05,0 - 4세,1998,156,82,74
'4521033000,  백산면,'10,5 - 9세,1998,153,71,82
'4521033000,  백산면,'15,10 - 14세,1998,247,136,111
'4521033000,  백산면,'20,15 - 19세,1998,483,230,253
'4521033000,  백산면,'25,20 - 24세,1998,551,301,250
'4521033000,  백산면,'30,25 - 29세,1998,327,233,94
'4521033000,  백산면,'35,30 - 34세,1998,221,141,80
'4521033000,  백산면,'40,35 - 39세,1998,267,151,116
'4521033000,  백산면,'45,40 - 44세,1998,277,129,148
'4521033000,  백산면,'50,45 - 49세,1998,297,146,151
'4521033000,  백산면,'55,50 - 54세,1998,286,145,141
'4521033000,  백산면,'60,55 - 59세,1998,355,158,197
'4521033000,  백산면,'65,60 - 64세,1998,347,161,186
'4521033000,  백산면,'70,65 - 69세,1998,285,120,165
'4521033000,  백산면,'75,70 - 74세,1998,225,108,117
'4521033000,  백산면,'80,75 - 79세,1998,114,45,69
'4521033000,  백산면,'85,80 - 84세,1998,64,18,46
'4521033000,  백산면,'90,85+ ,1998,46,10,36
'4521034000,  용지면,'00,계,1998,6786,3426,3360
'4521034000,  용지면,'05,0 - 4세,1998,280,146,134
'4521034000,  용지면,'10,5 - 9세,1998,318,147,171
'4521034000,  용지면,'15,10 - 14세,1998,363,160,203
'4521034000,  용지면,'20,15 - 19세,1998,635,335,300
'4521034000,  용지면,'25,20 - 24세,1998,722,410,312
'4521034000,  용지면,'30,25 - 29세,1998,542,348,194
'4521034000,  용지면,'35,30 - 34세,1998,350,207,143
'4521034000,  용지면,'40,35 - 39세,1998,429,245,184
'4521034000,  용지면,'45,40 - 44세,1998,432,219,213
'4521034000,  용지면,'50,45 - 49세,1998,388,211,177
'4521034000,  용지면,'55,50 - 54세,1998,362,174,188
'4521034000,  용지면,'60,55 - 59세,1998,474,218,256
'4521034000,  용지면,'65,60 - 64세,1998,449,192,257
'4521034000,  용지면,'70,65 - 69세,1998,411,169,242
'4521034000,  용지면,'75,70 - 74세,1998,289,132,157
'4521034000,  용지면,'80,75 - 79세,1998,189,70,119
'4521034000,  용지면,'85,80 - 84세,1998,95,30,65
'4521034000,  용지면,'90,85+ ,1998,58,13,45
'4521035000,  백구면,'00,계,1998,7237,3626,3611
'4521035000,  백구면,'05,0 - 4세,1998,325,154,171
'4521035000,  백구면,'10,5 - 9세,1998,343,166,177
'4521035000,  백구면,'15,10 - 14세,1998,417,224,193
'4521035000,  백구면,'20,15 - 19세,1998,678,357,321
'4521035000,  백구면,'25,20 - 24세,1998,814,452,362
'4521035000,  백구면,'30,25 - 29세,1998,615,368,247
'4521035000,  백구면,'35,30 - 34세,1998,411,238,173
'4521035000,  백구면,'40,35 - 39세,1998,453,242,211
'4521035000,  백구면,'45,40 - 44세,1998,448,238,210
'4521035000,  백구면,'50,45 - 49세,1998,438,207,231
'4521035000,  백구면,'55,50 - 54세,1998,382,183,199
'4521035000,  백구면,'60,55 - 59세,1998,496,217,279
'4521035000,  백구면,'65,60 - 64세,1998,507,224,283
'4521035000,  백구면,'70,65 - 69세,1998,349,147,202
'4521035000,  백구면,'75,70 - 74세,1998,259,121,138
'4521035000,  백구면,'80,75 - 79세,1998,160,61,99
'4521035000,  백구면,'85,80 - 84세,1998,87,18,69
'4521035000,  백구면,'90,85+ ,1998,55,9,46
'4521036000,  부량면,'00,계,1998,2701,1342,1359
'4521036000,  부량면,'05,0 - 4세,1998,81,39,42
'4521036000,  부량면,'10,5 - 9세,1998,82,43,39
'4521036000,  부량면,'15,10 - 14세,1998,144,75,69
'4521036000,  부량면,'20,15 - 19세,1998,254,147,107
'4521036000,  부량면,'25,20 - 24세,1998,278,170,108
'4521036000,  부량면,'30,25 - 29세,1998,177,116,61
'4521036000,  부량면,'35,30 - 34세,1998,114,70,44
'4521036000,  부량면,'40,35 - 39세,1998,131,71,60
'4521036000,  부량면,'45,40 - 44세,1998,154,80,74
'4521036000,  부량면,'50,45 - 49세,1998,170,76,94
'4521036000,  부량면,'55,50 - 54세,1998,130,58,72
'4521036000,  부량면,'60,55 - 59세,1998,239,93,146
'4521036000,  부량면,'65,60 - 64세,1998,266,112,154
'4521036000,  부량면,'70,65 - 69세,1998,205,79,126
'4521036000,  부량면,'75,70 - 74세,1998,127,57,70
'4521036000,  부량면,'80,75 - 79세,1998,87,42,45
'4521036000,  부량면,'85,80 - 84세,1998,41,13,28
'4521036000,  부량면,'90,85+ ,1998,21,1,20
'4521038000,  공덕면,'00,계,1998,4674,2352,2322
'4521038000,  공덕면,'05,0 - 4세,1998,187,93,94
'4521038000,  공덕면,'10,5 - 9세,1998,162,85,77
'4521038000,  공덕면,'15,10 - 14세,1998,260,149,111
'4521038000,  공덕면,'20,15 - 19세,1998,462,243,219
'4521038000,  공덕면,'25,20 - 24세,1998,493,272,221
'4521038000,  공덕면,'30,25 - 29세,1998,359,219,140
'4521038000,  공덕면,'35,30 - 34세,1998,231,141,90
'4521038000,  공덕면,'40,35 - 39세,1998,276,159,117
'4521038000,  공덕면,'45,40 - 44세,1998,296,150,146
'4521038000,  공덕면,'50,45 - 49세,1998,231,116,115
'4521038000,  공덕면,'55,50 - 54세,1998,232,126,106
'4521038000,  공덕면,'60,55 - 59세,1998,330,135,195
'4521038000,  공덕면,'65,60 - 64세,1998,347,144,203
'4521038000,  공덕면,'70,65 - 69세,1998,335,144,191
'4521038000,  공덕면,'75,70 - 74세,1998,213,86,127
'4521038000,  공덕면,'80,75 - 79세,1998,148,52,96
'4521038000,  공덕면,'85,80 - 84세,1998,74,27,47
'4521038000,  공덕면,'90,85+ ,1998,38,11,27
'4521039000,  청하면,'00,계,1998,3439,1772,1667
'4521039000,  청하면,'05,0 - 4세,1998,105,60,45
'4521039000,  청하면,'10,5 - 9세,1998,133,79,54
'4521039000,  청하면,'15,10 - 14세,1998,177,95,82
'4521039000,  청하면,'20,15 - 19세,1998,318,168,150
'4521039000,  청하면,'25,20 - 24세,1998,383,231,152
'4521039000,  청하면,'30,25 - 29세,1998,227,157,70
'4521039000,  청하면,'35,30 - 34세,1998,164,94,70
'4521039000,  청하면,'40,35 - 39세,1998,174,98,76
'4521039000,  청하면,'45,40 - 44세,1998,214,112,102
'4521039000,  청하면,'50,45 - 49세,1998,192,104,88
'4521039000,  청하면,'55,50 - 54세,1998,187,93,94
'4521039000,  청하면,'60,55 - 59세,1998,261,117,144
'4521039000,  청하면,'65,60 - 64세,1998,262,125,137
'4521039000,  청하면,'70,65 - 69세,1998,254,100,154
'4521039000,  청하면,'75,70 - 74세,1998,178,65,113
'4521039000,  청하면,'80,75 - 79세,1998,108,48,60
'4521039000,  청하면,'85,80 - 84세,1998,60,17,43
'4521039000,  청하면,'90,85+ ,1998,42,9,33
'4521040000,  성덕면,'00,계,1998,3360,1711,1649
'4521040000,  성덕면,'05,0 - 4세,1998,137,73,64
'4521040000,  성덕면,'10,5 - 9세,1998,112,59,53
'4521040000,  성덕면,'15,10 - 14세,1998,138,66,72
'4521040000,  성덕면,'20,15 - 19세,1998,308,163,145
'4521040000,  성덕면,'25,20 - 24세,1998,383,230,153
'4521040000,  성덕면,'30,25 - 29세,1998,218,151,67
'4521040000,  성덕면,'35,30 - 34세,1998,160,100,60
'4521040000,  성덕면,'40,35 - 39세,1998,189,108,81
'4521040000,  성덕면,'45,40 - 44세,1998,196,115,81
'4521040000,  성덕면,'50,45 - 49세,1998,174,87,87
'4521040000,  성덕면,'55,50 - 54세,1998,184,90,94
'4521040000,  성덕면,'60,55 - 59세,1998,245,102,143
'4521040000,  성덕면,'65,60 - 64세,1998,281,118,163
'4521040000,  성덕면,'70,65 - 69세,1998,257,104,153
'4521040000,  성덕면,'75,70 - 74세,1998,172,69,103
'4521040000,  성덕면,'80,75 - 79세,1998,106,42,64
'4521040000,  성덕면,'85,80 - 84세,1998,63,28,35
'4521040000,  성덕면,'90,85+ ,1998,37,6,31
'4521041000,  진봉면,'00,계,1998,5064,2553,2511
'4521041000,  진봉면,'05,0 - 4세,1998,153,70,83
'4521041000,  진봉면,'10,5 - 9세,1998,151,77,74
'4521041000,  진봉면,'15,10 - 14세,1998,250,131,119
'4521041000,  진봉면,'20,15 - 19세,1998,444,224,220
'4521041000,  진봉면,'25,20 - 24세,1998,517,313,204
'4521041000,  진봉면,'30,25 - 29세,1998,368,262,106
'4521041000,  진봉면,'35,30 - 34세,1998,225,145,80
'4521041000,  진봉면,'40,35 - 39세,1998,260,138,122
'4521041000,  진봉면,'45,40 - 44세,1998,282,153,129
'4521041000,  진봉면,'50,45 - 49세,1998,311,154,157
'4521041000,  진봉면,'55,50 - 54세,1998,312,148,164
'4521041000,  진봉면,'60,55 - 59세,1998,459,203,256
'4521041000,  진봉면,'65,60 - 64세,1998,433,195,238
'4521041000,  진봉면,'70,65 - 69세,1998,374,163,211
'4521041000,  진봉면,'75,70 - 74세,1998,254,92,162
'4521041000,  진봉면,'80,75 - 79세,1998,132,49,83
'4521041000,  진봉면,'85,80 - 84세,1998,95,28,67
'4521041000,  진봉면,'90,85+ ,1998,44,8,36
'4521042000,  금구면,'00,계,1998,6879,3443,3436
'4521042000,  금구면,'05,0 - 4세,1998,302,157,145
'4521042000,  금구면,'10,5 - 9세,1998,265,133,132
'4521042000,  금구면,'15,10 - 14세,1998,271,123,148
'4521042000,  금구면,'20,15 - 19세,1998,637,328,309
'4521042000,  금구면,'25,20 - 24세,1998,744,386,358
'4521042000,  금구면,'30,25 - 29세,1998,663,412,251
'4521042000,  금구면,'35,30 - 34세,1998,414,260,154
'4521042000,  금구면,'40,35 - 39세,1998,370,222,148
'4521042000,  금구면,'45,40 - 44세,1998,390,210,180
'4521042000,  금구면,'50,45 - 49세,1998,367,164,203
'4521042000,  금구면,'55,50 - 54세,1998,396,194,202
'4521042000,  금구면,'60,55 - 59세,1998,523,233,290
'4521042000,  금구면,'65,60 - 64세,1998,486,214,272
'4521042000,  금구면,'70,65 - 69세,1998,439,177,262
'4521042000,  금구면,'75,70 - 74세,1998,265,127,138
'4521042000,  금구면,'80,75 - 79세,1998,194,71,123
'4521042000,  금구면,'85,80 - 84세,1998,101,29,72
'4521042000,  금구면,'90,85+ ,1998,52,3,49
'4521043000,  봉남면,'00,계,1998,4339,2126,2213
'4521043000,  봉남면,'05,0 - 4세,1998,104,57,47
'4521043000,  봉남면,'10,5 - 9세,1998,156,76,80
'4521043000,  봉남면,'15,10 - 14세,1998,212,105,107
'4521043000,  봉남면,'20,15 - 19세,1998,400,214,186
'4521043000,  봉남면,'25,20 - 24세,1998,469,271,198
'4521043000,  봉남면,'30,25 - 29세,1998,311,209,102
'4521043000,  봉남면,'35,30 - 34세,1998,195,114,81
'4521043000,  봉남면,'40,35 - 39세,1998,210,119,91
'4521043000,  봉남면,'45,40 - 44세,1998,238,135,103
'4521043000,  봉남면,'50,45 - 49세,1998,225,93,132
'4521043000,  봉남면,'55,50 - 54세,1998,262,135,127
'4521043000,  봉남면,'60,55 - 59세,1998,366,145,221
'4521043000,  봉남면,'65,60 - 64세,1998,418,173,245
'4521043000,  봉남면,'70,65 - 69세,1998,302,133,169
'4521043000,  봉남면,'75,70 - 74세,1998,211,73,138
'4521043000,  봉남면,'80,75 - 79세,1998,145,50,95
'4521043000,  봉남면,'85,80 - 84세,1998,76,17,59
'4521043000,  봉남면,'90,85+ ,1998,39,7,32
'4521044000,  황산면,'00,계,1998,3431,1757,1674
'4521044000,  황산면,'05,0 - 4세,1998,145,79,66
'4521044000,  황산면,'10,5 - 9세,1998,130,64,66
'4521044000,  황산면,'15,10 - 14세,1998,172,95,77
'4521044000,  황산면,'20,15 - 19세,1998,293,145,148
'4521044000,  황산면,'25,20 - 24세,1998,385,229,156
'4521044000,  황산면,'30,25 - 29세,1998,253,170,83
'4521044000,  황산면,'35,30 - 34세,1998,184,106,78
'4521044000,  황산면,'40,35 - 39세,1998,184,102,82
'4521044000,  황산면,'45,40 - 44세,1998,191,108,83
'4521044000,  황산면,'50,45 - 49세,1998,165,83,82
'4521044000,  황산면,'55,50 - 54세,1998,194,90,104
'4521044000,  황산면,'60,55 - 59세,1998,295,138,157
'4521044000,  황산면,'65,60 - 64세,1998,295,115,180
'4521044000,  황산면,'70,65 - 69세,1998,207,84,123
'4521044000,  황산면,'75,70 - 74세,1998,137,78,59
'4521044000,  황산면,'80,75 - 79세,1998,110,47,63
'4521044000,  황산면,'85,80 - 84세,1998,61,19,42
'4521044000,  황산면,'90,85+ ,1998,30,5,25
'4521045000,  금산면,'00,계,1998,7645,3840,3805
'4521045000,  금산면,'05,0 - 4세,1998,379,181,198
'4521045000,  금산면,'10,5 - 9세,1998,429,217,212
'4521045000,  금산면,'15,10 - 14세,1998,409,198,211
'4521045000,  금산면,'20,15 - 19세,1998,660,330,330
'4521045000,  금산면,'25,20 - 24세,1998,755,452,303
'4521045000,  금산면,'30,25 - 29세,1998,630,401,229
'4521045000,  금산면,'35,30 - 34세,1998,482,283,199
'4521045000,  금산면,'40,35 - 39세,1998,476,276,200
'4521045000,  금산면,'45,40 - 44세,1998,434,231,203
'4521045000,  금산면,'50,45 - 49세,1998,379,175,204
'4521045000,  금산면,'55,50 - 54세,1998,395,187,208
'4521045000,  금산면,'60,55 - 59세,1998,549,245,304
'4521045000,  금산면,'65,60 - 64세,1998,520,206,314
'4521045000,  금산면,'70,65 - 69세,1998,440,201,239
'4521045000,  금산면,'75,70 - 74세,1998,302,131,171
'4521045000,  금산면,'80,75 - 79세,1998,230,75,155
'4521045000,  금산면,'85,80 - 84세,1998,113,39,74
'4521045000,  금산면,'90,85+ ,1998,63,12,51
'4521046000,  광활면,'00,계,1998,2553,1312,1241
'4521046000,  광활면,'05,0 - 4세,1998,82,48,34
'4521046000,  광활면,'10,5 - 9세,1998,82,44,38
'4521046000,  광활면,'15,10 - 14세,1998,106,52,54
'4521046000,  광활면,'20,15 - 19세,1998,248,133,115
'4521046000,  광활면,'25,20 - 24세,1998,278,166,112
'4521046000,  광활면,'30,25 - 29세,1998,160,113,47
'4521046000,  광활면,'35,30 - 34세,1998,108,60,48
'4521046000,  광활면,'40,35 - 39세,1998,135,83,52
'4521046000,  광활면,'45,40 - 44세,1998,140,72,68
'4521046000,  광활면,'50,45 - 49세,1998,153,77,76
'4521046000,  광활면,'55,50 - 54세,1998,182,89,93
'4521046000,  광활면,'60,55 - 59세,1998,220,96,124
'4521046000,  광활면,'65,60 - 64세,1998,226,100,126
'4521046000,  광활면,'70,65 - 69세,1998,196,80,116
'4521046000,  광활면,'75,70 - 74세,1998,124,54,70
'4521046000,  광활면,'80,75 - 79세,1998,79,37,42
'4521046000,  광활면,'85,80 - 84세,1998,24,6,18
'4521046000,  광활면,'90,85+ ,1998,10,2,8
'4521051000,  요촌동,'00,계,1998,13621,6720,6901
'4521051000,  요촌동,'05,0 - 4세,1998,848,434,414
'4521051000,  요촌동,'10,5 - 9세,1998,1219,634,585
'4521051000,  요촌동,'15,10 - 14세,1998,1123,564,559
'4521051000,  요촌동,'20,15 - 19세,1998,1302,667,635
'4521051000,  요촌동,'25,20 - 24세,1998,1233,635,598
'4521051000,  요촌동,'30,25 - 29세,1998,1005,523,482
'4521051000,  요촌동,'35,30 - 34세,1998,993,458,535
'4521051000,  요촌동,'40,35 - 39세,1998,1153,527,626
'4521051000,  요촌동,'45,40 - 44세,1998,1048,546,502
'4521051000,  요촌동,'50,45 - 49세,1998,796,407,389
'4521051000,  요촌동,'55,50 - 54세,1998,642,336,306
'4521051000,  요촌동,'60,55 - 59세,1998,613,295,318
'4521051000,  요촌동,'65,60 - 64세,1998,565,265,300
'4521051000,  요촌동,'70,65 - 69세,1998,472,198,274
'4521051000,  요촌동,'75,70 - 74세,1998,273,124,149
'4521051000,  요촌동,'80,75 - 79세,1998,183,66,117
'4521051000,  요촌동,'85,80 - 84세,1998,91,26,65
'4521051000,  요촌동,'90,85+ ,1998,62,15,47
'4521052000,  신풍동,'00,계,1998,15020,7414,7606
'4521052000,  신풍동,'05,0 - 4세,1998,1106,614,492
'4521052000,  신풍동,'10,5 - 9세,1998,1181,584,597
'4521052000,  신풍동,'15,10 - 14세,1998,1010,532,478
'4521052000,  신풍동,'20,15 - 19세,1998,1222,627,595
'4521052000,  신풍동,'25,20 - 24세,1998,1310,706,604
'4521052000,  신풍동,'30,25 - 29세,1998,1277,657,620
'4521052000,  신풍동,'35,30 - 34세,1998,1265,618,647
'4521052000,  신풍동,'40,35 - 39세,1998,1264,637,627
'4521052000,  신풍동,'45,40 - 44세,1998,953,521,432
'4521052000,  신풍동,'50,45 - 49세,1998,681,349,332
'4521052000,  신풍동,'55,50 - 54세,1998,624,289,335
'4521052000,  신풍동,'60,55 - 59세,1998,807,348,459
'4521052000,  신풍동,'65,60 - 64세,1998,785,348,437
'4521052000,  신풍동,'70,65 - 69세,1998,626,273,353
'4521052000,  신풍동,'75,70 - 74세,1998,398,161,237
'4521052000,  신풍동,'80,75 - 79세,1998,271,95,176
'4521052000,  신풍동,'85,80 - 84세,1998,148,40,108
'4521052000,  신풍동,'90,85+ ,1998,92,15,77
'4521054000,  검산동,'00,계,1998,10231,5052,5179
'4521054000,  검산동,'05,0 - 4세,1998,1183,629,554
'4521054000,  검산동,'10,5 - 9세,1998,582,295,287
'4521054000,  검산동,'15,10 - 14세,1998,571,299,272
'4521054000,  검산동,'20,15 - 19세,1998,761,373,388
'4521054000,  검산동,'25,20 - 24세,1998,875,438,437
'4521054000,  검산동,'30,25 - 29세,1998,1240,581,659
'4521054000,  검산동,'35,30 - 34세,1998,1187,706,481
'4521054000,  검산동,'40,35 - 39세,1998,790,449,341
'4521054000,  검산동,'45,40 - 44세,1998,561,286,275
'4521054000,  검산동,'50,45 - 49세,1998,410,186,224
'4521054000,  검산동,'55,50 - 54세,1998,366,175,191
'4521054000,  검산동,'60,55 - 59세,1998,401,180,221
'4521054000,  검산동,'65,60 - 64세,1998,419,152,267
'4521054000,  검산동,'70,65 - 69세,1998,354,126,228
'4521054000,  검산동,'75,70 - 74세,1998,222,87,135
'4521054000,  검산동,'80,75 - 79세,1998,184,55,129
'4521054000,  검산동,'85,80 - 84세,1998,78,24,54
'4521054000,  검산동,'90,85+ ,1998,47,11,36
'4521056500,  교동월촌동,'00,계,1998,9841,4905,4936
'4521056500,  교동월촌동,'05,0 - 4세,1998,534,283,251
'4521056500,  교동월촌동,'10,5 - 9세,1998,545,278,267
'4521056500,  교동월촌동,'15,10 - 14세,1998,607,314,293
'4521056500,  교동월촌동,'20,15 - 19세,1998,894,456,438
'4521056500,  교동월촌동,'25,20 - 24세,1998,965,524,441
'4521056500,  교동월촌동,'30,25 - 29세,1998,796,448,348
'4521056500,  교동월촌동,'35,30 - 34세,1998,628,349,279
'4521056500,  교동월촌동,'40,35 - 39세,1998,671,353,318
'4521056500,  교동월촌동,'45,40 - 44세,1998,619,339,280
'4521056500,  교동월촌동,'50,45 - 49세,1998,571,287,284
'4521056500,  교동월촌동,'55,50 - 54세,1998,518,255,263
'4521056500,  교동월촌동,'60,55 - 59세,1998,640,285,355
'4521056500,  교동월촌동,'65,60 - 64세,1998,581,264,317
'4521056500,  교동월촌동,'70,65 - 69세,1998,510,193,317
'4521056500,  교동월촌동,'75,70 - 74세,1998,336,136,200
'4521056500,  교동월촌동,'80,75 - 79세,1998,227,85,142
'4521056500,  교동월촌동,'85,80 - 84세,1998,122,36,86
'4521056500,  교동월촌동,'90,85+ ,1998,77,20,57
'45710, 완주군,'00,계,1998,86138,43991,42147
'45710, 완주군,'05,0 - 4세,1998,5802,3010,2792
'45710, 완주군,'10,5 - 9세,1998,4540,2348,2192
'45710, 완주군,'15,10 - 14세,1998,4263,2104,2159
'45710, 완주군,'20,15 - 19세,1998,7509,3860,3649
'45710, 완주군,'25,20 - 24세,1998,8723,4675,4048
'45710, 완주군,'30,25 - 29세,1998,8619,4986,3633
'45710, 완주군,'35,30 - 34세,1998,6459,3899,2560
'45710, 완주군,'40,35 - 39세,1998,5800,3385,2415
'45710, 완주군,'45,40 - 44세,1998,4911,2676,2235
'45710, 완주군,'50,45 - 49세,1998,4315,2196,2119
'45710, 완주군,'55,50 - 54세,1998,4352,2139,2213
'45710, 완주군,'60,55 - 59세,1998,5390,2397,2993
'45710, 완주군,'65,60 - 64세,1998,5388,2396,2992
'45710, 완주군,'70,65 - 69세,1998,3869,1631,2238
'45710, 완주군,'75,70 - 74세,1998,2759,1122,1637
'45710, 완주군,'80,75 - 79세,1998,1922,729,1193
'45710, 완주군,'85,80 - 84세,1998,960,322,638
'45710, 완주군,'90,85+ ,1998,557,116,441
'4571025000,  삼례읍,'00,계,1998,19269,9731,9538
'4571025000,  삼례읍,'05,0 - 4세,1998,1673,869,804
'4571025000,  삼례읍,'10,5 - 9세,1998,1111,587,524
'4571025000,  삼례읍,'15,10 - 14세,1998,911,446,465
'4571025000,  삼례읍,'20,15 - 19세,1998,1628,836,792
'4571025000,  삼례읍,'25,20 - 24세,1998,1925,926,999
'4571025000,  삼례읍,'30,25 - 29세,1998,2365,1265,1100
'4571025000,  삼례읍,'35,30 - 34세,1998,1699,1013,686
'4571025000,  삼례읍,'40,35 - 39세,1998,1357,764,593
'4571025000,  삼례읍,'45,40 - 44세,1998,1101,592,509
'4571025000,  삼례읍,'50,45 - 49세,1998,914,468,446
'4571025000,  삼례읍,'55,50 - 54세,1998,875,435,440
'4571025000,  삼례읍,'60,55 - 59세,1998,982,429,553
'4571025000,  삼례읍,'65,60 - 64세,1998,964,443,521
'4571025000,  삼례읍,'70,65 - 69세,1998,738,302,436
'4571025000,  삼례읍,'75,70 - 74세,1998,480,176,304
'4571025000,  삼례읍,'80,75 - 79세,1998,314,114,200
'4571025000,  삼례읍,'85,80 - 84세,1998,149,50,99
'4571025000,  삼례읍,'90,85+ ,1998,83,16,67
'4571025300,  봉동읍,'00,계,1998,15816,8190,7626
'4571025300,  봉동읍,'05,0 - 4세,1998,1379,722,657
'4571025300,  봉동읍,'10,5 - 9세,1998,1135,587,548
'4571025300,  봉동읍,'15,10 - 14세,1998,876,431,445
'4571025300,  봉동읍,'20,15 - 19세,1998,1297,668,629
'4571025300,  봉동읍,'25,20 - 24세,1998,1376,757,619
'4571025300,  봉동읍,'30,25 - 29세,1998,1670,942,728
'4571025300,  봉동읍,'35,30 - 34세,1998,1552,907,645
'4571025300,  봉동읍,'40,35 - 39세,1998,1215,715,500
'4571025300,  봉동읍,'45,40 - 44세,1998,914,502,412
'4571025300,  봉동읍,'50,45 - 49세,1998,725,369,356
'4571025300,  봉동읍,'55,50 - 54세,1998,673,338,335
'4571025300,  봉동읍,'60,55 - 59세,1998,785,352,433
'4571025300,  봉동읍,'65,60 - 64세,1998,808,358,450
'4571025300,  봉동읍,'70,65 - 69세,1998,537,220,317
'4571025300,  봉동읍,'75,70 - 74세,1998,387,146,241
'4571025300,  봉동읍,'80,75 - 79세,1998,283,116,167
'4571025300,  봉동읍,'85,80 - 84세,1998,119,45,74
'4571025300,  봉동읍,'90,85+ ,1998,85,15,70
'4571031000,  용진면,'00,계,1998,7878,4073,3805
'4571031000,  용진면,'05,0 - 4세,1998,560,288,272
'4571031000,  용진면,'10,5 - 9세,1998,353,187,166
'4571031000,  용진면,'15,10 - 14세,1998,351,176,175
'4571031000,  용진면,'20,15 - 19세,1998,660,361,299
'4571031000,  용진면,'25,20 - 24세,1998,899,469,430
'4571031000,  용진면,'30,25 - 29세,1998,920,520,400
'4571031000,  용진면,'35,30 - 34세,1998,592,370,222
'4571031000,  용진면,'40,35 - 39세,1998,473,300,173
'4571031000,  용진면,'45,40 - 44세,1998,430,227,203
'4571031000,  용진면,'50,45 - 49세,1998,409,203,206
'4571031000,  용진면,'55,50 - 54세,1998,401,198,203
'4571031000,  용진면,'60,55 - 59세,1998,472,208,264
'4571031000,  용진면,'65,60 - 64세,1998,501,231,270
'4571031000,  용진면,'70,65 - 69세,1998,312,132,180
'4571031000,  용진면,'75,70 - 74세,1998,239,92,147
'4571031000,  용진면,'80,75 - 79세,1998,172,69,103
'4571031000,  용진면,'85,80 - 84세,1998,86,32,54
'4571031000,  용진면,'90,85+ ,1998,48,10,38
'4571032000,  상관면,'00,계,1998,3958,2022,1936
'4571032000,  상관면,'05,0 - 4세,1998,253,126,127
'4571032000,  상관면,'10,5 - 9세,1998,186,85,101
'4571032000,  상관면,'15,10 - 14세,1998,164,85,79
'4571032000,  상관면,'20,15 - 19세,1998,334,170,164
'4571032000,  상관면,'25,20 - 24세,1998,430,220,210
'4571032000,  상관면,'30,25 - 29세,1998,395,235,160
'4571032000,  상관면,'35,30 - 34세,1998,288,183,105
'4571032000,  상관면,'40,35 - 39세,1998,263,168,95
'4571032000,  상관면,'45,40 - 44세,1998,211,119,92
'4571032000,  상관면,'50,45 - 49세,1998,222,120,102
'4571032000,  상관면,'55,50 - 54세,1998,223,101,122
'4571032000,  상관면,'60,55 - 59세,1998,239,114,125
'4571032000,  상관면,'65,60 - 64세,1998,261,119,142
'4571032000,  상관면,'70,65 - 69세,1998,181,61,120
'4571032000,  상관면,'75,70 - 74세,1998,133,55,78
'4571032000,  상관면,'80,75 - 79세,1998,96,37,59
'4571032000,  상관면,'85,80 - 84세,1998,53,18,35
'4571032000,  상관면,'90,85+ ,1998,26,6,20
'4571033000,  이서면,'00,계,1998,5984,3090,2894
'4571033000,  이서면,'05,0 - 4세,1998,299,161,138
'4571033000,  이서면,'10,5 - 9세,1998,282,155,127
'4571033000,  이서면,'15,10 - 14세,1998,265,124,141
'4571033000,  이서면,'20,15 - 19세,1998,556,277,279
'4571033000,  이서면,'25,20 - 24세,1998,666,365,301
'4571033000,  이서면,'30,25 - 29세,1998,561,358,203
'4571033000,  이서면,'35,30 - 34세,1998,349,224,125
'4571033000,  이서면,'40,35 - 39세,1998,379,218,161
'4571033000,  이서면,'45,40 - 44세,1998,325,180,145
'4571033000,  이서면,'50,45 - 49세,1998,307,150,157
'4571033000,  이서면,'55,50 - 54세,1998,327,166,161
'4571033000,  이서면,'60,55 - 59세,1998,449,194,255
'4571033000,  이서면,'65,60 - 64세,1998,427,190,237
'4571033000,  이서면,'70,65 - 69세,1998,321,155,166
'4571033000,  이서면,'75,70 - 74세,1998,228,100,128
'4571033000,  이서면,'80,75 - 79세,1998,131,46,85
'4571033000,  이서면,'85,80 - 84세,1998,68,19,49
'4571033000,  이서면,'90,85+ ,1998,44,8,36
'4571034000,  소양면,'00,계,1998,8036,4149,3887
'4571034000,  소양면,'05,0 - 4세,1998,447,228,219
'4571034000,  소양면,'10,5 - 9세,1998,372,194,178
'4571034000,  소양면,'15,10 - 14세,1998,434,201,233
'4571034000,  소양면,'20,15 - 19세,1998,773,414,359
'4571034000,  소양면,'25,20 - 24세,1998,817,471,346
'4571034000,  소양면,'30,25 - 29세,1998,707,408,299
'4571034000,  소양면,'35,30 - 34세,1998,513,309,204
'4571034000,  소양면,'40,35 - 39세,1998,531,306,225
'4571034000,  소양면,'45,40 - 44세,1998,536,276,260
'4571034000,  소양면,'50,45 - 49세,1998,460,254,206
'4571034000,  소양면,'55,50 - 54세,1998,441,221,220
'4571034000,  소양면,'60,55 - 59세,1998,516,253,263
'4571034000,  소양면,'65,60 - 64세,1998,489,215,274
'4571034000,  소양면,'70,65 - 69세,1998,366,161,205
'4571034000,  소양면,'75,70 - 74세,1998,250,107,143
'4571034000,  소양면,'80,75 - 79세,1998,204,75,129
'4571034000,  소양면,'85,80 - 84세,1998,117,41,76
'4571034000,  소양면,'90,85+ ,1998,63,15,48
'4571035000,  구이면,'00,계,1998,6711,3393,3318
'4571035000,  구이면,'05,0 - 4세,1998,366,184,182
'4571035000,  구이면,'10,5 - 9세,1998,307,144,163
'4571035000,  구이면,'15,10 - 14세,1998,275,130,145
'4571035000,  구이면,'20,15 - 19세,1998,557,288,269
'4571035000,  구이면,'25,20 - 24세,1998,756,413,343
'4571035000,  구이면,'30,25 - 29세,1998,619,381,238
'4571035000,  구이면,'35,30 - 34세,1998,409,256,153
'4571035000,  구이면,'40,35 - 39세,1998,423,260,163
'4571035000,  구이면,'45,40 - 44세,1998,321,186,135
'4571035000,  구이면,'50,45 - 49세,1998,324,158,166
'4571035000,  구이면,'55,50 - 54세,1998,382,181,201
'4571035000,  구이면,'60,55 - 59세,1998,522,224,298
'4571035000,  구이면,'65,60 - 64세,1998,494,217,277
'4571035000,  구이면,'70,65 - 69세,1998,364,144,220
'4571035000,  구이면,'75,70 - 74세,1998,257,118,139
'4571035000,  구이면,'80,75 - 79세,1998,188,68,120
'4571035000,  구이면,'85,80 - 84세,1998,97,30,67
'4571035000,  구이면,'90,85+ ,1998,50,11,39
'4571036000,  고산면,'00,계,1998,6501,3277,3224
'4571036000,  고산면,'05,0 - 4세,1998,311,172,139
'4571036000,  고산면,'10,5 - 9세,1998,285,155,130
'4571036000,  고산면,'15,10 - 14세,1998,394,195,199
'4571036000,  고산면,'20,15 - 19세,1998,674,333,341
'4571036000,  고산면,'25,20 - 24세,1998,637,344,293
'4571036000,  고산면,'30,25 - 29세,1998,542,338,204
'4571036000,  고산면,'35,30 - 34세,1998,401,244,157
'4571036000,  고산면,'40,35 - 39세,1998,418,225,193
'4571036000,  고산면,'45,40 - 44세,1998,381,209,172
'4571036000,  고산면,'50,45 - 49세,1998,363,183,180
'4571036000,  고산면,'55,50 - 54세,1998,341,162,179
'4571036000,  고산면,'60,55 - 59세,1998,440,200,240
'4571036000,  고산면,'65,60 - 64세,1998,449,193,256
'4571036000,  고산면,'70,65 - 69세,1998,306,123,183
'4571036000,  고산면,'75,70 - 74세,1998,247,100,147
'4571036000,  고산면,'80,75 - 79세,1998,167,62,105
'4571036000,  고산면,'85,80 - 84세,1998,95,29,66
'4571036000,  고산면,'90,85+ ,1998,50,10,40
'4571037000,  비봉면,'00,계,1998,2690,1374,1316
'4571037000,  비봉면,'05,0 - 4세,1998,121,65,56
'4571037000,  비봉면,'10,5 - 9세,1998,100,49,51
'4571037000,  비봉면,'15,10 - 14세,1998,136,70,66
'4571037000,  비봉면,'20,15 - 19세,1998,233,118,115
'4571037000,  비봉면,'25,20 - 24세,1998,291,164,127
'4571037000,  비봉면,'30,25 - 29세,1998,218,149,69
'4571037000,  비봉면,'35,30 - 34세,1998,156,101,55
'4571037000,  비봉면,'40,35 - 39세,1998,157,91,66
'4571037000,  비봉면,'45,40 - 44세,1998,142,79,63
'4571037000,  비봉면,'50,45 - 49세,1998,119,57,62
'4571037000,  비봉면,'55,50 - 54세,1998,147,71,76
'4571037000,  비봉면,'60,55 - 59세,1998,215,102,113
'4571037000,  비봉면,'65,60 - 64세,1998,205,96,109
'4571037000,  비봉면,'70,65 - 69세,1998,172,63,109
'4571037000,  비봉면,'75,70 - 74세,1998,127,51,76
'4571037000,  비봉면,'80,75 - 79세,1998,85,30,55
'4571037000,  비봉면,'85,80 - 84세,1998,40,14,26
'4571037000,  비봉면,'90,85+ ,1998,26,4,22
'4571038000,  운주면,'00,계,1998,2693,1357,1336
'4571038000,  운주면,'05,0 - 4세,1998,90,43,47
'4571038000,  운주면,'10,5 - 9세,1998,111,56,55
'4571038000,  운주면,'15,10 - 14세,1998,138,82,56
'4571038000,  운주면,'20,15 - 19세,1998,251,122,129
'4571038000,  운주면,'25,20 - 24세,1998,255,156,99
'4571038000,  운주면,'30,25 - 29세,1998,149,94,55
'4571038000,  운주면,'35,30 - 34세,1998,137,80,57
'4571038000,  운주면,'40,35 - 39세,1998,162,84,78
'4571038000,  운주면,'45,40 - 44세,1998,176,94,82
'4571038000,  운주면,'50,45 - 49세,1998,147,78,69
'4571038000,  운주면,'55,50 - 54세,1998,179,84,95
'4571038000,  운주면,'60,55 - 59세,1998,254,112,142
'4571038000,  운주면,'65,60 - 64세,1998,224,96,128
'4571038000,  운주면,'70,65 - 69세,1998,165,73,92
'4571038000,  운주면,'75,70 - 74세,1998,119,48,71
'4571038000,  운주면,'80,75 - 79세,1998,82,36,46
'4571038000,  운주면,'85,80 - 84세,1998,36,13,23
'4571038000,  운주면,'90,85+ ,1998,18,6,12
'4571039000,  화산면,'00,계,1998,3711,1884,1827
'4571039000,  화산면,'05,0 - 4세,1998,150,79,71
'4571039000,  화산면,'10,5 - 9세,1998,143,66,77
'4571039000,  화산면,'15,10 - 14세,1998,197,108,89
'4571039000,  화산면,'20,15 - 19세,1998,320,161,159
'4571039000,  화산면,'25,20 - 24세,1998,386,234,152
'4571039000,  화산면,'30,25 - 29세,1998,261,164,97
'4571039000,  화산면,'35,30 - 34세,1998,171,113,58
'4571039000,  화산면,'40,35 - 39세,1998,228,132,96
'4571039000,  화산면,'45,40 - 44세,1998,192,101,91
'4571039000,  화산면,'50,45 - 49세,1998,200,95,105
'4571039000,  화산면,'55,50 - 54세,1998,203,106,97
'4571039000,  화산면,'60,55 - 59세,1998,293,110,183
'4571039000,  화산면,'65,60 - 64세,1998,316,136,180
'4571039000,  화산면,'70,65 - 69세,1998,255,123,132
'4571039000,  화산면,'75,70 - 74세,1998,178,80,98
'4571039000,  화산면,'80,75 - 79세,1998,112,47,65
'4571039000,  화산면,'85,80 - 84세,1998,64,19,45
'4571039000,  화산면,'90,85+ ,1998,42,10,32
'4571040000,  동상면,'00,계,1998,1506,757,749
'4571040000,  동상면,'05,0 - 4세,1998,93,40,53
'4571040000,  동상면,'10,5 - 9세,1998,92,48,44
'4571040000,  동상면,'15,10 - 14세,1998,69,34,35
'4571040000,  동상면,'20,15 - 19세,1998,107,53,54
'4571040000,  동상면,'25,20 - 24세,1998,137,73,64
'4571040000,  동상면,'30,25 - 29세,1998,113,70,43
'4571040000,  동상면,'35,30 - 34세,1998,127,59,68
'4571040000,  동상면,'40,35 - 39세,1998,129,85,44
'4571040000,  동상면,'45,40 - 44세,1998,100,64,36
'4571040000,  동상면,'50,45 - 49세,1998,48,26,22
'4571040000,  동상면,'55,50 - 54세,1998,83,38,45
'4571040000,  동상면,'60,55 - 59세,1998,101,46,55
'4571040000,  동상면,'65,60 - 64세,1998,114,42,72
'4571040000,  동상면,'70,65 - 69세,1998,70,33,37
'4571040000,  동상면,'75,70 - 74세,1998,56,20,36
'4571040000,  동상면,'80,75 - 79세,1998,41,17,24
'4571040000,  동상면,'85,80 - 84세,1998,17,7,10
'4571040000,  동상면,'90,85+ ,1998,9,2,7
'4571041000,  경천면,'00,계,1998,1385,694,691
'4571041000,  경천면,'05,0 - 4세,1998,60,33,27
'4571041000,  경천면,'10,5 - 9세,1998,63,35,28
'4571041000,  경천면,'15,10 - 14세,1998,53,22,31
'4571041000,  경천면,'20,15 - 19세,1998,119,59,60
'4571041000,  경천면,'25,20 - 24세,1998,148,83,65
'4571041000,  경천면,'30,25 - 29세,1998,99,62,37
'4571041000,  경천면,'35,30 - 34세,1998,65,40,25
'4571041000,  경천면,'40,35 - 39세,1998,65,37,28
'4571041000,  경천면,'45,40 - 44세,1998,82,47,35
'4571041000,  경천면,'50,45 - 49세,1998,77,35,42
'4571041000,  경천면,'55,50 - 54세,1998,77,38,39
'4571041000,  경천면,'60,55 - 59세,1998,122,53,69
'4571041000,  경천면,'65,60 - 64세,1998,136,60,76
'4571041000,  경천면,'70,65 - 69세,1998,82,41,41
'4571041000,  경천면,'75,70 - 74세,1998,58,29,29
'4571041000,  경천면,'80,75 - 79세,1998,47,12,35
'4571041000,  경천면,'85,80 - 84세,1998,19,5,14
'4571041000,  경천면,'90,85+ ,1998,13,3,10
'45720, 진안군,'00,계,1998,34635,17567,17068
'45720, 진안군,'05,0 - 4세,1998,1587,834,753
'45720, 진안군,'10,5 - 9세,1998,1471,794,677
'45720, 진안군,'15,10 - 14세,1998,1693,847,846
'45720, 진안군,'20,15 - 19세,1998,2955,1451,1504
'45720, 진안군,'25,20 - 24세,1998,3628,2083,1545
'45720, 진안군,'30,25 - 29세,1998,2543,1589,954
'45720, 진안군,'35,30 - 34세,1998,1886,1106,780
'45720, 진안군,'40,35 - 39세,1998,2041,1144,897
'45720, 진안군,'45,40 - 44세,1998,1838,1017,821
'45720, 진안군,'50,45 - 49세,1998,1829,910,919
'45720, 진안군,'55,50 - 54세,1998,1997,1011,986
'45720, 진안군,'60,55 - 59세,1998,2737,1216,1521
'45720, 진안군,'65,60 - 64세,1998,2792,1238,1554
'45720, 진안군,'70,65 - 69세,1998,2183,935,1248
'45720, 진안군,'75,70 - 74세,1998,1542,690,852
'45720, 진안군,'80,75 - 79세,1998,1049,437,612
'45720, 진안군,'85,80 - 84세,1998,528,177,351
'45720, 진안군,'90,85+ ,1998,336,88,248
'4572025000,  진안읍,'00,계,1998,12359,6262,6097
'4572025000,  진안읍,'05,0 - 4세,1998,787,406,381
'4572025000,  진안읍,'10,5 - 9세,1998,743,407,336
'4572025000,  진안읍,'15,10 - 14세,1998,761,388,373
'4572025000,  진안읍,'20,15 - 19세,1998,1030,502,528
'4572025000,  진안읍,'25,20 - 24세,1998,1168,653,515
'4572025000,  진안읍,'30,25 - 29세,1998,1005,577,428
'4572025000,  진안읍,'35,30 - 34세,1998,891,488,403
'4572025000,  진안읍,'40,35 - 39세,1998,935,516,419
'4572025000,  진안읍,'45,40 - 44세,1998,682,381,301
'4572025000,  진안읍,'50,45 - 49세,1998,643,323,320
'4572025000,  진안읍,'55,50 - 54세,1998,651,332,319
'4572025000,  진안읍,'60,55 - 59세,1998,788,362,426
'4572025000,  진안읍,'65,60 - 64세,1998,729,316,413
'4572025000,  진안읍,'70,65 - 69세,1998,618,262,356
'4572025000,  진안읍,'75,70 - 74세,1998,420,181,239
'4572025000,  진안읍,'80,75 - 79세,1998,277,105,172
'4572025000,  진안읍,'85,80 - 84세,1998,149,46,103
'4572025000,  진안읍,'90,85+ ,1998,82,17,65
'4572031000,  용담면,'00,계,1998,1259,622,637
'4572031000,  용담면,'05,0 - 4세,1998,43,25,18
'4572031000,  용담면,'10,5 - 9세,1998,30,11,19
'4572031000,  용담면,'15,10 - 14세,1998,41,11,30
'4572031000,  용담면,'20,15 - 19세,1998,97,47,50
'4572031000,  용담면,'25,20 - 24세,1998,120,71,49
'4572031000,  용담면,'30,25 - 29세,1998,81,52,29
'4572031000,  용담면,'35,30 - 34세,1998,66,49,17
'4572031000,  용담면,'40,35 - 39세,1998,55,29,26
'4572031000,  용담면,'45,40 - 44세,1998,74,41,33
'4572031000,  용담면,'50,45 - 49세,1998,76,40,36
'4572031000,  용담면,'55,50 - 54세,1998,93,47,46
'4572031000,  용담면,'60,55 - 59세,1998,130,60,70
'4572031000,  용담면,'65,60 - 64세,1998,126,64,62
'4572031000,  용담면,'70,65 - 69세,1998,77,25,52
'4572031000,  용담면,'75,70 - 74세,1998,68,25,43
'4572031000,  용담면,'80,75 - 79세,1998,45,18,27
'4572031000,  용담면,'85,80 - 84세,1998,26,4,22
'4572031000,  용담면,'90,85+ ,1998,11,3,8
'4572032000,  안천면,'00,계,1998,1481,745,736
'4572032000,  안천면,'05,0 - 4세,1998,40,27,13
'4572032000,  안천면,'10,5 - 9세,1998,27,17,10
'4572032000,  안천면,'15,10 - 14세,1998,39,23,16
'4572032000,  안천면,'20,15 - 19세,1998,112,58,54
'4572032000,  안천면,'25,20 - 24세,1998,189,108,81
'4572032000,  안천면,'30,25 - 29세,1998,110,72,38
'4572032000,  안천면,'35,30 - 34세,1998,46,28,18
'4572032000,  안천면,'40,35 - 39세,1998,61,31,30
'4572032000,  안천면,'45,40 - 44세,1998,65,37,28
'4572032000,  안천면,'50,45 - 49세,1998,71,34,37
'4572032000,  안천면,'55,50 - 54세,1998,96,48,48
'4572032000,  안천면,'60,55 - 59세,1998,154,64,90
'4572032000,  안천면,'65,60 - 64세,1998,150,66,84
'4572032000,  안천면,'70,65 - 69세,1998,127,55,72
'4572032000,  안천면,'75,70 - 74세,1998,88,39,49
'4572032000,  안천면,'80,75 - 79세,1998,63,22,41
'4572032000,  안천면,'85,80 - 84세,1998,24,13,11
'4572032000,  안천면,'90,85+ ,1998,19,3,16
'4572033000,  동향면,'00,계,1998,1926,957,969
'4572033000,  동향면,'05,0 - 4세,1998,65,31,34
'4572033000,  동향면,'10,5 - 9세,1998,98,55,43
'4572033000,  동향면,'15,10 - 14세,1998,133,75,58
'4572033000,  동향면,'20,15 - 19세,1998,186,85,101
'4572033000,  동향면,'25,20 - 24세,1998,169,101,68
'4572033000,  동향면,'30,25 - 29세,1998,87,51,36
'4572033000,  동향면,'35,30 - 34세,1998,68,33,35
'4572033000,  동향면,'40,35 - 39세,1998,110,56,54
'4572033000,  동향면,'45,40 - 44세,1998,109,61,48
'4572033000,  동향면,'50,45 - 49세,1998,95,49,46
'4572033000,  동향면,'55,50 - 54세,1998,105,49,56
'4572033000,  동향면,'60,55 - 59세,1998,158,64,94
'4572033000,  동향면,'65,60 - 64세,1998,183,85,98
'4572033000,  동향면,'70,65 - 69세,1998,140,63,77
'4572033000,  동향면,'75,70 - 74세,1998,88,42,46
'4572033000,  동향면,'80,75 - 79세,1998,72,33,39
'4572033000,  동향면,'85,80 - 84세,1998,30,13,17
'4572033000,  동향면,'90,85+ ,1998,30,11,19
'4572034000,  상전면,'00,계,1998,2672,1356,1316
'4572034000,  상전면,'05,0 - 4세,1998,88,49,39
'4572034000,  상전면,'10,5 - 9세,1998,69,45,24
'4572034000,  상전면,'15,10 - 14세,1998,98,51,47
'4572034000,  상전면,'20,15 - 19세,1998,252,118,134
'4572034000,  상전면,'25,20 - 24세,1998,323,176,147
'4572034000,  상전면,'30,25 - 29세,1998,232,154,78
'4572034000,  상전면,'35,30 - 34세,1998,111,69,42
'4572034000,  상전면,'40,35 - 39세,1998,124,73,51
'4572034000,  상전면,'45,40 - 44세,1998,142,72,70
'4572034000,  상전면,'50,45 - 49세,1998,157,78,79
'4572034000,  상전면,'55,50 - 54세,1998,150,95,55
'4572034000,  상전면,'60,55 - 59세,1998,220,87,133
'4572034000,  상전면,'65,60 - 64세,1998,229,100,129
'4572034000,  상전면,'70,65 - 69세,1998,176,70,106
'4572034000,  상전면,'75,70 - 74세,1998,140,59,81
'4572034000,  상전면,'80,75 - 79세,1998,85,40,45
'4572034000,  상전면,'85,80 - 84세,1998,39,9,30
'4572034000,  상전면,'90,85+ ,1998,37,11,26
'4572035000,  백운면,'00,계,1998,2466,1238,1228
'4572035000,  백운면,'05,0 - 4세,1998,91,53,38
'4572035000,  백운면,'10,5 - 9세,1998,92,42,50
'4572035000,  백운면,'15,10 - 14세,1998,104,51,53
'4572035000,  백운면,'20,15 - 19세,1998,199,89,110
'4572035000,  백운면,'25,20 - 24세,1998,293,173,120
'4572035000,  백운면,'30,25 - 29세,1998,157,101,56
'4572035000,  백운면,'35,30 - 34세,1998,113,68,45
'4572035000,  백운면,'40,35 - 39세,1998,132,84,48
'4572035000,  백운면,'45,40 - 44세,1998,120,69,51
'4572035000,  백운면,'50,45 - 49세,1998,115,51,64
'4572035000,  백운면,'55,50 - 54세,1998,154,81,73
'4572035000,  백운면,'60,55 - 59세,1998,201,85,116
'4572035000,  백운면,'65,60 - 64세,1998,236,98,138
'4572035000,  백운면,'70,65 - 69세,1998,196,87,109
'4572035000,  백운면,'75,70 - 74세,1998,118,56,62
'4572035000,  백운면,'80,75 - 79세,1998,73,29,44
'4572035000,  백운면,'85,80 - 84세,1998,42,17,25
'4572035000,  백운면,'90,85+ ,1998,30,4,26
'4572036000,  성수면,'00,계,1998,2432,1228,1204
'4572036000,  성수면,'05,0 - 4세,1998,88,40,48
'4572036000,  성수면,'10,5 - 9세,1998,76,36,40
'4572036000,  성수면,'15,10 - 14세,1998,99,44,55
'4572036000,  성수면,'20,15 - 19세,1998,201,104,97
'4572036000,  성수면,'25,20 - 24세,1998,284,171,113
'4572036000,  성수면,'30,25 - 29세,1998,146,101,45
'4572036000,  성수면,'35,30 - 34세,1998,101,64,37
'4572036000,  성수면,'40,35 - 39세,1998,124,74,50
'4572036000,  성수면,'45,40 - 44세,1998,113,64,49
'4572036000,  성수면,'50,45 - 49세,1998,140,70,70
'4572036000,  성수면,'55,50 - 54세,1998,142,69,73
'4572036000,  성수면,'60,55 - 59세,1998,217,83,134
'4572036000,  성수면,'65,60 - 64세,1998,239,102,137
'4572036000,  성수면,'70,65 - 69세,1998,177,84,93
'4572036000,  성수면,'75,70 - 74세,1998,133,59,74
'4572036000,  성수면,'80,75 - 79세,1998,90,39,51
'4572036000,  성수면,'85,80 - 84세,1998,32,18,14
'4572036000,  성수면,'90,85+ ,1998,30,6,24
'4572037000,  마령면,'00,계,1998,2597,1329,1268
'4572037000,  마령면,'05,0 - 4세,1998,104,47,57
'4572037000,  마령면,'10,5 - 9세,1998,76,43,33
'4572037000,  마령면,'15,10 - 14세,1998,106,56,50
'4572037000,  마령면,'20,15 - 19세,1998,228,113,115
'4572037000,  마령면,'25,20 - 24세,1998,278,162,116
'4572037000,  마령면,'30,25 - 29세,1998,181,116,65
'4572037000,  마령면,'35,30 - 34세,1998,119,72,47
'4572037000,  마령면,'40,35 - 39세,1998,129,78,51
'4572037000,  마령면,'45,40 - 44세,1998,129,69,60
'4572037000,  마령면,'50,45 - 49세,1998,156,82,74
'4572037000,  마령면,'55,50 - 54세,1998,160,70,90
'4572037000,  마령면,'60,55 - 59세,1998,241,113,128
'4572037000,  마령면,'65,60 - 64세,1998,240,114,126
'4572037000,  마령면,'70,65 - 69세,1998,182,87,95
'4572037000,  마령면,'75,70 - 74세,1998,113,51,62
'4572037000,  마령면,'80,75 - 79세,1998,82,33,49
'4572037000,  마령면,'85,80 - 84세,1998,50,15,35
'4572037000,  마령면,'90,85+ ,1998,23,8,15
'4572038000,  부귀면,'00,계,1998,3086,1621,1465
'4572038000,  부귀면,'05,0 - 4세,1998,118,68,50
'4572038000,  부귀면,'10,5 - 9세,1998,119,65,54
'4572038000,  부귀면,'15,10 - 14세,1998,136,69,67
'4572038000,  부귀면,'20,15 - 19세,1998,302,154,148
'4572038000,  부귀면,'25,20 - 24세,1998,324,192,132
'4572038000,  부귀면,'30,25 - 29세,1998,246,159,87
'4572038000,  부귀면,'35,30 - 34세,1998,153,96,57
'4572038000,  부귀면,'40,35 - 39세,1998,150,84,66
'4572038000,  부귀면,'45,40 - 44세,1998,181,98,83
'4572038000,  부귀면,'50,45 - 49세,1998,169,87,82
'4572038000,  부귀면,'55,50 - 54세,1998,169,81,88
'4572038000,  부귀면,'60,55 - 59세,1998,227,111,116
'4572038000,  부귀면,'65,60 - 64세,1998,266,117,149
'4572038000,  부귀면,'70,65 - 69세,1998,207,92,115
'4572038000,  부귀면,'75,70 - 74세,1998,139,67,72
'4572038000,  부귀면,'80,75 - 79세,1998,103,51,52
'4572038000,  부귀면,'85,80 - 84세,1998,55,21,34
'4572038000,  부귀면,'90,85+ ,1998,22,9,13
'4572039000,  정천면,'00,계,1998,2267,1150,1117
'4572039000,  정천면,'05,0 - 4세,1998,94,47,47
'4572039000,  정천면,'10,5 - 9세,1998,61,33,28
'4572039000,  정천면,'15,10 - 14세,1998,91,39,52
'4572039000,  정천면,'20,15 - 19세,1998,203,99,104
'4572039000,  정천면,'25,20 - 24세,1998,271,151,120
'4572039000,  정천면,'30,25 - 29세,1998,185,127,58
'4572039000,  정천면,'35,30 - 34세,1998,114,78,36
'4572039000,  정천면,'40,35 - 39세,1998,113,59,54
'4572039000,  정천면,'45,40 - 44세,1998,120,63,57
'4572039000,  정천면,'50,45 - 49세,1998,111,54,57
'4572039000,  정천면,'55,50 - 54세,1998,142,75,67
'4572039000,  정천면,'60,55 - 59세,1998,187,86,101
'4572039000,  정천면,'65,60 - 64세,1998,182,80,102
'4572039000,  정천면,'70,65 - 69세,1998,139,55,84
'4572039000,  정천면,'75,70 - 74세,1998,123,65,58
'4572039000,  정천면,'80,75 - 79세,1998,64,24,40
'4572039000,  정천면,'85,80 - 84세,1998,44,9,35
'4572039000,  정천면,'90,85+ ,1998,23,6,17
'4572040000,  주천면,'00,계,1998,2090,1059,1031
'4572040000,  주천면,'05,0 - 4세,1998,69,41,28
'4572040000,  주천면,'10,5 - 9세,1998,80,40,40
'4572040000,  주천면,'15,10 - 14세,1998,85,40,45
'4572040000,  주천면,'20,15 - 19세,1998,145,82,63
'4572040000,  주천면,'25,20 - 24세,1998,209,125,84
'4572040000,  주천면,'30,25 - 29세,1998,113,79,34
'4572040000,  주천면,'35,30 - 34세,1998,104,61,43
'4572040000,  주천면,'40,35 - 39세,1998,108,60,48
'4572040000,  주천면,'45,40 - 44세,1998,103,62,41
'4572040000,  주천면,'50,45 - 49세,1998,96,42,54
'4572040000,  주천면,'55,50 - 54세,1998,135,64,71
'4572040000,  주천면,'60,55 - 59세,1998,214,101,113
'4572040000,  주천면,'65,60 - 64세,1998,212,96,116
'4572040000,  주천면,'70,65 - 69세,1998,144,55,89
'4572040000,  주천면,'75,70 - 74세,1998,112,46,66
'4572040000,  주천면,'80,75 - 79세,1998,95,43,52
'4572040000,  주천면,'85,80 - 84세,1998,37,12,25
'4572040000,  주천면,'90,85+ ,1998,29,10,19
'45730, 무주군,'00,계,1998,30580,15285,15295
'45730, 무주군,'05,0 - 4세,1998,1469,780,689
'45730, 무주군,'10,5 - 9세,1998,1682,891,791
'45730, 무주군,'15,10 - 14세,1998,1761,892,869
'45730, 무주군,'20,15 - 19세,1998,2627,1315,1312
'45730, 무주군,'25,20 - 24세,1998,2771,1628,1143
'45730, 무주군,'30,25 - 29세,1998,2015,1174,841
'45730, 무주군,'35,30 - 34세,1998,1829,990,839
'45730, 무주군,'40,35 - 39세,1998,2000,1097,903
'45730, 무주군,'45,40 - 44세,1998,1789,964,825
'45730, 무주군,'50,45 - 49세,1998,1562,763,799
'45730, 무주군,'55,50 - 54세,1998,1622,738,884
'45730, 무주군,'60,55 - 59세,1998,2427,1066,1361
'45730, 무주군,'65,60 - 64세,1998,2388,1064,1324
'45730, 무주군,'70,65 - 69세,1998,1803,794,1009
'45730, 무주군,'75,70 - 74세,1998,1294,583,711
'45730, 무주군,'80,75 - 79세,1998,849,333,516
'45730, 무주군,'85,80 - 84세,1998,427,151,276
'45730, 무주군,'90,85+ ,1998,265,62,203
'4573025000,  무주읍,'00,계,1998,10228,5121,5107
'4573025000,  무주읍,'05,0 - 4세,1998,641,337,304
'4573025000,  무주읍,'10,5 - 9세,1998,659,370,289
'4573025000,  무주읍,'15,10 - 14세,1998,564,269,295
'4573025000,  무주읍,'20,15 - 19세,1998,819,412,407
'4573025000,  무주읍,'25,20 - 24세,1998,929,522,407
'4573025000,  무주읍,'30,25 - 29세,1998,790,444,346
'4573025000,  무주읍,'35,30 - 34세,1998,741,392,349
'4573025000,  무주읍,'40,35 - 39세,1998,780,448,332
'4573025000,  무주읍,'45,40 - 44세,1998,606,311,295
'4573025000,  무주읍,'50,45 - 49세,1998,545,265,280
'4573025000,  무주읍,'55,50 - 54세,1998,507,247,260
'4573025000,  무주읍,'60,55 - 59세,1998,671,306,365
'4573025000,  무주읍,'65,60 - 64세,1998,631,252,379
'4573025000,  무주읍,'70,65 - 69세,1998,544,243,301
'4573025000,  무주읍,'75,70 - 74세,1998,367,162,205
'4573025000,  무주읍,'80,75 - 79세,1998,245,92,153
'4573025000,  무주읍,'85,80 - 84세,1998,122,35,87
'4573025000,  무주읍,'90,85+ ,1998,67,14,53
'4573031000,  무풍면,'00,계,1998,2952,1490,1462
'4573031000,  무풍면,'05,0 - 4세,1998,110,62,48
'4573031000,  무풍면,'10,5 - 9세,1998,144,74,70
'4573031000,  무풍면,'15,10 - 14세,1998,166,90,76
'4573031000,  무풍면,'20,15 - 19세,1998,243,129,114
'4573031000,  무풍면,'25,20 - 24세,1998,240,146,94
'4573031000,  무풍면,'30,25 - 29세,1998,166,96,70
'4573031000,  무풍면,'35,30 - 34세,1998,150,77,73
'4573031000,  무풍면,'40,35 - 39세,1998,180,96,84
'4573031000,  무풍면,'45,40 - 44세,1998,170,89,81
'4573031000,  무풍면,'50,45 - 49세,1998,170,93,77
'4573031000,  무풍면,'55,50 - 54세,1998,154,71,83
'4573031000,  무풍면,'60,55 - 59세,1998,271,111,160
'4573031000,  무풍면,'65,60 - 64세,1998,259,113,146
'4573031000,  무풍면,'70,65 - 69세,1998,214,99,115
'4573031000,  무풍면,'75,70 - 74세,1998,132,57,75
'4573031000,  무풍면,'80,75 - 79세,1998,99,46,53
'4573031000,  무풍면,'85,80 - 84세,1998,54,31,23
'4573031000,  무풍면,'90,85+ ,1998,30,10,20
'4573032000,  설천면,'00,계,1998,5238,2638,2600
'4573032000,  설천면,'05,0 - 4세,1998,307,160,147
'4573032000,  설천면,'10,5 - 9세,1998,310,155,155
'4573032000,  설천면,'15,10 - 14세,1998,289,145,144
'4573032000,  설천면,'20,15 - 19세,1998,421,213,208
'4573032000,  설천면,'25,20 - 24세,1998,435,253,182
'4573032000,  설천면,'30,25 - 29세,1998,409,234,175
'4573032000,  설천면,'35,30 - 34세,1998,363,212,151
'4573032000,  설천면,'40,35 - 39세,1998,381,203,178
'4573032000,  설천면,'45,40 - 44세,1998,309,178,131
'4573032000,  설천면,'50,45 - 49세,1998,272,132,140
'4573032000,  설천면,'55,50 - 54세,1998,256,114,142
'4573032000,  설천면,'60,55 - 59세,1998,396,169,227
'4573032000,  설천면,'65,60 - 64세,1998,359,171,188
'4573032000,  설천면,'70,65 - 69세,1998,278,126,152
'4573032000,  설천면,'75,70 - 74세,1998,208,97,111
'4573032000,  설천면,'80,75 - 79세,1998,143,49,94
'4573032000,  설천면,'85,80 - 84세,1998,71,21,50
'4573032000,  설천면,'90,85+ ,1998,31,6,25
'4573033000,  적상면,'00,계,1998,3663,1835,1828
'4573033000,  적상면,'05,0 - 4세,1998,130,76,54
'4573033000,  적상면,'10,5 - 9세,1998,146,75,71
'4573033000,  적상면,'15,10 - 14세,1998,216,120,96
'4573033000,  적상면,'20,15 - 19세,1998,304,141,163
'4573033000,  적상면,'25,20 - 24세,1998,337,204,133
'4573033000,  적상면,'30,25 - 29세,1998,197,124,73
'4573033000,  적상면,'35,30 - 34세,1998,154,86,68
'4573033000,  적상면,'40,35 - 39세,1998,199,110,89
'4573033000,  적상면,'45,40 - 44세,1998,187,107,80
'4573033000,  적상면,'50,45 - 49세,1998,168,71,97
'4573033000,  적상면,'55,50 - 54세,1998,208,83,125
'4573033000,  적상면,'60,55 - 59세,1998,362,171,191
'4573033000,  적상면,'65,60 - 64세,1998,377,176,201
'4573033000,  적상면,'70,65 - 69세,1998,266,122,144
'4573033000,  적상면,'75,70 - 74세,1998,199,92,107
'4573033000,  적상면,'80,75 - 79세,1998,117,46,71
'4573033000,  적상면,'85,80 - 84세,1998,62,22,40
'4573033000,  적상면,'90,85+ ,1998,34,9,25
'4573034000,  안성면,'00,계,1998,6518,3225,3293
'4573034000,  안성면,'05,0 - 4세,1998,224,121,103
'4573034000,  안성면,'10,5 - 9세,1998,349,185,164
'4573034000,  안성면,'15,10 - 14세,1998,416,215,201
'4573034000,  안성면,'20,15 - 19세,1998,672,336,336
'4573034000,  안성면,'25,20 - 24세,1998,646,386,260
'4573034000,  안성면,'30,25 - 29세,1998,344,203,141
'4573034000,  안성면,'35,30 - 34세,1998,336,175,161
'4573034000,  안성면,'40,35 - 39세,1998,370,191,179
'4573034000,  안성면,'45,40 - 44세,1998,428,223,205
'4573034000,  안성면,'50,45 - 49세,1998,314,155,159
'4573034000,  안성면,'55,50 - 54세,1998,362,166,196
'4573034000,  안성면,'60,55 - 59세,1998,536,221,315
'4573034000,  안성면,'65,60 - 64세,1998,552,265,287
'4573034000,  안성면,'70,65 - 69세,1998,367,145,222
'4573034000,  안성면,'75,70 - 74세,1998,273,123,150
'4573034000,  안성면,'80,75 - 79세,1998,170,71,99
'4573034000,  안성면,'85,80 - 84세,1998,83,28,55
'4573034000,  안성면,'90,85+ ,1998,76,16,60
'4573035000,  부남면,'00,계,1998,1981,976,1005
'4573035000,  부남면,'05,0 - 4세,1998,57,24,33
'4573035000,  부남면,'10,5 - 9세,1998,74,32,42
'4573035000,  부남면,'15,10 - 14세,1998,110,53,57
'4573035000,  부남면,'20,15 - 19세,1998,168,84,84
'4573035000,  부남면,'25,20 - 24세,1998,184,117,67
'4573035000,  부남면,'30,25 - 29세,1998,109,73,36
'4573035000,  부남면,'35,30 - 34세,1998,85,48,37
'4573035000,  부남면,'40,35 - 39세,1998,90,49,41
'4573035000,  부남면,'45,40 - 44세,1998,89,56,33
'4573035000,  부남면,'50,45 - 49세,1998,93,47,46
'4573035000,  부남면,'55,50 - 54세,1998,135,57,78
'4573035000,  부남면,'60,55 - 59세,1998,191,88,103
'4573035000,  부남면,'65,60 - 64세,1998,210,87,123
'4573035000,  부남면,'70,65 - 69세,1998,134,59,75
'4573035000,  부남면,'75,70 - 74세,1998,115,52,63
'4573035000,  부남면,'80,75 - 79세,1998,75,29,46
'4573035000,  부남면,'85,80 - 84세,1998,35,14,21
'4573035000,  부남면,'90,85+ ,1998,27,7,20
'45740, 장수군,'00,계,1998,30513,15102,15411
'45740, 장수군,'05,0 - 4세,1998,1596,863,733
'45740, 장수군,'10,5 - 9세,1998,1434,748,686
'45740, 장수군,'15,10 - 14세,1998,1819,916,903
'45740, 장수군,'20,15 - 19세,1998,2984,1521,1463
'45740, 장수군,'25,20 - 24세,1998,3190,1818,1372
'45740, 장수군,'30,25 - 29세,1998,2042,1184,858
'45740, 장수군,'35,30 - 34세,1998,1644,893,751
'45740, 장수군,'40,35 - 39세,1998,1774,937,837
'45740, 장수군,'45,40 - 44세,1998,1676,838,838
'45740, 장수군,'50,45 - 49세,1998,1587,790,797
'45740, 장수군,'55,50 - 54세,1998,1557,735,822
'45740, 장수군,'60,55 - 59세,1998,2312,1002,1310
'45740, 장수군,'65,60 - 64세,1998,2290,997,1293
'45740, 장수군,'70,65 - 69세,1998,1664,733,931
'45740, 장수군,'75,70 - 74세,1998,1347,555,792
'45740, 장수군,'80,75 - 79세,1998,886,348,538
'45740, 장수군,'85,80 - 84세,1998,439,147,292
'45740, 장수군,'90,85+ ,1998,272,77,195
'4574025000,  장수읍,'00,계,1998,8409,4184,4225
'4574025000,  장수읍,'05,0 - 4세,1998,545,291,254
'4574025000,  장수읍,'10,5 - 9세,1998,438,233,205
'4574025000,  장수읍,'15,10 - 14세,1998,535,267,268
'4574025000,  장수읍,'20,15 - 19세,1998,814,418,396
'4574025000,  장수읍,'25,20 - 24세,1998,871,482,389
'4574025000,  장수읍,'30,25 - 29세,1998,644,352,292
'4574025000,  장수읍,'35,30 - 34세,1998,539,314,225
'4574025000,  장수읍,'40,35 - 39세,1998,515,259,256
'4574025000,  장수읍,'45,40 - 44세,1998,490,237,253
'4574025000,  장수읍,'50,45 - 49세,1998,468,226,242
'4574025000,  장수읍,'55,50 - 54세,1998,415,199,216
'4574025000,  장수읍,'60,55 - 59세,1998,540,242,298
'4574025000,  장수읍,'65,60 - 64세,1998,510,220,290
'4574025000,  장수읍,'70,65 - 69세,1998,387,172,215
'4574025000,  장수읍,'75,70 - 74세,1998,321,126,195
'4574025000,  장수읍,'80,75 - 79세,1998,211,92,119
'4574025000,  장수읍,'85,80 - 84세,1998,115,44,71
'4574025000,  장수읍,'90,85+ ,1998,51,10,41
'4574031000,  산서면,'00,계,1998,3702,1797,1905
'4574031000,  산서면,'05,0 - 4세,1998,150,88,62
'4574031000,  산서면,'10,5 - 9세,1998,159,85,74
'4574031000,  산서면,'15,10 - 14세,1998,211,96,115
'4574031000,  산서면,'20,15 - 19세,1998,358,172,186
'4574031000,  산서면,'25,20 - 24세,1998,399,240,159
'4574031000,  산서면,'30,25 - 29세,1998,219,133,86
'4574031000,  산서면,'35,30 - 34세,1998,147,83,64
'4574031000,  산서면,'40,35 - 39세,1998,170,86,84
'4574031000,  산서면,'45,40 - 44세,1998,164,81,83
'4574031000,  산서면,'50,45 - 49세,1998,177,74,103
'4574031000,  산서면,'55,50 - 54세,1998,193,94,99
'4574031000,  산서면,'60,55 - 59세,1998,324,151,173
'4574031000,  산서면,'65,60 - 64세,1998,339,146,193
'4574031000,  산서면,'70,65 - 69세,1998,233,97,136
'4574031000,  산서면,'75,70 - 74세,1998,207,82,125
'4574031000,  산서면,'80,75 - 79세,1998,134,54,80
'4574031000,  산서면,'85,80 - 84세,1998,68,20,48
'4574031000,  산서면,'90,85+ ,1998,50,15,35
'4574032000,  번암면,'00,계,1998,3808,1906,1902
'4574032000,  번암면,'05,0 - 4세,1998,167,82,85
'4574032000,  번암면,'10,5 - 9세,1998,164,99,65
'4574032000,  번암면,'15,10 - 14세,1998,221,114,107
'4574032000,  번암면,'20,15 - 19세,1998,363,184,179
'4574032000,  번암면,'25,20 - 24세,1998,400,240,160
'4574032000,  번암면,'30,25 - 29세,1998,243,152,91
'4574032000,  번암면,'35,30 - 34세,1998,186,101,85
'4574032000,  번암면,'40,35 - 39세,1998,221,117,104
'4574032000,  번암면,'45,40 - 44세,1998,212,113,99
'4574032000,  번암면,'50,45 - 49세,1998,198,103,95
'4574032000,  번암면,'55,50 - 54세,1998,196,98,98
'4574032000,  번암면,'60,55 - 59세,1998,296,105,191
'4574032000,  번암면,'65,60 - 64세,1998,308,138,170
'4574032000,  번암면,'70,65 - 69세,1998,219,95,124
'4574032000,  번암면,'75,70 - 74세,1998,185,75,110
'4574032000,  번암면,'80,75 - 79세,1998,124,50,74
'4574032000,  번암면,'85,80 - 84세,1998,62,24,38
'4574032000,  번암면,'90,85+ ,1998,43,16,27
'4574033500,  장계면,'00,계,1998,5900,2955,2945
'4574033500,  장계면,'05,0 - 4세,1998,370,203,167
'4574033500,  장계면,'10,5 - 9세,1998,333,151,182
'4574033500,  장계면,'15,10 - 14세,1998,353,180,173
'4574033500,  장계면,'20,15 - 19세,1998,547,302,245
'4574033500,  장계면,'25,20 - 24세,1998,574,320,254
'4574033500,  장계면,'30,25 - 29세,1998,407,233,174
'4574033500,  장계면,'35,30 - 34세,1998,404,206,198
'4574033500,  장계면,'40,35 - 39세,1998,385,214,171
'4574033500,  장계면,'45,40 - 44세,1998,338,169,169
'4574033500,  장계면,'50,45 - 49세,1998,288,157,131
'4574033500,  장계면,'55,50 - 54세,1998,317,150,167
'4574033500,  장계면,'60,55 - 59세,1998,411,179,232
'4574033500,  장계면,'65,60 - 64세,1998,398,167,231
'4574033500,  장계면,'70,65 - 69세,1998,302,135,167
'4574033500,  장계면,'75,70 - 74세,1998,225,97,128
'4574033500,  장계면,'80,75 - 79세,1998,134,58,76
'4574033500,  장계면,'85,80 - 84세,1998,68,21,47
'4574033500,  장계면,'90,85+ ,1998,46,13,33
'4574034000,  천천면,'00,계,1998,3217,1587,1630
'4574034000,  천천면,'05,0 - 4세,1998,115,68,47
'4574034000,  천천면,'10,5 - 9세,1998,104,54,50
'4574034000,  천천면,'15,10 - 14세,1998,178,90,88
'4574034000,  천천면,'20,15 - 19세,1998,352,171,181
'4574034000,  천천면,'25,20 - 24세,1998,355,215,140
'4574034000,  천천면,'30,25 - 29세,1998,192,105,87
'4574034000,  천천면,'35,30 - 34세,1998,135,72,63
'4574034000,  천천면,'40,35 - 39세,1998,172,94,78
'4574034000,  천천면,'45,40 - 44세,1998,193,99,94
'4574034000,  천천면,'50,45 - 49세,1998,171,78,93
'4574034000,  천천면,'55,50 - 54세,1998,169,83,86
'4574034000,  천천면,'60,55 - 59세,1998,280,122,158
'4574034000,  천천면,'65,60 - 64세,1998,284,134,150
'4574034000,  천천면,'70,65 - 69세,1998,177,75,102
'4574034000,  천천면,'75,70 - 74세,1998,159,71,88
'4574034000,  천천면,'80,75 - 79세,1998,114,42,72
'4574034000,  천천면,'85,80 - 84세,1998,42,9,33
'4574034000,  천천면,'90,85+ ,1998,25,5,20
'4574035000,  계남면,'00,계,1998,2964,1433,1531
'4574035000,  계남면,'05,0 - 4세,1998,138,69,69
'4574035000,  계남면,'10,5 - 9세,1998,103,59,44
'4574035000,  계남면,'15,10 - 14세,1998,168,87,81
'4574035000,  계남면,'20,15 - 19세,1998,286,142,144
'4574035000,  계남면,'25,20 - 24세,1998,348,186,162
'4574035000,  계남면,'30,25 - 29세,1998,202,120,82
'4574035000,  계남면,'35,30 - 34세,1998,135,76,59
'4574035000,  계남면,'40,35 - 39세,1998,162,81,81
'4574035000,  계남면,'45,40 - 44세,1998,142,67,75
'4574035000,  계남면,'50,45 - 49세,1998,153,82,71
'4574035000,  계남면,'55,50 - 54세,1998,170,65,105
'4574035000,  계남면,'60,55 - 59세,1998,243,118,125
'4574035000,  계남면,'65,60 - 64세,1998,244,101,143
'4574035000,  계남면,'70,65 - 69세,1998,181,78,103
'4574035000,  계남면,'75,70 - 74세,1998,120,53,67
'4574035000,  계남면,'80,75 - 79세,1998,90,24,66
'4574035000,  계남면,'85,80 - 84세,1998,47,15,32
'4574035000,  계남면,'90,85+ ,1998,32,10,22
'4574036000,  계북면,'00,계,1998,2513,1240,1273
'4574036000,  계북면,'05,0 - 4세,1998,111,62,49
'4574036000,  계북면,'10,5 - 9세,1998,133,67,66
'4574036000,  계북면,'15,10 - 14세,1998,153,82,71
'4574036000,  계북면,'20,15 - 19세,1998,264,132,132
'4574036000,  계북면,'25,20 - 24세,1998,243,135,108
'4574036000,  계북면,'30,25 - 29세,1998,135,89,46
'4574036000,  계북면,'35,30 - 34세,1998,98,41,57
'4574036000,  계북면,'40,35 - 39세,1998,149,86,63
'4574036000,  계북면,'45,40 - 44세,1998,137,72,65
'4574036000,  계북면,'50,45 - 49세,1998,132,70,62
'4574036000,  계북면,'55,50 - 54세,1998,97,46,51
'4574036000,  계북면,'60,55 - 59세,1998,218,85,133
'4574036000,  계북면,'65,60 - 64세,1998,207,91,116
'4574036000,  계북면,'70,65 - 69세,1998,165,81,84
'4574036000,  계북면,'75,70 - 74세,1998,130,51,79
'4574036000,  계북면,'80,75 - 79세,1998,79,28,51
'4574036000,  계북면,'85,80 - 84세,1998,37,14,23
'4574036000,  계북면,'90,85+ ,1998,25,8,17
'45750, 임실군,'00,계,1998,40519,20335,20184
'45750, 임실군,'05,0 - 4세,1998,1851,959,892
'45750, 임실군,'10,5 - 9세,1998,1948,990,958
'45750, 임실군,'15,10 - 14세,1998,2103,1009,1094
'45750, 임실군,'20,15 - 19세,1998,3467,1803,1664
'45750, 임실군,'25,20 - 24세,1998,4010,2268,1742
'45750, 임실군,'30,25 - 29세,1998,2839,1777,1062
'45750, 임실군,'35,30 - 34세,1998,2280,1292,988
'45750, 임실군,'40,35 - 39세,1998,2415,1364,1051
'45750, 임실군,'45,40 - 44세,1998,2083,1146,937
'45750, 임실군,'50,45 - 49세,1998,2039,1025,1014
'45750, 임실군,'55,50 - 54세,1998,2215,1070,1145
'45750, 임실군,'60,55 - 59세,1998,3263,1428,1835
'45750, 임실군,'65,60 - 64세,1998,3408,1472,1936
'45750, 임실군,'70,65 - 69세,1998,2421,1049,1372
'45750, 임실군,'75,70 - 74세,1998,1841,829,1012
'45750, 임실군,'80,75 - 79세,1998,1301,518,783
'45750, 임실군,'85,80 - 84세,1998,660,239,421
'45750, 임실군,'90,85+ ,1998,375,97,278
'4575025000,  임실읍,'00,계,1998,7566,3871,3695
'4575025000,  임실읍,'05,0 - 4세,1998,469,242,227
'4575025000,  임실읍,'10,5 - 9세,1998,456,248,208
'4575025000,  임실읍,'15,10 - 14세,1998,383,167,216
'4575025000,  임실읍,'20,15 - 19세,1998,602,332,270
'4575025000,  임실읍,'25,20 - 24세,1998,654,375,279
'4575025000,  임실읍,'30,25 - 29세,1998,594,335,259
'4575025000,  임실읍,'35,30 - 34세,1998,537,289,248
'4575025000,  임실읍,'40,35 - 39세,1998,542,323,219
'4575025000,  임실읍,'45,40 - 44세,1998,395,222,173
'4575025000,  임실읍,'50,45 - 49세,1998,409,214,195
'4575025000,  임실읍,'55,50 - 54세,1998,361,187,174
'4575025000,  임실읍,'60,55 - 59세,1998,514,226,288
'4575025000,  임실읍,'65,60 - 64세,1998,566,239,327
'4575025000,  임실읍,'70,65 - 69세,1998,416,175,241
'4575025000,  임실읍,'75,70 - 74세,1998,286,141,145
'4575025000,  임실읍,'80,75 - 79세,1998,201,84,117
'4575025000,  임실읍,'85,80 - 84세,1998,123,55,68
'4575025000,  임실읍,'90,85+ ,1998,58,17,41
'4575031000,  청웅면,'00,계,1998,2270,1152,1118
'4575031000,  청웅면,'05,0 - 4세,1998,70,35,35
'4575031000,  청웅면,'10,5 - 9세,1998,92,44,48
'4575031000,  청웅면,'15,10 - 14세,1998,113,68,45
'4575031000,  청웅면,'20,15 - 19세,1998,193,101,92
'4575031000,  청웅면,'25,20 - 24세,1998,260,162,98
'4575031000,  청웅면,'30,25 - 29세,1998,138,94,44
'4575031000,  청웅면,'35,30 - 34세,1998,90,54,36
'4575031000,  청웅면,'40,35 - 39세,1998,111,57,54
'4575031000,  청웅면,'45,40 - 44세,1998,107,59,48
'4575031000,  청웅면,'50,45 - 49세,1998,106,53,53
'4575031000,  청웅면,'55,50 - 54세,1998,153,68,85
'4575031000,  청웅면,'60,55 - 59세,1998,200,93,107
'4575031000,  청웅면,'65,60 - 64세,1998,234,105,129
'4575031000,  청웅면,'70,65 - 69세,1998,145,56,89
'4575031000,  청웅면,'75,70 - 74세,1998,101,47,54
'4575031000,  청웅면,'80,75 - 79세,1998,83,31,52
'4575031000,  청웅면,'85,80 - 84세,1998,51,18,33
'4575031000,  청웅면,'90,85+ ,1998,23,7,16
'4575032000,  운암면,'00,계,1998,2210,1115,1095
'4575032000,  운암면,'05,0 - 4세,1998,71,36,35
'4575032000,  운암면,'10,5 - 9세,1998,67,24,43
'4575032000,  운암면,'15,10 - 14세,1998,73,34,39
'4575032000,  운암면,'20,15 - 19세,1998,212,106,106
'4575032000,  운암면,'25,20 - 24세,1998,261,141,120
'4575032000,  운암면,'30,25 - 29세,1998,129,90,39
'4575032000,  운암면,'35,30 - 34세,1998,105,63,42
'4575032000,  운암면,'40,35 - 39세,1998,111,69,42
'4575032000,  운암면,'45,40 - 44세,1998,135,74,61
'4575032000,  운암면,'50,45 - 49세,1998,123,59,64
'4575032000,  운암면,'55,50 - 54세,1998,123,63,60
'4575032000,  운암면,'60,55 - 59세,1998,202,102,100
'4575032000,  운암면,'65,60 - 64세,1998,214,91,123
'4575032000,  운암면,'70,65 - 69세,1998,153,62,91
'4575032000,  운암면,'75,70 - 74세,1998,101,45,56
'4575032000,  운암면,'80,75 - 79세,1998,69,29,40
'4575032000,  운암면,'85,80 - 84세,1998,41,19,22
'4575032000,  운암면,'90,85+ ,1998,20,8,12
'4575033000,  신평면,'00,계,1998,2331,1179,1152
'4575033000,  신평면,'05,0 - 4세,1998,89,39,50
'4575033000,  신평면,'10,5 - 9세,1998,77,37,40
'4575033000,  신평면,'15,10 - 14세,1998,101,53,48
'4575033000,  신평면,'20,15 - 19세,1998,198,110,88
'4575033000,  신평면,'25,20 - 24세,1998,246,146,100
'4575033000,  신평면,'30,25 - 29세,1998,175,106,69
'4575033000,  신평면,'35,30 - 34세,1998,115,73,42
'4575033000,  신평면,'40,35 - 39세,1998,112,64,48
'4575033000,  신평면,'45,40 - 44세,1998,111,54,57
'4575033000,  신평면,'50,45 - 49세,1998,129,62,67
'4575033000,  신평면,'55,50 - 54세,1998,130,65,65
'4575033000,  신평면,'60,55 - 59세,1998,192,84,108
'4575033000,  신평면,'65,60 - 64세,1998,223,105,118
'4575033000,  신평면,'70,65 - 69세,1998,160,71,89
'4575033000,  신평면,'75,70 - 74세,1998,123,59,64
'4575033000,  신평면,'80,75 - 79세,1998,82,30,52
'4575033000,  신평면,'85,80 - 84세,1998,41,11,30
'4575033000,  신평면,'90,85+ ,1998,27,10,17
'4575034000,  성수면,'00,계,1998,2613,1336,1277
'4575034000,  성수면,'05,0 - 4세,1998,107,58,49
'4575034000,  성수면,'10,5 - 9세,1998,106,53,53
'4575034000,  성수면,'15,10 - 14세,1998,145,66,79
'4575034000,  성수면,'20,15 - 19세,1998,202,115,87
'4575034000,  성수면,'25,20 - 24세,1998,269,159,110
'4575034000,  성수면,'30,25 - 29세,1998,188,132,56
'4575034000,  성수면,'35,30 - 34세,1998,116,70,46
'4575034000,  성수면,'40,35 - 39세,1998,167,90,77
'4575034000,  성수면,'45,40 - 44세,1998,110,61,49
'4575034000,  성수면,'50,45 - 49세,1998,113,62,51
'4575034000,  성수면,'55,50 - 54세,1998,133,61,72
'4575034000,  성수면,'60,55 - 59세,1998,247,100,147
'4575034000,  성수면,'65,60 - 64세,1998,275,129,146
'4575034000,  성수면,'70,65 - 69세,1998,152,67,85
'4575034000,  성수면,'75,70 - 74세,1998,108,53,55
'4575034000,  성수면,'80,75 - 79세,1998,100,40,60
'4575034000,  성수면,'85,80 - 84세,1998,44,13,31
'4575034000,  성수면,'90,85+ ,1998,31,7,24
'4575035500,  오수면,'00,계,1998,7055,3463,3592
'4575035500,  오수면,'05,0 - 4세,1998,385,201,184
'4575035500,  오수면,'10,5 - 9세,1998,408,196,212
'4575035500,  오수면,'15,10 - 14세,1998,444,197,247
'4575035500,  오수면,'20,15 - 19세,1998,663,337,326
'4575035500,  오수면,'25,20 - 24세,1998,653,366,287
'4575035500,  오수면,'30,25 - 29세,1998,480,278,202
'4575035500,  오수면,'35,30 - 34세,1998,459,255,204
'4575035500,  오수면,'40,35 - 39세,1998,444,237,207
'4575035500,  오수면,'45,40 - 44세,1998,394,203,191
'4575035500,  오수면,'50,45 - 49세,1998,347,181,166
'4575035500,  오수면,'55,50 - 54세,1998,363,161,202
'4575035500,  오수면,'60,55 - 59세,1998,482,211,271
'4575035500,  오수면,'65,60 - 64세,1998,547,230,317
'4575035500,  오수면,'70,65 - 69세,1998,379,181,198
'4575035500,  오수면,'75,70 - 74세,1998,306,125,181
'4575035500,  오수면,'80,75 - 79세,1998,161,69,92
'4575035500,  오수면,'85,80 - 84세,1998,86,24,62
'4575035500,  오수면,'90,85+ ,1998,54,11,43
'4575036000,  신덕면,'00,계,1998,1903,993,910
'4575036000,  신덕면,'05,0 - 4세,1998,50,28,22
'4575036000,  신덕면,'10,5 - 9세,1998,59,32,27
'4575036000,  신덕면,'15,10 - 14세,1998,68,39,29
'4575036000,  신덕면,'20,15 - 19세,1998,142,72,70
'4575036000,  신덕면,'25,20 - 24세,1998,207,118,89
'4575036000,  신덕면,'30,25 - 29세,1998,152,105,47
'4575036000,  신덕면,'35,30 - 34세,1998,88,58,30
'4575036000,  신덕면,'40,35 - 39세,1998,81,54,27
'4575036000,  신덕면,'45,40 - 44세,1998,76,49,27
'4575036000,  신덕면,'50,45 - 49세,1998,94,49,45
'4575036000,  신덕면,'55,50 - 54세,1998,139,60,79
'4575036000,  신덕면,'60,55 - 59세,1998,211,90,121
'4575036000,  신덕면,'65,60 - 64세,1998,165,66,99
'4575036000,  신덕면,'70,65 - 69세,1998,139,66,73
'4575036000,  신덕면,'75,70 - 74세,1998,129,60,69
'4575036000,  신덕면,'80,75 - 79세,1998,75,32,43
'4575036000,  신덕면,'85,80 - 84세,1998,20,12,8
'4575036000,  신덕면,'90,85+ ,1998,8,3,5
'4575037000,  삼계면,'00,계,1998,2383,1149,1234
'4575037000,  삼계면,'05,0 - 4세,1998,51,30,21
'4575037000,  삼계면,'10,5 - 9세,1998,65,31,34
'4575037000,  삼계면,'15,10 - 14세,1998,105,56,49
'4575037000,  삼계면,'20,15 - 19세,1998,200,95,105
'4575037000,  삼계면,'25,20 - 24세,1998,230,131,99
'4575037000,  삼계면,'30,25 - 29세,1998,115,72,43
'4575037000,  삼계면,'35,30 - 34세,1998,85,47,38
'4575037000,  삼계면,'40,35 - 39세,1998,108,61,47
'4575037000,  삼계면,'45,40 - 44세,1998,99,54,45
'4575037000,  삼계면,'50,45 - 49세,1998,132,61,71
'4575037000,  삼계면,'55,50 - 54세,1998,139,70,69
'4575037000,  삼계면,'60,55 - 59세,1998,211,89,122
'4575037000,  삼계면,'65,60 - 64세,1998,251,110,141
'4575037000,  삼계면,'70,65 - 69세,1998,220,87,133
'4575037000,  삼계면,'75,70 - 74세,1998,146,70,76
'4575037000,  삼계면,'80,75 - 79세,1998,119,50,69
'4575037000,  삼계면,'85,80 - 84세,1998,60,25,35
'4575037000,  삼계면,'90,85+ ,1998,47,10,37
'4575038000,  관촌면,'00,계,1998,5551,2763,2788
'4575038000,  관촌면,'05,0 - 4세,1998,284,137,147
'4575038000,  관촌면,'10,5 - 9세,1998,346,189,157
'4575038000,  관촌면,'15,10 - 14세,1998,328,160,168
'4575038000,  관촌면,'20,15 - 19세,1998,461,233,228
'4575038000,  관촌면,'25,20 - 24세,1998,579,304,275
'4575038000,  관촌면,'30,25 - 29세,1998,445,275,170
'4575038000,  관촌면,'35,30 - 34세,1998,376,203,173
'4575038000,  관촌면,'40,35 - 39세,1998,396,219,177
'4575038000,  관촌면,'45,40 - 44세,1998,316,177,139
'4575038000,  관촌면,'50,45 - 49세,1998,294,137,157
'4575038000,  관촌면,'55,50 - 54세,1998,291,145,146
'4575038000,  관촌면,'60,55 - 59세,1998,397,179,218
'4575038000,  관촌면,'65,60 - 64세,1998,355,147,208
'4575038000,  관촌면,'70,65 - 69세,1998,242,102,140
'4575038000,  관촌면,'75,70 - 74세,1998,184,74,110
'4575038000,  관촌면,'80,75 - 79세,1998,142,48,94
'4575038000,  관촌면,'85,80 - 84세,1998,81,26,55
'4575038000,  관촌면,'90,85+ ,1998,34,8,26
'4575039000,  강진면,'00,계,1998,2701,1403,1298
'4575039000,  강진면,'05,0 - 4세,1998,137,81,56
'4575039000,  강진면,'10,5 - 9세,1998,120,67,53
'4575039000,  강진면,'15,10 - 14세,1998,147,82,65
'4575039000,  강진면,'20,15 - 19세,1998,241,125,116
'4575039000,  강진면,'25,20 - 24세,1998,274,152,122
'4575039000,  강진면,'30,25 - 29세,1998,192,135,57
'4575039000,  강진면,'35,30 - 34세,1998,130,79,51
'4575039000,  강진면,'40,35 - 39세,1998,142,74,68
'4575039000,  강진면,'45,40 - 44세,1998,145,85,60
'4575039000,  강진면,'50,45 - 49세,1998,134,67,67
'4575039000,  강진면,'55,50 - 54세,1998,139,68,71
'4575039000,  강진면,'60,55 - 59세,1998,235,100,135
'4575039000,  강진면,'65,60 - 64세,1998,224,101,123
'4575039000,  강진면,'70,65 - 69세,1998,152,75,77
'4575039000,  강진면,'75,70 - 74세,1998,135,58,77
'4575039000,  강진면,'80,75 - 79세,1998,94,35,59
'4575039000,  강진면,'85,80 - 84세,1998,30,12,18
'4575039000,  강진면,'90,85+ ,1998,30,7,23
'4575040000,  덕치면,'00,계,1998,1862,907,955
'4575040000,  덕치면,'05,0 - 4세,1998,62,31,31
'4575040000,  덕치면,'10,5 - 9세,1998,71,32,39
'4575040000,  덕치면,'15,10 - 14세,1998,82,40,42
'4575040000,  덕치면,'20,15 - 19세,1998,169,90,79
'4575040000,  덕치면,'25,20 - 24세,1998,191,104,87
'4575040000,  덕치면,'30,25 - 29세,1998,102,69,33
'4575040000,  덕치면,'35,30 - 34세,1998,87,56,31
'4575040000,  덕치면,'40,35 - 39세,1998,87,51,36
'4575040000,  덕치면,'45,40 - 44세,1998,82,43,39
'4575040000,  덕치면,'50,45 - 49세,1998,71,39,32
'4575040000,  덕치면,'55,50 - 54세,1998,128,62,66
'4575040000,  덕치면,'60,55 - 59세,1998,199,78,121
'4575040000,  덕치면,'65,60 - 64세,1998,173,75,98
'4575040000,  덕치면,'70,65 - 69세,1998,120,52,68
'4575040000,  덕치면,'75,70 - 74세,1998,92,41,51
'4575040000,  덕치면,'80,75 - 79세,1998,93,32,61
'4575040000,  덕치면,'85,80 - 84세,1998,41,11,30
'4575040000,  덕치면,'90,85+ ,1998,12,1,11
'4575041000,  지사면,'00,계,1998,2074,1004,1070
'4575041000,  지사면,'05,0 - 4세,1998,76,41,35
'4575041000,  지사면,'10,5 - 9세,1998,81,37,44
'4575041000,  지사면,'15,10 - 14세,1998,114,47,67
'4575041000,  지사면,'20,15 - 19세,1998,184,87,97
'4575041000,  지사면,'25,20 - 24세,1998,186,110,76
'4575041000,  지사면,'30,25 - 29세,1998,129,86,43
'4575041000,  지사면,'35,30 - 34세,1998,92,45,47
'4575041000,  지사면,'40,35 - 39세,1998,114,65,49
'4575041000,  지사면,'45,40 - 44세,1998,113,65,48
'4575041000,  지사면,'50,45 - 49세,1998,87,41,46
'4575041000,  지사면,'55,50 - 54세,1998,116,60,56
'4575041000,  지사면,'60,55 - 59세,1998,173,76,97
'4575041000,  지사면,'65,60 - 64세,1998,181,74,107
'4575041000,  지사면,'70,65 - 69세,1998,143,55,88
'4575041000,  지사면,'75,70 - 74세,1998,130,56,74
'4575041000,  지사면,'80,75 - 79세,1998,82,38,44
'4575041000,  지사면,'85,80 - 84세,1998,42,13,29
'4575041000,  지사면,'90,85+ ,1998,31,8,23
'45770, 순창군,'00,계,1998,36832,18209,18623
'45770, 순창군,'05,0 - 4세,1998,1584,844,740
'45770, 순창군,'10,5 - 9세,1998,1713,867,846
'45770, 순창군,'15,10 - 14세,1998,2056,1068,988
'45770, 순창군,'20,15 - 19세,1998,3309,1671,1638
'45770, 순창군,'25,20 - 24세,1998,3521,2127,1394
'45770, 순창군,'30,25 - 29세,1998,2339,1460,879
'45770, 순창군,'35,30 - 34세,1998,1794,948,846
'45770, 순창군,'40,35 - 39세,1998,2074,1098,976
'45770, 순창군,'45,40 - 44세,1998,1917,1017,900
'45770, 순창군,'50,45 - 49세,1998,1798,847,951
'45770, 순창군,'55,50 - 54세,1998,2177,991,1186
'45770, 순창군,'60,55 - 59세,1998,3233,1346,1887
'45770, 순창군,'65,60 - 64세,1998,3153,1439,1714
'45770, 순창군,'70,65 - 69세,1998,2139,943,1196
'45770, 순창군,'75,70 - 74세,1998,1757,766,991
'45770, 순창군,'80,75 - 79세,1998,1228,459,769
'45770, 순창군,'85,80 - 84세,1998,612,215,397
'45770, 순창군,'90,85+ ,1998,428,103,325
'4577025000,  순창읍,'00,계,1998,10796,5407,5389
'4577025000,  순창읍,'05,0 - 4세,1998,735,401,334
'4577025000,  순창읍,'10,5 - 9세,1998,758,369,389
'4577025000,  순창읍,'15,10 - 14세,1998,769,408,361
'4577025000,  순창읍,'20,15 - 19세,1998,1004,541,463
'4577025000,  순창읍,'25,20 - 24세,1998,928,529,399
'4577025000,  순창읍,'30,25 - 29세,1998,836,436,400
'4577025000,  순창읍,'35,30 - 34세,1998,791,389,402
'4577025000,  순창읍,'40,35 - 39세,1998,820,422,398
'4577025000,  순창읍,'45,40 - 44세,1998,694,367,327
'4577025000,  순창읍,'50,45 - 49세,1998,565,279,286
'4577025000,  순창읍,'55,50 - 54세,1998,581,282,299
'4577025000,  순창읍,'60,55 - 59세,1998,608,280,328
'4577025000,  순창읍,'65,60 - 64세,1998,569,261,308
'4577025000,  순창읍,'70,65 - 69세,1998,422,180,242
'4577025000,  순창읍,'75,70 - 74세,1998,317,131,186
'4577025000,  순창읍,'80,75 - 79세,1998,226,81,145
'4577025000,  순창읍,'85,80 - 84세,1998,105,30,75
'4577025000,  순창읍,'90,85+ ,1998,68,21,47
'4577031000,  인계면,'00,계,1998,2330,1128,1202
'4577031000,  인계면,'05,0 - 4세,1998,82,44,38
'4577031000,  인계면,'10,5 - 9세,1998,76,37,39
'4577031000,  인계면,'15,10 - 14세,1998,101,48,53
'4577031000,  인계면,'20,15 - 19세,1998,195,90,105
'4577031000,  인계면,'25,20 - 24세,1998,215,130,85
'4577031000,  인계면,'30,25 - 29세,1998,132,86,46
'4577031000,  인계면,'35,30 - 34세,1998,98,63,35
'4577031000,  인계면,'40,35 - 39세,1998,102,46,56
'4577031000,  인계면,'45,40 - 44세,1998,117,62,55
'4577031000,  인계면,'50,45 - 49세,1998,96,60,36
'4577031000,  인계면,'55,50 - 54세,1998,132,58,74
'4577031000,  인계면,'60,55 - 59세,1998,231,89,142
'4577031000,  인계면,'65,60 - 64세,1998,249,110,139
'4577031000,  인계면,'70,65 - 69세,1998,164,57,107
'4577031000,  인계면,'75,70 - 74세,1998,161,78,83
'4577031000,  인계면,'80,75 - 79세,1998,85,37,48
'4577031000,  인계면,'85,80 - 84세,1998,63,27,36
'4577031000,  인계면,'90,85+ ,1998,31,6,25
'4577032000,  동계면,'00,계,1998,3049,1527,1522
'4577032000,  동계면,'05,0 - 4세,1998,92,52,40
'4577032000,  동계면,'10,5 - 9세,1998,106,59,47
'4577032000,  동계면,'15,10 - 14세,1998,130,60,70
'4577032000,  동계면,'20,15 - 19세,1998,256,128,128
'4577032000,  동계면,'25,20 - 24세,1998,328,220,108
'4577032000,  동계면,'30,25 - 29세,1998,183,134,49
'4577032000,  동계면,'35,30 - 34세,1998,126,61,65
'4577032000,  동계면,'40,35 - 39세,1998,135,74,61
'4577032000,  동계면,'45,40 - 44세,1998,141,79,62
'4577032000,  동계면,'50,45 - 49세,1998,144,71,73
'4577032000,  동계면,'55,50 - 54세,1998,194,83,111
'4577032000,  동계면,'60,55 - 59세,1998,332,120,212
'4577032000,  동계면,'65,60 - 64세,1998,314,154,160
'4577032000,  동계면,'70,65 - 69세,1998,186,87,99
'4577032000,  동계면,'75,70 - 74세,1998,164,67,97
'4577032000,  동계면,'80,75 - 79세,1998,114,50,64
'4577032000,  동계면,'85,80 - 84세,1998,56,21,35
'4577032000,  동계면,'90,85+ ,1998,48,7,41
'4577033000,  풍산면,'00,계,1998,2482,1205,1277
'4577033000,  풍산면,'05,0 - 4세,1998,74,38,36
'4577033000,  풍산면,'10,5 - 9세,1998,48,25,23
'4577033000,  풍산면,'15,10 - 14세,1998,104,59,45
'4577033000,  풍산면,'20,15 - 19세,1998,229,99,130
'4577033000,  풍산면,'25,20 - 24세,1998,287,156,131
'4577033000,  풍산면,'30,25 - 29세,1998,165,120,45
'4577033000,  풍산면,'35,30 - 34세,1998,69,37,32
'4577033000,  풍산면,'40,35 - 39세,1998,97,50,47
'4577033000,  풍산면,'45,40 - 44세,1998,108,51,57
'4577033000,  풍산면,'50,45 - 49세,1998,125,61,64
'4577033000,  풍산면,'55,50 - 54세,1998,162,72,90
'4577033000,  풍산면,'60,55 - 59세,1998,263,104,159
'4577033000,  풍산면,'65,60 - 64세,1998,251,123,128
'4577033000,  풍산면,'70,65 - 69세,1998,168,78,90
'4577033000,  풍산면,'75,70 - 74세,1998,141,62,79
'4577033000,  풍산면,'80,75 - 79세,1998,97,35,62
'4577033000,  풍산면,'85,80 - 84세,1998,56,28,28
'4577033000,  풍산면,'90,85+ ,1998,38,7,31
'4577034000,  금과면,'00,계,1998,2352,1163,1189
'4577034000,  금과면,'05,0 - 4세,1998,63,35,28
'4577034000,  금과면,'10,5 - 9세,1998,68,39,29
'4577034000,  금과면,'15,10 - 14세,1998,111,63,48
'4577034000,  금과면,'20,15 - 19세,1998,183,92,91
'4577034000,  금과면,'25,20 - 24세,1998,213,125,88
'4577034000,  금과면,'30,25 - 29세,1998,148,93,55
'4577034000,  금과면,'35,30 - 34세,1998,61,35,26
'4577034000,  금과면,'40,35 - 39세,1998,123,73,50
'4577034000,  금과면,'45,40 - 44세,1998,121,73,48
'4577034000,  금과면,'50,45 - 49세,1998,115,44,71
'4577034000,  금과면,'55,50 - 54세,1998,135,56,79
'4577034000,  금과면,'60,55 - 59세,1998,246,100,146
'4577034000,  금과면,'65,60 - 64세,1998,259,120,139
'4577034000,  금과면,'70,65 - 69세,1998,173,76,97
'4577034000,  금과면,'75,70 - 74세,1998,141,65,76
'4577034000,  금과면,'80,75 - 79세,1998,106,49,57
'4577034000,  금과면,'85,80 - 84세,1998,46,16,30
'4577034000,  금과면,'90,85+ ,1998,40,9,31
'4577035000,  팔덕면,'00,계,1998,2121,1026,1095
'4577035000,  팔덕면,'05,0 - 4세,1998,67,34,33
'4577035000,  팔덕면,'10,5 - 9세,1998,89,47,42
'4577035000,  팔덕면,'15,10 - 14세,1998,113,49,64
'4577035000,  팔덕면,'20,15 - 19세,1998,160,77,83
'4577035000,  팔덕면,'25,20 - 24세,1998,184,109,75
'4577035000,  팔덕면,'30,25 - 29세,1998,114,79,35
'4577035000,  팔덕면,'35,30 - 34세,1998,80,49,31
'4577035000,  팔덕면,'40,35 - 39세,1998,111,65,46
'4577035000,  팔덕면,'45,40 - 44세,1998,103,53,50
'4577035000,  팔덕면,'50,45 - 49세,1998,95,45,50
'4577035000,  팔덕면,'55,50 - 54세,1998,115,52,63
'4577035000,  팔덕면,'60,55 - 59세,1998,201,74,127
'4577035000,  팔덕면,'65,60 - 64세,1998,262,118,144
'4577035000,  팔덕면,'70,65 - 69세,1998,155,75,80
'4577035000,  팔덕면,'75,70 - 74세,1998,110,46,64
'4577035000,  팔덕면,'80,75 - 79세,1998,77,31,46
'4577035000,  팔덕면,'85,80 - 84세,1998,46,14,32
'4577035000,  팔덕면,'90,85+ ,1998,39,9,30
'4577036000,  쌍치면,'00,계,1998,2971,1455,1516
'4577036000,  쌍치면,'05,0 - 4세,1998,114,58,56
'4577036000,  쌍치면,'10,5 - 9세,1998,145,70,75
'4577036000,  쌍치면,'15,10 - 14세,1998,156,84,72
'4577036000,  쌍치면,'20,15 - 19세,1998,296,143,153
'4577036000,  쌍치면,'25,20 - 24세,1998,309,186,123
'4577036000,  쌍치면,'30,25 - 29세,1998,151,98,53
'4577036000,  쌍치면,'35,30 - 34세,1998,142,79,63
'4577036000,  쌍치면,'40,35 - 39세,1998,182,98,84
'4577036000,  쌍치면,'45,40 - 44세,1998,138,78,60
'4577036000,  쌍치면,'50,45 - 49세,1998,124,53,71
'4577036000,  쌍치면,'55,50 - 54세,1998,173,74,99
'4577036000,  쌍치면,'60,55 - 59세,1998,277,108,169
'4577036000,  쌍치면,'65,60 - 64세,1998,261,122,139
'4577036000,  쌍치면,'70,65 - 69세,1998,183,87,96
'4577036000,  쌍치면,'75,70 - 74세,1998,150,62,88
'4577036000,  쌍치면,'80,75 - 79세,1998,97,31,66
'4577036000,  쌍치면,'85,80 - 84세,1998,42,16,26
'4577036000,  쌍치면,'90,85+ ,1998,31,8,23
'4577037000,  복흥면,'00,계,1998,3412,1695,1717
'4577037000,  복흥면,'05,0 - 4세,1998,144,73,71
'4577037000,  복흥면,'10,5 - 9세,1998,181,95,86
'4577037000,  복흥면,'15,10 - 14세,1998,228,114,114
'4577037000,  복흥면,'20,15 - 19세,1998,344,167,177
'4577037000,  복흥면,'25,20 - 24세,1998,321,208,113
'4577037000,  복흥면,'30,25 - 29세,1998,177,112,65
'4577037000,  복흥면,'35,30 - 34세,1998,166,83,83
'4577037000,  복흥면,'40,35 - 39세,1998,189,106,83
'4577037000,  복흥면,'45,40 - 44세,1998,177,93,84
'4577037000,  복흥면,'50,45 - 49세,1998,146,66,80
'4577037000,  복흥면,'55,50 - 54세,1998,198,99,99
'4577037000,  복흥면,'60,55 - 59세,1998,324,148,176
'4577037000,  복흥면,'65,60 - 64세,1998,265,110,155
'4577037000,  복흥면,'70,65 - 69세,1998,198,90,108
'4577037000,  복흥면,'75,70 - 74세,1998,160,70,90
'4577037000,  복흥면,'80,75 - 79세,1998,108,34,74
'4577037000,  복흥면,'85,80 - 84세,1998,56,20,36
'4577037000,  복흥면,'90,85+ ,1998,30,7,23
'4577038000,  적성면,'00,계,1998,1932,949,983
'4577038000,  적성면,'05,0 - 4세,1998,49,27,22
'4577038000,  적성면,'10,5 - 9세,1998,68,37,31
'4577038000,  적성면,'15,10 - 14세,1998,93,54,39
'4577038000,  적성면,'20,15 - 19세,1998,146,73,73
'4577038000,  적성면,'25,20 - 24세,1998,191,121,70
'4577038000,  적성면,'30,25 - 29세,1998,105,75,30
'4577038000,  적성면,'35,30 - 34세,1998,68,41,27
'4577038000,  적성면,'40,35 - 39세,1998,93,45,48
'4577038000,  적성면,'45,40 - 44세,1998,92,48,44
'4577038000,  적성면,'50,45 - 49세,1998,79,35,44
'4577038000,  적성면,'55,50 - 54세,1998,136,62,74
'4577038000,  적성면,'60,55 - 59세,1998,189,84,105
'4577038000,  적성면,'65,60 - 64세,1998,202,92,110
'4577038000,  적성면,'70,65 - 69세,1998,146,55,91
'4577038000,  적성면,'75,70 - 74세,1998,112,53,59
'4577038000,  적성면,'80,75 - 79세,1998,99,33,66
'4577038000,  적성면,'85,80 - 84세,1998,41,9,32
'4577038000,  적성면,'90,85+ ,1998,23,5,18
'4577039000,  유등면,'00,계,1998,1871,904,967
'4577039000,  유등면,'05,0 - 4세,1998,54,27,27
'4577039000,  유등면,'10,5 - 9세,1998,50,27,23
'4577039000,  유등면,'15,10 - 14세,1998,92,45,47
'4577039000,  유등면,'20,15 - 19세,1998,190,97,93
'4577039000,  유등면,'25,20 - 24세,1998,184,113,71
'4577039000,  유등면,'30,25 - 29세,1998,100,72,28
'4577039000,  유등면,'35,30 - 34세,1998,57,38,19
'4577039000,  유등면,'40,35 - 39세,1998,80,42,38
'4577039000,  유등면,'45,40 - 44세,1998,79,34,45
'4577039000,  유등면,'50,45 - 49세,1998,122,52,70
'4577039000,  유등면,'55,50 - 54세,1998,121,55,66
'4577039000,  유등면,'60,55 - 59세,1998,181,82,99
'4577039000,  유등면,'65,60 - 64세,1998,163,67,96
'4577039000,  유등면,'70,65 - 69세,1998,147,61,86
'4577039000,  유등면,'75,70 - 74세,1998,114,51,63
'4577039000,  유등면,'80,75 - 79세,1998,79,25,54
'4577039000,  유등면,'85,80 - 84세,1998,32,9,23
'4577039000,  유등면,'90,85+ ,1998,26,7,19
'4577040000,  구림면,'00,계,1998,3516,1750,1766
'4577040000,  구림면,'05,0 - 4세,1998,110,55,55
'4577040000,  구림면,'10,5 - 9세,1998,124,62,62
'4577040000,  구림면,'15,10 - 14세,1998,159,84,75
'4577040000,  구림면,'20,15 - 19세,1998,306,164,142
'4577040000,  구림면,'25,20 - 24세,1998,361,230,131
'4577040000,  구림면,'30,25 - 29세,1998,228,155,73
'4577040000,  구림면,'35,30 - 34세,1998,136,73,63
'4577040000,  구림면,'40,35 - 39세,1998,142,77,65
'4577040000,  구림면,'45,40 - 44세,1998,147,79,68
'4577040000,  구림면,'50,45 - 49세,1998,187,81,106
'4577040000,  구림면,'55,50 - 54세,1998,230,98,132
'4577040000,  구림면,'60,55 - 59세,1998,381,157,224
'4577040000,  구림면,'65,60 - 64세,1998,358,162,196
'4577040000,  구림면,'70,65 - 69세,1998,197,97,100
'4577040000,  구림면,'75,70 - 74세,1998,187,81,106
'4577040000,  구림면,'80,75 - 79세,1998,140,53,87
'4577040000,  구림면,'85,80 - 84세,1998,69,25,44
'4577040000,  구림면,'90,85+ ,1998,54,17,37
'45790, 고창군,'00,계,1998,78587,38794,39793
'45790, 고창군,'05,0 - 4세,1998,3572,1839,1733
'45790, 고창군,'10,5 - 9세,1998,3919,2099,1820
'45790, 고창군,'15,10 - 14세,1998,5031,2514,2517
'45790, 고창군,'20,15 - 19세,1998,8098,4125,3973
'45790, 고창군,'25,20 - 24세,1998,7650,4688,2962
'45790, 고창군,'30,25 - 29세,1998,4743,2833,1910
'45790, 고창군,'35,30 - 34세,1998,4188,2264,1924
'45790, 고창군,'40,35 - 39세,1998,4591,2378,2213
'45790, 고창군,'45,40 - 44세,1998,4579,2328,2251
'45790, 고창군,'50,45 - 49세,1998,4152,2086,2066
'45790, 고창군,'55,50 - 54세,1998,4447,2156,2291
'45790, 고창군,'60,55 - 59세,1998,6209,2705,3504
'45790, 고창군,'65,60 - 64세,1998,5975,2554,3421
'45790, 고창군,'70,65 - 69세,1998,4375,1745,2630
'45790, 고창군,'75,70 - 74세,1998,2857,1137,1720
'45790, 고창군,'80,75 - 79세,1998,2319,846,1473
'45790, 고창군,'85,80 - 84세,1998,1090,333,757
'45790, 고창군,'90,85+ ,1998,792,164,628
'4579025000,  고창읍,'00,계,1998,20959,10321,10638
'4579025000,  고창읍,'05,0 - 4세,1998,1569,797,772
'4579025000,  고창읍,'10,5 - 9세,1998,1609,875,734
'4579025000,  고창읍,'15,10 - 14세,1998,1732,887,845
'4579025000,  고창읍,'20,15 - 19세,1998,2128,1083,1045
'4579025000,  고창읍,'25,20 - 24세,1998,1802,1000,802
'4579025000,  고창읍,'30,25 - 29세,1998,1578,794,784
'4579025000,  고창읍,'35,30 - 34세,1998,1652,801,851
'4579025000,  고창읍,'40,35 - 39세,1998,1671,813,858
'4579025000,  고창읍,'45,40 - 44세,1998,1458,739,719
'4579025000,  고창읍,'50,45 - 49세,1998,1085,554,531
'4579025000,  고창읍,'55,50 - 54세,1998,916,460,456
'4579025000,  고창읍,'60,55 - 59세,1998,1015,452,563
'4579025000,  고창읍,'65,60 - 64세,1998,928,406,522
'4579025000,  고창읍,'70,65 - 69세,1998,679,283,396
'4579025000,  고창읍,'75,70 - 74세,1998,490,180,310
'4579025000,  고창읍,'80,75 - 79세,1998,362,124,238
'4579025000,  고창읍,'85,80 - 84세,1998,178,56,122
'4579025000,  고창읍,'90,85+ ,1998,107,17,90
'4579031000,  고수면,'00,계,1998,3873,1887,1986
'4579031000,  고수면,'05,0 - 4세,1998,165,76,89
'4579031000,  고수면,'10,5 - 9세,1998,130,74,56
'4579031000,  고수면,'15,10 - 14세,1998,233,119,114
'4579031000,  고수면,'20,15 - 19세,1998,372,174,198
'4579031000,  고수면,'25,20 - 24세,1998,410,237,173
'4579031000,  고수면,'30,25 - 29세,1998,232,141,91
'4579031000,  고수면,'35,30 - 34세,1998,179,110,69
'4579031000,  고수면,'40,35 - 39세,1998,200,119,81
'4579031000,  고수면,'45,40 - 44세,1998,188,100,88
'4579031000,  고수면,'50,45 - 49세,1998,181,79,102
'4579031000,  고수면,'55,50 - 54세,1998,223,120,103
'4579031000,  고수면,'60,55 - 59세,1998,325,138,187
'4579031000,  고수면,'65,60 - 64세,1998,336,144,192
'4579031000,  고수면,'70,65 - 69세,1998,273,104,169
'4579031000,  고수면,'75,70 - 74세,1998,152,71,81
'4579031000,  고수면,'80,75 - 79세,1998,157,55,102
'4579031000,  고수면,'85,80 - 84세,1998,68,19,49
'4579031000,  고수면,'90,85+ ,1998,49,7,42
'4579032000,  아산면,'00,계,1998,4555,2318,2237
'4579032000,  아산면,'05,0 - 4세,1998,158,85,73
'4579032000,  아산면,'10,5 - 9세,1998,173,102,71
'4579032000,  아산면,'15,10 - 14세,1998,249,120,129
'4579032000,  아산면,'20,15 - 19세,1998,458,257,201
'4579032000,  아산면,'25,20 - 24세,1998,526,336,190
'4579032000,  아산면,'30,25 - 29세,1998,257,171,86
'4579032000,  아산면,'35,30 - 34세,1998,210,128,82
'4579032000,  아산면,'40,35 - 39세,1998,238,128,110
'4579032000,  아산면,'45,40 - 44세,1998,234,123,111
'4579032000,  아산면,'50,45 - 49세,1998,228,123,105
'4579032000,  아산면,'55,50 - 54세,1998,258,102,156
'4579032000,  아산면,'60,55 - 59세,1998,415,186,229
'4579032000,  아산면,'65,60 - 64세,1998,395,169,226
'4579032000,  아산면,'70,65 - 69세,1998,292,106,186
'4579032000,  아산면,'75,70 - 74세,1998,194,84,110
'4579032000,  아산면,'80,75 - 79세,1998,160,63,97
'4579032000,  아산면,'85,80 - 84세,1998,62,21,41
'4579032000,  아산면,'90,85+ ,1998,48,14,34
'4579033000,  무장면,'00,계,1998,5314,2647,2667
'4579033000,  무장면,'05,0 - 4세,1998,217,123,94
'4579033000,  무장면,'10,5 - 9세,1998,234,115,119
'4579033000,  무장면,'15,10 - 14세,1998,276,135,141
'4579033000,  무장면,'20,15 - 19세,1998,626,309,317
'4579033000,  무장면,'25,20 - 24세,1998,546,341,205
'4579033000,  무장면,'30,25 - 29세,1998,324,214,110
'4579033000,  무장면,'35,30 - 34세,1998,226,131,95
'4579033000,  무장면,'40,35 - 39세,1998,259,146,113
'4579033000,  무장면,'45,40 - 44세,1998,286,145,141
'4579033000,  무장면,'50,45 - 49세,1998,283,153,130
'4579033000,  무장면,'55,50 - 54세,1998,314,139,175
'4579033000,  무장면,'60,55 - 59세,1998,502,226,276
'4579033000,  무장면,'65,60 - 64세,1998,433,183,250
'4579033000,  무장면,'70,65 - 69세,1998,293,120,173
'4579033000,  무장면,'75,70 - 74세,1998,192,67,125
'4579033000,  무장면,'80,75 - 79세,1998,162,58,104
'4579033000,  무장면,'85,80 - 84세,1998,74,30,44
'4579033000,  무장면,'90,85+ ,1998,67,12,55
'4579034000,  공음면,'00,계,1998,4604,2332,2272
'4579034000,  공음면,'05,0 - 4세,1998,143,77,66
'4579034000,  공음면,'10,5 - 9세,1998,190,111,79
'4579034000,  공음면,'15,10 - 14세,1998,281,150,131
'4579034000,  공음면,'20,15 - 19세,1998,521,283,238
'4579034000,  공음면,'25,20 - 24세,1998,469,295,174
'4579034000,  공음면,'30,25 - 29세,1998,233,153,80
'4579034000,  공음면,'35,30 - 34세,1998,195,110,85
'4579034000,  공음면,'40,35 - 39세,1998,229,122,107
'4579034000,  공음면,'45,40 - 44세,1998,238,114,124
'4579034000,  공음면,'50,45 - 49세,1998,260,130,130
'4579034000,  공음면,'55,50 - 54세,1998,286,142,144
'4579034000,  공음면,'60,55 - 59세,1998,456,192,264
'4579034000,  공음면,'65,60 - 64세,1998,403,186,217
'4579034000,  공음면,'70,65 - 69세,1998,288,125,163
'4579034000,  공음면,'75,70 - 74세,1998,177,68,109
'4579034000,  공음면,'80,75 - 79세,1998,126,46,80
'4579034000,  공음면,'85,80 - 84세,1998,54,18,36
'4579034000,  공음면,'90,85+ ,1998,55,10,45
'4579035000,  상하면,'00,계,1998,3976,1936,2040
'4579035000,  상하면,'05,0 - 4세,1998,144,72,72
'4579035000,  상하면,'10,5 - 9세,1998,168,87,81
'4579035000,  상하면,'15,10 - 14세,1998,213,105,108
'4579035000,  상하면,'20,15 - 19세,1998,426,203,223
'4579035000,  상하면,'25,20 - 24세,1998,421,291,130
'4579035000,  상하면,'30,25 - 29세,1998,207,124,83
'4579035000,  상하면,'35,30 - 34세,1998,193,105,88
'4579035000,  상하면,'40,35 - 39세,1998,179,103,76
'4579035000,  상하면,'45,40 - 44세,1998,214,107,107
'4579035000,  상하면,'50,45 - 49세,1998,195,94,101
'4579035000,  상하면,'55,50 - 54세,1998,271,151,120
'4579035000,  상하면,'60,55 - 59세,1998,382,142,240
'4579035000,  상하면,'65,60 - 64세,1998,318,121,197
'4579035000,  상하면,'70,65 - 69세,1998,233,96,137
'4579035000,  상하면,'75,70 - 74세,1998,168,64,104
'4579035000,  상하면,'80,75 - 79세,1998,132,44,88
'4579035000,  상하면,'85,80 - 84세,1998,61,17,44
'4579035000,  상하면,'90,85+ ,1998,51,10,41
'4579036000,  해리면,'00,계,1998,5156,2484,2672
'4579036000,  해리면,'05,0 - 4세,1998,172,87,85
'4579036000,  해리면,'10,5 - 9세,1998,212,109,103
'4579036000,  해리면,'15,10 - 14세,1998,327,138,189
'4579036000,  해리면,'20,15 - 19세,1998,574,283,291
'4579036000,  해리면,'25,20 - 24세,1998,451,287,164
'4579036000,  해리면,'30,25 - 29세,1998,239,156,83
'4579036000,  해리면,'35,30 - 34세,1998,224,126,98
'4579036000,  해리면,'40,35 - 39세,1998,268,126,142
'4579036000,  해리면,'45,40 - 44세,1998,312,160,152
'4579036000,  해리면,'50,45 - 49세,1998,270,139,131
'4579036000,  해리면,'55,50 - 54세,1998,320,154,166
'4579036000,  해리면,'60,55 - 59세,1998,459,203,256
'4579036000,  해리면,'65,60 - 64세,1998,453,184,269
'4579036000,  해리면,'70,65 - 69세,1998,328,128,200
'4579036000,  해리면,'75,70 - 74세,1998,216,91,125
'4579036000,  해리면,'80,75 - 79세,1998,192,78,114
'4579036000,  해리면,'85,80 - 84세,1998,77,21,56
'4579036000,  해리면,'90,85+ ,1998,62,14,48
'4579037000,  성송면,'00,계,1998,3268,1624,1644
'4579037000,  성송면,'05,0 - 4세,1998,101,53,48
'4579037000,  성송면,'10,5 - 9세,1998,80,44,36
'4579037000,  성송면,'15,10 - 14세,1998,140,56,84
'4579037000,  성송면,'20,15 - 19세,1998,336,182,154
'4579037000,  성송면,'25,20 - 24세,1998,352,219,133
'4579037000,  성송면,'30,25 - 29세,1998,203,136,67
'4579037000,  성송면,'35,30 - 34세,1998,115,74,41
'4579037000,  성송면,'40,35 - 39세,1998,132,80,52
'4579037000,  성송면,'45,40 - 44세,1998,164,78,86
'4579037000,  성송면,'50,45 - 49세,1998,198,96,102
'4579037000,  성송면,'55,50 - 54세,1998,191,98,93
'4579037000,  성송면,'60,55 - 59세,1998,282,115,167
'4579037000,  성송면,'65,60 - 64세,1998,368,152,216
'4579037000,  성송면,'70,65 - 69세,1998,245,105,140
'4579037000,  성송면,'75,70 - 74세,1998,146,67,79
'4579037000,  성송면,'80,75 - 79세,1998,117,39,78
'4579037000,  성송면,'85,80 - 84세,1998,52,18,34
'4579037000,  성송면,'90,85+ ,1998,46,12,34
'4579038000,  대산면,'00,계,1998,6398,3216,3182
'4579038000,  대산면,'05,0 - 4세,1998,236,119,117
'4579038000,  대산면,'10,5 - 9세,1998,288,147,141
'4579038000,  대산면,'15,10 - 14세,1998,396,206,190
'4579038000,  대산면,'20,15 - 19세,1998,632,340,292
'4579038000,  대산면,'25,20 - 24세,1998,601,385,216
'4579038000,  대산면,'30,25 - 29세,1998,352,214,138
'4579038000,  대산면,'35,30 - 34세,1998,304,169,135
'4579038000,  대산면,'40,35 - 39세,1998,405,211,194
'4579038000,  대산면,'45,40 - 44세,1998,362,194,168
'4579038000,  대산면,'50,45 - 49세,1998,354,183,171
'4579038000,  대산면,'55,50 - 54세,1998,400,194,206
'4579038000,  대산면,'60,55 - 59세,1998,594,273,321
'4579038000,  대산면,'65,60 - 64세,1998,555,236,319
'4579038000,  대산면,'70,65 - 69세,1998,331,138,193
'4579038000,  대산면,'75,70 - 74세,1998,236,99,137
'4579038000,  대산면,'80,75 - 79세,1998,198,72,126
'4579038000,  대산면,'85,80 - 84세,1998,85,20,65
'4579038000,  대산면,'90,85+ ,1998,69,16,53
'4579039000,  심원면,'00,계,1998,4097,2003,2094
'4579039000,  심원면,'05,0 - 4세,1998,152,74,78
'4579039000,  심원면,'10,5 - 9세,1998,187,92,95
'4579039000,  심원면,'15,10 - 14세,1998,276,142,134
'4579039000,  심원면,'20,15 - 19세,1998,453,217,236
'4579039000,  심원면,'25,20 - 24세,1998,404,252,152
'4579039000,  심원면,'30,25 - 29세,1998,205,131,74
'4579039000,  심원면,'35,30 - 34세,1998,192,107,85
'4579039000,  심원면,'40,35 - 39세,1998,235,119,116
'4579039000,  심원면,'45,40 - 44세,1998,242,118,124
'4579039000,  심원면,'50,45 - 49세,1998,218,118,100
'4579039000,  심원면,'55,50 - 54세,1998,276,126,150
'4579039000,  심원면,'60,55 - 59세,1998,375,170,205
'4579039000,  심원면,'65,60 - 64세,1998,292,133,159
'4579039000,  심원면,'70,65 - 69세,1998,222,82,140
'4579039000,  심원면,'75,70 - 74세,1998,160,64,96
'4579039000,  심원면,'80,75 - 79세,1998,120,38,82
'4579039000,  심원면,'85,80 - 84세,1998,51,12,39
'4579039000,  심원면,'90,85+ ,1998,37,8,29
'4579040000,  흥덕면,'00,계,1998,5169,2498,2671
'4579040000,  흥덕면,'05,0 - 4세,1998,224,115,109
'4579040000,  흥덕면,'10,5 - 9세,1998,266,138,128
'4579040000,  흥덕면,'15,10 - 14세,1998,341,173,168
'4579040000,  흥덕면,'20,15 - 19세,1998,480,239,241
'4579040000,  흥덕면,'25,20 - 24세,1998,493,292,201
'4579040000,  흥덕면,'30,25 - 29세,1998,321,197,124
'4579040000,  흥덕면,'35,30 - 34세,1998,274,149,125
'4579040000,  흥덕면,'40,35 - 39세,1998,289,154,135
'4579040000,  흥덕면,'45,40 - 44세,1998,286,140,146
'4579040000,  흥덕면,'50,45 - 49세,1998,265,124,141
'4579040000,  흥덕면,'55,50 - 54세,1998,291,145,146
'4579040000,  흥덕면,'60,55 - 59세,1998,401,159,242
'4579040000,  흥덕면,'65,60 - 64세,1998,427,194,233
'4579040000,  흥덕면,'70,65 - 69세,1998,346,126,220
'4579040000,  흥덕면,'75,70 - 74세,1998,179,72,107
'4579040000,  흥덕면,'80,75 - 79세,1998,150,52,98
'4579040000,  흥덕면,'85,80 - 84세,1998,86,21,65
'4579040000,  흥덕면,'90,85+ ,1998,50,8,42
'4579041000,  성내면,'00,계,1998,3359,1686,1673
'4579041000,  성내면,'05,0 - 4세,1998,67,39,28
'4579041000,  성내면,'10,5 - 9세,1998,86,47,39
'4579041000,  성내면,'15,10 - 14세,1998,198,102,96
'4579041000,  성내면,'20,15 - 19세,1998,355,187,168
'4579041000,  성내면,'25,20 - 24세,1998,345,232,113
'4579041000,  성내면,'30,25 - 29세,1998,162,119,43
'4579041000,  성내면,'35,30 - 34세,1998,113,59,54
'4579041000,  성내면,'40,35 - 39세,1998,149,73,76
'4579041000,  성내면,'45,40 - 44세,1998,216,115,101
'4579041000,  성내면,'50,45 - 49세,1998,187,97,90
'4579041000,  성내면,'55,50 - 54세,1998,198,97,101
'4579041000,  성내면,'60,55 - 59세,1998,278,125,153
'4579041000,  성내면,'65,60 - 64세,1998,303,125,178
'4579041000,  성내면,'70,65 - 69세,1998,278,106,172
'4579041000,  성내면,'75,70 - 74세,1998,159,63,96
'4579041000,  성내면,'80,75 - 79세,1998,139,61,78
'4579041000,  성내면,'85,80 - 84세,1998,80,25,55
'4579041000,  성내면,'90,85+ ,1998,46,14,32
'4579042000,  신림면,'00,계,1998,3621,1785,1836
'4579042000,  신림면,'05,0 - 4세,1998,116,63,53
'4579042000,  신림면,'10,5 - 9세,1998,122,65,57
'4579042000,  신림면,'15,10 - 14세,1998,171,83,88
'4579042000,  신림면,'20,15 - 19세,1998,350,189,161
'4579042000,  신림면,'25,20 - 24세,1998,387,235,152
'4579042000,  신림면,'30,25 - 29세,1998,214,135,79
'4579042000,  신림면,'35,30 - 34세,1998,142,98,44
'4579042000,  신림면,'40,35 - 39세,1998,166,88,78
'4579042000,  신림면,'45,40 - 44세,1998,177,92,85
'4579042000,  신림면,'50,45 - 49세,1998,205,99,106
'4579042000,  신림면,'55,50 - 54세,1998,199,91,108
'4579042000,  신림면,'60,55 - 59세,1998,319,145,174
'4579042000,  신림면,'65,60 - 64세,1998,340,139,201
'4579042000,  신림면,'70,65 - 69세,1998,265,97,168
'4579042000,  신림면,'75,70 - 74세,1998,176,73,103
'4579042000,  신림면,'80,75 - 79세,1998,148,57,91
'4579042000,  신림면,'85,80 - 84세,1998,77,28,49
'4579042000,  신림면,'90,85+ ,1998,47,8,39
'4579043000,  부안면,'00,계,1998,4238,2057,2181
'4579043000,  부안면,'05,0 - 4세,1998,108,59,49
'4579043000,  부안면,'10,5 - 9세,1998,174,93,81
'4579043000,  부안면,'15,10 - 14세,1998,198,98,100
'4579043000,  부안면,'20,15 - 19세,1998,387,179,208
'4579043000,  부안면,'25,20 - 24세,1998,443,286,157
'4579043000,  부안면,'30,25 - 29세,1998,216,148,68
'4579043000,  부안면,'35,30 - 34세,1998,169,97,72
'4579043000,  부안면,'40,35 - 39세,1998,171,96,75
'4579043000,  부안면,'45,40 - 44세,1998,202,103,99
'4579043000,  부안면,'50,45 - 49세,1998,223,97,126
'4579043000,  부안면,'55,50 - 54세,1998,304,137,167
'4579043000,  부안면,'60,55 - 59세,1998,406,179,227
'4579043000,  부안면,'65,60 - 64세,1998,424,182,242
'4579043000,  부안면,'70,65 - 69세,1998,302,129,173
'4579043000,  부안면,'75,70 - 74세,1998,212,74,138
'4579043000,  부안면,'80,75 - 79세,1998,156,59,97
'4579043000,  부안면,'85,80 - 84세,1998,85,27,58
'4579043000,  부안면,'90,85+ ,1998,58,14,44
'45800, 부안군,'00,계,1998,79355,39222,40133
'45800, 부안군,'05,0 - 4세,1998,3874,1977,1897
'45800, 부안군,'10,5 - 9세,1998,4158,2163,1995
'45800, 부안군,'15,10 - 14세,1998,4929,2460,2469
'45800, 부안군,'20,15 - 19세,1998,7673,3820,3853
'45800, 부안군,'25,20 - 24세,1998,7709,4437,3272
'45800, 부안군,'30,25 - 29세,1998,5458,3237,2221
'45800, 부안군,'35,30 - 34세,1998,4739,2628,2111
'45800, 부안군,'40,35 - 39세,1998,5154,2735,2419
'45800, 부안군,'45,40 - 44세,1998,4889,2559,2330
'45800, 부안군,'50,45 - 49세,1998,4308,2185,2123
'45800, 부안군,'55,50 - 54세,1998,4455,2180,2275
'45800, 부안군,'60,55 - 59세,1998,5419,2339,3080
'45800, 부안군,'65,60 - 64세,1998,5513,2363,3150
'45800, 부안군,'70,65 - 69세,1998,4388,1763,2625
'45800, 부안군,'75,70 - 74세,1998,2941,1204,1737
'45800, 부안군,'80,75 - 79세,1998,2060,748,1312
'45800, 부안군,'85,80 - 84세,1998,1047,294,753
'45800, 부안군,'90,85+ ,1998,641,130,511
'4580025000,  부안읍,'00,계,1998,23681,11529,12152
'4580025000,  부안읍,'05,0 - 4세,1998,1771,902,869
'4580025000,  부안읍,'10,5 - 9세,1998,1930,1016,914
'4580025000,  부안읍,'15,10 - 14세,1998,1911,959,952
'4580025000,  부안읍,'20,15 - 19세,1998,2176,1057,1119
'4580025000,  부안읍,'25,20 - 24세,1998,1945,1038,907
'4580025000,  부안읍,'30,25 - 29세,1998,1797,883,914
'4580025000,  부안읍,'35,30 - 34세,1998,1910,911,999
'4580025000,  부안읍,'40,35 - 39세,1998,1962,984,978
'4580025000,  부안읍,'45,40 - 44세,1998,1665,865,800
'4580025000,  부안읍,'50,45 - 49세,1998,1192,620,572
'4580025000,  부안읍,'55,50 - 54세,1998,1154,567,587
'4580025000,  부안읍,'60,55 - 59세,1998,1123,514,609
'4580025000,  부안읍,'65,60 - 64세,1998,1090,459,631
'4580025000,  부안읍,'70,65 - 69세,1998,855,342,513
'4580025000,  부안읍,'75,70 - 74세,1998,528,209,319
'4580025000,  부안읍,'80,75 - 79세,1998,356,133,223
'4580025000,  부안읍,'85,80 - 84세,1998,176,40,136
'4580025000,  부안읍,'90,85+ ,1998,140,30,110
'4580031000,  주산면,'00,계,1998,3580,1783,1797
'4580031000,  주산면,'05,0 - 4세,1998,114,56,58
'4580031000,  주산면,'10,5 - 9세,1998,111,59,52
'4580031000,  주산면,'15,10 - 14세,1998,187,93,94
'4580031000,  주산면,'20,15 - 19세,1998,350,190,160
'4580031000,  주산면,'25,20 - 24세,1998,378,220,158
'4580031000,  주산면,'30,25 - 29세,1998,203,137,66
'4580031000,  주산면,'35,30 - 34세,1998,151,96,55
'4580031000,  주산면,'40,35 - 39세,1998,172,105,67
'4580031000,  주산면,'45,40 - 44세,1998,192,102,90
'4580031000,  주산면,'50,45 - 49세,1998,202,103,99
'4580031000,  주산면,'55,50 - 54세,1998,207,107,100
'4580031000,  주산면,'60,55 - 59세,1998,290,114,176
'4580031000,  주산면,'65,60 - 64세,1998,332,137,195
'4580031000,  주산면,'70,65 - 69세,1998,266,109,157
'4580031000,  주산면,'75,70 - 74세,1998,174,78,96
'4580031000,  주산면,'80,75 - 79세,1998,136,47,89
'4580031000,  주산면,'85,80 - 84세,1998,68,21,47
'4580031000,  주산면,'90,85+ ,1998,47,9,38
'4580032000,  동진면,'00,계,1998,5826,2960,2866
'4580032000,  동진면,'05,0 - 4세,1998,194,97,97
'4580032000,  동진면,'10,5 - 9세,1998,200,109,91
'4580032000,  동진면,'15,10 - 14세,1998,294,148,146
'4580032000,  동진면,'20,15 - 19세,1998,524,260,264
'4580032000,  동진면,'25,20 - 24세,1998,603,358,245
'4580032000,  동진면,'30,25 - 29세,1998,419,282,137
'4580032000,  동진면,'35,30 - 34세,1998,280,176,104
'4580032000,  동진면,'40,35 - 39세,1998,309,193,116
'4580032000,  동진면,'45,40 - 44세,1998,311,177,134
'4580032000,  동진면,'50,45 - 49세,1998,289,136,153
'4580032000,  동진면,'55,50 - 54세,1998,313,153,160
'4580032000,  동진면,'60,55 - 59세,1998,484,201,283
'4580032000,  동진면,'65,60 - 64세,1998,508,222,286
'4580032000,  동진면,'70,65 - 69세,1998,435,170,265
'4580032000,  동진면,'75,70 - 74세,1998,291,146,145
'4580032000,  동진면,'80,75 - 79세,1998,208,87,121
'4580032000,  동진면,'85,80 - 84세,1998,109,37,72
'4580032000,  동진면,'90,85+ ,1998,55,8,47
'4580033000,  행안면,'00,계,1998,3587,1768,1819
'4580033000,  행안면,'05,0 - 4세,1998,141,68,73
'4580033000,  행안면,'10,5 - 9세,1998,162,76,86
'4580033000,  행안면,'15,10 - 14세,1998,225,113,112
'4580033000,  행안면,'20,15 - 19세,1998,320,164,156
'4580033000,  행안면,'25,20 - 24세,1998,340,195,145
'4580033000,  행안면,'30,25 - 29세,1998,247,155,92
'4580033000,  행안면,'35,30 - 34세,1998,193,117,76
'4580033000,  행안면,'40,35 - 39세,1998,219,114,105
'4580033000,  행안면,'45,40 - 44세,1998,209,123,86
'4580033000,  행안면,'50,45 - 49세,1998,179,88,91
'4580033000,  행안면,'55,50 - 54세,1998,211,100,111
'4580033000,  행안면,'60,55 - 59세,1998,266,123,143
'4580033000,  행안면,'65,60 - 64세,1998,261,109,152
'4580033000,  행안면,'70,65 - 69세,1998,250,87,163
'4580033000,  행안면,'75,70 - 74세,1998,150,68,82
'4580033000,  행안면,'80,75 - 79세,1998,122,43,79
'4580033000,  행안면,'85,80 - 84세,1998,52,14,38
'4580033000,  행안면,'90,85+ ,1998,40,11,29
'4580034000,  계화면,'00,계,1998,7452,3795,3657
'4580034000,  계화면,'05,0 - 4세,1998,277,147,130
'4580034000,  계화면,'10,5 - 9세,1998,329,183,146
'4580034000,  계화면,'15,10 - 14세,1998,441,217,224
'4580034000,  계화면,'20,15 - 19세,1998,797,411,386
'4580034000,  계화면,'25,20 - 24세,1998,886,521,365
'4580034000,  계화면,'30,25 - 29세,1998,510,316,194
'4580034000,  계화면,'35,30 - 34세,1998,409,259,150
'4580034000,  계화면,'40,35 - 39세,1998,470,241,229
'4580034000,  계화면,'45,40 - 44세,1998,445,224,221
'4580034000,  계화면,'50,45 - 49세,1998,475,235,240
'4580034000,  계화면,'55,50 - 54세,1998,462,232,230
'4580034000,  계화면,'60,55 - 59세,1998,582,245,337
'4580034000,  계화면,'65,60 - 64세,1998,503,230,273
'4580034000,  계화면,'70,65 - 69세,1998,331,132,199
'4580034000,  계화면,'75,70 - 74세,1998,238,104,134
'4580034000,  계화면,'80,75 - 79세,1998,166,56,110
'4580034000,  계화면,'85,80 - 84세,1998,83,28,55
'4580034000,  계화면,'90,85+ ,1998,48,14,34
'4580035000,  보안면,'00,계,1998,4552,2227,2325
'4580035000,  보안면,'05,0 - 4세,1998,153,71,82
'4580035000,  보안면,'10,5 - 9세,1998,147,74,73
'4580035000,  보안면,'15,10 - 14세,1998,211,113,98
'4580035000,  보안면,'20,15 - 19세,1998,431,210,221
'4580035000,  보안면,'25,20 - 24세,1998,483,291,192
'4580035000,  보안면,'30,25 - 29세,1998,291,176,115
'4580035000,  보안면,'35,30 - 34세,1998,190,113,77
'4580035000,  보안면,'40,35 - 39세,1998,205,114,91
'4580035000,  보안면,'45,40 - 44세,1998,224,115,109
'4580035000,  보안면,'50,45 - 49세,1998,245,127,118
'4580035000,  보안면,'55,50 - 54세,1998,273,119,154
'4580035000,  보안면,'60,55 - 59세,1998,401,166,235
'4580035000,  보안면,'65,60 - 64세,1998,441,205,236
'4580035000,  보안면,'70,65 - 69세,1998,353,153,200
'4580035000,  보안면,'75,70 - 74세,1998,224,90,134
'4580035000,  보안면,'80,75 - 79세,1998,151,59,92
'4580035000,  보안면,'85,80 - 84세,1998,89,22,67
'4580035000,  보안면,'90,85+ ,1998,40,9,31
'4580036000,  변산면,'00,계,1998,6380,3175,3205
'4580036000,  변산면,'05,0 - 4세,1998,309,167,142
'4580036000,  변산면,'10,5 - 9세,1998,323,171,152
'4580036000,  변산면,'15,10 - 14세,1998,373,189,184
'4580036000,  변산면,'20,15 - 19세,1998,666,337,329
'4580036000,  변산면,'25,20 - 24세,1998,657,387,270
'4580036000,  변산면,'30,25 - 29세,1998,434,285,149
'4580036000,  변산면,'35,30 - 34세,1998,410,219,191
'4580036000,  변산면,'40,35 - 39세,1998,429,230,199
'4580036000,  변산면,'45,40 - 44세,1998,408,212,196
'4580036000,  변산면,'50,45 - 49세,1998,345,176,169
'4580036000,  변산면,'55,50 - 54세,1998,408,207,201
'4580036000,  변산면,'60,55 - 59세,1998,431,181,250
'4580036000,  변산면,'65,60 - 64세,1998,394,156,238
'4580036000,  변산면,'70,65 - 69세,1998,289,99,190
'4580036000,  변산면,'75,70 - 74세,1998,220,80,140
'4580036000,  변산면,'80,75 - 79세,1998,158,51,107
'4580036000,  변산면,'85,80 - 84세,1998,80,17,63
'4580036000,  변산면,'90,85+ ,1998,46,11,35
'4580037000,  진서면,'00,계,1998,3720,1868,1852
'4580037000,  진서면,'05,0 - 4세,1998,153,85,68
'4580037000,  진서면,'10,5 - 9세,1998,180,96,84
'4580037000,  진서면,'15,10 - 14세,1998,247,118,129
'4580037000,  진서면,'20,15 - 19세,1998,375,181,194
'4580037000,  진서면,'25,20 - 24세,1998,362,212,150
'4580037000,  진서면,'30,25 - 29세,1998,212,149,63
'4580037000,  진서면,'35,30 - 34세,1998,199,120,79
'4580037000,  진서면,'40,35 - 39세,1998,251,128,123
'4580037000,  진서면,'45,40 - 44세,1998,257,132,125
'4580037000,  진서면,'50,45 - 49세,1998,223,125,98
'4580037000,  진서면,'55,50 - 54세,1998,197,92,105
'4580037000,  진서면,'60,55 - 59세,1998,265,116,149
'4580037000,  진서면,'65,60 - 64세,1998,281,114,167
'4580037000,  진서면,'70,65 - 69세,1998,200,87,113
'4580037000,  진서면,'75,70 - 74세,1998,146,58,88
'4580037000,  진서면,'80,75 - 79세,1998,95,32,63
'4580037000,  진서면,'85,80 - 84세,1998,47,18,29
'4580037000,  진서면,'90,85+ ,1998,30,5,25
'4580038000,  백산면,'00,계,1998,5066,2457,2609
'4580038000,  백산면,'05,0 - 4세,1998,173,86,87
'4580038000,  백산면,'10,5 - 9세,1998,160,83,77
'4580038000,  백산면,'15,10 - 14세,1998,262,131,131
'4580038000,  백산면,'20,15 - 19세,1998,490,240,250
'4580038000,  백산면,'25,20 - 24세,1998,477,282,195
'4580038000,  백산면,'30,25 - 29세,1998,298,192,106
'4580038000,  백산면,'35,30 - 34세,1998,198,122,76
'4580038000,  백산면,'40,35 - 39세,1998,275,137,138
'4580038000,  백산면,'45,40 - 44세,1998,268,138,130
'4580038000,  백산면,'50,45 - 49세,1998,266,124,142
'4580038000,  백산면,'55,50 - 54세,1998,312,151,161
'4580038000,  백산면,'60,55 - 59세,1998,408,174,234
'4580038000,  백산면,'65,60 - 64세,1998,500,215,285
'4580038000,  백산면,'70,65 - 69세,1998,431,181,250
'4580038000,  백산면,'75,70 - 74세,1998,250,113,137
'4580038000,  백산면,'80,75 - 79세,1998,151,59,92
'4580038000,  백산면,'85,80 - 84세,1998,86,23,63
'4580038000,  백산면,'90,85+ ,1998,61,6,55
'4580039000,  상서면,'00,계,1998,3687,1809,1878
'4580039000,  상서면,'05,0 - 4세,1998,126,61,65
'4580039000,  상서면,'10,5 - 9세,1998,130,74,56
'4580039000,  상서면,'15,10 - 14세,1998,176,85,91
'4580039000,  상서면,'20,15 - 19세,1998,339,172,167
'4580039000,  상서면,'25,20 - 24세,1998,386,217,169
'4580039000,  상서면,'30,25 - 29세,1998,222,147,75
'4580039000,  상서면,'35,30 - 34세,1998,202,136,66
'4580039000,  상서면,'40,35 - 39세,1998,193,109,84
'4580039000,  상서면,'45,40 - 44세,1998,196,115,81
'4580039000,  상서면,'50,45 - 49세,1998,177,79,98
'4580039000,  상서면,'55,50 - 54세,1998,199,90,109
'4580039000,  상서면,'60,55 - 59세,1998,296,120,176
'4580039000,  상서면,'65,60 - 64세,1998,331,131,200
'4580039000,  상서면,'70,65 - 69세,1998,274,111,163
'4580039000,  상서면,'75,70 - 74세,1998,193,70,123
'4580039000,  상서면,'80,75 - 79세,1998,146,60,86
'4580039000,  상서면,'85,80 - 84세,1998,68,25,43
'4580039000,  상서면,'90,85+ ,1998,33,7,26
'4580040000,  하서면,'00,계,1998,5138,2543,2595
'4580040000,  하서면,'05,0 - 4세,1998,191,96,95
'4580040000,  하서면,'10,5 - 9세,1998,194,80,114
'4580040000,  하서면,'15,10 - 14세,1998,269,127,142
'4580040000,  하서면,'20,15 - 19세,1998,529,264,265
'4580040000,  하서면,'25,20 - 24세,1998,513,310,203
'4580040000,  하서면,'30,25 - 29세,1998,400,256,144
'4580040000,  하서면,'35,30 - 34세,1998,250,153,97
'4580040000,  하서면,'40,35 - 39세,1998,274,149,125
'4580040000,  하서면,'45,40 - 44세,1998,316,155,161
'4580040000,  하서면,'50,45 - 49세,1998,289,158,131
'4580040000,  하서면,'55,50 - 54세,1998,307,152,155
'4580040000,  하서면,'60,55 - 59세,1998,410,177,233
'4580040000,  하서면,'65,60 - 64세,1998,390,178,212
'4580040000,  하서면,'70,65 - 69세,1998,312,131,181
'4580040000,  하서면,'75,70 - 74세,1998,225,76,149
'4580040000,  하서면,'80,75 - 79세,1998,151,51,100
'4580040000,  하서면,'85,80 - 84세,1998,79,22,57
'4580040000,  하서면,'90,85+ ,1998,39,8,31
'4580041000,  줄포면,'00,계,1998,5123,2495,2628
'4580041000,  줄포면,'05,0 - 4세,1998,220,116,104
'4580041000,  줄포면,'10,5 - 9세,1998,250,118,132
'4580041000,  줄포면,'15,10 - 14세,1998,283,139,144
'4580041000,  줄포면,'20,15 - 19세,1998,538,260,278
'4580041000,  줄포면,'25,20 - 24세,1998,513,304,209
'4580041000,  줄포면,'30,25 - 29세,1998,320,189,131
'4580041000,  줄포면,'35,30 - 34세,1998,271,159,112
'4580041000,  줄포면,'40,35 - 39세,1998,311,170,141
'4580041000,  줄포면,'45,40 - 44세,1998,296,150,146
'4580041000,  줄포면,'50,45 - 49세,1998,313,153,160
'4580041000,  줄포면,'55,50 - 54세,1998,295,150,145
'4580041000,  줄포면,'60,55 - 59세,1998,332,144,188
'4580041000,  줄포면,'65,60 - 64세,1998,358,155,203
'4580041000,  줄포면,'70,65 - 69세,1998,297,124,173
'4580041000,  줄포면,'75,70 - 74세,1998,227,78,149
'4580041000,  줄포면,'80,75 - 79세,1998,174,57,117
'4580041000,  줄포면,'85,80 - 84세,1998,80,20,60
'4580041000,  줄포면,'90,85+ ,1998,45,9,36
'4580042000,  위도면,'00,계,1998,1563,813,750
'4580042000,  위도면,'05,0 - 4세,1998,52,25,27
'4580042000,  위도면,'10,5 - 9세,1998,42,24,18
'4580042000,  위도면,'15,10 - 14세,1998,50,28,22
'4580042000,  위도면,'20,15 - 19세,1998,138,74,64
'4580042000,  위도면,'25,20 - 24세,1998,166,102,64
'4580042000,  위도면,'30,25 - 29세,1998,105,70,35
'4580042000,  위도면,'35,30 - 34세,1998,76,47,29
'4580042000,  위도면,'40,35 - 39세,1998,84,61,23
'4580042000,  위도면,'45,40 - 44세,1998,102,51,51
'4580042000,  위도면,'50,45 - 49세,1998,113,61,52
'4580042000,  위도면,'55,50 - 54세,1998,117,60,57
'4580042000,  위도면,'60,55 - 59세,1998,131,64,67
'4580042000,  위도면,'65,60 - 64세,1998,124,52,72
'4580042000,  위도면,'70,65 - 69세,1998,95,37,58
'4580042000,  위도면,'75,70 - 74세,1998,75,34,41
'4580042000,  위도면,'80,75 - 79세,1998,46,13,33
'4580042000,  위도면,'85,80 - 84세,1998,30,7,23
'4580042000,  위도면,'90,85+ ,1998,17,3,14
'46,전라남도,'00,계,1998,2171024,1083418,1087606
'46,전라남도,'05,0 - 4세,1998,142157,74248,67909
'46,전라남도,'10,5 - 9세,1998,139483,72698,66785
'46,전라남도,'15,10 - 14세,1998,141130,71817,69313
'46,전라남도,'20,15 - 19세,1998,205832,104393,101439
'46,전라남도,'25,20 - 24세,1998,192973,107672,85301
'46,전라남도,'30,25 - 29세,1998,170639,94428,76211
'46,전라남도,'35,30 - 34세,1998,158864,85209,73655
'46,전라남도,'40,35 - 39세,1998,165198,86625,78573
'46,전라남도,'45,40 - 44세,1998,138103,72415,65688
'46,전라남도,'50,45 - 49세,1998,114536,58603,55933
'46,전라남도,'55,50 - 54세,1998,110965,54514,56451
'46,전라남도,'60,55 - 59세,1998,134696,61331,73365
'46,전라남도,'65,60 - 64세,1998,121600,53001,68599
'46,전라남도,'70,65 - 69세,1998,92483,37141,55342
'46,전라남도,'75,70 - 74세,1998,60182,24083,36099
'46,전라남도,'80,75 - 79세,1998,44991,15746,29245
'46,전라남도,'85,80 - 84세,1998,21830,6564,15266
'46,전라남도,'90,85+ ,1998,15362,2930,12432
'46110, 목포시,'00,계,1998,248568,123526,125042
'46110, 목포시,'05,0 - 4세,1998,19060,9929,9131
'46110, 목포시,'10,5 - 9세,1998,18643,9738,8905
'46110, 목포시,'15,10 - 14세,1998,19122,9863,9259
'46110, 목포시,'20,15 - 19세,1998,26242,13464,12778
'46110, 목포시,'25,20 - 24세,1998,23508,12257,11251
'46110, 목포시,'30,25 - 29세,1998,22619,11535,11084
'46110, 목포시,'35,30 - 34세,1998,20785,10602,10183
'46110, 목포시,'40,35 - 39세,1998,22319,10938,11381
'46110, 목포시,'45,40 - 44세,1998,18638,9434,9204
'46110, 목포시,'50,45 - 49세,1998,13768,6915,6853
'46110, 목포시,'55,50 - 54세,1998,11740,5852,5888
'46110, 목포시,'60,55 - 59세,1998,10472,5044,5428
'46110, 목포시,'65,60 - 64세,1998,7840,3386,4454
'46110, 목포시,'70,65 - 69세,1998,5507,2103,3404
'46110, 목포시,'75,70 - 74세,1998,3549,1246,2303
'46110, 목포시,'80,75 - 79세,1998,2770,791,1979
'46110, 목포시,'85,80 - 84세,1998,1220,315,905
'46110, 목포시,'90,85+ ,1998,766,114,652
'4611051000,  용당1동,'00,계,1998,14463,7158,7305
'4611051000,  용당1동,'05,0 - 4세,1998,897,448,449
'4611051000,  용당1동,'10,5 - 9세,1998,821,437,384
'4611051000,  용당1동,'15,10 - 14세,1998,1009,537,472
'4611051000,  용당1동,'20,15 - 19세,1998,1709,889,820
'4611051000,  용당1동,'25,20 - 24세,1998,1748,915,833
'4611051000,  용당1동,'30,25 - 29세,1998,1348,744,604
'4611051000,  용당1동,'35,30 - 34세,1998,902,482,420
'4611051000,  용당1동,'40,35 - 39세,1998,1050,458,592
'4611051000,  용당1동,'45,40 - 44세,1998,1080,497,583
'4611051000,  용당1동,'50,45 - 49세,1998,952,427,525
'4611051000,  용당1동,'55,50 - 54세,1998,856,460,396
'4611051000,  용당1동,'60,55 - 59세,1998,690,361,329
'4611051000,  용당1동,'65,60 - 64세,1998,520,227,293
'4611051000,  용당1동,'70,65 - 69세,1998,352,135,217
'4611051000,  용당1동,'75,70 - 74세,1998,218,74,144
'4611051000,  용당1동,'80,75 - 79세,1998,170,40,130
'4611051000,  용당1동,'85,80 - 84세,1998,84,19,65
'4611051000,  용당1동,'90,85+ ,1998,57,8,49
'4611052000,  용당2동,'00,계,1998,11070,5570,5500
'4611052000,  용당2동,'05,0 - 4세,1998,675,350,325
'4611052000,  용당2동,'10,5 - 9세,1998,641,323,318
'4611052000,  용당2동,'15,10 - 14세,1998,750,391,359
'4611052000,  용당2동,'20,15 - 19세,1998,1338,696,642
'4611052000,  용당2동,'25,20 - 24세,1998,1357,774,583
'4611052000,  용당2동,'30,25 - 29세,1998,1032,587,445
'4611052000,  용당2동,'35,30 - 34세,1998,692,352,340
'4611052000,  용당2동,'40,35 - 39세,1998,823,381,442
'4611052000,  용당2동,'45,40 - 44세,1998,821,372,449
'4611052000,  용당2동,'50,45 - 49세,1998,751,356,395
'4611052000,  용당2동,'55,50 - 54세,1998,695,336,359
'4611052000,  용당2동,'60,55 - 59세,1998,526,265,261
'4611052000,  용당2동,'65,60 - 64세,1998,365,173,192
'4611052000,  용당2동,'70,65 - 69세,1998,233,100,133
'4611052000,  용당2동,'75,70 - 74세,1998,152,52,100
'4611052000,  용당2동,'80,75 - 79세,1998,132,39,93
'4611052000,  용당2동,'85,80 - 84세,1998,52,15,37
'4611052000,  용당2동,'90,85+ ,1998,35,8,27
'4611053000,  산정1동,'00,계,1998,11472,5686,5786
'4611053000,  산정1동,'05,0 - 4세,1998,638,317,321
'4611053000,  산정1동,'10,5 - 9세,1998,625,316,309
'4611053000,  산정1동,'15,10 - 14세,1998,789,410,379
'4611053000,  산정1동,'20,15 - 19세,1998,1312,675,637
'4611053000,  산정1동,'25,20 - 24세,1998,1346,734,612
'4611053000,  산정1동,'30,25 - 29세,1998,995,565,430
'4611053000,  산정1동,'35,30 - 34세,1998,740,399,341
'4611053000,  산정1동,'40,35 - 39세,1998,813,387,426
'4611053000,  산정1동,'45,40 - 44세,1998,815,390,425
'4611053000,  산정1동,'50,45 - 49세,1998,749,342,407
'4611053000,  산정1동,'55,50 - 54세,1998,677,330,347
'4611053000,  산정1동,'60,55 - 59세,1998,706,338,368
'4611053000,  산정1동,'65,60 - 64세,1998,507,226,281
'4611053000,  산정1동,'70,65 - 69세,1998,346,138,208
'4611053000,  산정1동,'75,70 - 74세,1998,181,69,112
'4611053000,  산정1동,'80,75 - 79세,1998,143,36,107
'4611053000,  산정1동,'85,80 - 84세,1998,52,11,41
'4611053000,  산정1동,'90,85+ ,1998,38,3,35
'4611054000,  산정2동,'00,계,1998,6840,3432,3408
'4611054000,  산정2동,'05,0 - 4세,1998,317,181,136
'4611054000,  산정2동,'10,5 - 9세,1998,366,174,192
'4611054000,  산정2동,'15,10 - 14세,1998,466,258,208
'4611054000,  산정2동,'20,15 - 19세,1998,832,429,403
'4611054000,  산정2동,'25,20 - 24세,1998,855,467,388
'4611054000,  산정2동,'30,25 - 29세,1998,564,328,236
'4611054000,  산정2동,'35,30 - 34세,1998,428,236,192
'4611054000,  산정2동,'40,35 - 39세,1998,499,239,260
'4611054000,  산정2동,'45,40 - 44세,1998,488,234,254
'4611054000,  산정2동,'50,45 - 49세,1998,428,208,220
'4611054000,  산정2동,'55,50 - 54세,1998,429,201,228
'4611054000,  산정2동,'60,55 - 59세,1998,402,182,220
'4611054000,  산정2동,'65,60 - 64세,1998,278,135,143
'4611054000,  산정2동,'70,65 - 69세,1998,202,76,126
'4611054000,  산정2동,'75,70 - 74세,1998,116,42,74
'4611054000,  산정2동,'80,75 - 79세,1998,102,28,74
'4611054000,  산정2동,'85,80 - 84세,1998,34,9,25
'4611054000,  산정2동,'90,85+ ,1998,34,5,29
'4611055000,  산정3동,'00,계,1998,11020,5472,5548
'4611055000,  산정3동,'05,0 - 4세,1998,712,376,336
'4611055000,  산정3동,'10,5 - 9세,1998,859,465,394
'4611055000,  산정3동,'15,10 - 14세,1998,914,477,437
'4611055000,  산정3동,'20,15 - 19세,1998,1252,637,615
'4611055000,  산정3동,'25,20 - 24세,1998,996,503,493
'4611055000,  산정3동,'30,25 - 29세,1998,876,458,418
'4611055000,  산정3동,'35,30 - 34세,1998,812,397,415
'4611055000,  산정3동,'40,35 - 39세,1998,1081,505,576
'4611055000,  산정3동,'45,40 - 44세,1998,930,469,461
'4611055000,  산정3동,'50,45 - 49세,1998,621,329,292
'4611055000,  산정3동,'55,50 - 54세,1998,487,263,224
'4611055000,  산정3동,'60,55 - 59세,1998,417,208,209
'4611055000,  산정3동,'65,60 - 64세,1998,383,155,228
'4611055000,  산정3동,'70,65 - 69세,1998,273,106,167
'4611055000,  산정3동,'75,70 - 74세,1998,185,67,118
'4611055000,  산정3동,'80,75 - 79세,1998,121,41,80
'4611055000,  산정3동,'85,80 - 84세,1998,70,13,57
'4611055000,  산정3동,'90,85+ ,1998,31,3,28
'4611055400,  연산동,'00,계,1998,3821,1932,1889
'4611055400,  연산동,'05,0 - 4세,1998,210,112,98
'4611055400,  연산동,'10,5 - 9세,1998,299,159,140
'4611055400,  연산동,'15,10 - 14세,1998,391,209,182
'4611055400,  연산동,'20,15 - 19세,1998,473,256,217
'4611055400,  연산동,'25,20 - 24세,1998,285,156,129
'4611055400,  연산동,'30,25 - 29세,1998,212,120,92
'4611055400,  연산동,'35,30 - 34세,1998,226,110,116
'4611055400,  연산동,'40,35 - 39세,1998,361,154,207
'4611055400,  연산동,'45,40 - 44세,1998,405,198,207
'4611055400,  연산동,'50,45 - 49세,1998,261,150,111
'4611055400,  연산동,'55,50 - 54세,1998,180,98,82
'4611055400,  연산동,'60,55 - 59세,1998,146,71,75
'4611055400,  연산동,'65,60 - 64세,1998,121,56,65
'4611055400,  연산동,'70,65 - 69세,1998,86,33,53
'4611055400,  연산동,'75,70 - 74세,1998,65,29,36
'4611055400,  연산동,'80,75 - 79세,1998,55,9,46
'4611055400,  연산동,'85,80 - 84세,1998,23,8,15
'4611055400,  연산동,'90,85+ ,1998,22,4,18
'4611055800,  원산동,'00,계,1998,19402,9678,9724
'4611055800,  원산동,'05,0 - 4세,1998,2296,1208,1088
'4611055800,  원산동,'10,5 - 9세,1998,1921,1008,913
'4611055800,  원산동,'15,10 - 14세,1998,1535,778,757
'4611055800,  원산동,'20,15 - 19세,1998,1592,825,767
'4611055800,  원산동,'25,20 - 24세,1998,1289,607,682
'4611055800,  원산동,'30,25 - 29세,1998,2216,980,1236
'4611055800,  원산동,'35,30 - 34세,1998,2447,1269,1178
'4611055800,  원산동,'40,35 - 39세,1998,2021,1056,965
'4611055800,  원산동,'45,40 - 44세,1998,1406,761,645
'4611055800,  원산동,'50,45 - 49세,1998,769,408,361
'4611055800,  원산동,'55,50 - 54세,1998,513,266,247
'4611055800,  원산동,'60,55 - 59세,1998,463,210,253
'4611055800,  원산동,'65,60 - 64세,1998,312,106,206
'4611055800,  원산동,'70,65 - 69세,1998,246,91,155
'4611055800,  원산동,'75,70 - 74세,1998,165,53,112
'4611055800,  원산동,'80,75 - 79세,1998,120,33,87
'4611055800,  원산동,'85,80 - 84세,1998,59,14,45
'4611055800,  원산동,'90,85+ ,1998,32,5,27
'4611056500,  대성동,'00,계,1998,6898,3331,3567
'4611056500,  대성동,'05,0 - 4세,1998,372,183,189
'4611056500,  대성동,'10,5 - 9세,1998,414,194,220
'4611056500,  대성동,'15,10 - 14세,1998,418,219,199
'4611056500,  대성동,'20,15 - 19세,1998,774,399,375
'4611056500,  대성동,'25,20 - 24세,1998,756,383,373
'4611056500,  대성동,'30,25 - 29세,1998,594,335,259
'4611056500,  대성동,'35,30 - 34세,1998,475,240,235
'4611056500,  대성동,'40,35 - 39세,1998,503,263,240
'4611056500,  대성동,'45,40 - 44세,1998,473,229,244
'4611056500,  대성동,'50,45 - 49세,1998,416,214,202
'4611056500,  대성동,'55,50 - 54세,1998,362,163,199
'4611056500,  대성동,'60,55 - 59세,1998,394,175,219
'4611056500,  대성동,'65,60 - 64세,1998,331,136,195
'4611056500,  대성동,'70,65 - 69세,1998,246,93,153
'4611056500,  대성동,'75,70 - 74세,1998,147,47,100
'4611056500,  대성동,'80,75 - 79세,1998,121,35,86
'4611056500,  대성동,'85,80 - 84세,1998,74,19,55
'4611056500,  대성동,'90,85+ ,1998,28,4,24
'4611058500,  남양동,'00,계,1998,5912,2845,3067
'4611058500,  남양동,'05,0 - 4세,1998,309,174,135
'4611058500,  남양동,'10,5 - 9세,1998,312,153,159
'4611058500,  남양동,'15,10 - 14세,1998,388,203,185
'4611058500,  남양동,'20,15 - 19세,1998,742,358,384
'4611058500,  남양동,'25,20 - 24세,1998,635,342,293
'4611058500,  남양동,'30,25 - 29세,1998,476,255,221
'4611058500,  남양동,'35,30 - 34세,1998,338,162,176
'4611058500,  남양동,'40,35 - 39세,1998,395,170,225
'4611058500,  남양동,'45,40 - 44세,1998,471,214,257
'4611058500,  남양동,'50,45 - 49세,1998,405,200,205
'4611058500,  남양동,'55,50 - 54세,1998,373,175,198
'4611058500,  남양동,'60,55 - 59세,1998,330,154,176
'4611058500,  남양동,'65,60 - 64세,1998,244,112,132
'4611058500,  남양동,'70,65 - 69세,1998,217,85,132
'4611058500,  남양동,'75,70 - 74세,1998,118,48,70
'4611058500,  남양동,'80,75 - 79세,1998,96,23,73
'4611058500,  남양동,'85,80 - 84세,1998,39,16,23
'4611058500,  남양동,'90,85+ ,1998,24,1,23
'4611059000,  북교동,'00,계,1998,6486,3183,3303
'4611059000,  북교동,'05,0 - 4세,1998,325,158,167
'4611059000,  북교동,'10,5 - 9세,1998,355,197,158
'4611059000,  북교동,'15,10 - 14세,1998,425,218,207
'4611059000,  북교동,'20,15 - 19세,1998,690,331,359
'4611059000,  북교동,'25,20 - 24세,1998,668,354,314
'4611059000,  북교동,'30,25 - 29세,1998,590,349,241
'4611059000,  북교동,'35,30 - 34세,1998,405,223,182
'4611059000,  북교동,'40,35 - 39세,1998,451,237,214
'4611059000,  북교동,'45,40 - 44세,1998,389,182,207
'4611059000,  북교동,'50,45 - 49세,1998,388,202,186
'4611059000,  북교동,'55,50 - 54세,1998,383,187,196
'4611059000,  북교동,'60,55 - 59세,1998,412,165,247
'4611059000,  북교동,'65,60 - 64세,1998,363,164,199
'4611059000,  북교동,'70,65 - 69세,1998,250,103,147
'4611059000,  북교동,'75,70 - 74세,1998,169,56,113
'4611059000,  북교동,'80,75 - 79세,1998,112,28,84
'4611059000,  북교동,'85,80 - 84세,1998,70,22,48
'4611059000,  북교동,'90,85+ ,1998,41,7,34
'4611063000,  무안동,'00,계,1998,6375,3129,3246
'4611063000,  무안동,'05,0 - 4세,1998,294,150,144
'4611063000,  무안동,'10,5 - 9세,1998,364,184,180
'4611063000,  무안동,'15,10 - 14세,1998,412,215,197
'4611063000,  무안동,'20,15 - 19세,1998,677,334,343
'4611063000,  무안동,'25,20 - 24세,1998,678,345,333
'4611063000,  무안동,'30,25 - 29세,1998,533,301,232
'4611063000,  무안동,'35,30 - 34세,1998,366,191,175
'4611063000,  무안동,'40,35 - 39세,1998,479,218,261
'4611063000,  무안동,'45,40 - 44세,1998,472,218,254
'4611063000,  무안동,'50,45 - 49세,1998,454,226,228
'4611063000,  무안동,'55,50 - 54세,1998,437,193,244
'4611063000,  무안동,'60,55 - 59세,1998,418,223,195
'4611063000,  무안동,'65,60 - 64세,1998,268,126,142
'4611063000,  무안동,'70,65 - 69세,1998,205,85,120
'4611063000,  무안동,'75,70 - 74세,1998,164,71,93
'4611063000,  무안동,'80,75 - 79세,1998,88,33,55
'4611063000,  무안동,'85,80 - 84세,1998,42,14,28
'4611063000,  무안동,'90,85+ ,1998,24,2,22
'4611064000,  동명동,'00,계,1998,12156,6133,6023
'4611064000,  동명동,'05,0 - 4세,1998,691,360,331
'4611064000,  동명동,'10,5 - 9세,1998,701,392,309
'4611064000,  동명동,'15,10 - 14세,1998,851,449,402
'4611064000,  동명동,'20,15 - 19세,1998,1406,746,660
'4611064000,  동명동,'25,20 - 24세,1998,1414,756,658
'4611064000,  동명동,'30,25 - 29세,1998,1092,603,489
'4611064000,  동명동,'35,30 - 34세,1998,814,429,385
'4611064000,  동명동,'40,35 - 39세,1998,897,420,477
'4611064000,  동명동,'45,40 - 44세,1998,878,435,443
'4611064000,  동명동,'50,45 - 49세,1998,825,384,441
'4611064000,  동명동,'55,50 - 54세,1998,785,390,395
'4611064000,  동명동,'60,55 - 59세,1998,714,363,351
'4611064000,  동명동,'65,60 - 64세,1998,416,199,217
'4611064000,  동명동,'70,65 - 69세,1998,253,89,164
'4611064000,  동명동,'75,70 - 74세,1998,179,58,121
'4611064000,  동명동,'80,75 - 79세,1998,137,44,93
'4611064000,  동명동,'85,80 - 84세,1998,64,13,51
'4611064000,  동명동,'90,85+ ,1998,39,3,36
'4611064500,  삼학동,'00,계,1998,8995,4524,4471
'4611064500,  삼학동,'05,0 - 4세,1998,572,299,273
'4611064500,  삼학동,'10,5 - 9세,1998,744,387,357
'4611064500,  삼학동,'15,10 - 14세,1998,843,425,418
'4611064500,  삼학동,'20,15 - 19세,1998,1081,575,506
'4611064500,  삼학동,'25,20 - 24세,1998,808,443,365
'4611064500,  삼학동,'30,25 - 29세,1998,714,359,355
'4611064500,  삼학동,'35,30 - 34세,1998,628,303,325
'4611064500,  삼학동,'40,35 - 39세,1998,901,401,500
'4611064500,  삼학동,'45,40 - 44세,1998,859,431,428
'4611064500,  삼학동,'50,45 - 49세,1998,563,305,258
'4611064500,  삼학동,'55,50 - 54세,1998,405,216,189
'4611064500,  삼학동,'60,55 - 59세,1998,324,177,147
'4611064500,  삼학동,'65,60 - 64세,1998,201,94,107
'4611064500,  삼학동,'70,65 - 69세,1998,122,46,76
'4611064500,  삼학동,'75,70 - 74세,1998,92,37,55
'4611064500,  삼학동,'80,75 - 79세,1998,74,16,58
'4611064500,  삼학동,'85,80 - 84세,1998,34,6,28
'4611064500,  삼학동,'90,85+ ,1998,30,4,26
'4611065500,  만호동,'00,계,1998,7329,3761,3568
'4611065500,  만호동,'05,0 - 4세,1998,311,157,154
'4611065500,  만호동,'10,5 - 9세,1998,342,169,173
'4611065500,  만호동,'15,10 - 14세,1998,469,252,217
'4611065500,  만호동,'20,15 - 19세,1998,844,451,393
'4611065500,  만호동,'25,20 - 24세,1998,848,503,345
'4611065500,  만호동,'30,25 - 29세,1998,658,389,269
'4611065500,  만호동,'35,30 - 34세,1998,388,217,171
'4611065500,  만호동,'40,35 - 39세,1998,493,244,249
'4611065500,  만호동,'45,40 - 44세,1998,583,273,310
'4611065500,  만호동,'50,45 - 49세,1998,519,257,262
'4611065500,  만호동,'55,50 - 54세,1998,542,262,280
'4611065500,  만호동,'60,55 - 59세,1998,486,241,245
'4611065500,  만호동,'65,60 - 64세,1998,364,159,205
'4611065500,  만호동,'70,65 - 69세,1998,190,92,98
'4611065500,  만호동,'75,70 - 74세,1998,118,42,76
'4611065500,  만호동,'80,75 - 79세,1998,105,38,67
'4611065500,  만호동,'85,80 - 84세,1998,45,14,31
'4611065500,  만호동,'90,85+ ,1998,24,1,23
'4611066000,  유달동,'00,계,1998,6840,3403,3437
'4611066000,  유달동,'05,0 - 4세,1998,324,163,161
'4611066000,  유달동,'10,5 - 9세,1998,355,179,176
'4611066000,  유달동,'15,10 - 14세,1998,430,216,214
'4611066000,  유달동,'20,15 - 19세,1998,777,399,378
'4611066000,  유달동,'25,20 - 24세,1998,802,438,364
'4611066000,  유달동,'30,25 - 29세,1998,640,372,268
'4611066000,  유달동,'35,30 - 34세,1998,379,210,169
'4611066000,  유달동,'40,35 - 39세,1998,454,235,219
'4611066000,  유달동,'45,40 - 44세,1998,421,216,205
'4611066000,  유달동,'50,45 - 49세,1998,432,200,232
'4611066000,  유달동,'55,50 - 54세,1998,458,209,249
'4611066000,  유달동,'60,55 - 59세,1998,487,227,260
'4611066000,  유달동,'65,60 - 64세,1998,327,136,191
'4611066000,  유달동,'70,65 - 69세,1998,230,104,126
'4611066000,  유달동,'75,70 - 74세,1998,152,44,108
'4611066000,  유달동,'80,75 - 79세,1998,103,32,71
'4611066000,  유달동,'85,80 - 84세,1998,41,15,26
'4611066000,  유달동,'90,85+ ,1998,28,8,20
'4611069500,  죽교동,'00,계,1998,7162,3522,3640
'4611069500,  죽교동,'05,0 - 4세,1998,393,217,176
'4611069500,  죽교동,'10,5 - 9세,1998,403,204,199
'4611069500,  죽교동,'15,10 - 14세,1998,480,240,240
'4611069500,  죽교동,'20,15 - 19세,1998,805,405,400
'4611069500,  죽교동,'25,20 - 24세,1998,798,418,380
'4611069500,  죽교동,'30,25 - 29세,1998,625,360,265
'4611069500,  죽교동,'35,30 - 34세,1998,501,280,221
'4611069500,  죽교동,'40,35 - 39세,1998,491,245,246
'4611069500,  죽교동,'45,40 - 44세,1998,498,240,258
'4611069500,  죽교동,'50,45 - 49세,1998,398,197,201
'4611069500,  죽교동,'55,50 - 54세,1998,419,197,222
'4611069500,  죽교동,'60,55 - 59세,1998,424,206,218
'4611069500,  죽교동,'65,60 - 64세,1998,328,139,189
'4611069500,  죽교동,'70,65 - 69세,1998,208,79,129
'4611069500,  죽교동,'75,70 - 74세,1998,173,44,129
'4611069500,  죽교동,'80,75 - 79세,1998,144,40,104
'4611069500,  죽교동,'85,80 - 84세,1998,45,8,37
'4611069500,  죽교동,'90,85+ ,1998,29,3,26
'4611070500,  북항동,'00,계,1998,13267,6589,6678
'4611070500,  북항동,'05,0 - 4세,1998,1190,622,568
'4611070500,  북항동,'10,5 - 9세,1998,1073,571,502
'4611070500,  북항동,'15,10 - 14세,1998,1110,586,524
'4611070500,  북항동,'20,15 - 19세,1998,1451,724,727
'4611070500,  북항동,'25,20 - 24세,1998,1133,558,575
'4611070500,  북항동,'30,25 - 29세,1998,1181,568,613
'4611070500,  북항동,'35,30 - 34세,1998,1249,601,648
'4611070500,  북항동,'40,35 - 39세,1998,1397,679,718
'4611070500,  북항동,'45,40 - 44세,1998,1049,537,512
'4611070500,  북항동,'50,45 - 49세,1998,717,382,335
'4611070500,  북항동,'55,50 - 54세,1998,510,288,222
'4611070500,  북항동,'60,55 - 59세,1998,418,200,218
'4611070500,  북항동,'65,60 - 64세,1998,314,143,171
'4611070500,  북항동,'70,65 - 69세,1998,174,56,118
'4611070500,  북항동,'75,70 - 74세,1998,122,38,84
'4611070500,  북항동,'80,75 - 79세,1998,112,22,90
'4611070500,  북항동,'85,80 - 84세,1998,38,10,28
'4611070500,  북항동,'90,85+ ,1998,29,4,25
'4611074500,  용해동,'00,계,1998,9587,4815,4772
'4611074500,  용해동,'05,0 - 4세,1998,688,373,315
'4611074500,  용해동,'10,5 - 9세,1998,623,332,291
'4611074500,  용해동,'15,10 - 14세,1998,747,398,349
'4611074500,  용해동,'20,15 - 19세,1998,1083,576,507
'4611074500,  용해동,'25,20 - 24세,1998,954,508,446
'4611074500,  용해동,'30,25 - 29세,1998,855,447,408
'4611074500,  용해동,'35,30 - 34세,1998,736,373,363
'4611074500,  용해동,'40,35 - 39세,1998,800,391,409
'4611074500,  용해동,'45,40 - 44세,1998,704,354,350
'4611074500,  용해동,'50,45 - 49세,1998,558,269,289
'4611074500,  용해동,'55,50 - 54세,1998,500,259,241
'4611074500,  용해동,'60,55 - 59세,1998,400,192,208
'4611074500,  용해동,'65,60 - 64세,1998,305,134,171
'4611074500,  용해동,'70,65 - 69세,1998,246,93,153
'4611074500,  용해동,'75,70 - 74세,1998,162,61,101
'4611074500,  용해동,'80,75 - 79세,1998,129,32,97
'4611074500,  용해동,'85,80 - 84세,1998,49,13,36
'4611074500,  용해동,'90,85+ ,1998,48,10,38
'4611075000,  이로동,'00,계,1998,12327,5990,6337
'4611075000,  이로동,'05,0 - 4세,1998,877,463,414
'4611075000,  이로동,'10,5 - 9세,1998,1000,525,475
'4611075000,  이로동,'15,10 - 14세,1998,1181,591,590
'4611075000,  이로동,'20,15 - 19세,1998,1418,713,705
'4611075000,  이로동,'25,20 - 24세,1998,1069,520,549
'4611075000,  이로동,'30,25 - 29세,1998,934,486,448
'4611075000,  이로동,'35,30 - 34세,1998,892,432,460
'4611075000,  이로동,'40,35 - 39세,1998,1251,556,695
'4611075000,  이로동,'45,40 - 44세,1998,1091,537,554
'4611075000,  이로동,'50,45 - 49세,1998,739,364,375
'4611075000,  이로동,'55,50 - 54세,1998,537,288,249
'4611075000,  이로동,'60,55 - 59세,1998,358,181,177
'4611075000,  이로동,'65,60 - 64세,1998,307,137,170
'4611075000,  이로동,'70,65 - 69세,1998,259,79,180
'4611075000,  이로동,'75,70 - 74세,1998,187,70,117
'4611075000,  이로동,'80,75 - 79세,1998,135,33,102
'4611075000,  이로동,'85,80 - 84세,1998,61,11,50
'4611075000,  이로동,'90,85+ ,1998,31,4,27
'4611075600,  상동,'00,계,1998,14906,7250,7656
'4611075600,  상동,'05,0 - 4세,1998,1017,497,520
'4611075600,  상동,'10,5 - 9세,1998,1053,556,497
'4611075600,  상동,'15,10 - 14세,1998,1238,638,600
'4611075600,  상동,'20,15 - 19세,1998,1906,950,956
'4611075600,  상동,'25,20 - 24세,1998,1589,832,757
'4611075600,  상동,'30,25 - 29세,1998,1185,600,585
'4611075600,  상동,'35,30 - 34세,1998,1168,579,589
'4611075600,  상동,'40,35 - 39세,1998,1321,604,717
'4611075600,  상동,'45,40 - 44세,1998,1212,588,624
'4611075600,  상동,'50,45 - 49세,1998,868,426,442
'4611075600,  상동,'55,50 - 54세,1998,695,350,345
'4611075600,  상동,'60,55 - 59세,1998,545,238,307
'4611075600,  상동,'65,60 - 64세,1998,390,159,231
'4611075600,  상동,'70,65 - 69세,1998,290,95,195
'4611075600,  상동,'75,70 - 74세,1998,192,66,126
'4611075600,  상동,'80,75 - 79세,1998,143,52,91
'4611075600,  상동,'85,80 - 84세,1998,47,10,37
'4611075600,  상동,'90,85+ ,1998,47,10,37
'4611075700,  하당동,'00,계,1998,7194,3586,3608
'4611075700,  하당동,'05,0 - 4세,1998,715,379,336
'4611075700,  하당동,'10,5 - 9세,1998,647,320,327
'4611075700,  하당동,'15,10 - 14세,1998,642,322,320
'4611075700,  하당동,'20,15 - 19세,1998,707,352,355
'4611075700,  하당동,'25,20 - 24세,1998,528,281,247
'4611075700,  하당동,'30,25 - 29세,1998,693,330,363
'4611075700,  하당동,'35,30 - 34세,1998,681,333,348
'4611075700,  하당동,'40,35 - 39세,1998,769,378,391
'4611075700,  하당동,'45,40 - 44세,1998,609,341,268
'4611075700,  하당동,'50,45 - 49세,1998,344,190,154
'4611075700,  하당동,'55,50 - 54세,1998,255,135,120
'4611075700,  하당동,'60,55 - 59세,1998,194,88,106
'4611075700,  하당동,'65,60 - 64세,1998,157,60,97
'4611075700,  하당동,'70,65 - 69세,1998,93,30,63
'4611075700,  하당동,'75,70 - 74세,1998,60,22,38
'4611075700,  하당동,'80,75 - 79세,1998,60,17,43
'4611075700,  하당동,'85,80 - 84세,1998,32,8,24
'4611075700,  하당동,'90,85+ ,1998,8,0,8
'4611075800,  신흥동,'00,계,1998,18100,9000,9100
'4611075800,  신흥동,'05,0 - 4세,1998,2070,1113,957
'4611075800,  신흥동,'10,5 - 9세,1998,2297,1230,1067
'4611075800,  신흥동,'15,10 - 14세,1998,1833,909,924
'4611075800,  신흥동,'20,15 - 19세,1998,1332,677,655
'4611075800,  신흥동,'25,20 - 24세,1998,830,406,424
'4611075800,  신흥동,'30,25 - 29세,1998,1410,551,859
'4611075800,  신흥동,'35,30 - 34세,1998,2236,1000,1236
'4611075800,  신흥동,'40,35 - 39세,1998,2462,1261,1201
'4611075800,  신흥동,'45,40 - 44세,1998,1454,832,622
'4611075800,  신흥동,'50,45 - 49세,1998,612,360,252
'4611075800,  신흥동,'55,50 - 54세,1998,387,208,179
'4611075800,  신흥동,'60,55 - 59세,1998,341,161,180
'4611075800,  신흥동,'65,60 - 64세,1998,279,114,165
'4611075800,  신흥동,'70,65 - 69세,1998,225,79,146
'4611075800,  신흥동,'75,70 - 74세,1998,136,46,90
'4611075800,  신흥동,'80,75 - 79세,1998,113,35,78
'4611075800,  신흥동,'85,80 - 84세,1998,59,15,44
'4611075800,  신흥동,'90,85+ ,1998,24,3,21
'4611076000,  충무동,'00,계,1998,5102,2641,2461
'4611076000,  충무동,'05,0 - 4세,1998,276,158,118
'4611076000,  충무동,'10,5 - 9세,1998,221,116,105
'4611076000,  충무동,'15,10 - 14세,1998,301,152,149
'4611076000,  충무동,'20,15 - 19세,1998,627,337,290
'4611076000,  충무동,'25,20 - 24세,1998,623,364,259
'4611076000,  충무동,'30,25 - 29세,1998,464,287,177
'4611076000,  충무동,'35,30 - 34세,1998,296,184,112
'4611076000,  충무동,'40,35 - 39세,1998,317,182,135
'4611076000,  충무동,'45,40 - 44세,1998,274,150,124
'4611076000,  충무동,'50,45 - 49세,1998,254,118,136
'4611076000,  충무동,'55,50 - 54세,1998,316,142,174
'4611076000,  충무동,'60,55 - 59세,1998,334,150,184
'4611076000,  충무동,'65,60 - 64세,1998,296,125,171
'4611076000,  충무동,'70,65 - 69세,1998,212,82,130
'4611076000,  충무동,'75,70 - 74세,1998,123,41,82
'4611076000,  충무동,'80,75 - 79세,1998,108,39,69
'4611076000,  충무동,'85,80 - 84세,1998,37,8,29
'4611076000,  충무동,'90,85+ ,1998,23,6,17
'4611078000,  삼향동,'00,계,1998,4821,2478,2343
'4611078000,  삼향동,'05,0 - 4세,1998,482,244,238
'4611078000,  삼향동,'10,5 - 9세,1998,305,157,148
'4611078000,  삼향동,'15,10 - 14세,1998,261,136,125
'4611078000,  삼향동,'20,15 - 19세,1998,395,219,176
'4611078000,  삼향동,'25,20 - 24세,1998,435,238,197
'4611078000,  삼향동,'30,25 - 29세,1998,584,316,268
'4611078000,  삼향동,'35,30 - 34세,1998,477,268,209
'4611078000,  삼향동,'40,35 - 39세,1998,385,210,175
'4611078000,  삼향동,'45,40 - 44세,1998,300,161,139
'4611078000,  삼향동,'50,45 - 49세,1998,266,136,130
'4611078000,  삼향동,'55,50 - 54세,1998,213,92,121
'4611078000,  삼향동,'60,55 - 59세,1998,218,116,102
'4611078000,  삼향동,'65,60 - 64세,1998,186,68,118
'4611078000,  삼향동,'70,65 - 69세,1998,138,56,82
'4611078000,  삼향동,'75,70 - 74세,1998,68,25,43
'4611078000,  삼향동,'80,75 - 79세,1998,53,17,36
'4611078000,  삼향동,'85,80 - 84세,1998,37,15,22
'4611078000,  삼향동,'90,85+ ,1998,18,4,14
'4611079000,  옥암동,'00,계,1998,6918,3374,3544
'4611079000,  옥암동,'05,0 - 4세,1998,761,403,358
'4611079000,  옥암동,'10,5 - 9세,1998,750,384,366
'4611079000,  옥암동,'15,10 - 14세,1998,563,284,279
'4611079000,  옥암동,'20,15 - 19세,1998,526,264,262
'4611079000,  옥암동,'25,20 - 24세,1998,545,195,350
'4611079000,  옥암동,'30,25 - 29세,1998,689,276,413
'4611079000,  옥암동,'35,30 - 34세,1998,829,407,422
'4611079000,  옥암동,'40,35 - 39세,1998,823,443,380
'4611079000,  옥암동,'45,40 - 44세,1998,440,262,178
'4611079000,  옥암동,'50,45 - 49세,1998,243,136,107
'4611079000,  옥암동,'55,50 - 54세,1998,165,77,88
'4611079000,  옥암동,'60,55 - 59세,1998,183,90,93
'4611079000,  옥암동,'65,60 - 64세,1998,154,59,95
'4611079000,  옥암동,'70,65 - 69세,1998,104,45,59
'4611079000,  옥암동,'75,70 - 74세,1998,58,25,33
'4611079000,  옥암동,'80,75 - 79세,1998,53,17,36
'4611079000,  옥암동,'85,80 - 84세,1998,17,4,13
'4611079000,  옥암동,'90,85+ ,1998,15,3,12
'4611080000,  부흥동,'00,계,1998,10105,5044,5061
'4611080000,  부흥동,'05,0 - 4세,1998,1648,824,824
'4611080000,  부흥동,'10,5 - 9세,1998,1152,606,546
'4611080000,  부흥동,'15,10 - 14세,1998,676,350,326
'4611080000,  부흥동,'20,15 - 19세,1998,493,247,246
'4611080000,  부흥동,'25,20 - 24세,1998,519,217,302
'4611080000,  부흥동,'30,25 - 29세,1998,1459,569,890
'4611080000,  부흥동,'35,30 - 34세,1998,1680,925,755
'4611080000,  부흥동,'40,35 - 39세,1998,1082,621,461
'4611080000,  부흥동,'45,40 - 44세,1998,516,313,203
'4611080000,  부흥동,'50,45 - 49세,1998,236,129,107
'4611080000,  부흥동,'55,50 - 54세,1998,161,67,94
'4611080000,  부흥동,'60,55 - 59세,1998,142,62,80
'4611080000,  부흥동,'65,60 - 64세,1998,124,44,80
'4611080000,  부흥동,'70,65 - 69세,1998,107,33,74
'4611080000,  부흥동,'75,70 - 74세,1998,47,19,28
'4611080000,  부흥동,'80,75 - 79세,1998,41,12,29
'4611080000,  부흥동,'85,80 - 84세,1998,15,5,10
'4611080000,  부흥동,'90,85+ ,1998,7,1,6
'46130, 여수시,'00,계,1998,329409,166057,163352
'46130, 여수시,'05,0 - 4세,1998,24091,12620,11471
'46130, 여수시,'10,5 - 9세,1998,24954,12952,12002
'46130, 여수시,'15,10 - 14세,1998,23978,12245,11733
'46130, 여수시,'20,15 - 19세,1998,33089,16975,16114
'46130, 여수시,'25,20 - 24세,1998,29015,15518,13497
'46130, 여수시,'30,25 - 29세,1998,28193,15038,13155
'46130, 여수시,'35,30 - 34세,1998,27384,14194,13190
'46130, 여수시,'40,35 - 39세,1998,29366,14988,14378
'46130, 여수시,'45,40 - 44세,1998,24768,12729,12039
'46130, 여수시,'50,45 - 49세,1998,19418,10235,9183
'46130, 여수시,'55,50 - 54세,1998,15679,8065,7614
'46130, 여수시,'60,55 - 59세,1998,14967,7233,7734
'46130, 여수시,'65,60 - 64세,1998,11430,5235,6195
'46130, 여수시,'70,65 - 69세,1998,9129,3587,5542
'46130, 여수시,'75,70 - 74세,1998,5858,2188,3670
'46130, 여수시,'80,75 - 79세,1998,4363,1347,3016
'46130, 여수시,'85,80 - 84세,1998,2139,600,1539
'46130, 여수시,'90,85+ ,1998,1588,308,1280
'4613025000,  돌산읍,'00,계,1998,15234,7720,7514
'4613025000,  돌산읍,'05,0 - 4세,1998,628,328,300
'4613025000,  돌산읍,'10,5 - 9세,1998,620,290,330
'4613025000,  돌산읍,'15,10 - 14세,1998,966,472,494
'4613025000,  돌산읍,'20,15 - 19세,1998,1704,851,853
'4613025000,  돌산읍,'25,20 - 24세,1998,1592,911,681
'4613025000,  돌산읍,'30,25 - 29세,1998,1122,732,390
'4613025000,  돌산읍,'35,30 - 34세,1998,759,449,310
'4613025000,  돌산읍,'40,35 - 39세,1998,964,530,434
'4613025000,  돌산읍,'45,40 - 44세,1998,1010,519,491
'4613025000,  돌산읍,'50,45 - 49세,1998,947,478,469
'4613025000,  돌산읍,'55,50 - 54세,1998,913,438,475
'4613025000,  돌산읍,'60,55 - 59세,1998,1065,499,566
'4613025000,  돌산읍,'65,60 - 64세,1998,928,432,496
'4613025000,  돌산읍,'70,65 - 69세,1998,786,325,461
'4613025000,  돌산읍,'75,70 - 74세,1998,479,225,254
'4613025000,  돌산읍,'80,75 - 79세,1998,414,138,276
'4613025000,  돌산읍,'85,80 - 84세,1998,179,63,116
'4613025000,  돌산읍,'90,85+ ,1998,158,40,118
'4613031000,  소라면,'00,계,1998,10120,5161,4959
'4613031000,  소라면,'05,0 - 4세,1998,470,259,211
'4613031000,  소라면,'10,5 - 9세,1998,453,229,224
'4613031000,  소라면,'15,10 - 14세,1998,523,267,256
'4613031000,  소라면,'20,15 - 19세,1998,1021,548,473
'4613031000,  소라면,'25,20 - 24세,1998,1062,604,458
'4613031000,  소라면,'30,25 - 29세,1998,803,515,288
'4613031000,  소라면,'35,30 - 34세,1998,620,365,255
'4613031000,  소라면,'40,35 - 39세,1998,609,364,245
'4613031000,  소라면,'45,40 - 44세,1998,563,291,272
'4613031000,  소라면,'50,45 - 49세,1998,574,293,281
'4613031000,  소라면,'55,50 - 54세,1998,593,279,314
'4613031000,  소라면,'60,55 - 59세,1998,771,355,416
'4613031000,  소라면,'65,60 - 64세,1998,706,307,399
'4613031000,  소라면,'70,65 - 69세,1998,549,210,339
'4613031000,  소라면,'75,70 - 74세,1998,343,136,207
'4613031000,  소라면,'80,75 - 79세,1998,249,84,165
'4613031000,  소라면,'85,80 - 84세,1998,118,39,79
'4613031000,  소라면,'90,85+ ,1998,93,16,77
'4613032000,  율촌면,'00,계,1998,11163,5590,5573
'4613032000,  율촌면,'05,0 - 4세,1998,579,312,267
'4613032000,  율촌면,'10,5 - 9세,1998,470,229,241
'4613032000,  율촌면,'15,10 - 14세,1998,569,290,279
'4613032000,  율촌면,'20,15 - 19세,1998,1132,562,570
'4613032000,  율촌면,'25,20 - 24세,1998,1207,656,551
'4613032000,  율촌면,'30,25 - 29세,1998,925,572,353
'4613032000,  율촌면,'35,30 - 34세,1998,667,415,252
'4613032000,  율촌면,'40,35 - 39세,1998,645,333,312
'4613032000,  율촌면,'45,40 - 44세,1998,633,323,310
'4613032000,  율촌면,'50,45 - 49세,1998,661,342,319
'4613032000,  율촌면,'55,50 - 54세,1998,634,320,314
'4613032000,  율촌면,'60,55 - 59세,1998,755,347,408
'4613032000,  율촌면,'65,60 - 64세,1998,688,314,374
'4613032000,  율촌면,'70,65 - 69세,1998,620,241,379
'4613032000,  율촌면,'75,70 - 74세,1998,380,140,240
'4613032000,  율촌면,'80,75 - 79세,1998,296,107,189
'4613032000,  율촌면,'85,80 - 84세,1998,169,54,115
'4613032000,  율촌면,'90,85+ ,1998,133,33,100
'4613033000,  화양면,'00,계,1998,10341,5283,5058
'4613033000,  화양면,'05,0 - 4세,1998,359,185,174
'4613033000,  화양면,'10,5 - 9세,1998,332,180,152
'4613033000,  화양면,'15,10 - 14세,1998,513,234,279
'4613033000,  화양면,'20,15 - 19세,1998,1084,567,517
'4613033000,  화양면,'25,20 - 24세,1998,1246,724,522
'4613033000,  화양면,'30,25 - 29세,1998,760,508,252
'4613033000,  화양면,'35,30 - 34세,1998,521,357,164
'4613033000,  화양면,'40,35 - 39세,1998,554,328,226
'4613033000,  화양면,'45,40 - 44세,1998,532,304,228
'4613033000,  화양면,'50,45 - 49세,1998,631,313,318
'4613033000,  화양면,'55,50 - 54세,1998,610,296,314
'4613033000,  화양면,'60,55 - 59세,1998,833,379,454
'4613033000,  화양면,'65,60 - 64세,1998,743,313,430
'4613033000,  화양면,'70,65 - 69세,1998,675,297,378
'4613033000,  화양면,'75,70 - 74세,1998,417,150,267
'4613033000,  화양면,'80,75 - 79세,1998,285,99,186
'4613033000,  화양면,'85,80 - 84세,1998,134,31,103
'4613033000,  화양면,'90,85+ ,1998,112,18,94
'4613034000,  남면,'00,계,1998,5801,2976,2825
'4613034000,  남면,'05,0 - 4세,1998,158,88,70
'4613034000,  남면,'10,5 - 9세,1998,172,92,80
'4613034000,  남면,'15,10 - 14세,1998,317,156,161
'4613034000,  남면,'20,15 - 19세,1998,732,382,350
'4613034000,  남면,'25,20 - 24세,1998,595,362,233
'4613034000,  남면,'30,25 - 29세,1998,281,212,69
'4613034000,  남면,'35,30 - 34세,1998,233,144,89
'4613034000,  남면,'40,35 - 39세,1998,310,172,138
'4613034000,  남면,'45,40 - 44세,1998,361,194,167
'4613034000,  남면,'50,45 - 49세,1998,336,179,157
'4613034000,  남면,'55,50 - 54세,1998,404,195,209
'4613034000,  남면,'60,55 - 59세,1998,445,198,247
'4613034000,  남면,'65,60 - 64세,1998,500,233,267
'4613034000,  남면,'70,65 - 69세,1998,417,166,251
'4613034000,  남면,'75,70 - 74세,1998,196,94,102
'4613034000,  남면,'80,75 - 79세,1998,203,67,136
'4613034000,  남면,'85,80 - 84세,1998,86,32,54
'4613034000,  남면,'90,85+ ,1998,55,10,45
'4613035000,  화정면,'00,계,1998,4198,2115,2083
'4613035000,  화정면,'05,0 - 4세,1998,104,44,60
'4613035000,  화정면,'10,5 - 9세,1998,117,59,58
'4613035000,  화정면,'15,10 - 14세,1998,187,86,101
'4613035000,  화정면,'20,15 - 19세,1998,470,211,259
'4613035000,  화정면,'25,20 - 24세,1998,458,309,149
'4613035000,  화정면,'30,25 - 29세,1998,213,165,48
'4613035000,  화정면,'35,30 - 34세,1998,149,99,50
'4613035000,  화정면,'40,35 - 39세,1998,201,117,84
'4613035000,  화정면,'45,40 - 44세,1998,215,125,90
'4613035000,  화정면,'50,45 - 49세,1998,223,114,109
'4613035000,  화정면,'55,50 - 54세,1998,313,145,168
'4613035000,  화정면,'60,55 - 59세,1998,406,180,226
'4613035000,  화정면,'65,60 - 64세,1998,375,165,210
'4613035000,  화정면,'70,65 - 69세,1998,283,135,148
'4613035000,  화정면,'75,70 - 74세,1998,219,90,129
'4613035000,  화정면,'80,75 - 79세,1998,148,41,107
'4613035000,  화정면,'85,80 - 84세,1998,69,22,47
'4613035000,  화정면,'90,85+ ,1998,48,8,40
'4613036000,  삼산면,'00,계,1998,2788,1395,1393
'4613036000,  삼산면,'05,0 - 4세,1998,138,70,68
'4613036000,  삼산면,'10,5 - 9세,1998,165,88,77
'4613036000,  삼산면,'15,10 - 14세,1998,135,69,66
'4613036000,  삼산면,'20,15 - 19세,1998,203,104,99
'4613036000,  삼산면,'25,20 - 24세,1998,198,126,72
'4613036000,  삼산면,'30,25 - 29세,1998,153,90,63
'4613036000,  삼산면,'35,30 - 34세,1998,164,101,63
'4613036000,  삼산면,'40,35 - 39세,1998,253,144,109
'4613036000,  삼산면,'45,40 - 44세,1998,172,93,79
'4613036000,  삼산면,'50,45 - 49세,1998,147,77,70
'4613036000,  삼산면,'55,50 - 54세,1998,163,98,65
'4613036000,  삼산면,'60,55 - 59세,1998,190,73,117
'4613036000,  삼산면,'65,60 - 64세,1998,199,92,107
'4613036000,  삼산면,'70,65 - 69세,1998,207,80,127
'4613036000,  삼산면,'75,70 - 74세,1998,138,45,93
'4613036000,  삼산면,'80,75 - 79세,1998,88,27,61
'4613036000,  삼산면,'85,80 - 84세,1998,42,10,32
'4613036000,  삼산면,'90,85+ ,1998,33,8,25
'4613051500,  동문동,'00,계,1998,10574,5340,5234
'4613051500,  동문동,'05,0 - 4세,1998,474,242,232
'4613051500,  동문동,'10,5 - 9세,1998,523,283,240
'4613051500,  동문동,'15,10 - 14세,1998,647,346,301
'4613051500,  동문동,'20,15 - 19세,1998,1270,702,568
'4613051500,  동문동,'25,20 - 24세,1998,1124,625,499
'4613051500,  동문동,'30,25 - 29세,1998,856,511,345
'4613051500,  동문동,'35,30 - 34세,1998,568,309,259
'4613051500,  동문동,'40,35 - 39세,1998,755,378,377
'4613051500,  동문동,'45,40 - 44세,1998,843,374,469
'4613051500,  동문동,'50,45 - 49세,1998,795,397,398
'4613051500,  동문동,'55,50 - 54세,1998,725,356,369
'4613051500,  동문동,'60,55 - 59세,1998,631,310,321
'4613051500,  동문동,'65,60 - 64세,1998,433,191,242
'4613051500,  동문동,'70,65 - 69세,1998,368,140,228
'4613051500,  동문동,'75,70 - 74세,1998,261,106,155
'4613051500,  동문동,'80,75 - 79세,1998,174,43,131
'4613051500,  동문동,'85,80 - 84세,1998,78,20,58
'4613051500,  동문동,'90,85+ ,1998,49,7,42
'4613053500,  한려동,'00,계,1998,7518,3805,3713
'4613053500,  한려동,'05,0 - 4세,1998,328,148,180
'4613053500,  한려동,'10,5 - 9세,1998,346,185,161
'4613053500,  한려동,'15,10 - 14세,1998,461,253,208
'4613053500,  한려동,'20,15 - 19세,1998,862,439,423
'4613053500,  한려동,'25,20 - 24세,1998,816,448,368
'4613053500,  한려동,'30,25 - 29세,1998,676,391,285
'4613053500,  한려동,'35,30 - 34세,1998,426,235,191
'4613053500,  한려동,'40,35 - 39세,1998,513,244,269
'4613053500,  한려동,'45,40 - 44세,1998,566,260,306
'4613053500,  한려동,'50,45 - 49세,1998,584,301,283
'4613053500,  한려동,'55,50 - 54세,1998,538,261,277
'4613053500,  한려동,'60,55 - 59세,1998,492,244,248
'4613053500,  한려동,'65,60 - 64세,1998,326,160,166
'4613053500,  한려동,'70,65 - 69세,1998,232,108,124
'4613053500,  한려동,'75,70 - 74세,1998,152,55,97
'4613053500,  한려동,'80,75 - 79세,1998,114,44,70
'4613053500,  한려동,'85,80 - 84세,1998,55,20,35
'4613053500,  한려동,'90,85+ ,1998,31,9,22
'4613057000,  중앙동,'00,계,1998,8905,4469,4436
'4613057000,  중앙동,'05,0 - 4세,1998,426,233,193
'4613057000,  중앙동,'10,5 - 9세,1998,471,235,236
'4613057000,  중앙동,'15,10 - 14세,1998,531,275,256
'4613057000,  중앙동,'20,15 - 19세,1998,1029,516,513
'4613057000,  중앙동,'25,20 - 24세,1998,1027,572,455
'4613057000,  중앙동,'30,25 - 29세,1998,750,415,335
'4613057000,  중앙동,'35,30 - 34세,1998,529,288,241
'4613057000,  중앙동,'40,35 - 39세,1998,606,296,310
'4613057000,  중앙동,'45,40 - 44세,1998,715,334,381
'4613057000,  중앙동,'50,45 - 49세,1998,682,339,343
'4613057000,  중앙동,'55,50 - 54세,1998,606,293,313
'4613057000,  중앙동,'60,55 - 59세,1998,565,257,308
'4613057000,  중앙동,'65,60 - 64세,1998,361,203,158
'4613057000,  중앙동,'70,65 - 69세,1998,252,105,147
'4613057000,  중앙동,'75,70 - 74세,1998,148,43,105
'4613057000,  중앙동,'80,75 - 79세,1998,113,40,73
'4613057000,  중앙동,'85,80 - 84세,1998,58,19,39
'4613057000,  중앙동,'90,85+ ,1998,36,6,30
'4613060000,  충무동,'00,계,1998,9738,4956,4782
'4613060000,  충무동,'05,0 - 4세,1998,456,233,223
'4613060000,  충무동,'10,5 - 9세,1998,494,252,242
'4613060000,  충무동,'15,10 - 14세,1998,630,324,306
'4613060000,  충무동,'20,15 - 19세,1998,1125,591,534
'4613060000,  충무동,'25,20 - 24세,1998,1140,631,509
'4613060000,  충무동,'30,25 - 29세,1998,859,498,361
'4613060000,  충무동,'35,30 - 34세,1998,568,334,234
'4613060000,  충무동,'40,35 - 39세,1998,646,302,344
'4613060000,  충무동,'45,40 - 44세,1998,741,358,383
'4613060000,  충무동,'50,45 - 49세,1998,708,337,371
'4613060000,  충무동,'55,50 - 54세,1998,670,344,326
'4613060000,  충무동,'60,55 - 59세,1998,640,313,327
'4613060000,  충무동,'65,60 - 64세,1998,401,211,190
'4613060000,  충무동,'70,65 - 69세,1998,258,108,150
'4613060000,  충무동,'75,70 - 74세,1998,168,66,102
'4613060000,  충무동,'80,75 - 79세,1998,111,31,80
'4613060000,  충무동,'85,80 - 84세,1998,78,17,61
'4613060000,  충무동,'90,85+ ,1998,45,6,39
'4613062500,  광림동,'00,계,1998,12301,6165,6136
'4613062500,  광림동,'05,0 - 4세,1998,627,337,290
'4613062500,  광림동,'10,5 - 9세,1998,761,400,361
'4613062500,  광림동,'15,10 - 14세,1998,849,450,399
'4613062500,  광림동,'20,15 - 19세,1998,1456,717,739
'4613062500,  광림동,'25,20 - 24세,1998,1372,702,670
'4613062500,  광림동,'30,25 - 29세,1998,1014,603,411
'4613062500,  광림동,'35,30 - 34세,1998,799,411,388
'4613062500,  광림동,'40,35 - 39세,1998,944,453,491
'4613062500,  광림동,'45,40 - 44세,1998,987,473,514
'4613062500,  광림동,'50,45 - 49세,1998,870,423,447
'4613062500,  광림동,'55,50 - 54세,1998,767,381,386
'4613062500,  광림동,'60,55 - 59세,1998,679,360,319
'4613062500,  광림동,'65,60 - 64세,1998,423,200,223
'4613062500,  광림동,'70,65 - 69세,1998,306,113,193
'4613062500,  광림동,'75,70 - 74세,1998,190,73,117
'4613062500,  광림동,'80,75 - 79세,1998,147,43,104
'4613062500,  광림동,'85,80 - 84세,1998,70,20,50
'4613062500,  광림동,'90,85+ ,1998,40,6,34
'4613063500,  서강동,'00,계,1998,6232,3147,3085
'4613063500,  서강동,'05,0 - 4세,1998,252,139,113
'4613063500,  서강동,'10,5 - 9세,1998,321,159,162
'4613063500,  서강동,'15,10 - 14세,1998,403,212,191
'4613063500,  서강동,'20,15 - 19세,1998,757,384,373
'4613063500,  서강동,'25,20 - 24세,1998,726,412,314
'4613063500,  서강동,'30,25 - 29세,1998,490,299,191
'4613063500,  서강동,'35,30 - 34세,1998,353,202,151
'4613063500,  서강동,'40,35 - 39세,1998,406,175,231
'4613063500,  서강동,'45,40 - 44세,1998,502,234,268
'4613063500,  서강동,'50,45 - 49세,1998,446,212,234
'4613063500,  서강동,'55,50 - 54세,1998,430,215,215
'4613063500,  서강동,'60,55 - 59세,1998,367,205,162
'4613063500,  서강동,'65,60 - 64세,1998,252,109,143
'4613063500,  서강동,'70,65 - 69세,1998,213,85,128
'4613063500,  서강동,'75,70 - 74세,1998,137,44,93
'4613063500,  서강동,'80,75 - 79세,1998,100,36,64
'4613063500,  서강동,'85,80 - 84세,1998,52,13,39
'4613063500,  서강동,'90,85+ ,1998,25,12,13
'4613065500,  대교동,'00,계,1998,13206,6667,6539
'4613065500,  대교동,'05,0 - 4세,1998,618,323,295
'4613065500,  대교동,'10,5 - 9세,1998,688,358,330
'4613065500,  대교동,'15,10 - 14세,1998,877,432,445
'4613065500,  대교동,'20,15 - 19세,1998,1500,764,736
'4613065500,  대교동,'25,20 - 24세,1998,1555,839,716
'4613065500,  대교동,'30,25 - 29세,1998,1084,647,437
'4613065500,  대교동,'35,30 - 34세,1998,820,450,370
'4613065500,  대교동,'40,35 - 39세,1998,971,487,484
'4613065500,  대교동,'45,40 - 44세,1998,1014,506,508
'4613065500,  대교동,'50,45 - 49세,1998,979,458,521
'4613065500,  대교동,'55,50 - 54세,1998,822,406,416
'4613065500,  대교동,'60,55 - 59세,1998,805,407,398
'4613065500,  대교동,'65,60 - 64세,1998,513,259,254
'4613065500,  대교동,'70,65 - 69세,1998,410,155,255
'4613065500,  대교동,'75,70 - 74세,1998,233,96,137
'4613065500,  대교동,'80,75 - 79세,1998,176,53,123
'4613065500,  대교동,'85,80 - 84세,1998,81,19,62
'4613065500,  대교동,'90,85+ ,1998,60,8,52
'4613067000,  국동,'00,계,1998,19263,9763,9500
'4613067000,  국동,'05,0 - 4세,1998,1273,675,598
'4613067000,  국동,'10,5 - 9세,1998,1496,775,721
'4613067000,  국동,'15,10 - 14세,1998,1694,875,819
'4613067000,  국동,'20,15 - 19세,1998,2133,1140,993
'4613067000,  국동,'25,20 - 24세,1998,1792,917,875
'4613067000,  국동,'30,25 - 29세,1998,1569,831,738
'4613067000,  국동,'35,30 - 34세,1998,1531,736,795
'4613067000,  국동,'40,35 - 39세,1998,1900,927,973
'4613067000,  국동,'45,40 - 44세,1998,1644,844,800
'4613067000,  국동,'50,45 - 49세,1998,1198,651,547
'4613067000,  국동,'55,50 - 54세,1998,927,511,416
'4613067000,  국동,'60,55 - 59세,1998,752,366,386
'4613067000,  국동,'65,60 - 64세,1998,508,243,265
'4613067000,  국동,'70,65 - 69세,1998,332,137,195
'4613067000,  국동,'75,70 - 74세,1998,222,68,154
'4613067000,  국동,'80,75 - 79세,1998,159,42,117
'4613067000,  국동,'85,80 - 84세,1998,68,14,54
'4613067000,  국동,'90,85+ ,1998,65,11,54
'4613068500,  월호동,'00,계,1998,9410,4763,4647
'4613068500,  월호동,'05,0 - 4세,1998,541,286,255
'4613068500,  월호동,'10,5 - 9세,1998,661,331,330
'4613068500,  월호동,'15,10 - 14세,1998,748,378,370
'4613068500,  월호동,'20,15 - 19세,1998,1167,622,545
'4613068500,  월호동,'25,20 - 24세,1998,897,481,416
'4613068500,  월호동,'30,25 - 29세,1998,626,369,257
'4613068500,  월호동,'35,30 - 34세,1998,621,301,320
'4613068500,  월호동,'40,35 - 39세,1998,869,408,461
'4613068500,  월호동,'45,40 - 44세,1998,851,431,420
'4613068500,  월호동,'50,45 - 49세,1998,660,345,315
'4613068500,  월호동,'55,50 - 54세,1998,498,268,230
'4613068500,  월호동,'60,55 - 59세,1998,448,231,217
'4613068500,  월호동,'65,60 - 64세,1998,273,140,133
'4613068500,  월호동,'70,65 - 69세,1998,214,76,138
'4613068500,  월호동,'75,70 - 74세,1998,128,49,79
'4613068500,  월호동,'80,75 - 79세,1998,118,25,93
'4613068500,  월호동,'85,80 - 84세,1998,57,14,43
'4613068500,  월호동,'90,85+ ,1998,33,8,25
'4613070000,  여서동,'00,계,1998,27445,13578,13867
'4613070000,  여서동,'05,0 - 4세,1998,2504,1341,1163
'4613070000,  여서동,'10,5 - 9세,1998,2766,1461,1305
'4613070000,  여서동,'15,10 - 14세,1998,2493,1258,1235
'4613070000,  여서동,'20,15 - 19세,1998,2680,1322,1358
'4613070000,  여서동,'25,20 - 24세,1998,1726,863,863
'4613070000,  여서동,'30,25 - 29세,1998,1995,891,1104
'4613070000,  여서동,'35,30 - 34세,1998,2752,1253,1499
'4613070000,  여서동,'40,35 - 39세,1998,3228,1545,1683
'4613070000,  여서동,'45,40 - 44세,1998,2482,1323,1159
'4613070000,  여서동,'50,45 - 49세,1998,1496,846,650
'4613070000,  여서동,'55,50 - 54세,1998,941,519,422
'4613070000,  여서동,'60,55 - 59세,1998,731,382,349
'4613070000,  여서동,'65,60 - 64세,1998,539,221,318
'4613070000,  여서동,'70,65 - 69세,1998,414,149,265
'4613070000,  여서동,'75,70 - 74세,1998,322,107,215
'4613070000,  여서동,'80,75 - 79세,1998,212,61,151
'4613070000,  여서동,'85,80 - 84세,1998,95,22,73
'4613070000,  여서동,'90,85+ ,1998,69,14,55
'4613071000,  문수동,'00,계,1998,22749,11400,11349
'4613071000,  문수동,'05,0 - 4세,1998,2254,1180,1074
'4613071000,  문수동,'10,5 - 9세,1998,2139,1144,995
'4613071000,  문수동,'15,10 - 14세,1998,1814,937,877
'4613071000,  문수동,'20,15 - 19세,1998,2062,1048,1014
'4613071000,  문수동,'25,20 - 24세,1998,1624,813,811
'4613071000,  문수동,'30,25 - 29세,1998,2306,1082,1224
'4613071000,  문수동,'35,30 - 34세,1998,2403,1230,1173
'4613071000,  문수동,'40,35 - 39세,1998,2325,1204,1121
'4613071000,  문수동,'45,40 - 44세,1998,1804,898,906
'4613071000,  문수동,'50,45 - 49세,1998,1165,649,516
'4613071000,  문수동,'55,50 - 54세,1998,811,424,387
'4613071000,  문수동,'60,55 - 59세,1998,632,287,345
'4613071000,  문수동,'65,60 - 64세,1998,470,215,255
'4613071000,  문수동,'70,65 - 69세,1998,341,130,211
'4613071000,  문수동,'75,70 - 74세,1998,250,69,181
'4613071000,  문수동,'80,75 - 79세,1998,183,54,129
'4613071000,  문수동,'85,80 - 84세,1998,108,27,81
'4613071000,  문수동,'90,85+ ,1998,58,9,49
'4613073000,  미평동,'00,계,1998,16495,8280,8215
'4613073000,  미평동,'05,0 - 4세,1998,1557,797,760
'4613073000,  미평동,'10,5 - 9세,1998,1703,894,809
'4613073000,  미평동,'15,10 - 14세,1998,1382,734,648
'4613073000,  미평동,'20,15 - 19세,1998,1453,774,679
'4613073000,  미평동,'25,20 - 24세,1998,1240,673,567
'4613073000,  미평동,'30,25 - 29세,1998,1430,666,764
'4613073000,  미평동,'35,30 - 34세,1998,1746,822,924
'4613073000,  미평동,'40,35 - 39세,1998,1869,942,927
'4613073000,  미평동,'45,40 - 44세,1998,1258,688,570
'4613073000,  미평동,'50,45 - 49세,1998,813,424,389
'4613073000,  미평동,'55,50 - 54세,1998,605,309,296
'4613073000,  미평동,'60,55 - 59세,1998,465,211,254
'4613073000,  미평동,'65,60 - 64세,1998,327,137,190
'4613073000,  미평동,'70,65 - 69세,1998,273,100,173
'4613073000,  미평동,'75,70 - 74세,1998,150,60,90
'4613073000,  미평동,'80,75 - 79세,1998,130,28,102
'4613073000,  미평동,'85,80 - 84세,1998,50,10,40
'4613073000,  미평동,'90,85+ ,1998,44,11,33
'4613074000,  둔덕동,'00,계,1998,10086,5140,4946
'4613074000,  둔덕동,'05,0 - 4세,1998,1083,570,513
'4613074000,  둔덕동,'10,5 - 9세,1998,872,465,407
'4613074000,  둔덕동,'15,10 - 14세,1998,819,428,391
'4613074000,  둔덕동,'20,15 - 19세,1998,945,480,465
'4613074000,  둔덕동,'25,20 - 24세,1998,683,345,338
'4613074000,  둔덕동,'30,25 - 29세,1998,1029,471,558
'4613074000,  둔덕동,'35,30 - 34세,1998,1152,627,525
'4613074000,  둔덕동,'40,35 - 39세,1998,998,483,515
'4613074000,  둔덕동,'45,40 - 44세,1998,859,458,401
'4613074000,  둔덕동,'50,45 - 49세,1998,551,315,236
'4613074000,  둔덕동,'55,50 - 54세,1998,350,190,160
'4613074000,  둔덕동,'60,55 - 59세,1998,218,129,89
'4613074000,  둔덕동,'65,60 - 64세,1998,162,59,103
'4613074000,  둔덕동,'70,65 - 69세,1998,123,46,77
'4613074000,  둔덕동,'75,70 - 74세,1998,106,43,63
'4613074000,  둔덕동,'80,75 - 79세,1998,75,21,54
'4613074000,  둔덕동,'85,80 - 84세,1998,30,7,23
'4613074000,  둔덕동,'90,85+ ,1998,31,3,28
'4613076500,  만덕동,'00,계,1998,11915,5979,5936
'4613076500,  만덕동,'05,0 - 4세,1998,580,278,302
'4613076500,  만덕동,'10,5 - 9세,1998,631,322,309
'4613076500,  만덕동,'15,10 - 14세,1998,788,394,394
'4613076500,  만덕동,'20,15 - 19세,1998,1365,703,662
'4613076500,  만덕동,'25,20 - 24세,1998,1269,681,588
'4613076500,  만덕동,'30,25 - 29세,1998,1051,597,454
'4613076500,  만덕동,'35,30 - 34세,1998,749,433,316
'4613076500,  만덕동,'40,35 - 39세,1998,813,385,428
'4613076500,  만덕동,'45,40 - 44세,1998,916,434,482
'4613076500,  만덕동,'50,45 - 49세,1998,839,424,415
'4613076500,  만덕동,'55,50 - 54세,1998,759,395,364
'4613076500,  만덕동,'60,55 - 59세,1998,739,365,374
'4613076500,  만덕동,'65,60 - 64세,1998,486,244,242
'4613076500,  만덕동,'70,65 - 69세,1998,355,144,211
'4613076500,  만덕동,'75,70 - 74세,1998,237,86,151
'4613076500,  만덕동,'80,75 - 79세,1998,169,53,116
'4613076500,  만덕동,'85,80 - 84세,1998,100,33,67
'4613076500,  만덕동,'90,85+ ,1998,69,8,61
'4613078000,  쌍봉동,'00,계,1998,25725,13045,12680
'4613078000,  쌍봉동,'05,0 - 4세,1998,2461,1268,1193
'4613078000,  쌍봉동,'10,5 - 9세,1998,2823,1514,1309
'4613078000,  쌍봉동,'15,10 - 14세,1998,2328,1216,1112
'4613078000,  쌍봉동,'20,15 - 19세,1998,2289,1166,1123
'4613078000,  쌍봉동,'25,20 - 24세,1998,1608,822,786
'4613078000,  쌍봉동,'30,25 - 29세,1998,2179,1079,1100
'4613078000,  쌍봉동,'35,30 - 34세,1998,2751,1291,1460
'4613078000,  쌍봉동,'40,35 - 39세,1998,2979,1499,1480
'4613078000,  쌍봉동,'45,40 - 44세,1998,2167,1142,1025
'4613078000,  쌍봉동,'50,45 - 49세,1998,1427,848,579
'4613078000,  쌍봉동,'55,50 - 54세,1998,787,452,335
'4613078000,  쌍봉동,'60,55 - 59세,1998,535,288,247
'4613078000,  쌍봉동,'65,60 - 64세,1998,437,172,265
'4613078000,  쌍봉동,'70,65 - 69세,1998,379,135,244
'4613078000,  쌍봉동,'75,70 - 74세,1998,240,66,174
'4613078000,  쌍봉동,'80,75 - 79세,1998,159,45,114
'4613078000,  쌍봉동,'85,80 - 84세,1998,89,21,68
'4613078000,  쌍봉동,'90,85+ ,1998,87,21,66
'4613079000,  시전동,'00,계,1998,23233,11690,11543
'4613079000,  시전동,'05,0 - 4세,1998,2693,1428,1265
'4613079000,  시전동,'10,5 - 9세,1998,2912,1495,1417
'4613079000,  시전동,'15,10 - 14세,1998,1870,949,921
'4613079000,  시전동,'20,15 - 19세,1998,1676,876,800
'4613079000,  시전동,'25,20 - 24세,1998,1354,639,715
'4613079000,  시전동,'30,25 - 29세,1998,2293,1011,1282
'4613079000,  시전동,'35,30 - 34세,1998,2874,1401,1473
'4613079000,  시전동,'40,35 - 39세,1998,2788,1508,1280
'4613079000,  시전동,'45,40 - 44세,1998,1661,892,769
'4613079000,  시전동,'50,45 - 49세,1998,986,568,418
'4613079000,  시전동,'55,50 - 54세,1998,534,306,228
'4613079000,  시전동,'60,55 - 59세,1998,451,217,234
'4613079000,  시전동,'65,60 - 64세,1998,359,150,209
'4613079000,  시전동,'70,65 - 69세,1998,325,108,217
'4613079000,  시전동,'75,70 - 74세,1998,189,74,115
'4613079000,  시전동,'80,75 - 79세,1998,152,45,107
'4613079000,  시전동,'85,80 - 84세,1998,72,12,60
'4613079000,  시전동,'90,85+ ,1998,44,11,33
'4613080000,  여천동,'00,계,1998,16539,8203,8336
'4613080000,  여천동,'05,0 - 4세,1998,1828,955,873
'4613080000,  여천동,'10,5 - 9세,1998,1908,951,957
'4613080000,  여천동,'15,10 - 14세,1998,1374,681,693
'4613080000,  여천동,'20,15 - 19세,1998,1398,703,695
'4613080000,  여천동,'25,20 - 24세,1998,965,472,493
'4613080000,  여천동,'30,25 - 29세,1998,1506,657,849
'4613080000,  여천동,'35,30 - 34세,1998,2049,981,1068
'4613080000,  여천동,'40,35 - 39세,1998,1840,989,851
'4613080000,  여천동,'45,40 - 44세,1998,1220,664,556
'4613080000,  여천동,'50,45 - 49세,1998,758,421,337
'4613080000,  여천동,'55,50 - 54세,1998,427,252,175
'4613080000,  여천동,'60,55 - 59세,1998,350,149,201
'4613080000,  여천동,'65,60 - 64세,1998,306,140,166
'4613080000,  여천동,'70,65 - 69세,1998,228,82,146
'4613080000,  여천동,'75,70 - 74세,1998,162,54,108
'4613080000,  여천동,'80,75 - 79세,1998,118,33,85
'4613080000,  여천동,'85,80 - 84세,1998,54,13,41
'4613080000,  여천동,'90,85+ ,1998,48,6,42
'4613081000,  주삼동,'00,계,1998,5872,3011,2861
'4613081000,  주삼동,'05,0 - 4세,1998,781,421,360
'4613081000,  주삼동,'10,5 - 9세,1998,331,163,168
'4613081000,  주삼동,'15,10 - 14세,1998,329,166,163
'4613081000,  주삼동,'20,15 - 19세,1998,388,196,192
'4613081000,  주삼동,'25,20 - 24세,1998,489,220,269
'4613081000,  주삼동,'30,25 - 29세,1998,1002,488,514
'4613081000,  주삼동,'35,30 - 34세,1998,676,446,230
'4613081000,  주삼동,'40,35 - 39세,1998,420,230,190
'4613081000,  주삼동,'45,40 - 44세,1998,274,156,118
'4613081000,  주삼동,'50,45 - 49세,1998,238,116,122
'4613081000,  주삼동,'55,50 - 54세,1998,224,109,115
'4613081000,  주삼동,'60,55 - 59세,1998,239,115,124
'4613081000,  주삼동,'65,60 - 64세,1998,160,69,91
'4613081000,  주삼동,'70,65 - 69세,1998,124,45,79
'4613081000,  주삼동,'75,70 - 74세,1998,84,37,47
'4613081000,  주삼동,'80,75 - 79세,1998,67,19,48
'4613081000,  주삼동,'85,80 - 84세,1998,27,12,15
'4613081000,  주삼동,'90,85+ ,1998,19,3,16
'4613082000,  삼일동,'00,계,1998,7386,3765,3621
'4613082000,  삼일동,'05,0 - 4세,1998,610,319,291
'4613082000,  삼일동,'10,5 - 9세,1998,556,284,272
'4613082000,  삼일동,'15,10 - 14세,1998,463,227,236
'4613082000,  삼일동,'20,15 - 19세,1998,714,361,353
'4613082000,  삼일동,'25,20 - 24세,1998,692,370,322
'4613082000,  삼일동,'30,25 - 29세,1998,707,403,304
'4613082000,  삼일동,'35,30 - 34세,1998,580,299,281
'4613082000,  삼일동,'40,35 - 39세,1998,639,354,285
'4613082000,  삼일동,'45,40 - 44세,1998,513,274,239
'4613082000,  삼일동,'50,45 - 49세,1998,438,230,208
'4613082000,  삼일동,'55,50 - 54세,1998,352,169,183
'4613082000,  삼일동,'60,55 - 59세,1998,347,184,163
'4613082000,  삼일동,'65,60 - 64세,1998,252,117,135
'4613082000,  삼일동,'70,65 - 69세,1998,210,80,130
'4613082000,  삼일동,'75,70 - 74세,1998,138,55,83
'4613082000,  삼일동,'80,75 - 79세,1998,80,21,59
'4613082000,  삼일동,'85,80 - 84세,1998,52,14,38
'4613082000,  삼일동,'90,85+ ,1998,43,4,39
'4613083000,  묘도동,'00,계,1998,1802,937,865
'4613083000,  묘도동,'05,0 - 4세,1998,94,47,47
'4613083000,  묘도동,'10,5 - 9세,1998,59,38,21
'4613083000,  묘도동,'15,10 - 14세,1998,80,45,35
'4613083000,  묘도동,'20,15 - 19세,1998,167,84,83
'4613083000,  묘도동,'25,20 - 24세,1998,213,118,95
'4613083000,  묘도동,'30,25 - 29세,1998,183,125,58
'4613083000,  묘도동,'35,30 - 34세,1998,99,70,29
'4613083000,  묘도동,'40,35 - 39세,1998,109,69,40
'4613083000,  묘도동,'45,40 - 44세,1998,87,45,42
'4613083000,  묘도동,'50,45 - 49세,1998,88,45,43
'4613083000,  묘도동,'55,50 - 54세,1998,96,38,58
'4613083000,  묘도동,'60,55 - 59세,1998,168,76,92
'4613083000,  묘도동,'65,60 - 64세,1998,108,47,61
'4613083000,  묘도동,'70,65 - 69세,1998,110,43,67
'4613083000,  묘도동,'75,70 - 74세,1998,53,19,34
'4613083000,  묘도동,'80,75 - 79세,1998,44,17,27
'4613083000,  묘도동,'85,80 - 84세,1998,24,5,19
'4613083000,  묘도동,'90,85+ ,1998,20,6,14
'4613084000,  상암동,'00,계,1998,3370,1714,1656
'4613084000,  상암동,'05,0 - 4세,1998,215,114,101
'4613084000,  상암동,'10,5 - 9세,1998,164,76,88
'4613084000,  상암동,'15,10 - 14세,1998,188,91,97
'4613084000,  상암동,'20,15 - 19세,1998,307,162,145
'4613084000,  상암동,'25,20 - 24세,1998,345,183,162
'4613084000,  상암동,'30,25 - 29세,1998,331,210,121
'4613084000,  상암동,'35,30 - 34세,1998,225,145,80
'4613084000,  상암동,'40,35 - 39세,1998,212,122,90
'4613084000,  상암동,'45,40 - 44세,1998,178,92,86
'4613084000,  상암동,'50,45 - 49세,1998,178,90,88
'4613084000,  상암동,'55,50 - 54세,1998,180,96,84
'4613084000,  상암동,'60,55 - 59세,1998,248,106,142
'4613084000,  상암동,'65,60 - 64세,1998,195,92,103
'4613084000,  상암동,'70,65 - 69세,1998,125,44,81
'4613084000,  상암동,'75,70 - 74세,1998,116,38,78
'4613084000,  상암동,'80,75 - 79세,1998,79,30,49
'4613084000,  상암동,'85,80 - 84세,1998,44,17,27
'4613084000,  상암동,'90,85+ ,1998,40,6,34
'46150, 순천시,'00,계,1998,266553,133124,133429
'46150, 순천시,'05,0 - 4세,1998,21893,11432,10461
'46150, 순천시,'10,5 - 9세,1998,21926,11592,10334
'46150, 순천시,'15,10 - 14세,1998,20027,10323,9704
'46150, 순천시,'20,15 - 19세,1998,24448,12643,11805
'46150, 순천시,'25,20 - 24세,1998,21675,11253,10422
'46150, 순천시,'30,25 - 29세,1998,23127,11797,11330
'46150, 순천시,'35,30 - 34세,1998,24365,12286,12079
'46150, 순천시,'40,35 - 39세,1998,24989,12796,12193
'46150, 순천시,'45,40 - 44세,1998,18892,9744,9148
'46150, 순천시,'50,45 - 49세,1998,13219,6957,6262
'46150, 순천시,'55,50 - 54세,1998,10662,5326,5336
'46150, 순천시,'60,55 - 59세,1998,11380,5276,6104
'46150, 순천시,'65,60 - 64세,1998,10013,4404,5609
'46150, 순천시,'70,65 - 69세,1998,7732,3116,4616
'46150, 순천시,'75,70 - 74세,1998,5097,2008,3089
'46150, 순천시,'80,75 - 79세,1998,3668,1291,2377
'46150, 순천시,'85,80 - 84세,1998,1926,574,1352
'46150, 순천시,'90,85+ ,1998,1514,306,1208
'4615025000,  승주읍,'00,계,1998,4915,2465,2450
'4615025000,  승주읍,'05,0 - 4세,1998,215,120,95
'4615025000,  승주읍,'10,5 - 9세,1998,195,96,99
'4615025000,  승주읍,'15,10 - 14세,1998,224,125,99
'4615025000,  승주읍,'20,15 - 19세,1998,441,217,224
'4615025000,  승주읍,'25,20 - 24세,1998,495,273,222
'4615025000,  승주읍,'30,25 - 29세,1998,398,273,125
'4615025000,  승주읍,'35,30 - 34세,1998,271,159,112
'4615025000,  승주읍,'40,35 - 39세,1998,288,159,129
'4615025000,  승주읍,'45,40 - 44세,1998,224,122,102
'4615025000,  승주읍,'50,45 - 49세,1998,217,131,86
'4615025000,  승주읍,'55,50 - 54세,1998,255,103,152
'4615025000,  승주읍,'60,55 - 59세,1998,434,187,247
'4615025000,  승주읍,'65,60 - 64세,1998,380,159,221
'4615025000,  승주읍,'70,65 - 69세,1998,367,159,208
'4615025000,  승주읍,'75,70 - 74세,1998,207,94,113
'4615025000,  승주읍,'80,75 - 79세,1998,149,54,95
'4615025000,  승주읍,'85,80 - 84세,1998,88,22,66
'4615025000,  승주읍,'90,85+ ,1998,67,12,55
'4615031000,  해룡면,'00,계,1998,21799,10990,10809
'4615031000,  해룡면,'05,0 - 4세,1998,2600,1352,1248
'4615031000,  해룡면,'10,5 - 9세,1998,1910,978,932
'4615031000,  해룡면,'15,10 - 14세,1998,1345,670,675
'4615031000,  해룡면,'20,15 - 19세,1998,1531,820,711
'4615031000,  해룡면,'25,20 - 24세,1998,1466,750,716
'4615031000,  해룡면,'30,25 - 29세,1998,2283,1078,1205
'4615031000,  해룡면,'35,30 - 34세,1998,2633,1411,1222
'4615031000,  해룡면,'40,35 - 39세,1998,2061,1191,870
'4615031000,  해룡면,'45,40 - 44세,1998,1141,660,481
'4615031000,  해룡면,'50,45 - 49세,1998,755,406,349
'4615031000,  해룡면,'55,50 - 54세,1998,686,322,364
'4615031000,  해룡면,'60,55 - 59세,1998,844,378,466
'4615031000,  해룡면,'65,60 - 64세,1998,821,350,471
'4615031000,  해룡면,'70,65 - 69세,1998,700,256,444
'4615031000,  해룡면,'75,70 - 74세,1998,435,183,252
'4615031000,  해룡면,'80,75 - 79세,1998,317,106,211
'4615031000,  해룡면,'85,80 - 84세,1998,147,57,90
'4615031000,  해룡면,'90,85+ ,1998,124,22,102
'4615032000,  서면,'00,계,1998,9710,4949,4761
'4615032000,  서면,'05,0 - 4세,1998,551,274,277
'4615032000,  서면,'10,5 - 9세,1998,417,227,190
'4615032000,  서면,'15,10 - 14세,1998,503,264,239
'4615032000,  서면,'20,15 - 19세,1998,939,479,460
'4615032000,  서면,'25,20 - 24세,1998,1011,549,462
'4615032000,  서면,'30,25 - 29세,1998,878,555,323
'4615032000,  서면,'35,30 - 34세,1998,634,376,258
'4615032000,  서면,'40,35 - 39세,1998,606,344,262
'4615032000,  서면,'45,40 - 44세,1998,606,310,296
'4615032000,  서면,'50,45 - 49세,1998,519,260,259
'4615032000,  서면,'55,50 - 54세,1998,552,274,278
'4615032000,  서면,'60,55 - 59세,1998,656,299,357
'4615032000,  서면,'65,60 - 64세,1998,637,285,352
'4615032000,  서면,'70,65 - 69세,1998,480,202,278
'4615032000,  서면,'75,70 - 74세,1998,305,121,184
'4615032000,  서면,'80,75 - 79세,1998,225,82,143
'4615032000,  서면,'85,80 - 84세,1998,99,28,71
'4615032000,  서면,'90,85+ ,1998,92,20,72
'4615033000,  황전면,'00,계,1998,5419,2652,2767
'4615033000,  황전면,'05,0 - 4세,1998,151,74,77
'4615033000,  황전면,'10,5 - 9세,1998,170,83,87
'4615033000,  황전면,'15,10 - 14세,1998,266,132,134
'4615033000,  황전면,'20,15 - 19세,1998,583,290,293
'4615033000,  황전면,'25,20 - 24세,1998,574,336,238
'4615033000,  황전면,'30,25 - 29세,1998,335,236,99
'4615033000,  황전면,'35,30 - 34세,1998,226,146,80
'4615033000,  황전면,'40,35 - 39세,1998,256,132,124
'4615033000,  황전면,'45,40 - 44세,1998,239,117,122
'4615033000,  황전면,'50,45 - 49세,1998,301,153,148
'4615033000,  황전면,'55,50 - 54세,1998,332,159,173
'4615033000,  황전면,'60,55 - 59세,1998,502,226,276
'4615033000,  황전면,'65,60 - 64세,1998,529,198,331
'4615033000,  황전면,'70,65 - 69세,1998,381,176,205
'4615033000,  황전면,'75,70 - 74세,1998,229,81,148
'4615033000,  황전면,'80,75 - 79세,1998,183,67,116
'4615033000,  황전면,'85,80 - 84세,1998,91,27,64
'4615033000,  황전면,'90,85+ ,1998,71,19,52
'4615034000,  월등면,'00,계,1998,3134,1551,1583
'4615034000,  월등면,'05,0 - 4세,1998,115,56,59
'4615034000,  월등면,'10,5 - 9세,1998,101,49,52
'4615034000,  월등면,'15,10 - 14세,1998,179,86,93
'4615034000,  월등면,'20,15 - 19세,1998,293,137,156
'4615034000,  월등면,'25,20 - 24세,1998,360,216,144
'4615034000,  월등면,'30,25 - 29세,1998,200,133,67
'4615034000,  월등면,'35,30 - 34세,1998,149,89,60
'4615034000,  월등면,'40,35 - 39세,1998,169,91,78
'4615034000,  월등면,'45,40 - 44세,1998,149,77,72
'4615034000,  월등면,'50,45 - 49세,1998,156,83,73
'4615034000,  월등면,'55,50 - 54세,1998,178,81,97
'4615034000,  월등면,'60,55 - 59세,1998,244,112,132
'4615034000,  월등면,'65,60 - 64세,1998,264,92,172
'4615034000,  월등면,'70,65 - 69세,1998,250,112,138
'4615034000,  월등면,'75,70 - 74세,1998,140,61,79
'4615034000,  월등면,'80,75 - 79세,1998,95,42,53
'4615034000,  월등면,'85,80 - 84세,1998,53,24,29
'4615034000,  월등면,'90,85+ ,1998,39,10,29
'4615035000,  주암면,'00,계,1998,6282,3135,3147
'4615035000,  주암면,'05,0 - 4세,1998,256,128,128
'4615035000,  주암면,'10,5 - 9세,1998,227,115,112
'4615035000,  주암면,'15,10 - 14세,1998,306,164,142
'4615035000,  주암면,'20,15 - 19세,1998,573,305,268
'4615035000,  주암면,'25,20 - 24세,1998,675,398,277
'4615035000,  주암면,'30,25 - 29세,1998,396,259,137
'4615035000,  주암면,'35,30 - 34세,1998,305,180,125
'4615035000,  주암면,'40,35 - 39세,1998,336,185,151
'4615035000,  주암면,'45,40 - 44세,1998,282,142,140
'4615035000,  주암면,'50,45 - 49세,1998,291,146,145
'4615035000,  주암면,'55,50 - 54세,1998,339,156,183
'4615035000,  주암면,'60,55 - 59세,1998,559,244,315
'4615035000,  주암면,'65,60 - 64세,1998,563,219,344
'4615035000,  주암면,'70,65 - 69세,1998,461,216,245
'4615035000,  주암면,'75,70 - 74세,1998,313,135,178
'4615035000,  주암면,'80,75 - 79세,1998,208,83,125
'4615035000,  주암면,'85,80 - 84세,1998,99,41,58
'4615035000,  주암면,'90,85+ ,1998,93,19,74
'4615036000,  송광면,'00,계,1998,2768,1445,1323
'4615036000,  송광면,'05,0 - 4세,1998,74,43,31
'4615036000,  송광면,'10,5 - 9세,1998,112,64,48
'4615036000,  송광면,'15,10 - 14세,1998,139,79,60
'4615036000,  송광면,'20,15 - 19세,1998,226,112,114
'4615036000,  송광면,'25,20 - 24세,1998,240,147,93
'4615036000,  송광면,'30,25 - 29세,1998,171,113,58
'4615036000,  송광면,'35,30 - 34세,1998,151,94,57
'4615036000,  송광면,'40,35 - 39세,1998,174,114,60
'4615036000,  송광면,'45,40 - 44세,1998,141,82,59
'4615036000,  송광면,'50,45 - 49세,1998,145,82,63
'4615036000,  송광면,'55,50 - 54세,1998,154,68,86
'4615036000,  송광면,'60,55 - 59세,1998,278,120,158
'4615036000,  송광면,'65,60 - 64세,1998,269,125,144
'4615036000,  송광면,'70,65 - 69세,1998,183,74,109
'4615036000,  송광면,'75,70 - 74세,1998,139,57,82
'4615036000,  송광면,'80,75 - 79세,1998,84,35,49
'4615036000,  송광면,'85,80 - 84세,1998,51,23,28
'4615036000,  송광면,'90,85+ ,1998,37,13,24
'4615037000,  외서면,'00,계,1998,1875,916,959
'4615037000,  외서면,'05,0 - 4세,1998,66,39,27
'4615037000,  외서면,'10,5 - 9세,1998,56,31,25
'4615037000,  외서면,'15,10 - 14세,1998,86,51,35
'4615037000,  외서면,'20,15 - 19세,1998,188,86,102
'4615037000,  외서면,'25,20 - 24세,1998,193,104,89
'4615037000,  외서면,'30,25 - 29세,1998,111,72,39
'4615037000,  외서면,'35,30 - 34세,1998,84,48,36
'4615037000,  외서면,'40,35 - 39세,1998,94,63,31
'4615037000,  외서면,'45,40 - 44세,1998,97,35,62
'4615037000,  외서면,'50,45 - 49세,1998,99,56,43
'4615037000,  외서면,'55,50 - 54세,1998,101,51,50
'4615037000,  외서면,'60,55 - 59세,1998,153,65,88
'4615037000,  외서면,'65,60 - 64세,1998,151,67,84
'4615037000,  외서면,'70,65 - 69세,1998,155,52,103
'4615037000,  외서면,'75,70 - 74세,1998,112,42,70
'4615037000,  외서면,'80,75 - 79세,1998,79,35,44
'4615037000,  외서면,'85,80 - 84세,1998,29,12,17
'4615037000,  외서면,'90,85+ ,1998,21,7,14
'4615038000,  낙안면,'00,계,1998,5400,2671,2729
'4615038000,  낙안면,'05,0 - 4세,1998,209,109,100
'4615038000,  낙안면,'10,5 - 9세,1998,186,101,85
'4615038000,  낙안면,'15,10 - 14세,1998,299,159,140
'4615038000,  낙안면,'20,15 - 19세,1998,541,272,269
'4615038000,  낙안면,'25,20 - 24세,1998,539,305,234
'4615038000,  낙안면,'30,25 - 29세,1998,343,231,112
'4615038000,  낙안면,'35,30 - 34세,1998,227,139,88
'4615038000,  낙안면,'40,35 - 39세,1998,302,157,145
'4615038000,  낙안면,'45,40 - 44세,1998,278,148,130
'4615038000,  낙안면,'50,45 - 49세,1998,296,147,149
'4615038000,  낙안면,'55,50 - 54세,1998,303,129,174
'4615038000,  낙안면,'60,55 - 59세,1998,461,207,254
'4615038000,  낙안면,'65,60 - 64세,1998,475,197,278
'4615038000,  낙안면,'70,65 - 69세,1998,353,145,208
'4615038000,  낙안면,'75,70 - 74세,1998,224,102,122
'4615038000,  낙안면,'80,75 - 79세,1998,195,78,117
'4615038000,  낙안면,'85,80 - 84세,1998,96,28,68
'4615038000,  낙안면,'90,85+ ,1998,73,17,56
'4615039000,  별량면,'00,계,1998,9099,4574,4525
'4615039000,  별량면,'05,0 - 4세,1998,327,172,155
'4615039000,  별량면,'10,5 - 9세,1998,310,155,155
'4615039000,  별량면,'15,10 - 14세,1998,407,214,193
'4615039000,  별량면,'20,15 - 19세,1998,884,459,425
'4615039000,  별량면,'25,20 - 24세,1998,990,556,434
'4615039000,  별량면,'30,25 - 29세,1998,765,504,261
'4615039000,  별량면,'35,30 - 34세,1998,465,295,170
'4615039000,  별량면,'40,35 - 39세,1998,452,265,187
'4615039000,  별량면,'45,40 - 44세,1998,470,234,236
'4615039000,  별량면,'50,45 - 49세,1998,487,237,250
'4615039000,  별량면,'55,50 - 54세,1998,543,258,285
'4615039000,  별량면,'60,55 - 59세,1998,758,327,431
'4615039000,  별량면,'65,60 - 64세,1998,789,340,449
'4615039000,  별량면,'70,65 - 69세,1998,606,260,346
'4615039000,  별량면,'75,70 - 74세,1998,325,139,186
'4615039000,  별량면,'80,75 - 79세,1998,276,97,179
'4615039000,  별량면,'85,80 - 84세,1998,138,44,94
'4615039000,  별량면,'90,85+ ,1998,107,18,89
'4615040000,  상사면,'00,계,1998,3704,1879,1825
'4615040000,  상사면,'05,0 - 4세,1998,156,76,80
'4615040000,  상사면,'10,5 - 9세,1998,158,76,82
'4615040000,  상사면,'15,10 - 14세,1998,184,89,95
'4615040000,  상사면,'20,15 - 19세,1998,326,159,167
'4615040000,  상사면,'25,20 - 24세,1998,417,243,174
'4615040000,  상사면,'30,25 - 29세,1998,323,212,111
'4615040000,  상사면,'35,30 - 34세,1998,206,137,69
'4615040000,  상사면,'40,35 - 39세,1998,206,110,96
'4615040000,  상사면,'45,40 - 44세,1998,211,113,98
'4615040000,  상사면,'50,45 - 49세,1998,184,93,91
'4615040000,  상사면,'55,50 - 54세,1998,208,92,116
'4615040000,  상사면,'60,55 - 59세,1998,316,140,176
'4615040000,  상사면,'65,60 - 64세,1998,288,134,154
'4615040000,  상사면,'70,65 - 69세,1998,197,86,111
'4615040000,  상사면,'75,70 - 74세,1998,117,52,65
'4615040000,  상사면,'80,75 - 79세,1998,103,42,61
'4615040000,  상사면,'85,80 - 84세,1998,68,15,53
'4615040000,  상사면,'90,85+ ,1998,36,10,26
'4615051500,  향동,'00,계,1998,8337,4119,4218
'4615051500,  향동,'05,0 - 4세,1998,406,211,195
'4615051500,  향동,'10,5 - 9세,1998,472,242,230
'4615051500,  향동,'15,10 - 14세,1998,612,326,286
'4615051500,  향동,'20,15 - 19세,1998,1005,514,491
'4615051500,  향동,'25,20 - 24세,1998,867,459,408
'4615051500,  향동,'30,25 - 29세,1998,676,395,281
'4615051500,  향동,'35,30 - 34세,1998,486,260,226
'4615051500,  향동,'40,35 - 39세,1998,608,275,333
'4615051500,  향동,'45,40 - 44세,1998,618,282,336
'4615051500,  향동,'50,45 - 49세,1998,592,280,312
'4615051500,  향동,'55,50 - 54세,1998,446,236,210
'4615051500,  향동,'60,55 - 59세,1998,463,219,244
'4615051500,  향동,'65,60 - 64세,1998,356,159,197
'4615051500,  향동,'70,65 - 69세,1998,269,116,153
'4615051500,  향동,'75,70 - 74세,1998,178,63,115
'4615051500,  향동,'80,75 - 79세,1998,143,44,99
'4615051500,  향동,'85,80 - 84세,1998,75,25,50
'4615051500,  향동,'90,85+ ,1998,65,13,52
'4615054000,  매곡동,'00,계,1998,11119,5455,5664
'4615054000,  매곡동,'05,0 - 4세,1998,715,361,354
'4615054000,  매곡동,'10,5 - 9세,1998,826,417,409
'4615054000,  매곡동,'15,10 - 14세,1998,854,461,393
'4615054000,  매곡동,'20,15 - 19세,1998,1128,579,549
'4615054000,  매곡동,'25,20 - 24세,1998,1141,581,560
'4615054000,  매곡동,'30,25 - 29세,1998,1035,563,472
'4615054000,  매곡동,'35,30 - 34세,1998,831,396,435
'4615054000,  매곡동,'40,35 - 39세,1998,959,451,508
'4615054000,  매곡동,'45,40 - 44세,1998,853,400,453
'4615054000,  매곡동,'50,45 - 49세,1998,667,325,342
'4615054000,  매곡동,'55,50 - 54세,1998,529,277,252
'4615054000,  매곡동,'60,55 - 59세,1998,475,218,257
'4615054000,  매곡동,'65,60 - 64세,1998,397,183,214
'4615054000,  매곡동,'70,65 - 69세,1998,255,100,155
'4615054000,  매곡동,'75,70 - 74세,1998,183,64,119
'4615054000,  매곡동,'80,75 - 79세,1998,139,44,95
'4615054000,  매곡동,'85,80 - 84세,1998,71,20,51
'4615054000,  매곡동,'90,85+ ,1998,61,15,46
'4615055000,  삼산동,'00,계,1998,22371,11187,11184
'4615055000,  삼산동,'05,0 - 4세,1998,2029,1070,959
'4615055000,  삼산동,'10,5 - 9세,1998,2172,1172,1000
'4615055000,  삼산동,'15,10 - 14세,1998,1946,998,948
'4615055000,  삼산동,'20,15 - 19세,1998,2107,1118,989
'4615055000,  삼산동,'25,20 - 24세,1998,1605,823,782
'4615055000,  삼산동,'30,25 - 29세,1998,1731,784,947
'4615055000,  삼산동,'35,30 - 34세,1998,2171,1021,1150
'4615055000,  삼산동,'40,35 - 39세,1998,2520,1276,1244
'4615055000,  삼산동,'45,40 - 44세,1998,1863,937,926
'4615055000,  삼산동,'50,45 - 49세,1998,1228,686,542
'4615055000,  삼산동,'55,50 - 54세,1998,787,412,375
'4615055000,  삼산동,'60,55 - 59세,1998,607,317,290
'4615055000,  삼산동,'65,60 - 64세,1998,473,212,261
'4615055000,  삼산동,'70,65 - 69세,1998,391,136,255
'4615055000,  삼산동,'75,70 - 74세,1998,315,125,190
'4615055000,  삼산동,'80,75 - 79세,1998,200,64,136
'4615055000,  삼산동,'85,80 - 84세,1998,114,21,93
'4615055000,  삼산동,'90,85+ ,1998,112,15,97
'4615056000,  조곡동,'00,계,1998,8222,4189,4033
'4615056000,  조곡동,'05,0 - 4세,1998,534,276,258
'4615056000,  조곡동,'10,5 - 9세,1998,488,254,234
'4615056000,  조곡동,'15,10 - 14세,1998,528,283,245
'4615056000,  조곡동,'20,15 - 19세,1998,856,446,410
'4615056000,  조곡동,'25,20 - 24세,1998,841,467,374
'4615056000,  조곡동,'30,25 - 29세,1998,772,424,348
'4615056000,  조곡동,'35,30 - 34세,1998,635,349,286
'4615056000,  조곡동,'40,35 - 39세,1998,627,326,301
'4615056000,  조곡동,'45,40 - 44세,1998,591,285,306
'4615056000,  조곡동,'50,45 - 49세,1998,506,245,261
'4615056000,  조곡동,'55,50 - 54세,1998,449,240,209
'4615056000,  조곡동,'60,55 - 59세,1998,423,196,227
'4615056000,  조곡동,'65,60 - 64세,1998,327,152,175
'4615056000,  조곡동,'70,65 - 69세,1998,229,94,135
'4615056000,  조곡동,'75,70 - 74세,1998,187,82,105
'4615056000,  조곡동,'80,75 - 79세,1998,120,45,75
'4615056000,  조곡동,'85,80 - 84세,1998,65,16,49
'4615056000,  조곡동,'90,85+ ,1998,44,9,35
'4615057000,  덕연동,'00,계,1998,38625,19343,19282
'4615057000,  덕연동,'05,0 - 4세,1998,3482,1821,1661
'4615057000,  덕연동,'10,5 - 9세,1998,4573,2456,2117
'4615057000,  덕연동,'15,10 - 14세,1998,4203,2192,2011
'4615057000,  덕연동,'20,15 - 19세,1998,3628,1965,1663
'4615057000,  덕연동,'25,20 - 24세,1998,2167,1112,1055
'4615057000,  덕연동,'30,25 - 29세,1998,2474,1102,1372
'4615057000,  덕연동,'35,30 - 34세,1998,3946,1685,2261
'4615057000,  덕연동,'40,35 - 39세,1998,5015,2380,2635
'4615057000,  덕연동,'45,40 - 44세,1998,3584,1946,1638
'4615057000,  덕연동,'50,45 - 49세,1998,1801,1063,738
'4615057000,  덕연동,'55,50 - 54세,1998,986,536,450
'4615057000,  덕연동,'60,55 - 59세,1998,793,397,396
'4615057000,  덕연동,'65,60 - 64세,1998,623,272,351
'4615057000,  덕연동,'70,65 - 69세,1998,505,174,331
'4615057000,  덕연동,'75,70 - 74세,1998,352,107,245
'4615057000,  덕연동,'80,75 - 79세,1998,264,88,176
'4615057000,  덕연동,'85,80 - 84세,1998,140,34,106
'4615057000,  덕연동,'90,85+ ,1998,89,13,76
'4615058000,  풍덕동,'00,계,1998,13545,6784,6761
'4615058000,  풍덕동,'05,0 - 4세,1998,925,489,436
'4615058000,  풍덕동,'10,5 - 9세,1998,1084,565,519
'4615058000,  풍덕동,'15,10 - 14세,1998,1169,607,562
'4615058000,  풍덕동,'20,15 - 19세,1998,1494,761,733
'4615058000,  풍덕동,'25,20 - 24세,1998,1179,642,537
'4615058000,  풍덕동,'30,25 - 29세,1998,1086,559,527
'4615058000,  풍덕동,'35,30 - 34세,1998,996,483,513
'4615058000,  풍덕동,'40,35 - 39세,1998,1198,541,657
'4615058000,  풍덕동,'45,40 - 44세,1998,1167,586,581
'4615058000,  풍덕동,'50,45 - 49세,1998,884,433,451
'4615058000,  풍덕동,'55,50 - 54세,1998,711,373,338
'4615058000,  풍덕동,'60,55 - 59세,1998,591,314,277
'4615058000,  풍덕동,'65,60 - 64세,1998,375,191,184
'4615058000,  풍덕동,'70,65 - 69세,1998,235,102,133
'4615058000,  풍덕동,'75,70 - 74세,1998,172,62,110
'4615058000,  풍덕동,'80,75 - 79세,1998,131,33,98
'4615058000,  풍덕동,'85,80 - 84세,1998,99,28,71
'4615058000,  풍덕동,'90,85+ ,1998,49,15,34
'4615059000,  남제동,'00,계,1998,16545,8315,8230
'4615059000,  남제동,'05,0 - 4세,1998,1175,633,542
'4615059000,  남제동,'10,5 - 9세,1998,1255,680,575
'4615059000,  남제동,'15,10 - 14세,1998,1272,658,614
'4615059000,  남제동,'20,15 - 19세,1998,1840,958,882
'4615059000,  남제동,'25,20 - 24세,1998,1662,845,817
'4615059000,  남제동,'30,25 - 29세,1998,1560,833,727
'4615059000,  남제동,'35,30 - 34세,1998,1309,677,632
'4615059000,  남제동,'40,35 - 39세,1998,1392,665,727
'4615059000,  남제동,'45,40 - 44세,1998,1158,543,615
'4615059000,  남제동,'50,45 - 49세,1998,991,469,522
'4615059000,  남제동,'55,50 - 54세,1998,822,401,421
'4615059000,  남제동,'60,55 - 59세,1998,753,397,356
'4615059000,  남제동,'65,60 - 64세,1998,501,262,239
'4615059000,  남제동,'70,65 - 69세,1998,301,128,173
'4615059000,  남제동,'75,70 - 74세,1998,221,82,139
'4615059000,  남제동,'80,75 - 79세,1998,153,45,108
'4615059000,  남제동,'85,80 - 84세,1998,97,24,73
'4615059000,  남제동,'90,85+ ,1998,83,15,68
'4615060000,  저전동,'00,계,1998,6217,3033,3184
'4615060000,  저전동,'05,0 - 4세,1998,309,168,141
'4615060000,  저전동,'10,5 - 9세,1998,439,239,200
'4615060000,  저전동,'15,10 - 14세,1998,497,244,253
'4615060000,  저전동,'20,15 - 19세,1998,728,380,348
'4615060000,  저전동,'25,20 - 24세,1998,644,329,315
'4615060000,  저전동,'30,25 - 29세,1998,476,258,218
'4615060000,  저전동,'35,30 - 34세,1998,396,198,198
'4615060000,  저전동,'40,35 - 39세,1998,509,222,287
'4615060000,  저전동,'45,40 - 44세,1998,486,211,275
'4615060000,  저전동,'50,45 - 49세,1998,405,192,213
'4615060000,  저전동,'55,50 - 54세,1998,330,172,158
'4615060000,  저전동,'60,55 - 59세,1998,318,153,165
'4615060000,  저전동,'65,60 - 64세,1998,236,108,128
'4615060000,  저전동,'70,65 - 69세,1998,170,69,101
'4615060000,  저전동,'75,70 - 74세,1998,108,45,63
'4615060000,  저전동,'80,75 - 79세,1998,74,24,50
'4615060000,  저전동,'85,80 - 84세,1998,50,13,37
'4615060000,  저전동,'90,85+ ,1998,42,8,34
'4615061000,  장천동,'00,계,1998,5129,2510,2619
'4615061000,  장천동,'05,0 - 4세,1998,215,101,114
'4615061000,  장천동,'10,5 - 9세,1998,333,171,162
'4615061000,  장천동,'15,10 - 14세,1998,341,179,162
'4615061000,  장천동,'20,15 - 19세,1998,580,311,269
'4615061000,  장천동,'25,20 - 24세,1998,553,287,266
'4615061000,  장천동,'30,25 - 29세,1998,435,243,192
'4615061000,  장천동,'35,30 - 34세,1998,303,141,162
'4615061000,  장천동,'40,35 - 39세,1998,398,189,209
'4615061000,  장천동,'45,40 - 44세,1998,433,176,257
'4615061000,  장천동,'50,45 - 49세,1998,345,168,177
'4615061000,  장천동,'55,50 - 54세,1998,325,150,175
'4615061000,  장천동,'60,55 - 59세,1998,278,134,144
'4615061000,  장천동,'65,60 - 64세,1998,212,117,95
'4615061000,  장천동,'70,65 - 69세,1998,132,61,71
'4615061000,  장천동,'75,70 - 74세,1998,120,45,75
'4615061000,  장천동,'80,75 - 79세,1998,63,23,40
'4615061000,  장천동,'85,80 - 84세,1998,36,8,28
'4615061000,  장천동,'90,85+ ,1998,27,6,21
'4615062000,  중앙동,'00,계,1998,6518,3165,3353
'4615062000,  중앙동,'05,0 - 4세,1998,369,191,178
'4615062000,  중앙동,'10,5 - 9세,1998,429,243,186
'4615062000,  중앙동,'15,10 - 14세,1998,439,213,226
'4615062000,  중앙동,'20,15 - 19세,1998,700,335,365
'4615062000,  중앙동,'25,20 - 24세,1998,681,334,347
'4615062000,  중앙동,'30,25 - 29세,1998,531,289,242
'4615062000,  중앙동,'35,30 - 34세,1998,447,207,240
'4615062000,  중앙동,'40,35 - 39세,1998,531,256,275
'4615062000,  중앙동,'45,40 - 44세,1998,521,228,293
'4615062000,  중앙동,'50,45 - 49세,1998,465,230,235
'4615062000,  중앙동,'55,50 - 54세,1998,377,189,188
'4615062000,  중앙동,'60,55 - 59세,1998,337,160,177
'4615062000,  중앙동,'65,60 - 64세,1998,260,130,130
'4615062000,  중앙동,'70,65 - 69세,1998,170,70,100
'4615062000,  중앙동,'75,70 - 74세,1998,112,48,64
'4615062000,  중앙동,'80,75 - 79세,1998,81,27,54
'4615062000,  중앙동,'85,80 - 84세,1998,42,13,29
'4615062000,  중앙동,'90,85+ ,1998,26,2,24
'4615063500,  도사동,'00,계,1998,10766,5354,5412
'4615063500,  도사동,'05,0 - 4세,1998,765,405,360
'4615063500,  도사동,'10,5 - 9세,1998,659,350,309
'4615063500,  도사동,'15,10 - 14세,1998,728,362,366
'4615063500,  도사동,'20,15 - 19세,1998,1060,509,551
'4615063500,  도사동,'25,20 - 24세,1998,999,513,486
'4615063500,  도사동,'30,25 - 29세,1998,959,544,415
'4615063500,  도사동,'35,30 - 34세,1998,832,446,386
'4615063500,  도사동,'40,35 - 39세,1998,854,433,421
'4615063500,  도사동,'45,40 - 44세,1998,746,391,355
'4615063500,  도사동,'50,45 - 49세,1998,530,295,235
'4615063500,  도사동,'55,50 - 54세,1998,469,241,228
'4615063500,  도사동,'60,55 - 59세,1998,565,231,334
'4615063500,  도사동,'65,60 - 64세,1998,500,222,278
'4615063500,  도사동,'70,65 - 69세,1998,451,182,269
'4615063500,  도사동,'75,70 - 74세,1998,292,109,183
'4615063500,  도사동,'80,75 - 79세,1998,188,74,114
'4615063500,  도사동,'85,80 - 84세,1998,96,30,66
'4615063500,  도사동,'90,85+ ,1998,73,17,56
'4615066000,  왕조동,'00,계,1998,45054,22443,22611
'4615066000,  왕조동,'05,0 - 4세,1998,6249,3263,2986
'4615066000,  왕조동,'10,5 - 9세,1998,5354,2828,2526
'4615066000,  왕조동,'15,10 - 14세,1998,3500,1767,1733
'4615066000,  왕조동,'20,15 - 19세,1998,2797,1431,1366
'4615066000,  왕조동,'25,20 - 24세,1998,2376,984,1392
'4615066000,  왕조동,'30,25 - 29세,1998,5189,2137,3052
'4615066000,  왕조동,'35,30 - 34세,1998,6662,3349,3313
'4615066000,  왕조동,'40,35 - 39세,1998,5434,2971,2463
'4615066000,  왕조동,'45,40 - 44세,1998,3034,1719,1315
'4615066000,  왕조동,'50,45 - 49세,1998,1355,777,578
'4615066000,  왕조동,'55,50 - 54세,1998,780,406,374
'4615066000,  왕조동,'60,55 - 59세,1998,572,235,337
'4615066000,  왕조동,'65,60 - 64세,1998,587,230,357
'4615066000,  왕조동,'70,65 - 69세,1998,491,146,345
'4615066000,  왕조동,'75,70 - 74세,1998,311,109,202
'4615066000,  왕조동,'80,75 - 79세,1998,198,59,139
'4615066000,  왕조동,'85,80 - 84세,1998,82,21,61
'4615066000,  왕조동,'90,85+ ,1998,83,11,72
'46170, 나주시,'00,계,1998,111719,55726,55993
'46170, 나주시,'05,0 - 4세,1998,6357,3248,3109
'46170, 나주시,'10,5 - 9세,1998,6144,3166,2978
'46170, 나주시,'15,10 - 14세,1998,6098,3072,3026
'46170, 나주시,'20,15 - 19세,1998,9719,4828,4891
'46170, 나주시,'25,20 - 24세,1998,10445,5925,4520
'46170, 나주시,'30,25 - 29세,1998,8700,5195,3505
'46170, 나주시,'35,30 - 34세,1998,7140,3962,3178
'46170, 나주시,'40,35 - 39세,1998,7475,4299,3176
'46170, 나주시,'45,40 - 44세,1998,6621,3603,3018
'46170, 나주시,'50,45 - 49세,1998,5753,2976,2777
'46170, 나주시,'55,50 - 54세,1998,6175,2958,3217
'46170, 나주시,'60,55 - 59세,1998,7964,3488,4476
'46170, 나주시,'65,60 - 64세,1998,7676,3238,4438
'46170, 나주시,'70,65 - 69세,1998,6002,2305,3697
'46170, 나주시,'75,70 - 74세,1998,4208,1736,2472
'46170, 나주시,'80,75 - 79세,1998,2946,1092,1854
'46170, 나주시,'85,80 - 84세,1998,1415,475,940
'46170, 나주시,'90,85+ ,1998,881,160,721
'4617025000,  남평읍,'00,계,1998,9830,4929,4901
'4617025000,  남평읍,'05,0 - 4세,1998,581,298,283
'4617025000,  남평읍,'10,5 - 9세,1998,545,269,276
'4617025000,  남평읍,'15,10 - 14세,1998,420,209,211
'4617025000,  남평읍,'20,15 - 19세,1998,892,431,461
'4617025000,  남평읍,'25,20 - 24세,1998,1002,557,445
'4617025000,  남평읍,'30,25 - 29세,1998,861,508,353
'4617025000,  남평읍,'35,30 - 34세,1998,675,390,285
'4617025000,  남평읍,'40,35 - 39세,1998,677,399,278
'4617025000,  남평읍,'45,40 - 44세,1998,613,327,286
'4617025000,  남평읍,'50,45 - 49세,1998,526,272,254
'4617025000,  남평읍,'55,50 - 54세,1998,564,277,287
'4617025000,  남평읍,'60,55 - 59세,1998,672,286,386
'4617025000,  남평읍,'65,60 - 64세,1998,600,259,341
'4617025000,  남평읍,'70,65 - 69세,1998,486,188,298
'4617025000,  남평읍,'75,70 - 74세,1998,310,127,183
'4617025000,  남평읍,'80,75 - 79세,1998,236,88,148
'4617025000,  남평읍,'85,80 - 84세,1998,107,28,79
'4617025000,  남평읍,'90,85+ ,1998,63,16,47
'4617031000,  세지면,'00,계,1998,4716,2427,2289
'4617031000,  세지면,'05,0 - 4세,1998,205,108,97
'4617031000,  세지면,'10,5 - 9세,1998,193,98,95
'4617031000,  세지면,'15,10 - 14세,1998,248,134,114
'4617031000,  세지면,'20,15 - 19세,1998,429,214,215
'4617031000,  세지면,'25,20 - 24세,1998,445,269,176
'4617031000,  세지면,'30,25 - 29세,1998,318,214,104
'4617031000,  세지면,'35,30 - 34세,1998,226,136,90
'4617031000,  세지면,'40,35 - 39세,1998,258,159,99
'4617031000,  세지면,'45,40 - 44세,1998,266,134,132
'4617031000,  세지면,'50,45 - 49세,1998,264,141,123
'4617031000,  세지면,'55,50 - 54세,1998,305,135,170
'4617031000,  세지면,'60,55 - 59세,1998,392,190,202
'4617031000,  세지면,'65,60 - 64세,1998,402,183,219
'4617031000,  세지면,'70,65 - 69세,1998,304,128,176
'4617031000,  세지면,'75,70 - 74세,1998,214,93,121
'4617031000,  세지면,'80,75 - 79세,1998,139,61,78
'4617031000,  세지면,'85,80 - 84세,1998,55,19,36
'4617031000,  세지면,'90,85+ ,1998,53,11,42
'4617032000,  왕곡면,'00,계,1998,5022,2507,2515
'4617032000,  왕곡면,'05,0 - 4세,1998,250,123,127
'4617032000,  왕곡면,'10,5 - 9세,1998,197,103,94
'4617032000,  왕곡면,'15,10 - 14세,1998,312,155,157
'4617032000,  왕곡면,'20,15 - 19세,1998,497,246,251
'4617032000,  왕곡면,'25,20 - 24세,1998,461,274,187
'4617032000,  왕곡면,'30,25 - 29세,1998,336,204,132
'4617032000,  왕곡면,'35,30 - 34세,1998,254,160,94
'4617032000,  왕곡면,'40,35 - 39세,1998,324,182,142
'4617032000,  왕곡면,'45,40 - 44세,1998,296,154,142
'4617032000,  왕곡면,'50,45 - 49세,1998,284,160,124
'4617032000,  왕곡면,'55,50 - 54세,1998,263,123,140
'4617032000,  왕곡면,'60,55 - 59세,1998,430,194,236
'4617032000,  왕곡면,'65,60 - 64세,1998,374,153,221
'4617032000,  왕곡면,'70,65 - 69세,1998,283,101,182
'4617032000,  왕곡면,'75,70 - 74세,1998,206,86,120
'4617032000,  왕곡면,'80,75 - 79세,1998,135,60,75
'4617032000,  왕곡면,'85,80 - 84세,1998,75,20,55
'4617032000,  왕곡면,'90,85+ ,1998,45,9,36
'4617033000,  반남면,'00,계,1998,2839,1421,1418
'4617033000,  반남면,'05,0 - 4세,1998,110,57,53
'4617033000,  반남면,'10,5 - 9세,1998,138,80,58
'4617033000,  반남면,'15,10 - 14세,1998,145,76,69
'4617033000,  반남면,'20,15 - 19세,1998,284,135,149
'4617033000,  반남면,'25,20 - 24세,1998,270,159,111
'4617033000,  반남면,'30,25 - 29세,1998,170,116,54
'4617033000,  반남면,'35,30 - 34세,1998,129,73,56
'4617033000,  반남면,'40,35 - 39세,1998,153,85,68
'4617033000,  반남면,'45,40 - 44세,1998,164,89,75
'4617033000,  반남면,'50,45 - 49세,1998,156,76,80
'4617033000,  반남면,'55,50 - 54세,1998,162,86,76
'4617033000,  반남면,'60,55 - 59세,1998,244,99,145
'4617033000,  반남면,'65,60 - 64세,1998,215,88,127
'4617033000,  반남면,'70,65 - 69세,1998,206,87,119
'4617033000,  반남면,'75,70 - 74세,1998,127,55,72
'4617033000,  반남면,'80,75 - 79세,1998,89,35,54
'4617033000,  반남면,'85,80 - 84세,1998,48,18,30
'4617033000,  반남면,'90,85+ ,1998,29,7,22
'4617034000,  공산면,'00,계,1998,4116,2044,2072
'4617034000,  공산면,'05,0 - 4세,1998,153,79,74
'4617034000,  공산면,'10,5 - 9세,1998,172,90,82
'4617034000,  공산면,'15,10 - 14세,1998,225,120,105
'4617034000,  공산면,'20,15 - 19세,1998,356,176,180
'4617034000,  공산면,'25,20 - 24세,1998,380,222,158
'4617034000,  공산면,'30,25 - 29세,1998,255,170,85
'4617034000,  공산면,'35,30 - 34세,1998,166,100,66
'4617034000,  공산면,'40,35 - 39세,1998,221,115,106
'4617034000,  공산면,'45,40 - 44세,1998,229,126,103
'4617034000,  공산면,'50,45 - 49세,1998,228,118,110
'4617034000,  공산면,'55,50 - 54세,1998,246,108,138
'4617034000,  공산면,'60,55 - 59세,1998,376,164,212
'4617034000,  공산면,'65,60 - 64세,1998,410,175,235
'4617034000,  공산면,'70,65 - 69세,1998,270,115,155
'4617034000,  공산면,'75,70 - 74세,1998,196,87,109
'4617034000,  공산면,'80,75 - 79세,1998,138,55,83
'4617034000,  공산면,'85,80 - 84세,1998,62,21,41
'4617034000,  공산면,'90,85+ ,1998,33,3,30
'4617035000,  동강면,'00,계,1998,5009,2427,2582
'4617035000,  동강면,'05,0 - 4세,1998,187,90,97
'4617035000,  동강면,'10,5 - 9세,1998,180,89,91
'4617035000,  동강면,'15,10 - 14세,1998,262,124,138
'4617035000,  동강면,'20,15 - 19세,1998,476,242,234
'4617035000,  동강면,'25,20 - 24세,1998,489,281,208
'4617035000,  동강면,'30,25 - 29세,1998,287,189,98
'4617035000,  동강면,'35,30 - 34세,1998,231,132,99
'4617035000,  동강면,'40,35 - 39세,1998,281,152,129
'4617035000,  동강면,'45,40 - 44세,1998,266,151,115
'4617035000,  동강면,'50,45 - 49세,1998,284,147,137
'4617035000,  동강면,'55,50 - 54세,1998,325,148,177
'4617035000,  동강면,'60,55 - 59세,1998,425,184,241
'4617035000,  동강면,'65,60 - 64세,1998,444,182,262
'4617035000,  동강면,'70,65 - 69세,1998,362,147,215
'4617035000,  동강면,'75,70 - 74세,1998,217,82,135
'4617035000,  동강면,'80,75 - 79세,1998,176,62,114
'4617035000,  동강면,'85,80 - 84세,1998,74,22,52
'4617035000,  동강면,'90,85+ ,1998,43,3,40
'4617036000,  다시면,'00,계,1998,6345,3105,3240
'4617036000,  다시면,'05,0 - 4세,1998,249,134,115
'4617036000,  다시면,'10,5 - 9세,1998,277,143,134
'4617036000,  다시면,'15,10 - 14세,1998,342,173,169
'4617036000,  다시면,'20,15 - 19세,1998,530,245,285
'4617036000,  다시면,'25,20 - 24세,1998,590,357,233
'4617036000,  다시면,'30,25 - 29세,1998,411,269,142
'4617036000,  다시면,'35,30 - 34세,1998,321,180,141
'4617036000,  다시면,'40,35 - 39세,1998,337,196,141
'4617036000,  다시면,'45,40 - 44세,1998,342,192,150
'4617036000,  다시면,'50,45 - 49세,1998,317,158,159
'4617036000,  다시면,'55,50 - 54세,1998,340,151,189
'4617036000,  다시면,'60,55 - 59세,1998,520,226,294
'4617036000,  다시면,'65,60 - 64세,1998,580,232,348
'4617036000,  다시면,'70,65 - 69세,1998,477,174,303
'4617036000,  다시면,'75,70 - 74세,1998,314,132,182
'4617036000,  다시면,'80,75 - 79세,1998,240,94,146
'4617036000,  다시면,'85,80 - 84세,1998,107,41,66
'4617036000,  다시면,'90,85+ ,1998,51,8,43
'4617037000,  문평면,'00,계,1998,3695,1839,1856
'4617037000,  문평면,'05,0 - 4세,1998,147,84,63
'4617037000,  문평면,'10,5 - 9세,1998,167,82,85
'4617037000,  문평면,'15,10 - 14세,1998,167,84,83
'4617037000,  문평면,'20,15 - 19세,1998,320,164,156
'4617037000,  문평면,'25,20 - 24세,1998,332,212,120
'4617037000,  문평면,'30,25 - 29세,1998,237,163,74
'4617037000,  문평면,'35,30 - 34세,1998,161,89,72
'4617037000,  문평면,'40,35 - 39세,1998,219,138,81
'4617037000,  문평면,'45,40 - 44세,1998,211,121,90
'4617037000,  문평면,'50,45 - 49세,1998,158,80,78
'4617037000,  문평면,'55,50 - 54세,1998,204,96,108
'4617037000,  문평면,'60,55 - 59세,1998,358,151,207
'4617037000,  문평면,'65,60 - 64세,1998,346,141,205
'4617037000,  문평면,'70,65 - 69세,1998,258,91,167
'4617037000,  문평면,'75,70 - 74세,1998,169,66,103
'4617037000,  문평면,'80,75 - 79세,1998,144,54,90
'4617037000,  문평면,'85,80 - 84세,1998,63,18,45
'4617037000,  문평면,'90,85+ ,1998,34,5,29
'4617038000,  노안면,'00,계,1998,7107,3637,3470
'4617038000,  노안면,'05,0 - 4세,1998,299,148,151
'4617038000,  노안면,'10,5 - 9세,1998,275,141,134
'4617038000,  노안면,'15,10 - 14세,1998,302,165,137
'4617038000,  노안면,'20,15 - 19세,1998,607,322,285
'4617038000,  노안면,'25,20 - 24세,1998,615,357,258
'4617038000,  노안면,'30,25 - 29세,1998,560,386,174
'4617038000,  노안면,'35,30 - 34세,1998,401,245,156
'4617038000,  노안면,'40,35 - 39세,1998,430,268,162
'4617038000,  노안면,'45,40 - 44세,1998,418,227,191
'4617038000,  노안면,'50,45 - 49세,1998,386,205,181
'4617038000,  노안면,'55,50 - 54세,1998,410,184,226
'4617038000,  노안면,'60,55 - 59세,1998,577,251,326
'4617038000,  노안면,'65,60 - 64세,1998,595,250,345
'4617038000,  노안면,'70,65 - 69세,1998,434,172,262
'4617038000,  노안면,'75,70 - 74세,1998,355,167,188
'4617038000,  노안면,'80,75 - 79세,1998,231,80,151
'4617038000,  노안면,'85,80 - 84세,1998,129,54,75
'4617038000,  노안면,'90,85+ ,1998,83,15,68
'4617039000,  금천면,'00,계,1998,7772,3958,3814
'4617039000,  금천면,'05,0 - 4세,1998,419,211,208
'4617039000,  금천면,'10,5 - 9세,1998,387,201,186
'4617039000,  금천면,'15,10 - 14세,1998,410,217,193
'4617039000,  금천면,'20,15 - 19세,1998,738,352,386
'4617039000,  금천면,'25,20 - 24세,1998,791,455,336
'4617039000,  금천면,'30,25 - 29세,1998,581,367,214
'4617039000,  금천면,'35,30 - 34세,1998,440,269,171
'4617039000,  금천면,'40,35 - 39세,1998,484,295,189
'4617039000,  금천면,'45,40 - 44세,1998,464,256,208
'4617039000,  금천면,'50,45 - 49세,1998,406,209,197
'4617039000,  금천면,'55,50 - 54세,1998,474,247,227
'4617039000,  금천면,'60,55 - 59세,1998,567,244,323
'4617039000,  금천면,'65,60 - 64세,1998,489,214,275
'4617039000,  금천면,'70,65 - 69세,1998,430,172,258
'4617039000,  금천면,'75,70 - 74세,1998,315,124,191
'4617039000,  금천면,'80,75 - 79세,1998,214,82,132
'4617039000,  금천면,'85,80 - 84세,1998,99,36,63
'4617039000,  금천면,'90,85+ ,1998,64,7,57
'4617040000,  산포면,'00,계,1998,5669,2842,2827
'4617040000,  산포면,'05,0 - 4세,1998,265,132,133
'4617040000,  산포면,'10,5 - 9세,1998,231,125,106
'4617040000,  산포면,'15,10 - 14세,1998,285,135,150
'4617040000,  산포면,'20,15 - 19세,1998,460,223,237
'4617040000,  산포면,'25,20 - 24세,1998,581,333,248
'4617040000,  산포면,'30,25 - 29세,1998,474,298,176
'4617040000,  산포면,'35,30 - 34세,1998,322,189,133
'4617040000,  산포면,'40,35 - 39세,1998,363,223,140
'4617040000,  산포면,'45,40 - 44세,1998,313,168,145
'4617040000,  산포면,'50,45 - 49세,1998,288,146,142
'4617040000,  산포면,'55,50 - 54세,1998,346,169,177
'4617040000,  산포면,'60,55 - 59세,1998,442,194,248
'4617040000,  산포면,'65,60 - 64세,1998,436,174,262
'4617040000,  산포면,'70,65 - 69세,1998,327,126,201
'4617040000,  산포면,'75,70 - 74세,1998,230,107,123
'4617040000,  산포면,'80,75 - 79세,1998,169,64,105
'4617040000,  산포면,'85,80 - 84세,1998,86,23,63
'4617040000,  산포면,'90,85+ ,1998,51,13,38
'4617042000,  다도면,'00,계,1998,2806,1462,1344
'4617042000,  다도면,'05,0 - 4세,1998,75,43,32
'4617042000,  다도면,'10,5 - 9세,1998,57,28,29
'4617042000,  다도면,'15,10 - 14세,1998,108,61,47
'4617042000,  다도면,'20,15 - 19세,1998,219,116,103
'4617042000,  다도면,'25,20 - 24세,1998,304,198,106
'4617042000,  다도면,'30,25 - 29세,1998,207,155,52
'4617042000,  다도면,'35,30 - 34세,1998,129,84,45
'4617042000,  다도면,'40,35 - 39세,1998,119,78,41
'4617042000,  다도면,'45,40 - 44세,1998,145,82,63
'4617042000,  다도면,'50,45 - 49세,1998,143,67,76
'4617042000,  다도면,'55,50 - 54세,1998,199,91,108
'4617042000,  다도면,'60,55 - 59세,1998,270,126,144
'4617042000,  다도면,'65,60 - 64세,1998,303,133,170
'4617042000,  다도면,'70,65 - 69세,1998,187,72,115
'4617042000,  다도면,'75,70 - 74세,1998,130,55,75
'4617042000,  다도면,'80,75 - 79세,1998,102,35,67
'4617042000,  다도면,'85,80 - 84세,1998,71,31,40
'4617042000,  다도면,'90,85+ ,1998,38,7,31
'4617043000,  봉황면,'00,계,1998,7492,3804,3688
'4617043000,  봉황면,'05,0 - 4세,1998,302,145,157
'4617043000,  봉황면,'10,5 - 9세,1998,334,160,174
'4617043000,  봉황면,'15,10 - 14세,1998,377,179,198
'4617043000,  봉황면,'20,15 - 19세,1998,643,327,316
'4617043000,  봉황면,'25,20 - 24세,1998,721,436,285
'4617043000,  봉황면,'30,25 - 29세,1998,498,336,162
'4617043000,  봉황면,'35,30 - 34세,1998,388,247,141
'4617043000,  봉황면,'40,35 - 39세,1998,436,259,177
'4617043000,  봉황면,'45,40 - 44세,1998,378,211,167
'4617043000,  봉황면,'50,45 - 49세,1998,401,208,193
'4617043000,  봉황면,'55,50 - 54세,1998,475,241,234
'4617043000,  봉황면,'60,55 - 59세,1998,647,295,352
'4617043000,  봉황면,'65,60 - 64세,1998,647,289,358
'4617043000,  봉황면,'70,65 - 69세,1998,493,187,306
'4617043000,  봉황면,'75,70 - 74세,1998,312,139,173
'4617043000,  봉황면,'80,75 - 79세,1998,263,93,170
'4617043000,  봉황면,'85,80 - 84세,1998,113,39,74
'4617043000,  봉황면,'90,85+ ,1998,64,13,51
'4617051000,  송월동,'00,계,1998,5941,2983,2958
'4617051000,  송월동,'05,0 - 4세,1998,684,358,326
'4617051000,  송월동,'10,5 - 9세,1998,658,339,319
'4617051000,  송월동,'15,10 - 14세,1998,403,206,197
'4617051000,  송월동,'20,15 - 19세,1998,358,187,171
'4617051000,  송월동,'25,20 - 24세,1998,342,171,171
'4617051000,  송월동,'30,25 - 29세,1998,529,244,285
'4617051000,  송월동,'35,30 - 34세,1998,710,344,366
'4617051000,  송월동,'40,35 - 39세,1998,589,376,213
'4617051000,  송월동,'45,40 - 44세,1998,364,205,159
'4617051000,  송월동,'50,45 - 49세,1998,208,114,94
'4617051000,  송월동,'55,50 - 54세,1998,190,85,105
'4617051000,  송월동,'60,55 - 59세,1998,216,95,121
'4617051000,  송월동,'65,60 - 64세,1998,232,86,146
'4617051000,  송월동,'70,65 - 69세,1998,193,76,117
'4617051000,  송월동,'75,70 - 74세,1998,123,53,70
'4617051000,  송월동,'80,75 - 79세,1998,81,24,57
'4617051000,  송월동,'85,80 - 84세,1998,36,16,20
'4617051000,  송월동,'90,85+ ,1998,25,4,21
'4617052000,  영강동,'00,계,1998,3843,1847,1996
'4617052000,  영강동,'05,0 - 4세,1998,414,185,229
'4617052000,  영강동,'10,5 - 9세,1998,298,148,150
'4617052000,  영강동,'15,10 - 14세,1998,212,97,115
'4617052000,  영강동,'20,15 - 19세,1998,291,145,146
'4617052000,  영강동,'25,20 - 24세,1998,314,159,155
'4617052000,  영강동,'30,25 - 29세,1998,420,202,218
'4617052000,  영강동,'35,30 - 34세,1998,358,197,161
'4617052000,  영강동,'40,35 - 39세,1998,321,184,137
'4617052000,  영강동,'45,40 - 44세,1998,220,119,101
'4617052000,  영강동,'50,45 - 49세,1998,144,76,68
'4617052000,  영강동,'55,50 - 54세,1998,139,67,72
'4617052000,  영강동,'60,55 - 59세,1998,195,80,115
'4617052000,  영강동,'65,60 - 64세,1998,185,79,106
'4617052000,  영강동,'70,65 - 69세,1998,141,49,92
'4617052000,  영강동,'75,70 - 74세,1998,95,33,62
'4617052000,  영강동,'80,75 - 79세,1998,54,18,36
'4617052000,  영강동,'85,80 - 84세,1998,26,7,19
'4617052000,  영강동,'90,85+ ,1998,16,2,14
'4617054000,  금남동,'00,계,1998,9707,4722,4985
'4617054000,  금남동,'05,0 - 4세,1998,704,369,335
'4617054000,  금남동,'10,5 - 9세,1998,674,365,309
'4617054000,  금남동,'15,10 - 14세,1998,624,295,329
'4617054000,  금남동,'20,15 - 19세,1998,859,429,430
'4617054000,  금남동,'25,20 - 24세,1998,900,459,441
'4617054000,  금남동,'30,25 - 29세,1998,872,442,430
'4617054000,  금남동,'35,30 - 34세,1998,762,375,387
'4617054000,  금남동,'40,35 - 39세,1998,767,418,349
'4617054000,  금남동,'45,40 - 44세,1998,595,310,285
'4617054000,  금남동,'50,45 - 49세,1998,496,242,254
'4617054000,  금남동,'55,50 - 54세,1998,504,240,264
'4617054000,  금남동,'60,55 - 59세,1998,548,258,290
'4617054000,  금남동,'65,60 - 64세,1998,451,183,268
'4617054000,  금남동,'70,65 - 69세,1998,348,148,200
'4617054000,  금남동,'75,70 - 74세,1998,269,98,171
'4617054000,  금남동,'80,75 - 79세,1998,185,54,131
'4617054000,  금남동,'85,80 - 84세,1998,93,25,68
'4617054000,  금남동,'90,85+ ,1998,56,12,44
'4617055000,  성북동,'00,계,1998,8681,4289,4392
'4617055000,  성북동,'05,0 - 4세,1998,753,397,356
'4617055000,  성북동,'10,5 - 9세,1998,702,369,333
'4617055000,  성북동,'15,10 - 14세,1998,557,277,280
'4617055000,  성북동,'20,15 - 19세,1998,655,330,325
'4617055000,  성북동,'25,20 - 24세,1998,779,385,394
'4617055000,  성북동,'30,25 - 29세,1998,863,454,409
'4617055000,  성북동,'35,30 - 34세,1998,819,404,415
'4617055000,  성북동,'40,35 - 39세,1998,752,382,370
'4617055000,  성북동,'45,40 - 44세,1998,606,344,262
'4617055000,  성북동,'50,45 - 49세,1998,416,220,196
'4617055000,  성북동,'55,50 - 54세,1998,377,190,187
'4617055000,  성북동,'60,55 - 59세,1998,380,167,213
'4617055000,  성북동,'65,60 - 64세,1998,301,129,172
'4617055000,  성북동,'70,65 - 69세,1998,270,90,180
'4617055000,  성북동,'75,70 - 74세,1998,223,79,144
'4617055000,  성북동,'80,75 - 79세,1998,114,44,70
'4617055000,  성북동,'85,80 - 84세,1998,66,20,46
'4617055000,  성북동,'90,85+ ,1998,48,8,40
'4617058000,  영산동,'00,계,1998,5348,2611,2737
'4617058000,  영산동,'05,0 - 4세,1998,261,130,131
'4617058000,  영산동,'10,5 - 9세,1998,333,166,167
'4617058000,  영산동,'15,10 - 14세,1998,327,166,161
'4617058000,  영산동,'20,15 - 19세,1998,524,258,266
'4617058000,  영산동,'25,20 - 24세,1998,524,305,219
'4617058000,  영산동,'30,25 - 29세,1998,379,217,162
'4617058000,  영산동,'35,30 - 34세,1998,308,164,144
'4617058000,  영산동,'40,35 - 39세,1998,363,191,172
'4617058000,  영산동,'45,40 - 44세,1998,304,150,154
'4617058000,  영산동,'50,45 - 49세,1998,306,167,139
'4617058000,  영산동,'55,50 - 54세,1998,313,151,162
'4617058000,  영산동,'60,55 - 59세,1998,366,141,225
'4617058000,  영산동,'65,60 - 64세,1998,352,164,188
'4617058000,  영산동,'70,65 - 69세,1998,254,82,172
'4617058000,  영산동,'75,70 - 74세,1998,209,78,131
'4617058000,  영산동,'80,75 - 79세,1998,117,49,68
'4617058000,  영산동,'85,80 - 84세,1998,62,23,39
'4617058000,  영산동,'90,85+ ,1998,46,9,37
'4617060000,  이창동,'00,계,1998,5781,2872,2909
'4617060000,  이창동,'05,0 - 4세,1998,299,157,142
'4617060000,  이창동,'10,5 - 9세,1998,326,170,156
'4617060000,  이창동,'15,10 - 14세,1998,372,199,173
'4617060000,  이창동,'20,15 - 19세,1998,581,286,295
'4617060000,  이창동,'25,20 - 24세,1998,605,336,269
'4617060000,  이창동,'30,25 - 29세,1998,442,261,181
'4617060000,  이창동,'35,30 - 34세,1998,340,184,156
'4617060000,  이창동,'40,35 - 39세,1998,381,199,182
'4617060000,  이창동,'45,40 - 44세,1998,427,237,190
'4617060000,  이창동,'50,45 - 49세,1998,342,170,172
'4617060000,  이창동,'55,50 - 54세,1998,339,169,170
'4617060000,  이창동,'60,55 - 59세,1998,339,143,196
'4617060000,  이창동,'65,60 - 64세,1998,314,124,190
'4617060000,  이창동,'70,65 - 69세,1998,279,100,179
'4617060000,  이창동,'75,70 - 74세,1998,194,75,119
'4617060000,  이창동,'80,75 - 79세,1998,119,40,79
'4617060000,  이창동,'85,80 - 84세,1998,43,14,29
'4617060000,  이창동,'90,85+ ,1998,39,8,31
'46230, 광양시,'00,계,1998,136728,69902,66826
'46230, 광양시,'05,0 - 4세,1998,14351,7597,6754
'46230, 광양시,'10,5 - 9세,1998,12677,6685,5992
'46230, 광양시,'15,10 - 14세,1998,9759,5007,4752
'46230, 광양시,'20,15 - 19세,1998,10953,5594,5359
'46230, 광양시,'25,20 - 24세,1998,9633,4940,4693
'46230, 광양시,'30,25 - 29세,1998,13513,6547,6966
'46230, 광양시,'35,30 - 34세,1998,15997,8851,7146
'46230, 광양시,'40,35 - 39세,1998,12995,6948,6047
'46230, 광양시,'45,40 - 44세,1998,9441,5178,4263
'46230, 광양시,'50,45 - 49세,1998,5950,3360,2590
'46230, 광양시,'55,50 - 54세,1998,4304,2241,2063
'46230, 광양시,'60,55 - 59세,1998,4453,2019,2434
'46230, 광양시,'65,60 - 64세,1998,4216,1877,2339
'46230, 광양시,'70,65 - 69세,1998,3246,1285,1961
'46230, 광양시,'75,70 - 74세,1998,2229,871,1358
'46230, 광양시,'80,75 - 79세,1998,1579,561,1018
'46230, 광양시,'85,80 - 84세,1998,830,236,594
'46230, 광양시,'90,85+ ,1998,602,105,497
'4623025000,  광양읍,'00,계,1998,40214,20153,20061
'4623025000,  광양읍,'05,0 - 4세,1998,3324,1733,1591
'4623025000,  광양읍,'10,5 - 9세,1998,3539,1827,1712
'4623025000,  광양읍,'15,10 - 14세,1998,3138,1626,1512
'4623025000,  광양읍,'20,15 - 19세,1998,3676,1852,1824
'4623025000,  광양읍,'25,20 - 24세,1998,3350,1693,1657
'4623025000,  광양읍,'30,25 - 29세,1998,3620,1900,1720
'4623025000,  광양읍,'35,30 - 34세,1998,3708,1870,1838
'4623025000,  광양읍,'40,35 - 39세,1998,3951,2076,1875
'4623025000,  광양읍,'45,40 - 44세,1998,2925,1545,1380
'4623025000,  광양읍,'50,45 - 49세,1998,1928,1025,903
'4623025000,  광양읍,'55,50 - 54세,1998,1529,806,723
'4623025000,  광양읍,'60,55 - 59세,1998,1504,685,819
'4623025000,  광양읍,'65,60 - 64세,1998,1376,601,775
'4623025000,  광양읍,'70,65 - 69세,1998,985,382,603
'4623025000,  광양읍,'75,70 - 74세,1998,699,267,432
'4623025000,  광양읍,'80,75 - 79세,1998,482,169,313
'4623025000,  광양읍,'85,80 - 84세,1998,270,61,209
'4623025000,  광양읍,'90,85+ ,1998,210,35,175
'4623031000,  봉강면,'00,계,1998,3006,1519,1487
'4623031000,  봉강면,'05,0 - 4세,1998,129,74,55
'4623031000,  봉강면,'10,5 - 9세,1998,131,59,72
'4623031000,  봉강면,'15,10 - 14세,1998,154,69,85
'4623031000,  봉강면,'20,15 - 19세,1998,230,122,108
'4623031000,  봉강면,'25,20 - 24세,1998,377,202,175
'4623031000,  봉강면,'30,25 - 29세,1998,255,171,84
'4623031000,  봉강면,'35,30 - 34세,1998,174,111,63
'4623031000,  봉강면,'40,35 - 39세,1998,184,120,64
'4623031000,  봉강면,'45,40 - 44세,1998,149,82,67
'4623031000,  봉강면,'50,45 - 49세,1998,141,71,70
'4623031000,  봉강면,'55,50 - 54세,1998,169,67,102
'4623031000,  봉강면,'60,55 - 59세,1998,208,89,119
'4623031000,  봉강면,'65,60 - 64세,1998,236,109,127
'4623031000,  봉강면,'70,65 - 69세,1998,179,77,102
'4623031000,  봉강면,'75,70 - 74세,1998,118,50,68
'4623031000,  봉강면,'80,75 - 79세,1998,79,24,55
'4623031000,  봉강면,'85,80 - 84세,1998,54,19,35
'4623031000,  봉강면,'90,85+ ,1998,39,3,36
'4623032000,  옥룡면,'00,계,1998,4097,2108,1989
'4623032000,  옥룡면,'05,0 - 4세,1998,171,85,86
'4623032000,  옥룡면,'10,5 - 9세,1998,132,74,58
'4623032000,  옥룡면,'15,10 - 14세,1998,131,64,67
'4623032000,  옥룡면,'20,15 - 19세,1998,321,153,168
'4623032000,  옥룡면,'25,20 - 24세,1998,477,276,201
'4623032000,  옥룡면,'30,25 - 29세,1998,365,261,104
'4623032000,  옥룡면,'35,30 - 34세,1998,240,172,68
'4623032000,  옥룡면,'40,35 - 39세,1998,200,125,75
'4623032000,  옥룡면,'45,40 - 44세,1998,179,102,77
'4623032000,  옥룡면,'50,45 - 49세,1998,174,73,101
'4623032000,  옥룡면,'55,50 - 54세,1998,262,109,153
'4623032000,  옥룡면,'60,55 - 59세,1998,350,158,192
'4623032000,  옥룡면,'65,60 - 64세,1998,389,171,218
'4623032000,  옥룡면,'70,65 - 69세,1998,277,126,151
'4623032000,  옥룡면,'75,70 - 74세,1998,193,72,121
'4623032000,  옥룡면,'80,75 - 79세,1998,122,57,65
'4623032000,  옥룡면,'85,80 - 84세,1998,60,20,40
'4623032000,  옥룡면,'90,85+ ,1998,54,10,44
'4623033000,  옥곡면,'00,계,1998,5530,2787,2743
'4623033000,  옥곡면,'05,0 - 4세,1998,336,170,166
'4623033000,  옥곡면,'10,5 - 9세,1998,307,163,144
'4623033000,  옥곡면,'15,10 - 14세,1998,358,173,185
'4623033000,  옥곡면,'20,15 - 19세,1998,519,266,253
'4623033000,  옥곡면,'25,20 - 24세,1998,554,308,246
'4623033000,  옥곡면,'30,25 - 29세,1998,484,291,193
'4623033000,  옥곡면,'35,30 - 34세,1998,376,214,162
'4623033000,  옥곡면,'40,35 - 39세,1998,376,206,170
'4623033000,  옥곡면,'45,40 - 44세,1998,320,172,148
'4623033000,  옥곡면,'50,45 - 49세,1998,293,147,146
'4623033000,  옥곡면,'55,50 - 54세,1998,267,128,139
'4623033000,  옥곡면,'60,55 - 59세,1998,338,145,193
'4623033000,  옥곡면,'65,60 - 64세,1998,352,152,200
'4623033000,  옥곡면,'70,65 - 69세,1998,244,99,145
'4623033000,  옥곡면,'75,70 - 74세,1998,165,74,91
'4623033000,  옥곡면,'80,75 - 79세,1998,122,54,68
'4623033000,  옥곡면,'85,80 - 84세,1998,65,19,46
'4623033000,  옥곡면,'90,85+ ,1998,54,6,48
'4623034000,  진상면,'00,계,1998,4741,2388,2353
'4623034000,  진상면,'05,0 - 4세,1998,201,115,86
'4623034000,  진상면,'10,5 - 9세,1998,179,95,84
'4623034000,  진상면,'15,10 - 14세,1998,243,129,114
'4623034000,  진상면,'20,15 - 19세,1998,479,244,235
'4623034000,  진상면,'25,20 - 24세,1998,492,263,229
'4623034000,  진상면,'30,25 - 29세,1998,384,248,136
'4623034000,  진상면,'35,30 - 34세,1998,282,186,96
'4623034000,  진상면,'40,35 - 39세,1998,233,107,126
'4623034000,  진상면,'45,40 - 44세,1998,262,146,116
'4623034000,  진상면,'50,45 - 49세,1998,252,118,134
'4623034000,  진상면,'55,50 - 54세,1998,268,135,133
'4623034000,  진상면,'60,55 - 59세,1998,380,162,218
'4623034000,  진상면,'65,60 - 64세,1998,356,173,183
'4623034000,  진상면,'70,65 - 69세,1998,282,113,169
'4623034000,  진상면,'75,70 - 74세,1998,195,73,122
'4623034000,  진상면,'80,75 - 79세,1998,130,49,81
'4623034000,  진상면,'85,80 - 84세,1998,75,25,50
'4623034000,  진상면,'90,85+ ,1998,48,7,41
'4623035000,  진월면,'00,계,1998,5324,2689,2635
'4623035000,  진월면,'05,0 - 4세,1998,214,113,101
'4623035000,  진월면,'10,5 - 9세,1998,194,116,78
'4623035000,  진월면,'15,10 - 14세,1998,263,138,125
'4623035000,  진월면,'20,15 - 19세,1998,570,271,299
'4623035000,  진월면,'25,20 - 24세,1998,573,329,244
'4623035000,  진월면,'30,25 - 29세,1998,418,279,139
'4623035000,  진월면,'35,30 - 34세,1998,263,171,92
'4623035000,  진월면,'40,35 - 39세,1998,305,154,151
'4623035000,  진월면,'45,40 - 44세,1998,292,142,150
'4623035000,  진월면,'50,45 - 49세,1998,311,141,170
'4623035000,  진월면,'55,50 - 54세,1998,317,162,155
'4623035000,  진월면,'60,55 - 59세,1998,396,172,224
'4623035000,  진월면,'65,60 - 64세,1998,367,168,199
'4623035000,  진월면,'70,65 - 69세,1998,309,126,183
'4623035000,  진월면,'75,70 - 74세,1998,259,111,148
'4623035000,  진월면,'80,75 - 79세,1998,161,61,100
'4623035000,  진월면,'85,80 - 84세,1998,68,20,48
'4623035000,  진월면,'90,85+ ,1998,44,15,29
'4623036000,  다압면,'00,계,1998,2443,1260,1183
'4623036000,  다압면,'05,0 - 4세,1998,94,50,44
'4623036000,  다압면,'10,5 - 9세,1998,80,41,39
'4623036000,  다압면,'15,10 - 14세,1998,89,44,45
'4623036000,  다압면,'20,15 - 19세,1998,232,128,104
'4623036000,  다압면,'25,20 - 24세,1998,302,180,122
'4623036000,  다압면,'30,25 - 29세,1998,179,134,45
'4623036000,  다압면,'35,30 - 34세,1998,125,90,35
'4623036000,  다압면,'40,35 - 39세,1998,121,72,49
'4623036000,  다압면,'45,40 - 44세,1998,127,65,62
'4623036000,  다압면,'50,45 - 49세,1998,124,58,66
'4623036000,  다압면,'55,50 - 54세,1998,140,58,82
'4623036000,  다압면,'60,55 - 59세,1998,214,81,133
'4623036000,  다압면,'65,60 - 64세,1998,223,103,120
'4623036000,  다압면,'70,65 - 69세,1998,163,69,94
'4623036000,  다압면,'75,70 - 74세,1998,98,43,55
'4623036000,  다압면,'80,75 - 79세,1998,70,23,47
'4623036000,  다압면,'85,80 - 84세,1998,42,16,26
'4623036000,  다압면,'90,85+ ,1998,20,5,15
'4623051500,  골약동,'00,계,1998,3615,1885,1730
'4623051500,  골약동,'05,0 - 4세,1998,188,104,84
'4623051500,  골약동,'10,5 - 9세,1998,156,79,77
'4623051500,  골약동,'15,10 - 14세,1998,177,97,80
'4623051500,  골약동,'20,15 - 19세,1998,341,184,157
'4623051500,  골약동,'25,20 - 24세,1998,370,199,171
'4623051500,  골약동,'30,25 - 29세,1998,305,209,96
'4623051500,  골약동,'35,30 - 34세,1998,230,150,80
'4623051500,  골약동,'40,35 - 39세,1998,238,130,108
'4623051500,  골약동,'45,40 - 44세,1998,199,109,90
'4623051500,  골약동,'50,45 - 49세,1998,202,100,102
'4623051500,  골약동,'55,50 - 54세,1998,216,107,109
'4623051500,  골약동,'60,55 - 59세,1998,251,113,138
'4623051500,  골약동,'65,60 - 64세,1998,229,113,116
'4623051500,  골약동,'70,65 - 69세,1998,219,92,127
'4623051500,  골약동,'75,70 - 74세,1998,111,48,63
'4623051500,  골약동,'80,75 - 79세,1998,101,34,67
'4623051500,  골약동,'85,80 - 84세,1998,50,12,38
'4623051500,  골약동,'90,85+ ,1998,32,5,27
'4623053000,  중마동,'00,계,1998,25495,13063,12432
'4623053000,  중마동,'05,0 - 4세,1998,4631,2486,2145
'4623053000,  중마동,'10,5 - 9세,1998,3068,1561,1507
'4623053000,  중마동,'15,10 - 14세,1998,1436,711,725
'4623053000,  중마동,'20,15 - 19세,1998,1072,541,531
'4623053000,  중마동,'25,20 - 24세,1998,1075,445,630
'4623053000,  중마동,'30,25 - 29세,1998,3556,1320,2236
'4623053000,  중마동,'35,30 - 34세,1998,4800,2764,2036
'4623053000,  중마동,'40,35 - 39세,1998,2565,1513,1052
'4623053000,  중마동,'45,40 - 44세,1998,1198,731,467
'4623053000,  중마동,'50,45 - 49세,1998,594,343,251
'4623053000,  중마동,'55,50 - 54세,1998,351,188,163
'4623053000,  중마동,'60,55 - 59세,1998,307,148,159
'4623053000,  중마동,'65,60 - 64세,1998,278,126,152
'4623053000,  중마동,'70,65 - 69세,1998,237,88,149
'4623053000,  중마동,'75,70 - 74세,1998,126,43,83
'4623053000,  중마동,'80,75 - 79세,1998,110,33,77
'4623053000,  중마동,'85,80 - 84세,1998,53,14,39
'4623053000,  중마동,'90,85+ ,1998,38,8,30
'4623054000,  광영동,'00,계,1998,17385,8993,8392
'4623054000,  광영동,'05,0 - 4세,1998,2312,1223,1089
'4623054000,  광영동,'10,5 - 9세,1998,2037,1124,913
'4623054000,  광영동,'15,10 - 14세,1998,1319,659,660
'4623054000,  광영동,'20,15 - 19세,1998,1197,624,573
'4623054000,  광영동,'25,20 - 24세,1998,936,418,518
'4623054000,  광영동,'30,25 - 29세,1998,1973,906,1067
'4623054000,  광영동,'35,30 - 34세,1998,2575,1329,1246
'4623054000,  광영동,'40,35 - 39세,1998,2026,1115,911
'4623054000,  광영동,'45,40 - 44세,1998,1182,652,530
'4623054000,  광영동,'50,45 - 49세,1998,608,396,212
'4623054000,  광영동,'55,50 - 54세,1998,337,173,164
'4623054000,  광영동,'60,55 - 59세,1998,291,156,135
'4623054000,  광영동,'65,60 - 64세,1998,203,88,115
'4623054000,  광영동,'70,65 - 69세,1998,164,52,112
'4623054000,  광영동,'75,70 - 74세,1998,98,40,58
'4623054000,  광영동,'80,75 - 79세,1998,84,28,56
'4623054000,  광영동,'85,80 - 84세,1998,21,5,16
'4623054000,  광영동,'90,85+ ,1998,22,5,17
'4623055000,  금호동,'00,계,1998,20729,10907,9822
'4623055000,  금호동,'05,0 - 4세,1998,2434,1280,1154
'4623055000,  금호동,'10,5 - 9세,1998,2522,1381,1141
'4623055000,  금호동,'15,10 - 14세,1998,2171,1165,1006
'4623055000,  금호동,'20,15 - 19세,1998,1925,1014,911
'4623055000,  금호동,'25,20 - 24세,1998,737,393,344
'4623055000,  금호동,'30,25 - 29세,1998,1614,613,1001
'4623055000,  금호동,'35,30 - 34세,1998,2842,1586,1256
'4623055000,  금호동,'40,35 - 39세,1998,2388,1105,1283
'4623055000,  금호동,'45,40 - 44세,1998,2343,1286,1057
'4623055000,  금호동,'50,45 - 49세,1998,1110,769,341
'4623055000,  금호동,'55,50 - 54세,1998,285,215,70
'4623055000,  금호동,'60,55 - 59세,1998,58,42,16
'4623055000,  금호동,'65,60 - 64세,1998,35,7,28
'4623055000,  금호동,'70,65 - 69세,1998,50,7,43
'4623055000,  금호동,'75,70 - 74세,1998,96,17,79
'4623055000,  금호동,'80,75 - 79세,1998,59,11,48
'4623055000,  금호동,'85,80 - 84세,1998,44,14,30
'4623055000,  금호동,'90,85+ ,1998,16,2,14
'4623057000,  태인동,'00,계,1998,4149,2150,1999
'4623057000,  태인동,'05,0 - 4세,1998,317,164,153
'4623057000,  태인동,'10,5 - 9세,1998,332,165,167
'4623057000,  태인동,'15,10 - 14세,1998,280,132,148
'4623057000,  태인동,'20,15 - 19세,1998,391,195,196
'4623057000,  태인동,'25,20 - 24세,1998,390,234,156
'4623057000,  태인동,'30,25 - 29세,1998,360,215,145
'4623057000,  태인동,'35,30 - 34세,1998,382,208,174
'4623057000,  태인동,'40,35 - 39세,1998,408,225,183
'4623057000,  태인동,'45,40 - 44세,1998,265,146,119
'4623057000,  태인동,'50,45 - 49세,1998,213,119,94
'4623057000,  태인동,'55,50 - 54세,1998,163,93,70
'4623057000,  태인동,'60,55 - 59세,1998,156,68,88
'4623057000,  태인동,'65,60 - 64세,1998,172,66,106
'4623057000,  태인동,'70,65 - 69세,1998,137,54,83
'4623057000,  태인동,'75,70 - 74세,1998,71,33,38
'4623057000,  태인동,'80,75 - 79세,1998,59,18,41
'4623057000,  태인동,'85,80 - 84세,1998,28,11,17
'4623057000,  태인동,'90,85+ ,1998,25,4,21
'46710, 담양군,'00,계,1998,57797,29160,28637
'46710, 담양군,'05,0 - 4세,1998,2946,1543,1403
'46710, 담양군,'10,5 - 9세,1998,2616,1345,1271
'46710, 담양군,'15,10 - 14세,1998,2905,1471,1434
'46710, 담양군,'20,15 - 19세,1998,5041,2512,2529
'46710, 담양군,'25,20 - 24세,1998,6038,3393,2645
'46710, 담양군,'30,25 - 29세,1998,4973,3145,1828
'46710, 담양군,'35,30 - 34세,1998,3390,1940,1450
'46710, 담양군,'40,35 - 39세,1998,3626,2023,1603
'46710, 담양군,'45,40 - 44세,1998,3210,1698,1512
'46710, 담양군,'50,45 - 49세,1998,2998,1467,1531
'46710, 담양군,'55,50 - 54세,1998,3326,1590,1736
'46710, 담양군,'60,55 - 59세,1998,4526,2034,2492
'46710, 담양군,'65,60 - 64세,1998,4026,1762,2264
'46710, 담양군,'70,65 - 69세,1998,2910,1244,1666
'46710, 담양군,'75,70 - 74세,1998,2133,927,1206
'46710, 담양군,'80,75 - 79세,1998,1643,619,1024
'46710, 담양군,'85,80 - 84세,1998,893,315,578
'46710, 담양군,'90,85+ ,1998,597,132,465
'4671025000,  담양읍,'00,계,1998,16683,8430,8253
'4671025000,  담양읍,'05,0 - 4세,1998,1132,598,534
'4671025000,  담양읍,'10,5 - 9세,1998,1018,518,500
'4671025000,  담양읍,'15,10 - 14세,1998,1015,523,492
'4671025000,  담양읍,'20,15 - 19세,1998,1470,736,734
'4671025000,  담양읍,'25,20 - 24세,1998,1711,937,774
'4671025000,  담양읍,'30,25 - 29세,1998,1556,894,662
'4671025000,  담양읍,'35,30 - 34세,1998,1212,626,586
'4671025000,  담양읍,'40,35 - 39세,1998,1236,680,556
'4671025000,  담양읍,'45,40 - 44세,1998,1014,530,484
'4671025000,  담양읍,'50,45 - 49세,1998,865,407,458
'4671025000,  담양읍,'55,50 - 54세,1998,915,462,453
'4671025000,  담양읍,'60,55 - 59세,1998,1078,486,592
'4671025000,  담양읍,'65,60 - 64세,1998,858,406,452
'4671025000,  담양읍,'70,65 - 69세,1998,602,260,342
'4671025000,  담양읍,'75,70 - 74세,1998,410,166,244
'4671025000,  담양읍,'80,75 - 79세,1998,318,125,193
'4671025000,  담양읍,'85,80 - 84세,1998,170,51,119
'4671025000,  담양읍,'90,85+ ,1998,103,25,78
'4671031000,  봉산면,'00,계,1998,3908,1954,1954
'4671031000,  봉산면,'05,0 - 4세,1998,154,82,72
'4671031000,  봉산면,'10,5 - 9세,1998,136,66,70
'4671031000,  봉산면,'15,10 - 14세,1998,187,90,97
'4671031000,  봉산면,'20,15 - 19세,1998,388,182,206
'4671031000,  봉산면,'25,20 - 24세,1998,407,232,175
'4671031000,  봉산면,'30,25 - 29세,1998,301,206,95
'4671031000,  봉산면,'35,30 - 34세,1998,193,119,74
'4671031000,  봉산면,'40,35 - 39세,1998,246,143,103
'4671031000,  봉산면,'45,40 - 44세,1998,222,116,106
'4671031000,  봉산면,'50,45 - 49세,1998,207,103,104
'4671031000,  봉산면,'55,50 - 54세,1998,230,102,128
'4671031000,  봉산면,'60,55 - 59세,1998,338,163,175
'4671031000,  봉산면,'65,60 - 64세,1998,298,117,181
'4671031000,  봉산면,'70,65 - 69세,1998,211,88,123
'4671031000,  봉산면,'75,70 - 74세,1998,171,70,101
'4671031000,  봉산면,'80,75 - 79세,1998,113,43,70
'4671031000,  봉산면,'85,80 - 84세,1998,56,23,33
'4671031000,  봉산면,'90,85+ ,1998,50,9,41
'4671032000,  고서면,'00,계,1998,4436,2251,2185
'4671032000,  고서면,'05,0 - 4세,1998,237,127,110
'4671032000,  고서면,'10,5 - 9세,1998,178,106,72
'4671032000,  고서면,'15,10 - 14세,1998,216,109,107
'4671032000,  고서면,'20,15 - 19세,1998,381,190,191
'4671032000,  고서면,'25,20 - 24세,1998,475,250,225
'4671032000,  고서면,'30,25 - 29세,1998,411,264,147
'4671032000,  고서면,'35,30 - 34세,1998,279,170,109
'4671032000,  고서면,'40,35 - 39세,1998,257,131,126
'4671032000,  고서면,'45,40 - 44세,1998,256,136,120
'4671032000,  고서면,'50,45 - 49세,1998,213,120,93
'4671032000,  고서면,'55,50 - 54세,1998,266,112,154
'4671032000,  고서면,'60,55 - 59세,1998,350,168,182
'4671032000,  고서면,'65,60 - 64세,1998,287,106,181
'4671032000,  고서면,'70,65 - 69세,1998,232,97,135
'4671032000,  고서면,'75,70 - 74세,1998,165,74,91
'4671032000,  고서면,'80,75 - 79세,1998,117,55,62
'4671032000,  고서면,'85,80 - 84세,1998,80,29,51
'4671032000,  고서면,'90,85+ ,1998,36,7,29
'4671033000,  남면,'00,계,1998,1754,925,829
'4671033000,  남면,'05,0 - 4세,1998,66,44,22
'4671033000,  남면,'10,5 - 9세,1998,63,38,25
'4671033000,  남면,'15,10 - 14세,1998,76,37,39
'4671033000,  남면,'20,15 - 19세,1998,141,80,61
'4671033000,  남면,'25,20 - 24세,1998,191,123,68
'4671033000,  남면,'30,25 - 29세,1998,143,93,50
'4671033000,  남면,'35,30 - 34세,1998,101,60,41
'4671033000,  남면,'40,35 - 39세,1998,90,51,39
'4671033000,  남면,'45,40 - 44세,1998,95,55,40
'4671033000,  남면,'50,45 - 49세,1998,93,48,45
'4671033000,  남면,'55,50 - 54세,1998,89,43,46
'4671033000,  남면,'60,55 - 59세,1998,164,69,95
'4671033000,  남면,'65,60 - 64세,1998,130,57,73
'4671033000,  남면,'70,65 - 69세,1998,118,57,61
'4671033000,  남면,'75,70 - 74세,1998,72,34,38
'4671033000,  남면,'80,75 - 79세,1998,59,19,40
'4671033000,  남면,'85,80 - 84세,1998,33,12,21
'4671033000,  남면,'90,85+ ,1998,30,5,25
'4671034000,  창평면,'00,계,1998,5012,2520,2492
'4671034000,  창평면,'05,0 - 4세,1998,260,130,130
'4671034000,  창평면,'10,5 - 9세,1998,191,93,98
'4671034000,  창평면,'15,10 - 14세,1998,229,111,118
'4671034000,  창평면,'20,15 - 19세,1998,407,214,193
'4671034000,  창평면,'25,20 - 24세,1998,515,291,224
'4671034000,  창평면,'30,25 - 29세,1998,440,288,152
'4671034000,  창평면,'35,30 - 34세,1998,296,162,134
'4671034000,  창평면,'40,35 - 39세,1998,296,176,120
'4671034000,  창평면,'45,40 - 44세,1998,268,134,134
'4671034000,  창평면,'50,45 - 49세,1998,262,132,130
'4671034000,  창평면,'55,50 - 54세,1998,285,123,162
'4671034000,  창평면,'60,55 - 59세,1998,403,185,218
'4671034000,  창평면,'65,60 - 64세,1998,390,172,218
'4671034000,  창평면,'70,65 - 69세,1998,307,137,170
'4671034000,  창평면,'75,70 - 74세,1998,190,85,105
'4671034000,  창평면,'80,75 - 79세,1998,139,45,94
'4671034000,  창평면,'85,80 - 84세,1998,79,29,50
'4671034000,  창평면,'90,85+ ,1998,55,13,42
'4671035000,  대덕면,'00,계,1998,2416,1216,1200
'4671035000,  대덕면,'05,0 - 4세,1998,103,56,47
'4671035000,  대덕면,'10,5 - 9세,1998,96,46,50
'4671035000,  대덕면,'15,10 - 14세,1998,101,51,50
'4671035000,  대덕면,'20,15 - 19세,1998,168,78,90
'4671035000,  대덕면,'25,20 - 24세,1998,240,138,102
'4671035000,  대덕면,'30,25 - 29세,1998,187,126,61
'4671035000,  대덕면,'35,30 - 34세,1998,141,95,46
'4671035000,  대덕면,'40,35 - 39세,1998,113,63,50
'4671035000,  대덕면,'45,40 - 44세,1998,117,66,51
'4671035000,  대덕면,'50,45 - 49세,1998,107,51,56
'4671035000,  대덕면,'55,50 - 54세,1998,133,54,79
'4671035000,  대덕면,'60,55 - 59세,1998,242,115,127
'4671035000,  대덕면,'65,60 - 64세,1998,209,87,122
'4671035000,  대덕면,'70,65 - 69세,1998,155,66,89
'4671035000,  대덕면,'75,70 - 74세,1998,142,70,72
'4671035000,  대덕면,'80,75 - 79세,1998,88,34,54
'4671035000,  대덕면,'85,80 - 84세,1998,43,17,26
'4671035000,  대덕면,'90,85+ ,1998,31,3,28
'4671036000,  무정면,'00,계,1998,3835,1878,1957
'4671036000,  무정면,'05,0 - 4세,1998,162,71,91
'4671036000,  무정면,'10,5 - 9세,1998,149,71,78
'4671036000,  무정면,'15,10 - 14세,1998,169,79,90
'4671036000,  무정면,'20,15 - 19세,1998,366,172,194
'4671036000,  무정면,'25,20 - 24세,1998,388,213,175
'4671036000,  무정면,'30,25 - 29세,1998,284,196,88
'4671036000,  무정면,'35,30 - 34세,1998,165,99,66
'4671036000,  무정면,'40,35 - 39세,1998,218,121,97
'4671036000,  무정면,'45,40 - 44세,1998,193,104,89
'4671036000,  무정면,'50,45 - 49세,1998,211,92,119
'4671036000,  무정면,'55,50 - 54세,1998,218,107,111
'4671036000,  무정면,'60,55 - 59세,1998,318,150,168
'4671036000,  무정면,'65,60 - 64세,1998,304,126,178
'4671036000,  무정면,'70,65 - 69세,1998,234,96,138
'4671036000,  무정면,'75,70 - 74세,1998,164,69,95
'4671036000,  무정면,'80,75 - 79세,1998,156,70,86
'4671036000,  무정면,'85,80 - 84세,1998,88,31,57
'4671036000,  무정면,'90,85+ ,1998,48,11,37
'4671037000,  금성면,'00,계,1998,3626,1822,1804
'4671037000,  금성면,'05,0 - 4세,1998,134,68,66
'4671037000,  금성면,'10,5 - 9세,1998,134,58,76
'4671037000,  금성면,'15,10 - 14세,1998,167,80,87
'4671037000,  금성면,'20,15 - 19세,1998,348,173,175
'4671037000,  금성면,'25,20 - 24세,1998,377,224,153
'4671037000,  금성면,'30,25 - 29세,1998,285,189,96
'4671037000,  금성면,'35,30 - 34세,1998,157,102,55
'4671037000,  금성면,'40,35 - 39세,1998,218,124,94
'4671037000,  금성면,'45,40 - 44세,1998,213,97,116
'4671037000,  금성면,'50,45 - 49세,1998,192,103,89
'4671037000,  금성면,'55,50 - 54세,1998,206,98,108
'4671037000,  금성면,'60,55 - 59세,1998,291,128,163
'4671037000,  금성면,'65,60 - 64세,1998,294,131,163
'4671037000,  금성면,'70,65 - 69세,1998,192,87,105
'4671037000,  금성면,'75,70 - 74세,1998,152,78,74
'4671037000,  금성면,'80,75 - 79세,1998,134,38,96
'4671037000,  금성면,'85,80 - 84세,1998,76,25,51
'4671037000,  금성면,'90,85+ ,1998,56,19,37
'4671038000,  용면,'00,계,1998,2410,1215,1195
'4671038000,  용면,'05,0 - 4세,1998,92,42,50
'4671038000,  용면,'10,5 - 9세,1998,98,51,47
'4671038000,  용면,'15,10 - 14세,1998,113,48,65
'4671038000,  용면,'20,15 - 19세,1998,174,93,81
'4671038000,  용면,'25,20 - 24세,1998,256,160,96
'4671038000,  용면,'30,25 - 29세,1998,195,125,70
'4671038000,  용면,'35,30 - 34세,1998,114,71,43
'4671038000,  용면,'40,35 - 39세,1998,145,77,68
'4671038000,  용면,'45,40 - 44세,1998,124,64,60
'4671038000,  용면,'50,45 - 49세,1998,136,72,64
'4671038000,  용면,'55,50 - 54세,1998,142,63,79
'4671038000,  용면,'60,55 - 59세,1998,230,96,134
'4671038000,  용면,'65,60 - 64세,1998,211,102,109
'4671038000,  용면,'70,65 - 69세,1998,116,51,65
'4671038000,  용면,'75,70 - 74세,1998,95,35,60
'4671038000,  용면,'80,75 - 79세,1998,79,34,45
'4671038000,  용면,'85,80 - 84세,1998,55,22,33
'4671038000,  용면,'90,85+ ,1998,35,9,26
'4671039000,  월산면,'00,계,1998,3381,1771,1610
'4671039000,  월산면,'05,0 - 4세,1998,143,76,67
'4671039000,  월산면,'10,5 - 9세,1998,126,70,56
'4671039000,  월산면,'15,10 - 14세,1998,182,97,85
'4671039000,  월산면,'20,15 - 19세,1998,304,163,141
'4671039000,  월산면,'25,20 - 24세,1998,371,214,157
'4671039000,  월산면,'30,25 - 29세,1998,246,163,83
'4671039000,  월산면,'35,30 - 34세,1998,175,112,63
'4671039000,  월산면,'40,35 - 39세,1998,212,125,87
'4671039000,  월산면,'45,40 - 44세,1998,191,109,82
'4671039000,  월산면,'50,45 - 49세,1998,184,85,99
'4671039000,  월산면,'55,50 - 54세,1998,226,118,108
'4671039000,  월산면,'60,55 - 59세,1998,282,126,156
'4671039000,  월산면,'65,60 - 64세,1998,242,115,127
'4671039000,  월산면,'70,65 - 69세,1998,166,70,96
'4671039000,  월산면,'75,70 - 74세,1998,129,55,74
'4671039000,  월산면,'80,75 - 79세,1998,119,39,80
'4671039000,  월산면,'85,80 - 84세,1998,47,19,28
'4671039000,  월산면,'90,85+ ,1998,36,15,21
'4671040000,  수북면,'00,계,1998,4845,2423,2422
'4671040000,  수북면,'05,0 - 4세,1998,209,103,106
'4671040000,  수북면,'10,5 - 9세,1998,188,103,85
'4671040000,  수북면,'15,10 - 14세,1998,213,113,100
'4671040000,  수북면,'20,15 - 19세,1998,428,228,200
'4671040000,  수북면,'25,20 - 24세,1998,513,296,217
'4671040000,  수북면,'30,25 - 29세,1998,385,248,137
'4671040000,  수북면,'35,30 - 34세,1998,248,148,100
'4671040000,  수북면,'40,35 - 39세,1998,266,133,133
'4671040000,  수북면,'45,40 - 44세,1998,250,131,119
'4671040000,  수북면,'50,45 - 49세,1998,265,139,126
'4671040000,  수북면,'55,50 - 54세,1998,290,152,138
'4671040000,  수북면,'60,55 - 59세,1998,388,159,229
'4671040000,  수북면,'65,60 - 64세,1998,356,146,210
'4671040000,  수북면,'70,65 - 69세,1998,321,128,193
'4671040000,  수북면,'75,70 - 74세,1998,225,106,119
'4671040000,  수북면,'80,75 - 79세,1998,156,55,101
'4671040000,  수북면,'85,80 - 84세,1998,81,26,55
'4671040000,  수북면,'90,85+ ,1998,63,9,54
'4671041000,  대전면,'00,계,1998,5491,2755,2736
'4671041000,  대전면,'05,0 - 4세,1998,254,146,108
'4671041000,  대전면,'10,5 - 9세,1998,239,125,114
'4671041000,  대전면,'15,10 - 14세,1998,237,133,104
'4671041000,  대전면,'20,15 - 19세,1998,466,203,263
'4671041000,  대전면,'25,20 - 24세,1998,594,315,279
'4671041000,  대전면,'30,25 - 29세,1998,540,353,187
'4671041000,  대전면,'35,30 - 34세,1998,309,176,133
'4671041000,  대전면,'40,35 - 39세,1998,329,199,130
'4671041000,  대전면,'45,40 - 44세,1998,267,156,111
'4671041000,  대전면,'50,45 - 49세,1998,263,115,148
'4671041000,  대전면,'55,50 - 54세,1998,326,156,170
'4671041000,  대전면,'60,55 - 59세,1998,442,189,253
'4671041000,  대전면,'65,60 - 64세,1998,447,197,250
'4671041000,  대전면,'70,65 - 69세,1998,256,107,149
'4671041000,  대전면,'75,70 - 74세,1998,218,85,133
'4671041000,  대전면,'80,75 - 79세,1998,165,62,103
'4671041000,  대전면,'85,80 - 84세,1998,85,31,54
'4671041000,  대전면,'90,85+ ,1998,54,7,47
'46720, 곡성군,'00,계,1998,40809,19966,20843
'46720, 곡성군,'05,0 - 4세,1998,2216,1141,1075
'46720, 곡성군,'10,5 - 9세,1998,1916,987,929
'46720, 곡성군,'15,10 - 14세,1998,2045,966,1079
'46720, 곡성군,'20,15 - 19세,1998,3358,1671,1687
'46720, 곡성군,'25,20 - 24세,1998,3783,2151,1632
'46720, 곡성군,'30,25 - 29세,1998,2987,1780,1207
'46720, 곡성군,'35,30 - 34세,1998,2332,1342,990
'46720, 곡성군,'40,35 - 39세,1998,2355,1276,1079
'46720, 곡성군,'45,40 - 44세,1998,2059,1078,981
'46720, 곡성군,'50,45 - 49세,1998,2003,1013,990
'46720, 곡성군,'55,50 - 54세,1998,2211,1024,1187
'46720, 곡성군,'60,55 - 59세,1998,3217,1345,1872
'46720, 곡성군,'65,60 - 64세,1998,3465,1466,1999
'46720, 곡성군,'70,65 - 69세,1998,2543,1081,1462
'46720, 곡성군,'75,70 - 74세,1998,1886,807,1079
'46720, 곡성군,'80,75 - 79세,1998,1285,517,768
'46720, 곡성군,'85,80 - 84세,1998,672,217,455
'46720, 곡성군,'90,85+ ,1998,476,104,372
'4672025000,  곡성읍,'00,계,1998,10471,5120,5351
'4672025000,  곡성읍,'05,0 - 4세,1998,666,337,329
'4672025000,  곡성읍,'10,5 - 9세,1998,657,343,314
'4672025000,  곡성읍,'15,10 - 14세,1998,676,331,345
'4672025000,  곡성읍,'20,15 - 19세,1998,909,452,457
'4672025000,  곡성읍,'25,20 - 24세,1998,920,515,405
'4672025000,  곡성읍,'30,25 - 29세,1998,793,426,367
'4672025000,  곡성읍,'35,30 - 34세,1998,712,371,341
'4672025000,  곡성읍,'40,35 - 39세,1998,772,393,379
'4672025000,  곡성읍,'45,40 - 44세,1998,628,328,300
'4672025000,  곡성읍,'50,45 - 49세,1998,535,275,260
'4672025000,  곡성읍,'55,50 - 54세,1998,554,267,287
'4672025000,  곡성읍,'60,55 - 59세,1998,648,283,365
'4672025000,  곡성읍,'65,60 - 64세,1998,660,269,391
'4672025000,  곡성읍,'70,65 - 69세,1998,504,213,291
'4672025000,  곡성읍,'75,70 - 74세,1998,373,154,219
'4672025000,  곡성읍,'80,75 - 79세,1998,248,103,145
'4672025000,  곡성읍,'85,80 - 84세,1998,129,44,85
'4672025000,  곡성읍,'90,85+ ,1998,87,16,71
'4672031000,  오곡면,'00,계,1998,2988,1458,1530
'4672031000,  오곡면,'05,0 - 4세,1998,104,53,51
'4672031000,  오곡면,'10,5 - 9세,1998,108,54,54
'4672031000,  오곡면,'15,10 - 14세,1998,141,62,79
'4672031000,  오곡면,'20,15 - 19세,1998,279,148,131
'4672031000,  오곡면,'25,20 - 24세,1998,309,179,130
'4672031000,  오곡면,'30,25 - 29세,1998,174,122,52
'4672031000,  오곡면,'35,30 - 34세,1998,145,80,65
'4672031000,  오곡면,'40,35 - 39세,1998,163,90,73
'4672031000,  오곡면,'45,40 - 44세,1998,143,79,64
'4672031000,  오곡면,'50,45 - 49세,1998,176,77,99
'4672031000,  오곡면,'55,50 - 54세,1998,159,62,97
'4672031000,  오곡면,'60,55 - 59세,1998,266,114,152
'4672031000,  오곡면,'65,60 - 64세,1998,301,135,166
'4672031000,  오곡면,'70,65 - 69세,1998,188,82,106
'4672031000,  오곡면,'75,70 - 74세,1998,145,59,86
'4672031000,  오곡면,'80,75 - 79세,1998,91,37,54
'4672031000,  오곡면,'85,80 - 84세,1998,58,17,41
'4672031000,  오곡면,'90,85+ ,1998,38,8,30
'4672032000,  삼기면,'00,계,1998,2614,1252,1362
'4672032000,  삼기면,'05,0 - 4세,1998,94,52,42
'4672032000,  삼기면,'10,5 - 9세,1998,85,44,41
'4672032000,  삼기면,'15,10 - 14세,1998,89,40,49
'4672032000,  삼기면,'20,15 - 19세,1998,204,102,102
'4672032000,  삼기면,'25,20 - 24세,1998,255,142,113
'4672032000,  삼기면,'30,25 - 29세,1998,163,105,58
'4672032000,  삼기면,'35,30 - 34세,1998,111,68,43
'4672032000,  삼기면,'40,35 - 39세,1998,125,69,56
'4672032000,  삼기면,'45,40 - 44세,1998,123,69,54
'4672032000,  삼기면,'50,45 - 49세,1998,104,51,53
'4672032000,  삼기면,'55,50 - 54세,1998,158,78,80
'4672032000,  삼기면,'60,55 - 59세,1998,242,94,148
'4672032000,  삼기면,'65,60 - 64세,1998,270,119,151
'4672032000,  삼기면,'70,65 - 69세,1998,196,75,121
'4672032000,  삼기면,'75,70 - 74세,1998,167,71,96
'4672032000,  삼기면,'80,75 - 79세,1998,123,43,80
'4672032000,  삼기면,'85,80 - 84세,1998,53,19,34
'4672032000,  삼기면,'90,85+ ,1998,52,11,41
'4672033000,  석곡면,'00,계,1998,3835,1850,1985
'4672033000,  석곡면,'05,0 - 4세,1998,173,96,77
'4672033000,  석곡면,'10,5 - 9세,1998,159,80,79
'4672033000,  석곡면,'15,10 - 14세,1998,187,91,96
'4672033000,  석곡면,'20,15 - 19세,1998,344,162,182
'4672033000,  석곡면,'25,20 - 24세,1998,348,193,155
'4672033000,  석곡면,'30,25 - 29세,1998,245,149,96
'4672033000,  석곡면,'35,30 - 34세,1998,188,100,88
'4672033000,  석곡면,'40,35 - 39세,1998,190,111,79
'4672033000,  석곡면,'45,40 - 44세,1998,175,74,101
'4672033000,  석곡면,'50,45 - 49세,1998,211,109,102
'4672033000,  석곡면,'55,50 - 54세,1998,205,87,118
'4672033000,  석곡면,'60,55 - 59세,1998,321,135,186
'4672033000,  석곡면,'65,60 - 64세,1998,386,169,217
'4672033000,  석곡면,'70,65 - 69세,1998,262,119,143
'4672033000,  석곡면,'75,70 - 74세,1998,200,87,113
'4672033000,  석곡면,'80,75 - 79세,1998,129,55,74
'4672033000,  석곡면,'85,80 - 84세,1998,66,24,42
'4672033000,  석곡면,'90,85+ ,1998,46,9,37
'4672034000,  목사동면,'00,계,1998,2280,1125,1155
'4672034000,  목사동면,'05,0 - 4세,1998,73,40,33
'4672034000,  목사동면,'10,5 - 9세,1998,110,56,54
'4672034000,  목사동면,'15,10 - 14세,1998,121,56,65
'4672034000,  목사동면,'20,15 - 19세,1998,189,99,90
'4672034000,  목사동면,'25,20 - 24세,1998,175,106,69
'4672034000,  목사동면,'30,25 - 29세,1998,125,84,41
'4672034000,  목사동면,'35,30 - 34세,1998,99,60,39
'4672034000,  목사동면,'40,35 - 39세,1998,121,63,58
'4672034000,  목사동면,'45,40 - 44세,1998,101,56,45
'4672034000,  목사동면,'50,45 - 49세,1998,103,55,48
'4672034000,  목사동면,'55,50 - 54세,1998,137,61,76
'4672034000,  목사동면,'60,55 - 59세,1998,217,86,131
'4672034000,  목사동면,'65,60 - 64세,1998,231,105,126
'4672034000,  목사동면,'70,65 - 69세,1998,175,80,95
'4672034000,  목사동면,'75,70 - 74세,1998,131,59,72
'4672034000,  목사동면,'80,75 - 79세,1998,80,32,48
'4672034000,  목사동면,'85,80 - 84세,1998,60,18,42
'4672034000,  목사동면,'90,85+ ,1998,32,9,23
'4672035000,  죽곡면,'00,계,1998,2718,1311,1407
'4672035000,  죽곡면,'05,0 - 4세,1998,106,56,50
'4672035000,  죽곡면,'10,5 - 9세,1998,89,46,43
'4672035000,  죽곡면,'15,10 - 14세,1998,127,55,72
'4672035000,  죽곡면,'20,15 - 19세,1998,266,133,133
'4672035000,  죽곡면,'25,20 - 24세,1998,275,162,113
'4672035000,  죽곡면,'30,25 - 29세,1998,166,109,57
'4672035000,  죽곡면,'35,30 - 34세,1998,97,59,38
'4672035000,  죽곡면,'40,35 - 39세,1998,119,63,56
'4672035000,  죽곡면,'45,40 - 44세,1998,132,63,69
'4672035000,  죽곡면,'50,45 - 49세,1998,149,75,74
'4672035000,  죽곡면,'55,50 - 54세,1998,173,76,97
'4672035000,  죽곡면,'60,55 - 59세,1998,282,113,169
'4672035000,  죽곡면,'65,60 - 64세,1998,253,111,142
'4672035000,  죽곡면,'70,65 - 69세,1998,183,79,104
'4672035000,  죽곡면,'75,70 - 74세,1998,132,45,87
'4672035000,  죽곡면,'80,75 - 79세,1998,99,45,54
'4672035000,  죽곡면,'85,80 - 84세,1998,37,11,26
'4672035000,  죽곡면,'90,85+ ,1998,33,10,23
'4672036000,  고달면,'00,계,1998,1912,943,969
'4672036000,  고달면,'05,0 - 4세,1998,61,30,31
'4672036000,  고달면,'10,5 - 9세,1998,73,39,34
'4672036000,  고달면,'15,10 - 14세,1998,77,39,38
'4672036000,  고달면,'20,15 - 19세,1998,122,64,58
'4672036000,  고달면,'25,20 - 24세,1998,186,111,75
'4672036000,  고달면,'30,25 - 29세,1998,95,57,38
'4672036000,  고달면,'35,30 - 34세,1998,73,38,35
'4672036000,  고달면,'40,35 - 39세,1998,91,61,30
'4672036000,  고달면,'45,40 - 44세,1998,80,43,37
'4672036000,  고달면,'50,45 - 49세,1998,101,46,55
'4672036000,  고달면,'55,50 - 54세,1998,108,52,56
'4672036000,  고달면,'60,55 - 59세,1998,188,84,104
'4672036000,  고달면,'65,60 - 64세,1998,201,90,111
'4672036000,  고달면,'70,65 - 69세,1998,173,77,96
'4672036000,  고달면,'75,70 - 74세,1998,124,62,62
'4672036000,  고달면,'80,75 - 79세,1998,86,32,54
'4672036000,  고달면,'85,80 - 84세,1998,39,10,29
'4672036000,  고달면,'90,85+ ,1998,34,8,26
'4672037000,  옥과면,'00,계,1998,5062,2521,2541
'4672037000,  옥과면,'05,0 - 4세,1998,293,138,155
'4672037000,  옥과면,'10,5 - 9세,1998,275,141,134
'4672037000,  옥과면,'15,10 - 14세,1998,270,131,139
'4672037000,  옥과면,'20,15 - 19세,1998,418,205,213
'4672037000,  옥과면,'25,20 - 24세,1998,466,267,199
'4672037000,  옥과면,'30,25 - 29세,1998,413,235,178
'4672037000,  옥과면,'35,30 - 34세,1998,353,211,142
'4672037000,  옥과면,'40,35 - 39세,1998,347,189,158
'4672037000,  옥과면,'45,40 - 44세,1998,289,153,136
'4672037000,  옥과면,'50,45 - 49세,1998,266,144,122
'4672037000,  옥과면,'55,50 - 54세,1998,273,134,139
'4672037000,  옥과면,'60,55 - 59세,1998,330,150,180
'4672037000,  옥과면,'65,60 - 64세,1998,365,146,219
'4672037000,  옥과면,'70,65 - 69세,1998,291,118,173
'4672037000,  옥과면,'75,70 - 74세,1998,199,86,113
'4672037000,  옥과면,'80,75 - 79세,1998,114,40,74
'4672037000,  옥과면,'85,80 - 84세,1998,64,26,38
'4672037000,  옥과면,'90,85+ ,1998,36,7,29
'4672038000,  입면,'00,계,1998,4354,2170,2184
'4672038000,  입면,'05,0 - 4세,1998,452,240,212
'4672038000,  입면,'10,5 - 9세,1998,196,106,90
'4672038000,  입면,'15,10 - 14세,1998,164,79,85
'4672038000,  입면,'20,15 - 19세,1998,275,125,150
'4672038000,  입면,'25,20 - 24세,1998,389,213,176
'4672038000,  입면,'30,25 - 29세,1998,498,281,217
'4672038000,  입면,'35,30 - 34세,1998,358,233,125
'4672038000,  입면,'40,35 - 39세,1998,206,119,87
'4672038000,  입면,'45,40 - 44세,1998,173,91,82
'4672038000,  입면,'50,45 - 49세,1998,145,75,70
'4672038000,  입면,'55,50 - 54세,1998,173,84,89
'4672038000,  입면,'60,55 - 59세,1998,324,130,194
'4672038000,  입면,'65,60 - 64세,1998,338,132,206
'4672038000,  입면,'70,65 - 69세,1998,247,111,136
'4672038000,  입면,'75,70 - 74세,1998,183,79,104
'4672038000,  입면,'80,75 - 79세,1998,110,44,66
'4672038000,  입면,'85,80 - 84세,1998,72,18,54
'4672038000,  입면,'90,85+ ,1998,51,10,41
'4672039000,  겸면,'00,계,1998,2560,1211,1349
'4672039000,  겸면,'05,0 - 4세,1998,127,68,59
'4672039000,  겸면,'10,5 - 9세,1998,83,39,44
'4672039000,  겸면,'15,10 - 14세,1998,104,45,59
'4672039000,  겸면,'20,15 - 19세,1998,197,98,99
'4672039000,  겸면,'25,20 - 24세,1998,278,153,125
'4672039000,  겸면,'30,25 - 29세,1998,161,102,59
'4672039000,  겸면,'35,30 - 34세,1998,98,58,40
'4672039000,  겸면,'40,35 - 39세,1998,122,63,59
'4672039000,  겸면,'45,40 - 44세,1998,109,63,46
'4672039000,  겸면,'50,45 - 49세,1998,106,48,58
'4672039000,  겸면,'55,50 - 54세,1998,161,69,92
'4672039000,  겸면,'60,55 - 59세,1998,240,95,145
'4672039000,  겸면,'65,60 - 64세,1998,268,119,149
'4672039000,  겸면,'70,65 - 69세,1998,181,76,105
'4672039000,  겸면,'75,70 - 74세,1998,126,48,78
'4672039000,  겸면,'80,75 - 79세,1998,105,44,61
'4672039000,  겸면,'85,80 - 84세,1998,53,14,39
'4672039000,  겸면,'90,85+ ,1998,41,9,32
'4672040000,  오산면,'00,계,1998,2015,1005,1010
'4672040000,  오산면,'05,0 - 4세,1998,67,31,36
'4672040000,  오산면,'10,5 - 9세,1998,81,39,42
'4672040000,  오산면,'15,10 - 14세,1998,89,37,52
'4672040000,  오산면,'20,15 - 19세,1998,155,83,72
'4672040000,  오산면,'25,20 - 24세,1998,182,110,72
'4672040000,  오산면,'30,25 - 29세,1998,154,110,44
'4672040000,  오산면,'35,30 - 34세,1998,98,64,34
'4672040000,  오산면,'40,35 - 39세,1998,99,55,44
'4672040000,  오산면,'45,40 - 44세,1998,106,59,47
'4672040000,  오산면,'50,45 - 49세,1998,107,58,49
'4672040000,  오산면,'55,50 - 54세,1998,110,54,56
'4672040000,  오산면,'60,55 - 59세,1998,159,61,98
'4672040000,  오산면,'65,60 - 64세,1998,192,71,121
'4672040000,  오산면,'70,65 - 69세,1998,143,51,92
'4672040000,  오산면,'75,70 - 74세,1998,106,57,49
'4672040000,  오산면,'80,75 - 79세,1998,100,42,58
'4672040000,  오산면,'85,80 - 84세,1998,41,16,25
'4672040000,  오산면,'90,85+ ,1998,26,7,19
'46730, 구례군,'00,계,1998,34949,17189,17760
'46730, 구례군,'05,0 - 4세,1998,1692,871,821
'46730, 구례군,'10,5 - 9세,1998,1777,918,859
'46730, 구례군,'15,10 - 14세,1998,1970,977,993
'46730, 구례군,'20,15 - 19세,1998,3207,1613,1594
'46730, 구례군,'25,20 - 24세,1998,3354,1896,1458
'46730, 구례군,'30,25 - 29세,1998,2434,1460,974
'46730, 구례군,'35,30 - 34세,1998,2038,1134,904
'46730, 구례군,'40,35 - 39세,1998,2278,1222,1056
'46730, 구례군,'45,40 - 44세,1998,1850,961,889
'46730, 구례군,'50,45 - 49세,1998,1789,871,918
'46730, 구례군,'55,50 - 54세,1998,1972,921,1051
'46730, 구례군,'60,55 - 59세,1998,2775,1181,1594
'46730, 구례군,'65,60 - 64세,1998,2619,1208,1411
'46730, 구례군,'70,65 - 69세,1998,1927,778,1149
'46730, 구례군,'75,70 - 74세,1998,1361,547,814
'46730, 구례군,'80,75 - 79세,1998,967,362,605
'46730, 구례군,'85,80 - 84세,1998,527,177,350
'46730, 구례군,'90,85+ ,1998,412,92,320
'4673025000,  구례읍,'00,계,1998,14232,7041,7191
'4673025000,  구례읍,'05,0 - 4세,1998,960,509,451
'4673025000,  구례읍,'10,5 - 9세,1998,1053,542,511
'4673025000,  구례읍,'15,10 - 14세,1998,950,475,475
'4673025000,  구례읍,'20,15 - 19세,1998,1309,660,649
'4673025000,  구례읍,'25,20 - 24세,1998,1260,683,577
'4673025000,  구례읍,'30,25 - 29세,1998,1138,607,531
'4673025000,  구례읍,'35,30 - 34세,1998,1062,537,525
'4673025000,  구례읍,'40,35 - 39세,1998,1144,592,552
'4673025000,  구례읍,'45,40 - 44세,1998,855,448,407
'4673025000,  구례읍,'50,45 - 49세,1998,764,378,386
'4673025000,  구례읍,'55,50 - 54세,1998,730,357,373
'4673025000,  구례읍,'60,55 - 59세,1998,795,350,445
'4673025000,  구례읍,'65,60 - 64세,1998,722,346,376
'4673025000,  구례읍,'70,65 - 69세,1998,541,221,320
'4673025000,  구례읍,'75,70 - 74세,1998,406,153,253
'4673025000,  구례읍,'80,75 - 79세,1998,281,103,178
'4673025000,  구례읍,'85,80 - 84세,1998,153,53,100
'4673025000,  구례읍,'90,85+ ,1998,109,27,82
'4673031000,  문척면,'00,계,1998,1657,811,846
'4673031000,  문척면,'05,0 - 4세,1998,58,29,29
'4673031000,  문척면,'10,5 - 9세,1998,55,25,30
'4673031000,  문척면,'15,10 - 14세,1998,89,38,51
'4673031000,  문척면,'20,15 - 19세,1998,145,80,65
'4673031000,  문척면,'25,20 - 24세,1998,190,108,82
'4673031000,  문척면,'30,25 - 29세,1998,97,62,35
'4673031000,  문척면,'35,30 - 34세,1998,76,49,27
'4673031000,  문척면,'40,35 - 39세,1998,86,54,32
'4673031000,  문척면,'45,40 - 44세,1998,79,47,32
'4673031000,  문척면,'50,45 - 49세,1998,80,37,43
'4673031000,  문척면,'55,50 - 54세,1998,92,38,54
'4673031000,  문척면,'60,55 - 59세,1998,160,67,93
'4673031000,  문척면,'65,60 - 64세,1998,151,64,87
'4673031000,  문척면,'70,65 - 69세,1998,108,44,64
'4673031000,  문척면,'75,70 - 74세,1998,83,34,49
'4673031000,  문척면,'80,75 - 79세,1998,50,17,33
'4673031000,  문척면,'85,80 - 84세,1998,27,9,18
'4673031000,  문척면,'90,85+ ,1998,31,9,22
'4673032000,  간전면,'00,계,1998,2231,1097,1134
'4673032000,  간전면,'05,0 - 4세,1998,84,39,45
'4673032000,  간전면,'10,5 - 9세,1998,77,39,38
'4673032000,  간전면,'15,10 - 14세,1998,96,49,47
'4673032000,  간전면,'20,15 - 19세,1998,197,100,97
'4673032000,  간전면,'25,20 - 24세,1998,252,148,104
'4673032000,  간전면,'30,25 - 29세,1998,157,109,48
'4673032000,  간전면,'35,30 - 34세,1998,120,73,47
'4673032000,  간전면,'40,35 - 39세,1998,119,63,56
'4673032000,  간전면,'45,40 - 44세,1998,97,45,52
'4673032000,  간전면,'50,45 - 49세,1998,91,48,43
'4673032000,  간전면,'55,50 - 54세,1998,147,67,80
'4673032000,  간전면,'60,55 - 59세,1998,223,88,135
'4673032000,  간전면,'65,60 - 64세,1998,199,95,104
'4673032000,  간전면,'70,65 - 69세,1998,125,48,77
'4673032000,  간전면,'75,70 - 74세,1998,101,42,59
'4673032000,  간전면,'80,75 - 79세,1998,73,27,46
'4673032000,  간전면,'85,80 - 84세,1998,39,12,27
'4673032000,  간전면,'90,85+ ,1998,34,5,29
'4673033000,  토지면,'00,계,1998,3326,1670,1656
'4673033000,  토지면,'05,0 - 4세,1998,121,60,61
'4673033000,  토지면,'10,5 - 9세,1998,115,58,57
'4673033000,  토지면,'15,10 - 14세,1998,165,90,75
'4673033000,  토지면,'20,15 - 19세,1998,293,143,150
'4673033000,  토지면,'25,20 - 24세,1998,327,202,125
'4673033000,  토지면,'30,25 - 29세,1998,219,157,62
'4673033000,  토지면,'35,30 - 34세,1998,171,106,65
'4673033000,  토지면,'40,35 - 39세,1998,201,108,93
'4673033000,  토지면,'45,40 - 44세,1998,157,93,64
'4673033000,  토지면,'50,45 - 49세,1998,148,65,83
'4673033000,  토지면,'55,50 - 54세,1998,192,84,108
'4673033000,  토지면,'60,55 - 59세,1998,317,131,186
'4673033000,  토지면,'65,60 - 64세,1998,308,131,177
'4673033000,  토지면,'70,65 - 69세,1998,231,100,131
'4673033000,  토지면,'75,70 - 74세,1998,163,76,87
'4673033000,  토지면,'80,75 - 79세,1998,92,35,57
'4673033000,  토지면,'85,80 - 84세,1998,57,23,34
'4673033000,  토지면,'90,85+ ,1998,49,8,41
'4673034000,  마산면,'00,계,1998,3659,1796,1863
'4673034000,  마산면,'05,0 - 4세,1998,151,75,76
'4673034000,  마산면,'10,5 - 9세,1998,137,69,68
'4673034000,  마산면,'15,10 - 14세,1998,222,117,105
'4673034000,  마산면,'20,15 - 19세,1998,365,183,182
'4673034000,  마산면,'25,20 - 24세,1998,374,204,170
'4673034000,  마산면,'30,25 - 29세,1998,219,130,89
'4673034000,  마산면,'35,30 - 34세,1998,197,122,75
'4673034000,  마산면,'40,35 - 39세,1998,233,120,113
'4673034000,  마산면,'45,40 - 44세,1998,215,109,106
'4673034000,  마산면,'50,45 - 49세,1998,182,88,94
'4673034000,  마산면,'55,50 - 54세,1998,227,112,115
'4673034000,  마산면,'60,55 - 59세,1998,266,124,142
'4673034000,  마산면,'65,60 - 64세,1998,286,124,162
'4673034000,  마산면,'70,65 - 69세,1998,214,80,134
'4673034000,  마산면,'75,70 - 74세,1998,156,61,95
'4673034000,  마산면,'80,75 - 79세,1998,120,47,73
'4673034000,  마산면,'85,80 - 84세,1998,49,18,31
'4673034000,  마산면,'90,85+ ,1998,46,13,33
'4673035000,  광의면,'00,계,1998,3557,1713,1844
'4673035000,  광의면,'05,0 - 4세,1998,98,47,51
'4673035000,  광의면,'10,5 - 9세,1998,100,57,43
'4673035000,  광의면,'15,10 - 14세,1998,162,82,80
'4673035000,  광의면,'20,15 - 19세,1998,320,162,158
'4673035000,  광의면,'25,20 - 24세,1998,323,184,139
'4673035000,  광의면,'30,25 - 29세,1998,220,145,75
'4673035000,  광의면,'35,30 - 34세,1998,116,69,47
'4673035000,  광의면,'40,35 - 39세,1998,191,108,83
'4673035000,  광의면,'45,40 - 44세,1998,168,88,80
'4673035000,  광의면,'50,45 - 49세,1998,189,87,102
'4673035000,  광의면,'55,50 - 54세,1998,199,98,101
'4673035000,  광의면,'60,55 - 59세,1998,378,147,231
'4673035000,  광의면,'65,60 - 64세,1998,355,179,176
'4673035000,  광의면,'70,65 - 69세,1998,271,98,173
'4673035000,  광의면,'75,70 - 74세,1998,187,74,113
'4673035000,  광의면,'80,75 - 79세,1998,145,53,92
'4673035000,  광의면,'85,80 - 84세,1998,84,23,61
'4673035000,  광의면,'90,85+ ,1998,51,12,39
'4673036000,  용방면,'00,계,1998,2112,994,1118
'4673036000,  용방면,'05,0 - 4세,1998,70,34,36
'4673036000,  용방면,'10,5 - 9세,1998,67,30,37
'4673036000,  용방면,'15,10 - 14세,1998,88,46,42
'4673036000,  용방면,'20,15 - 19세,1998,208,107,101
'4673036000,  용방면,'25,20 - 24세,1998,231,122,109
'4673036000,  용방면,'30,25 - 29세,1998,119,73,46
'4673036000,  용방면,'35,30 - 34세,1998,83,46,37
'4673036000,  용방면,'40,35 - 39세,1998,98,55,43
'4673036000,  용방면,'45,40 - 44세,1998,91,42,49
'4673036000,  용방면,'50,45 - 49세,1998,114,54,60
'4673036000,  용방면,'55,50 - 54세,1998,123,56,67
'4673036000,  용방면,'60,55 - 59세,1998,199,87,112
'4673036000,  용방면,'65,60 - 64세,1998,203,90,113
'4673036000,  용방면,'70,65 - 69세,1998,154,62,92
'4673036000,  용방면,'75,70 - 74세,1998,110,39,71
'4673036000,  용방면,'80,75 - 79세,1998,78,32,46
'4673036000,  용방면,'85,80 - 84세,1998,41,13,28
'4673036000,  용방면,'90,85+ ,1998,35,6,29
'4673037000,  산동면,'00,계,1998,4175,2067,2108
'4673037000,  산동면,'05,0 - 4세,1998,150,78,72
'4673037000,  산동면,'10,5 - 9세,1998,173,98,75
'4673037000,  산동면,'15,10 - 14세,1998,198,80,118
'4673037000,  산동면,'20,15 - 19세,1998,370,178,192
'4673037000,  산동면,'25,20 - 24세,1998,397,245,152
'4673037000,  산동면,'30,25 - 29세,1998,265,177,88
'4673037000,  산동면,'35,30 - 34세,1998,213,132,81
'4673037000,  산동면,'40,35 - 39세,1998,206,122,84
'4673037000,  산동면,'45,40 - 44세,1998,188,89,99
'4673037000,  산동면,'50,45 - 49세,1998,221,114,107
'4673037000,  산동면,'55,50 - 54세,1998,262,109,153
'4673037000,  산동면,'60,55 - 59세,1998,437,187,250
'4673037000,  산동면,'65,60 - 64세,1998,395,179,216
'4673037000,  산동면,'70,65 - 69세,1998,283,125,158
'4673037000,  산동면,'75,70 - 74세,1998,155,68,87
'4673037000,  산동면,'80,75 - 79세,1998,128,48,80
'4673037000,  산동면,'85,80 - 84세,1998,77,26,51
'4673037000,  산동면,'90,85+ ,1998,57,12,45
'46770, 고흥군,'00,계,1998,103256,51004,52252
'46770, 고흥군,'05,0 - 4세,1998,4219,2185,2034
'46770, 고흥군,'10,5 - 9세,1998,4609,2428,2181
'46770, 고흥군,'15,10 - 14세,1998,5990,3037,2953
'46770, 고흥군,'20,15 - 19세,1998,10290,5234,5056
'46770, 고흥군,'25,20 - 24세,1998,9121,5552,3569
'46770, 고흥군,'30,25 - 29세,1998,5581,3442,2139
'46770, 고흥군,'35,30 - 34세,1998,4849,2661,2188
'46770, 고흥군,'40,35 - 39세,1998,6170,3185,2985
'46770, 고흥군,'45,40 - 44세,1998,5796,2928,2868
'46770, 고흥군,'50,45 - 49세,1998,5857,2887,2970
'46770, 고흥군,'55,50 - 54세,1998,6236,3005,3231
'46770, 고흥군,'60,55 - 59세,1998,8588,3954,4634
'46770, 고흥군,'65,60 - 64세,1998,8072,3567,4505
'46770, 고흥군,'70,65 - 69세,1998,7133,2974,4159
'46770, 고흥군,'75,70 - 74세,1998,4357,1898,2459
'46770, 고흥군,'80,75 - 79세,1998,3378,1237,2141
'46770, 고흥군,'85,80 - 84세,1998,1758,558,1200
'46770, 고흥군,'90,85+ ,1998,1252,272,980
'4677025000,  고흥읍,'00,계,1998,14372,7115,7257
'4677025000,  고흥읍,'05,0 - 4세,1998,1078,574,504
'4677025000,  고흥읍,'10,5 - 9세,1998,1119,596,523
'4677025000,  고흥읍,'15,10 - 14세,1998,1103,555,548
'4677025000,  고흥읍,'20,15 - 19세,1998,1323,661,662
'4677025000,  고흥읍,'25,20 - 24세,1998,1075,608,467
'4677025000,  고흥읍,'30,25 - 29세,1998,1043,559,484
'4677025000,  고흥읍,'35,30 - 34세,1998,1075,530,545
'4677025000,  고흥읍,'40,35 - 39세,1998,1238,606,632
'4677025000,  고흥읍,'45,40 - 44세,1998,978,497,481
'4677025000,  고흥읍,'50,45 - 49세,1998,791,390,401
'4677025000,  고흥읍,'55,50 - 54세,1998,702,378,324
'4677025000,  고흥읍,'60,55 - 59세,1998,766,345,421
'4677025000,  고흥읍,'65,60 - 64세,1998,647,288,359
'4677025000,  고흥읍,'70,65 - 69세,1998,539,207,332
'4677025000,  고흥읍,'75,70 - 74세,1998,371,159,212
'4677025000,  고흥읍,'80,75 - 79세,1998,276,95,181
'4677025000,  고흥읍,'85,80 - 84세,1998,156,50,106
'4677025000,  고흥읍,'90,85+ ,1998,92,17,75
'4677025300,  도양읍,'00,계,1998,16107,8065,8042
'4677025300,  도양읍,'05,0 - 4세,1998,860,444,416
'4677025300,  도양읍,'10,5 - 9세,1998,849,429,420
'4677025300,  도양읍,'15,10 - 14세,1998,1042,527,515
'4677025300,  도양읍,'20,15 - 19세,1998,1618,860,758
'4677025300,  도양읍,'25,20 - 24세,1998,1394,780,614
'4677025300,  도양읍,'30,25 - 29세,1998,1014,579,435
'4677025300,  도양읍,'35,30 - 34세,1998,963,490,473
'4677025300,  도양읍,'40,35 - 39세,1998,1152,570,582
'4677025300,  도양읍,'45,40 - 44세,1998,1012,526,486
'4677025300,  도양읍,'50,45 - 49세,1998,936,430,506
'4677025300,  도양읍,'55,50 - 54세,1998,957,487,470
'4677025300,  도양읍,'60,55 - 59세,1998,1077,544,533
'4677025300,  도양읍,'65,60 - 64세,1998,908,443,465
'4677025300,  도양읍,'70,65 - 69세,1998,831,374,457
'4677025300,  도양읍,'75,70 - 74세,1998,559,253,306
'4677025300,  도양읍,'80,75 - 79세,1998,447,183,264
'4677025300,  도양읍,'85,80 - 84세,1998,305,103,202
'4677025300,  도양읍,'90,85+ ,1998,183,43,140
'4677031000,  풍양면,'00,계,1998,5958,2905,3053
'4677031000,  풍양면,'05,0 - 4세,1998,171,92,79
'4677031000,  풍양면,'10,5 - 9세,1998,189,101,88
'4677031000,  풍양면,'15,10 - 14세,1998,315,157,158
'4677031000,  풍양면,'20,15 - 19세,1998,597,308,289
'4677031000,  풍양면,'25,20 - 24세,1998,490,306,184
'4677031000,  풍양면,'30,25 - 29세,1998,280,185,95
'4677031000,  풍양면,'35,30 - 34세,1998,217,144,73
'4677031000,  풍양면,'40,35 - 39세,1998,290,152,138
'4677031000,  풍양면,'45,40 - 44세,1998,311,156,155
'4677031000,  풍양면,'50,45 - 49세,1998,350,170,180
'4677031000,  풍양면,'55,50 - 54세,1998,408,193,215
'4677031000,  풍양면,'60,55 - 59세,1998,553,251,302
'4677031000,  풍양면,'65,60 - 64세,1998,524,233,291
'4677031000,  풍양면,'70,65 - 69세,1998,498,211,287
'4677031000,  풍양면,'75,70 - 74세,1998,263,100,163
'4677031000,  풍양면,'80,75 - 79세,1998,261,80,181
'4677031000,  풍양면,'85,80 - 84세,1998,137,45,92
'4677031000,  풍양면,'90,85+ ,1998,104,21,83
'4677032000,  도덕면,'00,계,1998,5256,2584,2672
'4677032000,  도덕면,'05,0 - 4세,1998,156,86,70
'4677032000,  도덕면,'10,5 - 9세,1998,178,89,89
'4677032000,  도덕면,'15,10 - 14세,1998,243,136,107
'4677032000,  도덕면,'20,15 - 19세,1998,508,264,244
'4677032000,  도덕면,'25,20 - 24세,1998,425,269,156
'4677032000,  도덕면,'30,25 - 29세,1998,240,146,94
'4677032000,  도덕면,'35,30 - 34세,1998,169,104,65
'4677032000,  도덕면,'40,35 - 39세,1998,250,138,112
'4677032000,  도덕면,'45,40 - 44세,1998,268,135,133
'4677032000,  도덕면,'50,45 - 49세,1998,300,149,151
'4677032000,  도덕면,'55,50 - 54세,1998,314,143,171
'4677032000,  도덕면,'60,55 - 59세,1998,517,231,286
'4677032000,  도덕면,'65,60 - 64세,1998,503,242,261
'4677032000,  도덕면,'70,65 - 69세,1998,472,192,280
'4677032000,  도덕면,'75,70 - 74세,1998,255,106,149
'4677032000,  도덕면,'80,75 - 79세,1998,234,95,139
'4677032000,  도덕면,'85,80 - 84세,1998,127,41,86
'4677032000,  도덕면,'90,85+ ,1998,97,18,79
'4677033000,  금산면,'00,계,1998,7721,3936,3785
'4677033000,  금산면,'05,0 - 4세,1998,243,128,115
'4677033000,  금산면,'10,5 - 9세,1998,319,187,132
'4677033000,  금산면,'15,10 - 14세,1998,459,225,234
'4677033000,  금산면,'20,15 - 19세,1998,875,428,447
'4677033000,  금산면,'25,20 - 24세,1998,726,481,245
'4677033000,  금산면,'30,25 - 29세,1998,343,242,101
'4677033000,  금산면,'35,30 - 34세,1998,292,162,130
'4677033000,  금산면,'40,35 - 39세,1998,456,237,219
'4677033000,  금산면,'45,40 - 44세,1998,429,223,206
'4677033000,  금산면,'50,45 - 49세,1998,450,223,227
'4677033000,  금산면,'55,50 - 54세,1998,566,269,297
'4677033000,  금산면,'60,55 - 59세,1998,675,336,339
'4677033000,  금산면,'65,60 - 64세,1998,665,313,352
'4677033000,  금산면,'70,65 - 69세,1998,539,226,313
'4677033000,  금산면,'75,70 - 74세,1998,287,129,158
'4677033000,  금산면,'80,75 - 79세,1998,224,92,132
'4677033000,  금산면,'85,80 - 84세,1998,98,21,77
'4677033000,  금산면,'90,85+ ,1998,75,14,61
'4677034000,  도화면,'00,계,1998,7197,3593,3604
'4677034000,  도화면,'05,0 - 4세,1998,237,113,124
'4677034000,  도화면,'10,5 - 9세,1998,282,147,135
'4677034000,  도화면,'15,10 - 14세,1998,430,226,204
'4677034000,  도화면,'20,15 - 19세,1998,771,387,384
'4677034000,  도화면,'25,20 - 24세,1998,733,465,268
'4677034000,  도화면,'30,25 - 29세,1998,378,244,134
'4677034000,  도화면,'35,30 - 34세,1998,286,160,126
'4677034000,  도화면,'40,35 - 39세,1998,377,185,192
'4677034000,  도화면,'45,40 - 44세,1998,395,200,195
'4677034000,  도화면,'50,45 - 49세,1998,419,212,207
'4677034000,  도화면,'55,50 - 54세,1998,450,223,227
'4677034000,  도화면,'60,55 - 59세,1998,625,296,329
'4677034000,  도화면,'65,60 - 64세,1998,610,273,337
'4677034000,  도화면,'70,65 - 69세,1998,496,196,300
'4677034000,  도화면,'75,70 - 74세,1998,287,132,155
'4677034000,  도화면,'80,75 - 79세,1998,233,83,150
'4677034000,  도화면,'85,80 - 84세,1998,106,37,69
'4677034000,  도화면,'90,85+ ,1998,82,14,68
'4677035000,  포두면,'00,계,1998,8590,4243,4347
'4677035000,  포두면,'05,0 - 4세,1998,285,148,137
'4677035000,  포두면,'10,5 - 9세,1998,318,161,157
'4677035000,  포두면,'15,10 - 14세,1998,431,216,215
'4677035000,  포두면,'20,15 - 19세,1998,845,431,414
'4677035000,  포두면,'25,20 - 24세,1998,819,499,320
'4677035000,  포두면,'30,25 - 29세,1998,426,273,153
'4677035000,  포두면,'35,30 - 34세,1998,359,198,161
'4677035000,  포두면,'40,35 - 39세,1998,442,253,189
'4677035000,  포두면,'45,40 - 44세,1998,467,222,245
'4677035000,  포두면,'50,45 - 49세,1998,499,239,260
'4677035000,  포두면,'55,50 - 54세,1998,544,262,282
'4677035000,  포두면,'60,55 - 59세,1998,812,383,429
'4677035000,  포두면,'65,60 - 64세,1998,761,317,444
'4677035000,  포두면,'70,65 - 69세,1998,650,269,381
'4677035000,  포두면,'75,70 - 74세,1998,425,206,219
'4677035000,  포두면,'80,75 - 79세,1998,280,108,172
'4677035000,  포두면,'85,80 - 84세,1998,120,36,84
'4677035000,  포두면,'90,85+ ,1998,107,22,85
'4677036000,  봉래면,'00,계,1998,3488,1733,1755
'4677036000,  봉래면,'05,0 - 4세,1998,118,68,50
'4677036000,  봉래면,'10,5 - 9세,1998,136,80,56
'4677036000,  봉래면,'15,10 - 14세,1998,167,89,78
'4677036000,  봉래면,'20,15 - 19세,1998,350,164,186
'4677036000,  봉래면,'25,20 - 24세,1998,313,195,118
'4677036000,  봉래면,'30,25 - 29세,1998,203,128,75
'4677036000,  봉래면,'35,30 - 34세,1998,155,92,63
'4677036000,  봉래면,'40,35 - 39세,1998,190,106,84
'4677036000,  봉래면,'45,40 - 44세,1998,210,108,102
'4677036000,  봉래면,'50,45 - 49세,1998,194,99,95
'4677036000,  봉래면,'55,50 - 54세,1998,215,100,115
'4677036000,  봉래면,'60,55 - 59세,1998,332,147,185
'4677036000,  봉래면,'65,60 - 64세,1998,276,126,150
'4677036000,  봉래면,'70,65 - 69세,1998,256,111,145
'4677036000,  봉래면,'75,70 - 74세,1998,167,70,97
'4677036000,  봉래면,'80,75 - 79세,1998,121,33,88
'4677036000,  봉래면,'85,80 - 84세,1998,48,9,39
'4677036000,  봉래면,'90,85+ ,1998,37,8,29
'4677037000,  점암면,'00,계,1998,4792,2274,2518
'4677037000,  점암면,'05,0 - 4세,1998,138,69,69
'4677037000,  점암면,'10,5 - 9세,1998,158,86,72
'4677037000,  점암면,'15,10 - 14세,1998,208,107,101
'4677037000,  점암면,'20,15 - 19세,1998,468,235,233
'4677037000,  점암면,'25,20 - 24세,1998,432,260,172
'4677037000,  점암면,'30,25 - 29세,1998,212,140,72
'4677037000,  점암면,'35,30 - 34세,1998,157,103,54
'4677037000,  점암면,'40,35 - 39세,1998,216,108,108
'4677037000,  점암면,'45,40 - 44세,1998,213,110,103
'4677037000,  점암면,'50,45 - 49세,1998,261,128,133
'4677037000,  점암면,'55,50 - 54세,1998,297,118,179
'4677037000,  점암면,'60,55 - 59세,1998,512,233,279
'4677037000,  점암면,'65,60 - 64세,1998,430,180,250
'4677037000,  점암면,'70,65 - 69세,1998,452,168,284
'4677037000,  점암면,'75,70 - 74세,1998,286,114,172
'4677037000,  점암면,'80,75 - 79세,1998,196,73,123
'4677037000,  점암면,'85,80 - 84세,1998,94,27,67
'4677037000,  점암면,'90,85+ ,1998,62,15,47
'4677038000,  과역면,'00,계,1998,5923,2871,3052
'4677038000,  과역면,'05,0 - 4세,1998,226,115,111
'4677038000,  과역면,'10,5 - 9세,1998,257,127,130
'4677038000,  과역면,'15,10 - 14세,1998,399,207,192
'4677038000,  과역면,'20,15 - 19세,1998,598,303,295
'4677038000,  과역면,'25,20 - 24세,1998,513,316,197
'4677038000,  과역면,'30,25 - 29세,1998,266,171,95
'4677038000,  과역면,'35,30 - 34세,1998,280,139,141
'4677038000,  과역면,'40,35 - 39세,1998,363,177,186
'4677038000,  과역면,'45,40 - 44세,1998,345,175,170
'4677038000,  과역면,'50,45 - 49세,1998,342,178,164
'4677038000,  과역면,'55,50 - 54세,1998,313,153,160
'4677038000,  과역면,'60,55 - 59세,1998,497,212,285
'4677038000,  과역면,'65,60 - 64세,1998,467,185,282
'4677038000,  과역면,'70,65 - 69세,1998,450,206,244
'4677038000,  과역면,'75,70 - 74세,1998,283,116,167
'4677038000,  과역면,'80,75 - 79세,1998,168,53,115
'4677038000,  과역면,'85,80 - 84세,1998,97,29,68
'4677038000,  과역면,'90,85+ ,1998,59,9,50
'4677039000,  남양면,'00,계,1998,4108,1980,2128
'4677039000,  남양면,'05,0 - 4세,1998,113,53,60
'4677039000,  남양면,'10,5 - 9세,1998,124,74,50
'4677039000,  남양면,'15,10 - 14세,1998,208,83,125
'4677039000,  남양면,'20,15 - 19세,1998,441,218,223
'4677039000,  남양면,'25,20 - 24세,1998,369,233,136
'4677039000,  남양면,'30,25 - 29세,1998,185,118,67
'4677039000,  남양면,'35,30 - 34세,1998,161,96,65
'4677039000,  남양면,'40,35 - 39세,1998,211,124,87
'4677039000,  남양면,'45,40 - 44세,1998,201,101,100
'4677039000,  남양면,'50,45 - 49세,1998,249,116,133
'4677039000,  남양면,'55,50 - 54세,1998,236,102,134
'4677039000,  남양면,'60,55 - 59세,1998,359,161,198
'4677039000,  남양면,'65,60 - 64세,1998,346,143,203
'4677039000,  남양면,'70,65 - 69세,1998,387,153,234
'4677039000,  남양면,'75,70 - 74세,1998,216,91,125
'4677039000,  남양면,'80,75 - 79세,1998,156,64,92
'4677039000,  남양면,'85,80 - 84세,1998,94,34,60
'4677039000,  남양면,'90,85+ ,1998,52,16,36
'4677040000,  동강면,'00,계,1998,5378,2662,2716
'4677040000,  동강면,'05,0 - 4세,1998,215,107,108
'4677040000,  동강면,'10,5 - 9세,1998,215,97,118
'4677040000,  동강면,'15,10 - 14세,1998,262,142,120
'4677040000,  동강면,'20,15 - 19세,1998,534,291,243
'4677040000,  동강면,'25,20 - 24세,1998,491,299,192
'4677040000,  동강면,'30,25 - 29세,1998,300,182,118
'4677040000,  동강면,'35,30 - 34세,1998,229,139,90
'4677040000,  동강면,'40,35 - 39세,1998,282,157,125
'4677040000,  동강면,'45,40 - 44세,1998,275,112,163
'4677040000,  동강면,'50,45 - 49세,1998,292,152,140
'4677040000,  동강면,'55,50 - 54세,1998,300,153,147
'4677040000,  동강면,'60,55 - 59세,1998,456,201,255
'4677040000,  동강면,'65,60 - 64세,1998,456,188,268
'4677040000,  동강면,'70,65 - 69세,1998,432,166,266
'4677040000,  동강면,'75,70 - 74세,1998,282,138,144
'4677040000,  동강면,'80,75 - 79세,1998,207,86,121
'4677040000,  동강면,'85,80 - 84세,1998,95,35,60
'4677040000,  동강면,'90,85+ ,1998,55,17,38
'4677041000,  대서면,'00,계,1998,4423,2172,2251
'4677041000,  대서면,'05,0 - 4세,1998,144,69,75
'4677041000,  대서면,'10,5 - 9세,1998,180,98,82
'4677041000,  대서면,'15,10 - 14세,1998,237,127,110
'4677041000,  대서면,'20,15 - 19세,1998,446,217,229
'4677041000,  대서면,'25,20 - 24세,1998,428,268,160
'4677041000,  대서면,'30,25 - 29세,1998,210,128,82
'4677041000,  대서면,'35,30 - 34세,1998,183,102,81
'4677041000,  대서면,'40,35 - 39세,1998,248,126,122
'4677041000,  대서면,'45,40 - 44세,1998,219,115,104
'4677041000,  대서면,'50,45 - 49세,1998,234,127,107
'4677041000,  대서면,'55,50 - 54세,1998,228,102,126
'4677041000,  대서면,'60,55 - 59세,1998,390,162,228
'4677041000,  대서면,'65,60 - 64세,1998,442,189,253
'4677041000,  대서면,'70,65 - 69세,1998,326,149,177
'4677041000,  대서면,'75,70 - 74세,1998,181,80,101
'4677041000,  대서면,'80,75 - 79세,1998,171,61,110
'4677041000,  대서면,'85,80 - 84세,1998,81,35,46
'4677041000,  대서면,'90,85+ ,1998,75,17,58
'4677042000,  두원면,'00,계,1998,5276,2568,2708
'4677042000,  두원면,'05,0 - 4세,1998,125,60,65
'4677042000,  두원면,'10,5 - 9세,1998,132,75,57
'4677042000,  두원면,'15,10 - 14세,1998,216,107,109
'4677042000,  두원면,'20,15 - 19세,1998,470,258,212
'4677042000,  두원면,'25,20 - 24세,1998,464,281,183
'4677042000,  두원면,'30,25 - 29세,1998,237,165,72
'4677042000,  두원면,'35,30 - 34세,1998,149,93,56
'4677042000,  두원면,'40,35 - 39세,1998,216,122,94
'4677042000,  두원면,'45,40 - 44세,1998,221,106,115
'4677042000,  두원면,'50,45 - 49세,1998,295,148,147
'4677042000,  두원면,'55,50 - 54세,1998,383,176,207
'4677042000,  두원면,'60,55 - 59세,1998,588,265,323
'4677042000,  두원면,'65,60 - 64세,1998,566,251,315
'4677042000,  두원면,'70,65 - 69세,1998,484,215,269
'4677042000,  두원면,'75,70 - 74세,1998,265,107,158
'4677042000,  두원면,'80,75 - 79세,1998,229,73,156
'4677042000,  두원면,'85,80 - 84세,1998,123,38,85
'4677042000,  두원면,'90,85+ ,1998,113,28,85
'4677044000,  영남면,'00,계,1998,2342,1128,1214
'4677044000,  영남면,'05,0 - 4세,1998,55,32,23
'4677044000,  영남면,'10,5 - 9세,1998,65,33,32
'4677044000,  영남면,'15,10 - 14세,1998,121,64,57
'4677044000,  영남면,'20,15 - 19세,1998,240,108,132
'4677044000,  영남면,'25,20 - 24세,1998,238,155,83
'4677044000,  영남면,'30,25 - 29세,1998,100,67,33
'4677044000,  영남면,'35,30 - 34세,1998,89,57,32
'4677044000,  영남면,'40,35 - 39세,1998,100,46,54
'4677044000,  영남면,'45,40 - 44세,1998,126,65,61
'4677044000,  영남면,'50,45 - 49세,1998,127,68,59
'4677044000,  영남면,'55,50 - 54세,1998,169,63,106
'4677044000,  영남면,'60,55 - 59세,1998,220,106,114
'4677044000,  영남면,'65,60 - 64세,1998,259,105,154
'4677044000,  영남면,'70,65 - 69세,1998,159,68,91
'4677044000,  영남면,'75,70 - 74세,1998,116,48,68
'4677044000,  영남면,'80,75 - 79세,1998,87,27,60
'4677044000,  영남면,'85,80 - 84세,1998,39,7,32
'4677044000,  영남면,'90,85+ ,1998,32,9,23
'4677045000,  동일면,'00,계,1998,2325,1175,1150
'4677045000,  동일면,'05,0 - 4세,1998,55,27,28
'4677045000,  동일면,'10,5 - 9세,1998,88,48,40
'4677045000,  동일면,'15,10 - 14세,1998,149,69,80
'4677045000,  동일면,'20,15 - 19세,1998,206,101,105
'4677045000,  동일면,'25,20 - 24세,1998,211,137,74
'4677045000,  동일면,'30,25 - 29세,1998,144,115,29
'4677045000,  동일면,'35,30 - 34세,1998,85,52,33
'4677045000,  동일면,'40,35 - 39세,1998,139,78,61
'4677045000,  동일면,'45,40 - 44세,1998,126,77,49
'4677045000,  동일면,'50,45 - 49세,1998,118,58,60
'4677045000,  동일면,'55,50 - 54세,1998,154,83,71
'4677045000,  동일면,'60,55 - 59세,1998,209,81,128
'4677045000,  동일면,'65,60 - 64세,1998,212,91,121
'4677045000,  동일면,'70,65 - 69세,1998,162,63,99
'4677045000,  동일면,'75,70 - 74세,1998,114,49,65
'4677045000,  동일면,'80,75 - 79세,1998,88,31,57
'4677045000,  동일면,'85,80 - 84세,1998,38,11,27
'4677045000,  동일면,'90,85+ ,1998,27,4,23
'46780, 보성군,'00,계,1998,64445,31690,32755
'46780, 보성군,'05,0 - 4세,1998,2931,1561,1370
'46780, 보성군,'10,5 - 9세,1998,3104,1655,1449
'46780, 보성군,'15,10 - 14세,1998,3660,1809,1851
'46780, 보성군,'20,15 - 19세,1998,6067,3015,3052
'46780, 보성군,'25,20 - 24세,1998,5701,3361,2340
'46780, 보성군,'30,25 - 29세,1998,3975,2378,1597
'46780, 보성군,'35,30 - 34세,1998,3336,1862,1474
'46780, 보성군,'40,35 - 39세,1998,3764,1985,1779
'46780, 보성군,'45,40 - 44세,1998,3470,1873,1597
'46780, 보성군,'50,45 - 49세,1998,3524,1723,1801
'46780, 보성군,'55,50 - 54세,1998,3544,1729,1815
'46780, 보성군,'60,55 - 59세,1998,5303,2261,3042
'46780, 보성군,'65,60 - 64세,1998,5281,2246,3035
'46780, 보성군,'70,65 - 69세,1998,4216,1762,2454
'46780, 보성군,'75,70 - 74세,1998,2592,1114,1478
'46780, 보성군,'80,75 - 79세,1998,2127,820,1307
'46780, 보성군,'85,80 - 84세,1998,1063,369,694
'46780, 보성군,'90,85+ ,1998,787,167,620
'4678025000,  보성읍,'00,계,1998,11544,5649,5895
'4678025000,  보성읍,'05,0 - 4세,1998,773,422,351
'4678025000,  보성읍,'10,5 - 9세,1998,833,444,389
'4678025000,  보성읍,'15,10 - 14세,1998,797,395,402
'4678025000,  보성읍,'20,15 - 19세,1998,977,480,497
'4678025000,  보성읍,'25,20 - 24세,1998,953,515,438
'4678025000,  보성읍,'30,25 - 29세,1998,818,415,403
'4678025000,  보성읍,'35,30 - 34세,1998,766,391,375
'4678025000,  보성읍,'40,35 - 39세,1998,881,443,438
'4678025000,  보성읍,'45,40 - 44세,1998,692,385,307
'4678025000,  보성읍,'50,45 - 49세,1998,615,302,313
'4678025000,  보성읍,'55,50 - 54세,1998,601,300,301
'4678025000,  보성읍,'60,55 - 59세,1998,752,327,425
'4678025000,  보성읍,'65,60 - 64세,1998,685,306,379
'4678025000,  보성읍,'70,65 - 69세,1998,550,218,332
'4678025000,  보성읍,'75,70 - 74세,1998,314,137,177
'4678025000,  보성읍,'80,75 - 79세,1998,289,104,185
'4678025000,  보성읍,'85,80 - 84세,1998,133,51,82
'4678025000,  보성읍,'90,85+ ,1998,115,14,101
'4678025300,  벌교읍,'00,계,1998,20188,9967,10221
'4678025300,  벌교읍,'05,0 - 4세,1998,1015,538,477
'4678025300,  벌교읍,'10,5 - 9세,1998,996,530,466
'4678025300,  벌교읍,'15,10 - 14세,1998,1204,585,619
'4678025300,  벌교읍,'20,15 - 19세,1998,2117,1092,1025
'4678025300,  벌교읍,'25,20 - 24세,1998,1803,1048,755
'4678025300,  벌교읍,'30,25 - 29세,1998,1318,784,534
'4678025300,  벌교읍,'35,30 - 34세,1998,1111,621,490
'4678025300,  벌교읍,'40,35 - 39세,1998,1209,597,612
'4678025300,  벌교읍,'45,40 - 44세,1998,1187,623,564
'4678025300,  벌교읍,'50,45 - 49세,1998,1197,583,614
'4678025300,  벌교읍,'55,50 - 54세,1998,1110,553,557
'4678025300,  벌교읍,'60,55 - 59세,1998,1501,656,845
'4678025300,  벌교읍,'65,60 - 64세,1998,1412,603,809
'4678025300,  벌교읍,'70,65 - 69세,1998,1193,477,716
'4678025300,  벌교읍,'75,70 - 74세,1998,734,318,416
'4678025300,  벌교읍,'80,75 - 79세,1998,582,212,370
'4678025300,  벌교읍,'85,80 - 84세,1998,274,97,177
'4678025300,  벌교읍,'90,85+ ,1998,225,50,175
'4678031000,  노동면,'00,계,1998,1783,890,893
'4678031000,  노동면,'05,0 - 4세,1998,40,19,21
'4678031000,  노동면,'10,5 - 9세,1998,44,25,19
'4678031000,  노동면,'15,10 - 14세,1998,80,45,35
'4678031000,  노동면,'20,15 - 19세,1998,146,85,61
'4678031000,  노동면,'25,20 - 24세,1998,150,100,50
'4678031000,  노동면,'30,25 - 29세,1998,104,66,38
'4678031000,  노동면,'35,30 - 34세,1998,45,29,16
'4678031000,  노동면,'40,35 - 39세,1998,74,42,32
'4678031000,  노동면,'45,40 - 44세,1998,74,46,28
'4678031000,  노동면,'50,45 - 49세,1998,70,31,39
'4678031000,  노동면,'55,50 - 54세,1998,106,52,54
'4678031000,  노동면,'60,55 - 59세,1998,181,79,102
'4678031000,  노동면,'65,60 - 64세,1998,241,90,151
'4678031000,  노동면,'70,65 - 69세,1998,156,73,83
'4678031000,  노동면,'75,70 - 74세,1998,118,62,56
'4678031000,  노동면,'80,75 - 79세,1998,71,22,49
'4678031000,  노동면,'85,80 - 84세,1998,53,19,34
'4678031000,  노동면,'90,85+ ,1998,30,5,25
'4678032000,  미력면,'00,계,1998,2327,1149,1178
'4678032000,  미력면,'05,0 - 4세,1998,69,32,37
'4678032000,  미력면,'10,5 - 9세,1998,72,38,34
'4678032000,  미력면,'15,10 - 14세,1998,124,66,58
'4678032000,  미력면,'20,15 - 19세,1998,173,74,99
'4678032000,  미력면,'25,20 - 24세,1998,215,134,81
'4678032000,  미력면,'30,25 - 29세,1998,132,85,47
'4678032000,  미력면,'35,30 - 34세,1998,94,56,38
'4678032000,  미력면,'40,35 - 39세,1998,123,75,48
'4678032000,  미력면,'45,40 - 44세,1998,115,65,50
'4678032000,  미력면,'50,45 - 49세,1998,108,58,50
'4678032000,  미력면,'55,50 - 54세,1998,120,47,73
'4678032000,  미력면,'60,55 - 59세,1998,249,110,139
'4678032000,  미력면,'65,60 - 64세,1998,251,114,137
'4678032000,  미력면,'70,65 - 69세,1998,184,73,111
'4678032000,  미력면,'75,70 - 74세,1998,133,63,70
'4678032000,  미력면,'80,75 - 79세,1998,77,32,45
'4678032000,  미력면,'85,80 - 84세,1998,55,19,36
'4678032000,  미력면,'90,85+ ,1998,33,8,25
'4678033000,  겸백면,'00,계,1998,2081,1033,1048
'4678033000,  겸백면,'05,0 - 4세,1998,64,38,26
'4678033000,  겸백면,'10,5 - 9세,1998,64,33,31
'4678033000,  겸백면,'15,10 - 14세,1998,95,53,42
'4678033000,  겸백면,'20,15 - 19세,1998,199,99,100
'4678033000,  겸백면,'25,20 - 24세,1998,212,127,85
'4678033000,  겸백면,'30,25 - 29세,1998,123,86,37
'4678033000,  겸백면,'35,30 - 34세,1998,85,56,29
'4678033000,  겸백면,'40,35 - 39세,1998,75,42,33
'4678033000,  겸백면,'45,40 - 44세,1998,75,40,35
'4678033000,  겸백면,'50,45 - 49세,1998,110,50,60
'4678033000,  겸백면,'55,50 - 54세,1998,107,59,48
'4678033000,  겸백면,'60,55 - 59세,1998,190,76,114
'4678033000,  겸백면,'65,60 - 64세,1998,233,96,137
'4678033000,  겸백면,'70,65 - 69세,1998,182,78,104
'4678033000,  겸백면,'75,70 - 74세,1998,97,36,61
'4678033000,  겸백면,'80,75 - 79세,1998,88,39,49
'4678033000,  겸백면,'85,80 - 84세,1998,47,21,26
'4678033000,  겸백면,'90,85+ ,1998,35,4,31
'4678034000,  율어면,'00,계,1998,2100,1054,1046
'4678034000,  율어면,'05,0 - 4세,1998,77,35,42
'4678034000,  율어면,'10,5 - 9세,1998,81,42,39
'4678034000,  율어면,'15,10 - 14세,1998,107,54,53
'4678034000,  율어면,'20,15 - 19세,1998,169,94,75
'4678034000,  율어면,'25,20 - 24세,1998,199,122,77
'4678034000,  율어면,'30,25 - 29세,1998,132,98,34
'4678034000,  율어면,'35,30 - 34세,1998,88,50,38
'4678034000,  율어면,'40,35 - 39세,1998,101,58,43
'4678034000,  율어면,'45,40 - 44세,1998,92,57,35
'4678034000,  율어면,'50,45 - 49세,1998,101,46,55
'4678034000,  율어면,'55,50 - 54세,1998,98,41,57
'4678034000,  율어면,'60,55 - 59세,1998,225,101,124
'4678034000,  율어면,'65,60 - 64세,1998,228,83,145
'4678034000,  율어면,'70,65 - 69세,1998,168,81,87
'4678034000,  율어면,'75,70 - 74세,1998,79,32,47
'4678034000,  율어면,'80,75 - 79세,1998,83,34,49
'4678034000,  율어면,'85,80 - 84세,1998,41,11,30
'4678034000,  율어면,'90,85+ ,1998,31,15,16
'4678035000,  복내면,'00,계,1998,2732,1299,1433
'4678035000,  복내면,'05,0 - 4세,1998,88,40,48
'4678035000,  복내면,'10,5 - 9세,1998,132,67,65
'4678035000,  복내면,'15,10 - 14세,1998,124,61,63
'4678035000,  복내면,'20,15 - 19세,1998,195,86,109
'4678035000,  복내면,'25,20 - 24세,1998,233,136,97
'4678035000,  복내면,'30,25 - 29세,1998,161,99,62
'4678035000,  복내면,'35,30 - 34세,1998,111,70,41
'4678035000,  복내면,'40,35 - 39세,1998,127,74,53
'4678035000,  복내면,'45,40 - 44세,1998,138,84,54
'4678035000,  복내면,'50,45 - 49세,1998,121,54,67
'4678035000,  복내면,'55,50 - 54세,1998,139,67,72
'4678035000,  복내면,'60,55 - 59세,1998,274,111,163
'4678035000,  복내면,'65,60 - 64세,1998,305,127,178
'4678035000,  복내면,'70,65 - 69세,1998,226,95,131
'4678035000,  복내면,'75,70 - 74세,1998,126,50,76
'4678035000,  복내면,'80,75 - 79세,1998,120,45,75
'4678035000,  복내면,'85,80 - 84세,1998,59,23,36
'4678035000,  복내면,'90,85+ ,1998,53,10,43
'4678036000,  문덕면,'00,계,1998,1212,611,601
'4678036000,  문덕면,'05,0 - 4세,1998,37,20,17
'4678036000,  문덕면,'10,5 - 9세,1998,26,13,13
'4678036000,  문덕면,'15,10 - 14세,1998,29,11,18
'4678036000,  문덕면,'20,15 - 19세,1998,81,43,38
'4678036000,  문덕면,'25,20 - 24세,1998,103,72,31
'4678036000,  문덕면,'30,25 - 29세,1998,69,46,23
'4678036000,  문덕면,'35,30 - 34세,1998,61,38,23
'4678036000,  문덕면,'40,35 - 39세,1998,65,43,22
'4678036000,  문덕면,'45,40 - 44세,1998,47,28,19
'4678036000,  문덕면,'50,45 - 49세,1998,75,36,39
'4678036000,  문덕면,'55,50 - 54세,1998,66,33,33
'4678036000,  문덕면,'60,55 - 59세,1998,145,59,86
'4678036000,  문덕면,'65,60 - 64세,1998,134,52,82
'4678036000,  문덕면,'70,65 - 69세,1998,94,39,55
'4678036000,  문덕면,'75,70 - 74세,1998,69,30,39
'4678036000,  문덕면,'80,75 - 79세,1998,64,27,37
'4678036000,  문덕면,'85,80 - 84세,1998,33,17,16
'4678036000,  문덕면,'90,85+ ,1998,14,4,10
'4678037000,  조성면,'00,계,1998,6651,3268,3383
'4678037000,  조성면,'05,0 - 4세,1998,258,142,116
'4678037000,  조성면,'10,5 - 9세,1998,234,120,114
'4678037000,  조성면,'15,10 - 14세,1998,336,169,167
'4678037000,  조성면,'20,15 - 19세,1998,666,324,342
'4678037000,  조성면,'25,20 - 24세,1998,611,372,239
'4678037000,  조성면,'30,25 - 29세,1998,407,253,154
'4678037000,  조성면,'35,30 - 34세,1998,315,193,122
'4678037000,  조성면,'40,35 - 39세,1998,335,183,152
'4678037000,  조성면,'45,40 - 44세,1998,322,162,160
'4678037000,  조성면,'50,45 - 49세,1998,375,188,187
'4678037000,  조성면,'55,50 - 54세,1998,402,202,200
'4678037000,  조성면,'60,55 - 59세,1998,569,232,337
'4678037000,  조성면,'65,60 - 64세,1998,592,239,353
'4678037000,  조성면,'70,65 - 69세,1998,475,209,266
'4678037000,  조성면,'75,70 - 74세,1998,283,125,158
'4678037000,  조성면,'80,75 - 79세,1998,262,101,161
'4678037000,  조성면,'85,80 - 84세,1998,111,32,79
'4678037000,  조성면,'90,85+ ,1998,98,22,76
'4678038000,  득량면,'00,계,1998,7139,3453,3686
'4678038000,  득량면,'05,0 - 4세,1998,270,151,119
'4678038000,  득량면,'10,5 - 9세,1998,335,184,151
'4678038000,  득량면,'15,10 - 14세,1998,394,174,220
'4678038000,  득량면,'20,15 - 19세,1998,723,335,388
'4678038000,  득량면,'25,20 - 24세,1998,636,369,267
'4678038000,  득량면,'30,25 - 29세,1998,405,251,154
'4678038000,  득량면,'35,30 - 34세,1998,333,185,148
'4678038000,  득량면,'40,35 - 39세,1998,401,228,173
'4678038000,  득량면,'45,40 - 44세,1998,384,198,186
'4678038000,  득량면,'50,45 - 49세,1998,393,189,204
'4678038000,  득량면,'55,50 - 54세,1998,395,185,210
'4678038000,  득량면,'60,55 - 59세,1998,621,252,369
'4678038000,  득량면,'65,60 - 64세,1998,636,285,351
'4678038000,  득량면,'70,65 - 69세,1998,482,200,282
'4678038000,  득량면,'75,70 - 74세,1998,304,120,184
'4678038000,  득량면,'80,75 - 79세,1998,234,96,138
'4678038000,  득량면,'85,80 - 84세,1998,121,37,84
'4678038000,  득량면,'90,85+ ,1998,72,14,58
'4678039000,  회천면,'00,계,1998,4811,2382,2429
'4678039000,  회천면,'05,0 - 4세,1998,178,95,83
'4678039000,  회천면,'10,5 - 9세,1998,218,119,99
'4678039000,  회천면,'15,10 - 14세,1998,284,149,135
'4678039000,  회천면,'20,15 - 19세,1998,459,213,246
'4678039000,  회천면,'25,20 - 24세,1998,428,275,153
'4678039000,  회천면,'30,25 - 29세,1998,212,124,88
'4678039000,  회천면,'35,30 - 34세,1998,244,130,114
'4678039000,  회천면,'40,35 - 39세,1998,270,146,124
'4678039000,  회천면,'45,40 - 44세,1998,265,144,121
'4678039000,  회천면,'50,45 - 49세,1998,264,130,134
'4678039000,  회천면,'55,50 - 54세,1998,287,140,147
'4678039000,  회천면,'60,55 - 59세,1998,433,191,242
'4678039000,  회천면,'65,60 - 64세,1998,389,180,209
'4678039000,  회천면,'70,65 - 69세,1998,335,139,196
'4678039000,  회천면,'75,70 - 74세,1998,221,95,126
'4678039000,  회천면,'80,75 - 79세,1998,173,70,103
'4678039000,  회천면,'85,80 - 84세,1998,92,24,68
'4678039000,  회천면,'90,85+ ,1998,59,18,41
'4678040000,  웅치면,'00,계,1998,1877,935,942
'4678040000,  웅치면,'05,0 - 4세,1998,62,29,33
'4678040000,  웅치면,'10,5 - 9세,1998,69,40,29
'4678040000,  웅치면,'15,10 - 14세,1998,86,47,39
'4678040000,  웅치면,'20,15 - 19세,1998,162,90,72
'4678040000,  웅치면,'25,20 - 24세,1998,158,91,67
'4678040000,  웅치면,'30,25 - 29세,1998,94,71,23
'4678040000,  웅치면,'35,30 - 34세,1998,83,43,40
'4678040000,  웅치면,'40,35 - 39세,1998,103,54,49
'4678040000,  웅치면,'45,40 - 44세,1998,79,41,38
'4678040000,  웅치면,'50,45 - 49세,1998,95,56,39
'4678040000,  웅치면,'55,50 - 54세,1998,113,50,63
'4678040000,  웅치면,'60,55 - 59세,1998,163,67,96
'4678040000,  웅치면,'65,60 - 64세,1998,175,71,104
'4678040000,  웅치면,'70,65 - 69세,1998,171,80,91
'4678040000,  웅치면,'75,70 - 74세,1998,114,46,68
'4678040000,  웅치면,'80,75 - 79세,1998,84,38,46
'4678040000,  웅치면,'85,80 - 84세,1998,44,18,26
'4678040000,  웅치면,'90,85+ ,1998,22,3,19
'46790, 화순군,'00,계,1998,76299,38327,37972
'46790, 화순군,'05,0 - 4세,1998,5692,2906,2786
'46790, 화순군,'10,5 - 9세,1998,4361,2223,2138
'46790, 화순군,'15,10 - 14세,1998,3580,1812,1768
'46790, 화순군,'20,15 - 19세,1998,5701,2892,2809
'46790, 화순군,'25,20 - 24세,1998,7375,4086,3289
'46790, 화순군,'30,25 - 29세,1998,7899,4384,3515
'46790, 화순군,'35,30 - 34세,1998,6393,3772,2621
'46790, 화순군,'40,35 - 39세,1998,5186,2991,2195
'46790, 화순군,'45,40 - 44세,1998,3711,2067,1644
'46790, 화순군,'50,45 - 49세,1998,3271,1575,1696
'46790, 화순군,'55,50 - 54세,1998,3677,1689,1988
'46790, 화순군,'60,55 - 59세,1998,5328,2279,3049
'46790, 화순군,'65,60 - 64세,1998,4992,2119,2873
'46790, 화순군,'70,65 - 69세,1998,3640,1477,2163
'46790, 화순군,'75,70 - 74세,1998,2418,1044,1374
'46790, 화순군,'80,75 - 79세,1998,1705,637,1068
'46790, 화순군,'85,80 - 84세,1998,794,264,530
'46790, 화순군,'90,85+ ,1998,576,110,466
'4679025000,  화순읍,'00,계,1998,37727,18914,18813
'4679025000,  화순읍,'05,0 - 4세,1998,4289,2196,2093
'4679025000,  화순읍,'10,5 - 9세,1998,3055,1555,1500
'4679025000,  화순읍,'15,10 - 14세,1998,1886,941,945
'4679025000,  화순읍,'20,15 - 19세,1998,2474,1266,1208
'4679025000,  화순읍,'25,20 - 24세,1998,3205,1621,1584
'4679025000,  화순읍,'30,25 - 29세,1998,4845,2333,2512
'4679025000,  화순읍,'35,30 - 34세,1998,4408,2452,1956
'4679025000,  화순읍,'40,35 - 39세,1998,3152,1805,1347
'4679025000,  화순읍,'45,40 - 44세,1998,1893,1068,825
'4679025000,  화순읍,'50,45 - 49세,1998,1477,694,783
'4679025000,  화순읍,'55,50 - 54세,1998,1453,703,750
'4679025000,  화순읍,'60,55 - 59세,1998,1671,720,951
'4679025000,  화순읍,'65,60 - 64세,1998,1440,641,799
'4679025000,  화순읍,'70,65 - 69세,1998,982,381,601
'4679025000,  화순읍,'75,70 - 74세,1998,650,290,360
'4679025000,  화순읍,'80,75 - 79세,1998,450,137,313
'4679025000,  화순읍,'85,80 - 84세,1998,227,82,145
'4679025000,  화순읍,'90,85+ ,1998,170,29,141
'4679031000,  한천면,'00,계,1998,2457,1242,1215
'4679031000,  한천면,'05,0 - 4세,1998,80,47,33
'4679031000,  한천면,'10,5 - 9세,1998,64,29,35
'4679031000,  한천면,'15,10 - 14세,1998,87,56,31
'4679031000,  한천면,'20,15 - 19세,1998,189,101,88
'4679031000,  한천면,'25,20 - 24세,1998,309,179,130
'4679031000,  한천면,'30,25 - 29세,1998,198,134,64
'4679031000,  한천면,'35,30 - 34세,1998,111,78,33
'4679031000,  한천면,'40,35 - 39세,1998,109,67,42
'4679031000,  한천면,'45,40 - 44세,1998,109,56,53
'4679031000,  한천면,'50,45 - 49세,1998,136,49,87
'4679031000,  한천면,'55,50 - 54세,1998,170,74,96
'4679031000,  한천면,'60,55 - 59세,1998,245,107,138
'4679031000,  한천면,'65,60 - 64세,1998,217,94,123
'4679031000,  한천면,'70,65 - 69세,1998,182,78,104
'4679031000,  한천면,'75,70 - 74세,1998,116,51,65
'4679031000,  한천면,'80,75 - 79세,1998,77,25,52
'4679031000,  한천면,'85,80 - 84세,1998,28,10,18
'4679031000,  한천면,'90,85+ ,1998,30,7,23
'4679032000,  춘양면,'00,계,1998,3098,1548,1550
'4679032000,  춘양면,'05,0 - 4세,1998,95,51,44
'4679032000,  춘양면,'10,5 - 9세,1998,81,42,39
'4679032000,  춘양면,'15,10 - 14세,1998,116,63,53
'4679032000,  춘양면,'20,15 - 19세,1998,253,128,125
'4679032000,  춘양면,'25,20 - 24세,1998,329,190,139
'4679032000,  춘양면,'30,25 - 29세,1998,221,162,59
'4679032000,  춘양면,'35,30 - 34세,1998,144,95,49
'4679032000,  춘양면,'40,35 - 39세,1998,153,82,71
'4679032000,  춘양면,'45,40 - 44세,1998,120,59,61
'4679032000,  춘양면,'50,45 - 49세,1998,137,74,63
'4679032000,  춘양면,'55,50 - 54세,1998,173,75,98
'4679032000,  춘양면,'60,55 - 59세,1998,296,148,148
'4679032000,  춘양면,'65,60 - 64세,1998,334,131,203
'4679032000,  춘양면,'70,65 - 69세,1998,269,103,166
'4679032000,  춘양면,'75,70 - 74세,1998,177,74,103
'4679032000,  춘양면,'80,75 - 79세,1998,113,49,64
'4679032000,  춘양면,'85,80 - 84세,1998,49,10,39
'4679032000,  춘양면,'90,85+ ,1998,38,12,26
'4679033000,  청풍면,'00,계,1998,1974,1029,945
'4679033000,  청풍면,'05,0 - 4세,1998,53,28,25
'4679033000,  청풍면,'10,5 - 9세,1998,57,26,31
'4679033000,  청풍면,'15,10 - 14세,1998,70,34,36
'4679033000,  청풍면,'20,15 - 19세,1998,145,78,67
'4679033000,  청풍면,'25,20 - 24세,1998,207,141,66
'4679033000,  청풍면,'30,25 - 29세,1998,156,111,45
'4679033000,  청풍면,'35,30 - 34세,1998,100,70,30
'4679033000,  청풍면,'40,35 - 39세,1998,95,62,33
'4679033000,  청풍면,'45,40 - 44세,1998,87,51,36
'4679033000,  청풍면,'50,45 - 49세,1998,78,43,35
'4679033000,  청풍면,'55,50 - 54세,1998,114,53,61
'4679033000,  청풍면,'60,55 - 59세,1998,199,83,116
'4679033000,  청풍면,'65,60 - 64세,1998,203,74,129
'4679033000,  청풍면,'70,65 - 69세,1998,171,75,96
'4679033000,  청풍면,'75,70 - 74세,1998,101,45,56
'4679033000,  청풍면,'80,75 - 79세,1998,83,40,43
'4679033000,  청풍면,'85,80 - 84세,1998,36,11,25
'4679033000,  청풍면,'90,85+ ,1998,19,4,15
'4679034000,  이양면,'00,계,1998,3333,1650,1683
'4679034000,  이양면,'05,0 - 4세,1998,110,45,65
'4679034000,  이양면,'10,5 - 9세,1998,116,65,51
'4679034000,  이양면,'15,10 - 14세,1998,158,75,83
'4679034000,  이양면,'20,15 - 19세,1998,270,137,133
'4679034000,  이양면,'25,20 - 24세,1998,340,209,131
'4679034000,  이양면,'30,25 - 29세,1998,224,142,82
'4679034000,  이양면,'35,30 - 34세,1998,152,101,51
'4679034000,  이양면,'40,35 - 39세,1998,171,106,65
'4679034000,  이양면,'45,40 - 44세,1998,149,83,66
'4679034000,  이양면,'50,45 - 49세,1998,141,74,67
'4679034000,  이양면,'55,50 - 54세,1998,199,83,116
'4679034000,  이양면,'60,55 - 59세,1998,322,134,188
'4679034000,  이양면,'65,60 - 64세,1998,347,147,200
'4679034000,  이양면,'70,65 - 69세,1998,254,104,150
'4679034000,  이양면,'75,70 - 74세,1998,168,69,99
'4679034000,  이양면,'80,75 - 79세,1998,126,53,73
'4679034000,  이양면,'85,80 - 84세,1998,55,21,34
'4679034000,  이양면,'90,85+ ,1998,31,2,29
'4679035000,  능주면,'00,계,1998,5235,2597,2638
'4679035000,  능주면,'05,0 - 4세,1998,250,134,116
'4679035000,  능주면,'10,5 - 9세,1998,272,143,129
'4679035000,  능주면,'15,10 - 14세,1998,337,163,174
'4679035000,  능주면,'20,15 - 19세,1998,515,237,278
'4679035000,  능주면,'25,20 - 24세,1998,565,319,246
'4679035000,  능주면,'30,25 - 29세,1998,432,266,166
'4679035000,  능주면,'35,30 - 34세,1998,317,193,124
'4679035000,  능주면,'40,35 - 39세,1998,323,179,144
'4679035000,  능주면,'45,40 - 44세,1998,306,157,149
'4679035000,  능주면,'50,45 - 49세,1998,275,131,144
'4679035000,  능주면,'55,50 - 54세,1998,276,135,141
'4679035000,  능주면,'60,55 - 59세,1998,363,169,194
'4679035000,  능주면,'65,60 - 64세,1998,363,142,221
'4679035000,  능주면,'70,65 - 69세,1998,256,103,153
'4679035000,  능주면,'75,70 - 74세,1998,165,63,102
'4679035000,  능주면,'80,75 - 79세,1998,114,41,73
'4679035000,  능주면,'85,80 - 84세,1998,60,16,44
'4679035000,  능주면,'90,85+ ,1998,46,6,40
'4679036000,  도곡면,'00,계,1998,3705,1870,1835
'4679036000,  도곡면,'05,0 - 4세,1998,137,71,66
'4679036000,  도곡면,'10,5 - 9세,1998,104,57,47
'4679036000,  도곡면,'15,10 - 14세,1998,179,98,81
'4679036000,  도곡면,'20,15 - 19세,1998,311,162,149
'4679036000,  도곡면,'25,20 - 24세,1998,395,225,170
'4679036000,  도곡면,'30,25 - 29세,1998,314,211,103
'4679036000,  도곡면,'35,30 - 34세,1998,184,130,54
'4679036000,  도곡면,'40,35 - 39세,1998,195,102,93
'4679036000,  도곡면,'45,40 - 44세,1998,209,121,88
'4679036000,  도곡면,'50,45 - 49세,1998,170,90,80
'4679036000,  도곡면,'55,50 - 54세,1998,210,99,111
'4679036000,  도곡면,'60,55 - 59세,1998,327,134,193
'4679036000,  도곡면,'65,60 - 64세,1998,348,120,228
'4679036000,  도곡면,'70,65 - 69세,1998,253,109,144
'4679036000,  도곡면,'75,70 - 74세,1998,172,75,97
'4679036000,  도곡면,'80,75 - 79세,1998,116,40,76
'4679036000,  도곡면,'85,80 - 84세,1998,49,20,29
'4679036000,  도곡면,'90,85+ ,1998,32,6,26
'4679037000,  도암면,'00,계,1998,2422,1221,1201
'4679037000,  도암면,'05,0 - 4세,1998,70,33,37
'4679037000,  도암면,'10,5 - 9세,1998,60,26,34
'4679037000,  도암면,'15,10 - 14세,1998,89,47,42
'4679037000,  도암면,'20,15 - 19세,1998,199,99,100
'4679037000,  도암면,'25,20 - 24세,1998,262,167,95
'4679037000,  도암면,'30,25 - 29세,1998,188,139,49
'4679037000,  도암면,'35,30 - 34세,1998,123,79,44
'4679037000,  도암면,'40,35 - 39세,1998,110,68,42
'4679037000,  도암면,'45,40 - 44세,1998,107,52,55
'4679037000,  도암면,'50,45 - 49세,1998,104,56,48
'4679037000,  도암면,'55,50 - 54세,1998,138,48,90
'4679037000,  도암면,'60,55 - 59세,1998,286,127,159
'4679037000,  도암면,'65,60 - 64세,1998,241,112,129
'4679037000,  도암면,'70,65 - 69세,1998,169,64,105
'4679037000,  도암면,'75,70 - 74세,1998,114,49,65
'4679037000,  도암면,'80,75 - 79세,1998,91,37,54
'4679037000,  도암면,'85,80 - 84세,1998,49,13,36
'4679037000,  도암면,'90,85+ ,1998,22,5,17
'4679038000,  이서면,'00,계,1998,1299,659,640
'4679038000,  이서면,'05,0 - 4세,1998,35,18,17
'4679038000,  이서면,'10,5 - 9세,1998,51,30,21
'4679038000,  이서면,'15,10 - 14세,1998,45,25,20
'4679038000,  이서면,'20,15 - 19세,1998,98,52,46
'4679038000,  이서면,'25,20 - 24세,1998,111,63,48
'4679038000,  이서면,'30,25 - 29세,1998,88,62,26
'4679038000,  이서면,'35,30 - 34세,1998,67,43,24
'4679038000,  이서면,'40,35 - 39세,1998,66,42,24
'4679038000,  이서면,'45,40 - 44세,1998,60,35,25
'4679038000,  이서면,'50,45 - 49세,1998,68,35,33
'4679038000,  이서면,'55,50 - 54세,1998,82,35,47
'4679038000,  이서면,'60,55 - 59세,1998,134,49,85
'4679038000,  이서면,'65,60 - 64세,1998,144,71,73
'4679038000,  이서면,'70,65 - 69세,1998,95,39,56
'4679038000,  이서면,'75,70 - 74세,1998,68,30,38
'4679038000,  이서면,'80,75 - 79세,1998,53,22,31
'4679038000,  이서면,'85,80 - 84세,1998,17,6,11
'4679038000,  이서면,'90,85+ ,1998,17,2,15
'4679039000,  북면,'00,계,1998,2748,1371,1377
'4679039000,  북면,'05,0 - 4세,1998,100,55,45
'4679039000,  북면,'10,5 - 9세,1998,94,50,44
'4679039000,  북면,'15,10 - 14세,1998,91,36,55
'4679039000,  북면,'20,15 - 19세,1998,216,104,112
'4679039000,  북면,'25,20 - 24세,1998,295,185,110
'4679039000,  북면,'30,25 - 29세,1998,194,126,68
'4679039000,  북면,'35,30 - 34세,1998,138,98,40
'4679039000,  북면,'40,35 - 39세,1998,141,85,56
'4679039000,  북면,'45,40 - 44세,1998,113,73,40
'4679039000,  북면,'50,45 - 49세,1998,115,53,62
'4679039000,  북면,'55,50 - 54세,1998,159,56,103
'4679039000,  북면,'60,55 - 59세,1998,303,126,177
'4679039000,  북면,'65,60 - 64세,1998,265,116,149
'4679039000,  북면,'70,65 - 69세,1998,207,90,117
'4679039000,  북면,'75,70 - 74세,1998,141,66,75
'4679039000,  북면,'80,75 - 79세,1998,91,30,61
'4679039000,  북면,'85,80 - 84세,1998,44,12,32
'4679039000,  북면,'90,85+ ,1998,41,10,31
'4679040000,  동복면,'00,계,1998,2892,1426,1466
'4679040000,  동복면,'05,0 - 4세,1998,84,34,50
'4679040000,  동복면,'10,5 - 9세,1998,80,42,38
'4679040000,  동복면,'15,10 - 14세,1998,122,65,57
'4679040000,  동복면,'20,15 - 19세,1998,251,144,107
'4679040000,  동복면,'25,20 - 24세,1998,312,178,134
'4679040000,  동복면,'30,25 - 29세,1998,194,132,62
'4679040000,  동복면,'35,30 - 34세,1998,130,83,47
'4679040000,  동복면,'40,35 - 39세,1998,148,94,54
'4679040000,  동복면,'45,40 - 44세,1998,124,64,60
'4679040000,  동복면,'50,45 - 49세,1998,140,66,74
'4679040000,  동복면,'55,50 - 54세,1998,169,75,94
'4679040000,  동복면,'60,55 - 59세,1998,283,110,173
'4679040000,  동복면,'65,60 - 64세,1998,262,116,146
'4679040000,  동복면,'70,65 - 69세,1998,214,80,134
'4679040000,  동복면,'75,70 - 74세,1998,156,55,101
'4679040000,  동복면,'80,75 - 79세,1998,125,57,68
'4679040000,  동복면,'85,80 - 84세,1998,58,20,38
'4679040000,  동복면,'90,85+ ,1998,40,11,29
'4679041000,  남면,'00,계,1998,3807,1939,1868
'4679041000,  남면,'05,0 - 4세,1998,136,75,61
'4679041000,  남면,'10,5 - 9세,1998,130,65,65
'4679041000,  남면,'15,10 - 14세,1998,161,79,82
'4679041000,  남면,'20,15 - 19세,1998,331,152,179
'4679041000,  남면,'25,20 - 24세,1998,414,242,172
'4679041000,  남면,'30,25 - 29세,1998,283,198,85
'4679041000,  남면,'35,30 - 34세,1998,194,133,61
'4679041000,  남면,'40,35 - 39세,1998,189,98,91
'4679041000,  남면,'45,40 - 44세,1998,183,110,73
'4679041000,  남면,'50,45 - 49세,1998,175,93,82
'4679041000,  남면,'55,50 - 54세,1998,224,108,116
'4679041000,  남면,'60,55 - 59세,1998,380,159,221
'4679041000,  남면,'65,60 - 64세,1998,321,129,192
'4679041000,  남면,'70,65 - 69세,1998,277,118,159
'4679041000,  남면,'75,70 - 74세,1998,185,92,93
'4679041000,  남면,'80,75 - 79세,1998,126,55,71
'4679041000,  남면,'85,80 - 84세,1998,58,23,35
'4679041000,  남면,'90,85+ ,1998,40,10,30
'4679042000,  동면,'00,계,1998,5602,2861,2741
'4679042000,  동면,'05,0 - 4세,1998,253,119,134
'4679042000,  동면,'10,5 - 9세,1998,197,93,104
'4679042000,  동면,'15,10 - 14세,1998,239,130,109
'4679042000,  동면,'20,15 - 19세,1998,449,232,217
'4679042000,  동면,'25,20 - 24세,1998,631,367,264
'4679042000,  동면,'30,25 - 29세,1998,562,368,194
'4679042000,  동면,'35,30 - 34세,1998,325,217,108
'4679042000,  동면,'40,35 - 39세,1998,334,201,133
'4679042000,  동면,'45,40 - 44세,1998,251,138,113
'4679042000,  동면,'50,45 - 49세,1998,255,117,138
'4679042000,  동면,'55,50 - 54세,1998,310,145,165
'4679042000,  동면,'60,55 - 59세,1998,519,213,306
'4679042000,  동면,'65,60 - 64세,1998,507,226,281
'4679042000,  동면,'70,65 - 69세,1998,311,133,178
'4679042000,  동면,'75,70 - 74세,1998,205,85,120
'4679042000,  동면,'80,75 - 79세,1998,140,51,89
'4679042000,  동면,'85,80 - 84세,1998,64,20,44
'4679042000,  동면,'90,85+ ,1998,50,6,44
'46800, 장흥군,'00,계,1998,56894,27765,29129
'46800, 장흥군,'05,0 - 4세,1998,2863,1505,1358
'46800, 장흥군,'10,5 - 9세,1998,2884,1467,1417
'46800, 장흥군,'15,10 - 14세,1998,3740,1856,1884
'46800, 장흥군,'20,15 - 19세,1998,5750,2885,2865
'46800, 장흥군,'25,20 - 24세,1998,4950,2932,2018
'46800, 장흥군,'30,25 - 29세,1998,3346,1919,1427
'46800, 장흥군,'35,30 - 34세,1998,3067,1651,1416
'46800, 장흥군,'40,35 - 39세,1998,3436,1812,1624
'46800, 장흥군,'45,40 - 44세,1998,3081,1546,1535
'46800, 장흥군,'50,45 - 49세,1998,2823,1422,1401
'46800, 장흥군,'55,50 - 54세,1998,3164,1475,1689
'46800, 장흥군,'60,55 - 59세,1998,4412,1950,2462
'46800, 장흥군,'65,60 - 64세,1998,4424,1909,2515
'46800, 장흥군,'70,65 - 69세,1998,3590,1450,2140
'46800, 장흥군,'75,70 - 74세,1998,2346,974,1372
'46800, 장흥군,'80,75 - 79세,1998,1677,626,1051
'46800, 장흥군,'85,80 - 84세,1998,800,274,526
'46800, 장흥군,'90,85+ ,1998,541,112,429
'4680025000,  장흥읍,'00,계,1998,17549,8543,9006
'4680025000,  장흥읍,'05,0 - 4세,1998,1208,648,560
'4680025000,  장흥읍,'10,5 - 9세,1998,1180,624,556
'4680025000,  장흥읍,'15,10 - 14세,1998,1385,682,703
'4680025000,  장흥읍,'20,15 - 19세,1998,1755,870,885
'4680025000,  장흥읍,'25,20 - 24세,1998,1318,725,593
'4680025000,  장흥읍,'30,25 - 29세,1998,1201,590,611
'4680025000,  장흥읍,'35,30 - 34세,1998,1249,655,594
'4680025000,  장흥읍,'40,35 - 39세,1998,1337,693,644
'4680025000,  장흥읍,'45,40 - 44세,1998,1146,562,584
'4680025000,  장흥읍,'50,45 - 49세,1998,877,446,431
'4680025000,  장흥읍,'55,50 - 54세,1998,887,459,428
'4680025000,  장흥읍,'60,55 - 59세,1998,973,432,541
'4680025000,  장흥읍,'65,60 - 64세,1998,958,407,551
'4680025000,  장흥읍,'70,65 - 69세,1998,809,297,512
'4680025000,  장흥읍,'75,70 - 74세,1998,553,230,323
'4680025000,  장흥읍,'80,75 - 79세,1998,420,149,271
'4680025000,  장흥읍,'85,80 - 84세,1998,179,51,128
'4680025000,  장흥읍,'90,85+ ,1998,114,23,91
'4680025300,  관산읍,'00,계,1998,9318,4546,4772
'4680025300,  관산읍,'05,0 - 4세,1998,423,225,198
'4680025300,  관산읍,'10,5 - 9세,1998,461,230,231
'4680025300,  관산읍,'15,10 - 14세,1998,674,325,349
'4680025300,  관산읍,'20,15 - 19세,1998,1061,545,516
'4680025300,  관산읍,'25,20 - 24세,1998,841,508,333
'4680025300,  관산읍,'30,25 - 29세,1998,456,281,175
'4680025300,  관산읍,'35,30 - 34세,1998,454,234,220
'4680025300,  관산읍,'40,35 - 39세,1998,550,281,269
'4680025300,  관산읍,'45,40 - 44세,1998,503,252,251
'4680025300,  관산읍,'50,45 - 49세,1998,489,245,244
'4680025300,  관산읍,'55,50 - 54세,1998,528,250,278
'4680025300,  관산읍,'60,55 - 59세,1998,738,328,410
'4680025300,  관산읍,'65,60 - 64세,1998,736,314,422
'4680025300,  관산읍,'70,65 - 69세,1998,592,246,346
'4680025300,  관산읍,'75,70 - 74세,1998,342,135,207
'4680025300,  관산읍,'80,75 - 79세,1998,263,91,172
'4680025300,  관산읍,'85,80 - 84세,1998,124,43,81
'4680025300,  관산읍,'90,85+ ,1998,83,13,70
'4680025600,  대덕읍,'00,계,1998,5918,2899,3019
'4680025600,  대덕읍,'05,0 - 4세,1998,264,143,121
'4680025600,  대덕읍,'10,5 - 9세,1998,288,152,136
'4680025600,  대덕읍,'15,10 - 14세,1998,350,172,178
'4680025600,  대덕읍,'20,15 - 19세,1998,650,307,343
'4680025600,  대덕읍,'25,20 - 24세,1998,562,347,215
'4680025600,  대덕읍,'30,25 - 29세,1998,327,191,136
'4680025600,  대덕읍,'35,30 - 34세,1998,274,157,117
'4680025600,  대덕읍,'40,35 - 39세,1998,301,156,145
'4680025600,  대덕읍,'45,40 - 44세,1998,332,168,164
'4680025600,  대덕읍,'50,45 - 49세,1998,320,158,162
'4680025600,  대덕읍,'55,50 - 54세,1998,339,151,188
'4680025600,  대덕읍,'60,55 - 59세,1998,510,231,279
'4680025600,  대덕읍,'65,60 - 64세,1998,530,245,285
'4680025600,  대덕읍,'70,65 - 69세,1998,376,160,216
'4680025600,  대덕읍,'75,70 - 74세,1998,208,83,125
'4680025600,  대덕읍,'80,75 - 79세,1998,169,57,112
'4680025600,  대덕읍,'85,80 - 84세,1998,66,14,52
'4680025600,  대덕읍,'90,85+ ,1998,52,7,45
'4680031000,  용산면,'00,계,1998,3808,1826,1982
'4680031000,  용산면,'05,0 - 4세,1998,113,63,50
'4680031000,  용산면,'10,5 - 9세,1998,139,61,78
'4680031000,  용산면,'15,10 - 14세,1998,235,122,113
'4680031000,  용산면,'20,15 - 19세,1998,408,203,205
'4680031000,  용산면,'25,20 - 24세,1998,356,212,144
'4680031000,  용산면,'30,25 - 29세,1998,182,121,61
'4680031000,  용산면,'35,30 - 34세,1998,124,78,46
'4680031000,  용산면,'40,35 - 39세,1998,186,94,92
'4680031000,  용산면,'45,40 - 44세,1998,174,90,84
'4680031000,  용산면,'50,45 - 49세,1998,186,98,88
'4680031000,  용산면,'55,50 - 54세,1998,222,94,128
'4680031000,  용산면,'60,55 - 59세,1998,368,150,218
'4680031000,  용산면,'65,60 - 64세,1998,374,163,211
'4680031000,  용산면,'70,65 - 69세,1998,312,125,187
'4680031000,  용산면,'75,70 - 74세,1998,190,74,116
'4680031000,  용산면,'80,75 - 79세,1998,142,50,92
'4680031000,  용산면,'85,80 - 84세,1998,52,18,34
'4680031000,  용산면,'90,85+ ,1998,45,10,35
'4680032000,  안양면,'00,계,1998,4378,2137,2241
'4680032000,  안양면,'05,0 - 4세,1998,179,92,87
'4680032000,  안양면,'10,5 - 9세,1998,187,97,90
'4680032000,  안양면,'15,10 - 14세,1998,257,134,123
'4680032000,  안양면,'20,15 - 19세,1998,408,219,189
'4680032000,  안양면,'25,20 - 24세,1998,351,215,136
'4680032000,  안양면,'30,25 - 29세,1998,237,144,93
'4680032000,  안양면,'35,30 - 34세,1998,187,100,87
'4680032000,  안양면,'40,35 - 39세,1998,249,136,113
'4680032000,  안양면,'45,40 - 44세,1998,190,102,88
'4680032000,  안양면,'50,45 - 49세,1998,216,109,107
'4680032000,  안양면,'55,50 - 54세,1998,266,117,149
'4680032000,  안양면,'60,55 - 59세,1998,328,151,177
'4680032000,  안양면,'65,60 - 64세,1998,388,149,239
'4680032000,  안양면,'70,65 - 69세,1998,380,145,235
'4680032000,  안양면,'75,70 - 74세,1998,266,114,152
'4680032000,  안양면,'80,75 - 79세,1998,157,64,93
'4680032000,  안양면,'85,80 - 84세,1998,85,37,48
'4680032000,  안양면,'90,85+ ,1998,47,12,35
'4680033000,  장동면,'00,계,1998,2020,1000,1020
'4680033000,  장동면,'05,0 - 4세,1998,86,43,43
'4680033000,  장동면,'10,5 - 9세,1998,71,29,42
'4680033000,  장동면,'15,10 - 14세,1998,100,53,47
'4680033000,  장동면,'20,15 - 19세,1998,163,82,81
'4680033000,  장동면,'25,20 - 24세,1998,177,108,69
'4680033000,  장동면,'30,25 - 29세,1998,111,73,38
'4680033000,  장동면,'35,30 - 34세,1998,88,47,41
'4680033000,  장동면,'40,35 - 39세,1998,93,51,42
'4680033000,  장동면,'45,40 - 44세,1998,102,54,48
'4680033000,  장동면,'50,45 - 49세,1998,85,45,40
'4680033000,  장동면,'55,50 - 54세,1998,99,50,49
'4680033000,  장동면,'60,55 - 59세,1998,182,75,107
'4680033000,  장동면,'65,60 - 64세,1998,213,90,123
'4680033000,  장동면,'70,65 - 69세,1998,169,64,105
'4680033000,  장동면,'75,70 - 74세,1998,121,70,51
'4680033000,  장동면,'80,75 - 79세,1998,77,33,44
'4680033000,  장동면,'85,80 - 84세,1998,44,21,23
'4680033000,  장동면,'90,85+ ,1998,39,12,27
'4680034000,  장평면,'00,계,1998,3659,1833,1826
'4680034000,  장평면,'05,0 - 4세,1998,157,87,70
'4680034000,  장평면,'10,5 - 9세,1998,129,62,67
'4680034000,  장평면,'15,10 - 14세,1998,160,81,79
'4680034000,  장평면,'20,15 - 19세,1998,289,159,130
'4680034000,  장평면,'25,20 - 24세,1998,342,219,123
'4680034000,  장평면,'30,25 - 29세,1998,217,150,67
'4680034000,  장평면,'35,30 - 34세,1998,176,100,76
'4680034000,  장평면,'40,35 - 39세,1998,174,101,73
'4680034000,  장평면,'45,40 - 44세,1998,137,72,65
'4680034000,  장평면,'50,45 - 49세,1998,159,79,80
'4680034000,  장평면,'55,50 - 54세,1998,199,84,115
'4680034000,  장평면,'60,55 - 59세,1998,397,166,231
'4680034000,  장평면,'65,60 - 64세,1998,414,177,237
'4680034000,  장평면,'70,65 - 69세,1998,279,131,148
'4680034000,  장평면,'75,70 - 74세,1998,172,67,105
'4680034000,  장평면,'80,75 - 79세,1998,130,62,68
'4680034000,  장평면,'85,80 - 84세,1998,82,27,55
'4680034000,  장평면,'90,85+ ,1998,46,9,37
'4680035000,  유치면,'00,계,1998,3339,1637,1702
'4680035000,  유치면,'05,0 - 4세,1998,172,86,86
'4680035000,  유치면,'10,5 - 9세,1998,137,70,67
'4680035000,  유치면,'15,10 - 14세,1998,136,73,63
'4680035000,  유치면,'20,15 - 19세,1998,246,127,119
'4680035000,  유치면,'25,20 - 24세,1998,328,199,129
'4680035000,  유치면,'30,25 - 29세,1998,235,130,105
'4680035000,  유치면,'35,30 - 34세,1998,218,117,101
'4680035000,  유치면,'40,35 - 39세,1998,206,115,91
'4680035000,  유치면,'45,40 - 44세,1998,154,85,69
'4680035000,  유치면,'50,45 - 49세,1998,128,68,60
'4680035000,  유치면,'55,50 - 54세,1998,168,72,96
'4680035000,  유치면,'60,55 - 59세,1998,281,105,176
'4680035000,  유치면,'65,60 - 64세,1998,267,118,149
'4680035000,  유치면,'70,65 - 69세,1998,264,115,149
'4680035000,  유치면,'75,70 - 74세,1998,183,73,110
'4680035000,  유치면,'80,75 - 79세,1998,119,43,76
'4680035000,  유치면,'85,80 - 84세,1998,62,29,33
'4680035000,  유치면,'90,85+ ,1998,35,12,23
'4680036000,  부산면,'00,계,1998,2107,977,1130
'4680036000,  부산면,'05,0 - 4세,1998,60,28,32
'4680036000,  부산면,'10,5 - 9세,1998,54,23,31
'4680036000,  부산면,'15,10 - 14세,1998,65,33,32
'4680036000,  부산면,'20,15 - 19세,1998,165,76,89
'4680036000,  부산면,'25,20 - 24세,1998,208,115,93
'4680036000,  부산면,'30,25 - 29세,1998,135,79,56
'4680036000,  부산면,'35,30 - 34세,1998,77,50,27
'4680036000,  부산면,'40,35 - 39세,1998,72,48,24
'4680036000,  부산면,'45,40 - 44세,1998,67,26,41
'4680036000,  부산면,'50,45 - 49세,1998,82,41,41
'4680036000,  부산면,'55,50 - 54세,1998,135,49,86
'4680036000,  부산면,'60,55 - 59세,1998,222,104,118
'4680036000,  부산면,'65,60 - 64세,1998,235,97,138
'4680036000,  부산면,'70,65 - 69세,1998,192,74,118
'4680036000,  부산면,'75,70 - 74세,1998,153,64,89
'4680036000,  부산면,'80,75 - 79세,1998,97,38,59
'4680036000,  부산면,'85,80 - 84세,1998,51,22,29
'4680036000,  부산면,'90,85+ ,1998,37,10,27
'4680037000,  회진면,'00,계,1998,4798,2367,2431
'4680037000,  회진면,'05,0 - 4세,1998,201,90,111
'4680037000,  회진면,'10,5 - 9세,1998,238,119,119
'4680037000,  회진면,'15,10 - 14세,1998,378,181,197
'4680037000,  회진면,'20,15 - 19세,1998,605,297,308
'4680037000,  회진면,'25,20 - 24세,1998,467,284,183
'4680037000,  회진면,'30,25 - 29세,1998,245,160,85
'4680037000,  회진면,'35,30 - 34세,1998,220,113,107
'4680037000,  회진면,'40,35 - 39세,1998,268,137,131
'4680037000,  회진면,'45,40 - 44세,1998,276,135,141
'4680037000,  회진면,'50,45 - 49세,1998,281,133,148
'4680037000,  회진면,'55,50 - 54세,1998,321,149,172
'4680037000,  회진면,'60,55 - 59세,1998,413,208,205
'4680037000,  회진면,'65,60 - 64세,1998,309,149,160
'4680037000,  회진면,'70,65 - 69세,1998,217,93,124
'4680037000,  회진면,'75,70 - 74세,1998,158,64,94
'4680037000,  회진면,'80,75 - 79세,1998,103,39,64
'4680037000,  회진면,'85,80 - 84세,1998,55,12,43
'4680037000,  회진면,'90,85+ ,1998,43,4,39
'46810, 강진군,'00,계,1998,51739,25130,26609
'46810, 강진군,'05,0 - 4세,1998,2540,1321,1219
'46810, 강진군,'10,5 - 9세,1998,2757,1450,1307
'46810, 강진군,'15,10 - 14세,1998,3225,1637,1588
'46810, 강진군,'20,15 - 19세,1998,5025,2486,2539
'46810, 강진군,'25,20 - 24세,1998,4543,2598,1945
'46810, 강진군,'30,25 - 29세,1998,3198,1888,1310
'46810, 강진군,'35,30 - 34세,1998,2842,1511,1331
'46810, 강진군,'40,35 - 39세,1998,3325,1725,1600
'46810, 강진군,'45,40 - 44세,1998,2782,1437,1345
'46810, 강진군,'50,45 - 49세,1998,2609,1269,1340
'46810, 강진군,'55,50 - 54세,1998,3007,1393,1614
'46810, 강진군,'60,55 - 59세,1998,3975,1772,2203
'46810, 강진군,'65,60 - 64세,1998,3970,1730,2240
'46810, 강진군,'70,65 - 69세,1998,3189,1238,1951
'46810, 강진군,'75,70 - 74세,1998,2057,812,1245
'46810, 강진군,'80,75 - 79세,1998,1454,551,903
'46810, 강진군,'85,80 - 84세,1998,702,200,502
'46810, 강진군,'90,85+ ,1998,539,112,427
'4681025000,  강진읍,'00,계,1998,18441,8998,9443
'4681025000,  강진읍,'05,0 - 4세,1998,1393,724,669
'4681025000,  강진읍,'10,5 - 9세,1998,1453,756,697
'4681025000,  강진읍,'15,10 - 14세,1998,1469,764,705
'4681025000,  강진읍,'20,15 - 19세,1998,1706,844,862
'4681025000,  강진읍,'25,20 - 24세,1998,1509,807,702
'4681025000,  강진읍,'30,25 - 29세,1998,1368,682,686
'4681025000,  강진읍,'35,30 - 34세,1998,1376,675,701
'4681025000,  강진읍,'40,35 - 39세,1998,1509,746,763
'4681025000,  강진읍,'45,40 - 44세,1998,1157,593,564
'4681025000,  강진읍,'50,45 - 49세,1998,964,482,482
'4681025000,  강진읍,'55,50 - 54세,1998,897,457,440
'4681025000,  강진읍,'60,55 - 59세,1998,999,466,533
'4681025000,  강진읍,'65,60 - 64세,1998,860,377,483
'4681025000,  강진읍,'70,65 - 69세,1998,697,253,444
'4681025000,  강진읍,'75,70 - 74세,1998,460,176,284
'4681025000,  강진읍,'80,75 - 79세,1998,332,119,213
'4681025000,  강진읍,'85,80 - 84세,1998,164,45,119
'4681025000,  강진읍,'90,85+ ,1998,128,32,96
'4681031000,  군동면,'00,계,1998,5080,2426,2654
'4681031000,  군동면,'05,0 - 4세,1998,197,107,90
'4681031000,  군동면,'10,5 - 9세,1998,158,90,68
'4681031000,  군동면,'15,10 - 14세,1998,222,115,107
'4681031000,  군동면,'20,15 - 19세,1998,448,211,237
'4681031000,  군동면,'25,20 - 24세,1998,435,252,183
'4681031000,  군동면,'30,25 - 29세,1998,279,178,101
'4681031000,  군동면,'35,30 - 34세,1998,232,141,91
'4681031000,  군동면,'40,35 - 39세,1998,271,157,114
'4681031000,  군동면,'45,40 - 44세,1998,235,130,105
'4681031000,  군동면,'50,45 - 49세,1998,240,111,129
'4681031000,  군동면,'55,50 - 54세,1998,306,135,171
'4681031000,  군동면,'60,55 - 59세,1998,448,176,272
'4681031000,  군동면,'65,60 - 64세,1998,554,253,301
'4681031000,  군동면,'70,65 - 69세,1998,425,151,274
'4681031000,  군동면,'75,70 - 74세,1998,273,113,160
'4681031000,  군동면,'80,75 - 79세,1998,181,67,114
'4681031000,  군동면,'85,80 - 84세,1998,91,25,66
'4681031000,  군동면,'90,85+ ,1998,85,14,71
'4681032000,  칠량면,'00,계,1998,3982,1922,2060
'4681032000,  칠량면,'05,0 - 4세,1998,128,63,65
'4681032000,  칠량면,'10,5 - 9세,1998,158,82,76
'4681032000,  칠량면,'15,10 - 14세,1998,230,111,119
'4681032000,  칠량면,'20,15 - 19세,1998,390,187,203
'4681032000,  칠량면,'25,20 - 24세,1998,411,244,167
'4681032000,  칠량면,'30,25 - 29세,1998,227,163,64
'4681032000,  칠량면,'35,30 - 34세,1998,180,90,90
'4681032000,  칠량면,'40,35 - 39세,1998,223,127,96
'4681032000,  칠량면,'45,40 - 44세,1998,197,102,95
'4681032000,  칠량면,'50,45 - 49세,1998,190,100,90
'4681032000,  칠량면,'55,50 - 54세,1998,233,101,132
'4681032000,  칠량면,'60,55 - 59세,1998,349,151,198
'4681032000,  칠량면,'65,60 - 64세,1998,373,155,218
'4681032000,  칠량면,'70,65 - 69세,1998,289,117,172
'4681032000,  칠량면,'75,70 - 74세,1998,185,64,121
'4681032000,  칠량면,'80,75 - 79세,1998,123,48,75
'4681032000,  칠량면,'85,80 - 84세,1998,53,13,40
'4681032000,  칠량면,'90,85+ ,1998,43,4,39
'4681033000,  대구면,'00,계,1998,2041,954,1087
'4681033000,  대구면,'05,0 - 4세,1998,65,26,39
'4681033000,  대구면,'10,5 - 9세,1998,83,42,41
'4681033000,  대구면,'15,10 - 14세,1998,123,64,59
'4681033000,  대구면,'20,15 - 19세,1998,223,101,122
'4681033000,  대구면,'25,20 - 24세,1998,219,126,93
'4681033000,  대구면,'30,25 - 29세,1998,111,61,50
'4681033000,  대구면,'35,30 - 34세,1998,81,54,27
'4681033000,  대구면,'40,35 - 39세,1998,112,50,62
'4681033000,  대구면,'45,40 - 44세,1998,94,55,39
'4681033000,  대구면,'50,45 - 49세,1998,107,50,57
'4681033000,  대구면,'55,50 - 54세,1998,154,74,80
'4681033000,  대구면,'60,55 - 59세,1998,173,80,93
'4681033000,  대구면,'65,60 - 64세,1998,173,73,100
'4681033000,  대구면,'70,65 - 69세,1998,133,43,90
'4681033000,  대구면,'75,70 - 74세,1998,80,28,52
'4681033000,  대구면,'80,75 - 79세,1998,56,19,37
'4681033000,  대구면,'85,80 - 84세,1998,32,4,28
'4681033000,  대구면,'90,85+ ,1998,22,4,18
'4681034000,  도암면,'00,계,1998,4246,2079,2167
'4681034000,  도암면,'05,0 - 4세,1998,125,65,60
'4681034000,  도암면,'10,5 - 9세,1998,183,109,74
'4681034000,  도암면,'15,10 - 14세,1998,230,110,120
'4681034000,  도암면,'20,15 - 19세,1998,415,206,209
'4681034000,  도암면,'25,20 - 24세,1998,393,230,163
'4681034000,  도암면,'30,25 - 29세,1998,253,175,78
'4681034000,  도암면,'35,30 - 34세,1998,195,109,86
'4681034000,  도암면,'40,35 - 39세,1998,219,114,105
'4681034000,  도암면,'45,40 - 44세,1998,214,110,104
'4681034000,  도암면,'50,45 - 49세,1998,218,112,106
'4681034000,  도암면,'55,50 - 54세,1998,279,105,174
'4681034000,  도암면,'60,55 - 59세,1998,380,175,205
'4681034000,  도암면,'65,60 - 64세,1998,396,168,228
'4681034000,  도암면,'70,65 - 69세,1998,314,135,179
'4681034000,  도암면,'75,70 - 74세,1998,187,73,114
'4681034000,  도암면,'80,75 - 79세,1998,143,57,86
'4681034000,  도암면,'85,80 - 84세,1998,60,21,39
'4681034000,  도암면,'90,85+ ,1998,42,5,37
'4681035000,  신전면,'00,계,1998,3109,1533,1576
'4681035000,  신전면,'05,0 - 4세,1998,84,47,37
'4681035000,  신전면,'10,5 - 9세,1998,123,65,58
'4681035000,  신전면,'15,10 - 14세,1998,171,86,85
'4681035000,  신전면,'20,15 - 19세,1998,335,156,179
'4681035000,  신전면,'25,20 - 24세,1998,298,174,124
'4681035000,  신전면,'30,25 - 29세,1998,152,106,46
'4681035000,  신전면,'35,30 - 34세,1998,140,76,64
'4681035000,  신전면,'40,35 - 39세,1998,192,112,80
'4681035000,  신전면,'45,40 - 44세,1998,149,73,76
'4681035000,  신전면,'50,45 - 49세,1998,179,91,88
'4681035000,  신전면,'55,50 - 54세,1998,198,95,103
'4681035000,  신전면,'60,55 - 59세,1998,300,145,155
'4681035000,  신전면,'65,60 - 64세,1998,277,122,155
'4681035000,  신전면,'70,65 - 69세,1998,215,85,130
'4681035000,  신전면,'75,70 - 74세,1998,112,52,60
'4681035000,  신전면,'80,75 - 79세,1998,94,36,58
'4681035000,  신전면,'85,80 - 84세,1998,54,5,49
'4681035000,  신전면,'90,85+ ,1998,36,7,29
'4681036000,  성전면,'00,계,1998,4605,2293,2312
'4681036000,  성전면,'05,0 - 4세,1998,189,105,84
'4681036000,  성전면,'10,5 - 9세,1998,196,100,96
'4681036000,  성전면,'15,10 - 14세,1998,223,114,109
'4681036000,  성전면,'20,15 - 19세,1998,535,280,255
'4681036000,  성전면,'25,20 - 24세,1998,412,235,177
'4681036000,  성전면,'30,25 - 29세,1998,281,191,90
'4681036000,  성전면,'35,30 - 34세,1998,190,112,78
'4681036000,  성전면,'40,35 - 39세,1998,272,146,126
'4681036000,  성전면,'45,40 - 44세,1998,218,101,117
'4681036000,  성전면,'50,45 - 49세,1998,232,115,117
'4681036000,  성전면,'55,50 - 54세,1998,296,146,150
'4681036000,  성전면,'60,55 - 59세,1998,379,152,227
'4681036000,  성전면,'65,60 - 64세,1998,411,191,220
'4681036000,  성전면,'70,65 - 69세,1998,315,133,182
'4681036000,  성전면,'75,70 - 74세,1998,212,94,118
'4681036000,  성전면,'80,75 - 79세,1998,128,43,85
'4681036000,  성전면,'85,80 - 84세,1998,63,23,40
'4681036000,  성전면,'90,85+ ,1998,53,12,41
'4681037000,  작천면,'00,계,1998,3181,1553,1628
'4681037000,  작천면,'05,0 - 4세,1998,99,50,49
'4681037000,  작천면,'10,5 - 9세,1998,119,69,50
'4681037000,  작천면,'15,10 - 14세,1998,151,80,71
'4681037000,  작천면,'20,15 - 19세,1998,277,152,125
'4681037000,  작천면,'25,20 - 24세,1998,261,150,111
'4681037000,  작천면,'30,25 - 29세,1998,145,92,53
'4681037000,  작천면,'35,30 - 34세,1998,122,69,53
'4681037000,  작천면,'40,35 - 39세,1998,164,92,72
'4681037000,  작천면,'45,40 - 44세,1998,147,81,66
'4681037000,  작천면,'50,45 - 49세,1998,135,52,83
'4681037000,  작천면,'55,50 - 54세,1998,209,96,113
'4681037000,  작천면,'60,55 - 59세,1998,313,140,173
'4681037000,  작천면,'65,60 - 64세,1998,319,141,178
'4681037000,  작천면,'70,65 - 69세,1998,294,122,172
'4681037000,  작천면,'75,70 - 74세,1998,189,75,114
'4681037000,  작천면,'80,75 - 79세,1998,129,55,74
'4681037000,  작천면,'85,80 - 84세,1998,63,22,41
'4681037000,  작천면,'90,85+ ,1998,45,15,30
'4681038000,  병영면,'00,계,1998,3077,1431,1646
'4681038000,  병영면,'05,0 - 4세,1998,103,54,49
'4681038000,  병영면,'10,5 - 9세,1998,116,58,58
'4681038000,  병영면,'15,10 - 14세,1998,175,87,88
'4681038000,  병영면,'20,15 - 19세,1998,329,162,167
'4681038000,  병영면,'25,20 - 24세,1998,252,161,91
'4681038000,  병영면,'30,25 - 29세,1998,145,87,58
'4681038000,  병영면,'35,30 - 34세,1998,126,74,52
'4681038000,  병영면,'40,35 - 39세,1998,136,66,70
'4681038000,  병영면,'45,40 - 44세,1998,145,68,77
'4681038000,  병영면,'50,45 - 49세,1998,126,56,70
'4681038000,  병영면,'55,50 - 54세,1998,183,74,109
'4681038000,  병영면,'60,55 - 59세,1998,284,111,173
'4681038000,  병영면,'65,60 - 64세,1998,274,121,153
'4681038000,  병영면,'70,65 - 69세,1998,259,103,156
'4681038000,  병영면,'75,70 - 74세,1998,171,60,111
'4681038000,  병영면,'80,75 - 79세,1998,135,54,81
'4681038000,  병영면,'85,80 - 84세,1998,67,24,43
'4681038000,  병영면,'90,85+ ,1998,51,11,40
'4681039000,  옴천면,'00,계,1998,1112,537,575
'4681039000,  옴천면,'05,0 - 4세,1998,29,14,15
'4681039000,  옴천면,'10,5 - 9세,1998,28,13,15
'4681039000,  옴천면,'15,10 - 14세,1998,35,18,17
'4681039000,  옴천면,'20,15 - 19세,1998,77,40,37
'4681039000,  옴천면,'25,20 - 24세,1998,100,61,39
'4681039000,  옴천면,'30,25 - 29세,1998,61,45,16
'4681039000,  옴천면,'35,30 - 34세,1998,45,31,14
'4681039000,  옴천면,'40,35 - 39세,1998,57,30,27
'4681039000,  옴천면,'45,40 - 44세,1998,45,22,23
'4681039000,  옴천면,'50,45 - 49세,1998,61,30,31
'4681039000,  옴천면,'55,50 - 54세,1998,73,36,37
'4681039000,  옴천면,'60,55 - 59세,1998,109,45,64
'4681039000,  옴천면,'65,60 - 64세,1998,119,44,75
'4681039000,  옴천면,'70,65 - 69세,1998,94,42,52
'4681039000,  옴천면,'75,70 - 74세,1998,86,33,53
'4681039000,  옴천면,'80,75 - 79세,1998,50,21,29
'4681039000,  옴천면,'85,80 - 84세,1998,28,8,20
'4681039000,  옴천면,'90,85+ ,1998,15,4,11
'4681040000,  마량면,'00,계,1998,2865,1404,1461
'4681040000,  마량면,'05,0 - 4세,1998,128,66,62
'4681040000,  마량면,'10,5 - 9세,1998,140,66,74
'4681040000,  마량면,'15,10 - 14세,1998,196,88,108
'4681040000,  마량면,'20,15 - 19세,1998,290,147,143
'4681040000,  마량면,'25,20 - 24세,1998,253,158,95
'4681040000,  마량면,'30,25 - 29세,1998,176,108,68
'4681040000,  마량면,'35,30 - 34세,1998,155,80,75
'4681040000,  마량면,'40,35 - 39세,1998,170,85,85
'4681040000,  마량면,'45,40 - 44세,1998,181,102,79
'4681040000,  마량면,'50,45 - 49세,1998,157,70,87
'4681040000,  마량면,'55,50 - 54세,1998,179,74,105
'4681040000,  마량면,'60,55 - 59세,1998,241,131,110
'4681040000,  마량면,'65,60 - 64세,1998,214,85,129
'4681040000,  마량면,'70,65 - 69세,1998,154,54,100
'4681040000,  마량면,'75,70 - 74세,1998,102,44,58
'4681040000,  마량면,'80,75 - 79세,1998,83,32,51
'4681040000,  마량면,'85,80 - 84세,1998,27,10,17
'4681040000,  마량면,'90,85+ ,1998,19,4,15
'46820, 해남군,'00,계,1998,101758,49762,51996
'46820, 해남군,'05,0 - 4세,1998,5523,2916,2607
'46820, 해남군,'10,5 - 9세,1998,5555,2828,2727
'46820, 해남군,'15,10 - 14세,1998,6455,3269,3186
'46820, 해남군,'20,15 - 19세,1998,9928,4964,4964
'46820, 해남군,'25,20 - 24세,1998,8986,5113,3873
'46820, 해남군,'30,25 - 29세,1998,6480,3666,2814
'46820, 해남군,'35,30 - 34세,1998,5913,3165,2748
'46820, 해남군,'40,35 - 39세,1998,6650,3470,3180
'46820, 해남군,'45,40 - 44세,1998,6000,3100,2900
'46820, 해남군,'50,45 - 49세,1998,5538,2757,2781
'46820, 해남군,'55,50 - 54세,1998,5891,2828,3063
'46820, 해남군,'60,55 - 59세,1998,7869,3587,4282
'46820, 해남군,'65,60 - 64세,1998,7146,3064,4082
'46820, 해남군,'70,65 - 69세,1998,5615,2246,3369
'46820, 해남군,'75,70 - 74세,1998,3621,1440,2181
'46820, 해남군,'80,75 - 79세,1998,2634,879,1755
'46820, 해남군,'85,80 - 84세,1998,1198,346,852
'46820, 해남군,'90,85+ ,1998,756,124,632
'4682025000,  해남읍,'00,계,1998,26724,13130,13594
'4682025000,  해남읍,'05,0 - 4세,1998,2228,1176,1052
'4682025000,  해남읍,'10,5 - 9세,1998,2252,1144,1108
'4682025000,  해남읍,'15,10 - 14세,1998,2044,1056,988
'4682025000,  해남읍,'20,15 - 19세,1998,2432,1211,1221
'4682025000,  해남읍,'25,20 - 24세,1998,2076,1044,1032
'4682025000,  해남읍,'30,25 - 29세,1998,2205,1085,1120
'4682025000,  해남읍,'35,30 - 34세,1998,2368,1200,1168
'4682025000,  해남읍,'40,35 - 39세,1998,2350,1169,1181
'4682025000,  해남읍,'45,40 - 44세,1998,1819,935,884
'4682025000,  해남읍,'50,45 - 49세,1998,1373,705,668
'4682025000,  해남읍,'55,50 - 54세,1998,1182,597,585
'4682025000,  해남읍,'60,55 - 59세,1998,1288,607,681
'4682025000,  해남읍,'65,60 - 64세,1998,1055,456,599
'4682025000,  해남읍,'70,65 - 69세,1998,818,321,497
'4682025000,  해남읍,'75,70 - 74세,1998,556,211,345
'4682025000,  해남읍,'80,75 - 79세,1998,384,130,254
'4682025000,  해남읍,'85,80 - 84세,1998,181,60,121
'4682025000,  해남읍,'90,85+ ,1998,113,23,90
'4682031000,  삼산면,'00,계,1998,4562,2238,2324
'4682031000,  삼산면,'05,0 - 4세,1998,214,102,112
'4682031000,  삼산면,'10,5 - 9세,1998,181,94,87
'4682031000,  삼산면,'15,10 - 14세,1998,275,132,143
'4682031000,  삼산면,'20,15 - 19세,1998,437,222,215
'4682031000,  삼산면,'25,20 - 24세,1998,424,256,168
'4682031000,  삼산면,'30,25 - 29세,1998,287,181,106
'4682031000,  삼산면,'35,30 - 34세,1998,209,124,85
'4682031000,  삼산면,'40,35 - 39세,1998,274,156,118
'4682031000,  삼산면,'45,40 - 44세,1998,262,142,120
'4682031000,  삼산면,'50,45 - 49세,1998,241,122,119
'4682031000,  삼산면,'55,50 - 54세,1998,275,113,162
'4682031000,  삼산면,'60,55 - 59세,1998,379,179,200
'4682031000,  삼산면,'65,60 - 64세,1998,369,155,214
'4682031000,  삼산면,'70,65 - 69세,1998,278,97,181
'4682031000,  삼산면,'75,70 - 74세,1998,185,86,99
'4682031000,  삼산면,'80,75 - 79세,1998,145,50,95
'4682031000,  삼산면,'85,80 - 84세,1998,76,20,56
'4682031000,  삼산면,'90,85+ ,1998,51,7,44
'4682032000,  화산면,'00,계,1998,6000,2979,3021
'4682032000,  화산면,'05,0 - 4세,1998,256,129,127
'4682032000,  화산면,'10,5 - 9세,1998,246,133,113
'4682032000,  화산면,'15,10 - 14세,1998,338,181,157
'4682032000,  화산면,'20,15 - 19세,1998,622,311,311
'4682032000,  화산면,'25,20 - 24세,1998,583,328,255
'4682032000,  화산면,'30,25 - 29세,1998,365,225,140
'4682032000,  화산면,'35,30 - 34세,1998,281,171,110
'4682032000,  화산면,'40,35 - 39세,1998,326,175,151
'4682032000,  화산면,'45,40 - 44세,1998,353,163,190
'4682032000,  화산면,'50,45 - 49세,1998,358,193,165
'4682032000,  화산면,'55,50 - 54세,1998,374,188,186
'4682032000,  화산면,'60,55 - 59세,1998,540,253,287
'4682032000,  화산면,'65,60 - 64세,1998,476,212,264
'4682032000,  화산면,'70,65 - 69세,1998,362,149,213
'4682032000,  화산면,'75,70 - 74세,1998,227,91,136
'4682032000,  화산면,'80,75 - 79세,1998,165,45,120
'4682032000,  화산면,'85,80 - 84세,1998,78,26,52
'4682032000,  화산면,'90,85+ ,1998,50,6,44
'4682033000,  현산면,'00,계,1998,5516,2677,2839
'4682033000,  현산면,'05,0 - 4세,1998,232,122,110
'4682033000,  현산면,'10,5 - 9세,1998,233,114,119
'4682033000,  현산면,'15,10 - 14세,1998,345,183,162
'4682033000,  현산면,'20,15 - 19세,1998,569,282,287
'4682033000,  현산면,'25,20 - 24세,1998,485,289,196
'4682033000,  현산면,'30,25 - 29세,1998,332,199,133
'4682033000,  현산면,'35,30 - 34세,1998,257,130,127
'4682033000,  현산면,'40,35 - 39세,1998,327,179,148
'4682033000,  현산면,'45,40 - 44세,1998,310,162,148
'4682033000,  현산면,'50,45 - 49세,1998,268,123,145
'4682033000,  현산면,'55,50 - 54세,1998,338,158,180
'4682033000,  현산면,'60,55 - 59세,1998,490,215,275
'4682033000,  현산면,'65,60 - 64세,1998,467,205,262
'4682033000,  현산면,'70,65 - 69세,1998,345,138,207
'4682033000,  현산면,'75,70 - 74세,1998,237,90,147
'4682033000,  현산면,'80,75 - 79세,1998,157,56,101
'4682033000,  현산면,'85,80 - 84세,1998,84,24,60
'4682033000,  현산면,'90,85+ ,1998,40,8,32
'4682034000,  송지면,'00,계,1998,10147,5010,5137
'4682034000,  송지면,'05,0 - 4세,1998,501,269,232
'4682034000,  송지면,'10,5 - 9세,1998,567,296,271
'4682034000,  송지면,'15,10 - 14세,1998,725,359,366
'4682034000,  송지면,'20,15 - 19세,1998,1059,542,517
'4682034000,  송지면,'25,20 - 24세,1998,875,515,360
'4682034000,  송지면,'30,25 - 29세,1998,582,334,248
'4682034000,  송지면,'35,30 - 34세,1998,555,299,256
'4682034000,  송지면,'40,35 - 39세,1998,658,349,309
'4682034000,  송지면,'45,40 - 44세,1998,613,315,298
'4682034000,  송지면,'50,45 - 49세,1998,539,264,275
'4682034000,  송지면,'55,50 - 54세,1998,644,334,310
'4682034000,  송지면,'60,55 - 59세,1998,817,384,433
'4682034000,  송지면,'65,60 - 64세,1998,757,314,443
'4682034000,  송지면,'70,65 - 69세,1998,516,201,315
'4682034000,  송지면,'75,70 - 74세,1998,317,119,198
'4682034000,  송지면,'80,75 - 79세,1998,235,68,167
'4682034000,  송지면,'85,80 - 84세,1998,104,35,69
'4682034000,  송지면,'90,85+ ,1998,83,13,70
'4682035000,  북평면,'00,계,1998,4877,2356,2521
'4682035000,  북평면,'05,0 - 4세,1998,206,104,102
'4682035000,  북평면,'10,5 - 9세,1998,211,98,113
'4682035000,  북평면,'15,10 - 14세,1998,282,144,138
'4682035000,  북평면,'20,15 - 19세,1998,483,238,245
'4682035000,  북평면,'25,20 - 24세,1998,460,284,176
'4682035000,  북평면,'30,25 - 29세,1998,254,137,117
'4682035000,  북평면,'35,30 - 34세,1998,210,118,92
'4682035000,  북평면,'40,35 - 39세,1998,274,136,138
'4682035000,  북평면,'45,40 - 44세,1998,264,137,127
'4682035000,  북평면,'50,45 - 49세,1998,274,139,135
'4682035000,  북평면,'55,50 - 54세,1998,335,156,179
'4682035000,  북평면,'60,55 - 59세,1998,432,203,229
'4682035000,  북평면,'65,60 - 64세,1998,403,171,232
'4682035000,  북평면,'70,65 - 69세,1998,342,142,200
'4682035000,  북평면,'75,70 - 74세,1998,184,72,112
'4682035000,  북평면,'80,75 - 79세,1998,160,58,102
'4682035000,  북평면,'85,80 - 84세,1998,54,9,45
'4682035000,  북평면,'90,85+ ,1998,49,10,39
'4682036000,  북일면,'00,계,1998,3540,1682,1858
'4682036000,  북일면,'05,0 - 4세,1998,131,65,66
'4682036000,  북일면,'10,5 - 9세,1998,137,70,67
'4682036000,  북일면,'15,10 - 14세,1998,178,86,92
'4682036000,  북일면,'20,15 - 19세,1998,364,179,185
'4682036000,  북일면,'25,20 - 24세,1998,345,202,143
'4682036000,  북일면,'30,25 - 29세,1998,208,115,93
'4682036000,  북일면,'35,30 - 34세,1998,147,83,64
'4682036000,  북일면,'40,35 - 39세,1998,174,91,83
'4682036000,  북일면,'45,40 - 44세,1998,183,89,94
'4682036000,  북일면,'50,45 - 49세,1998,210,102,108
'4682036000,  북일면,'55,50 - 54세,1998,241,98,143
'4682036000,  북일면,'60,55 - 59세,1998,323,155,168
'4682036000,  북일면,'65,60 - 64세,1998,341,155,186
'4682036000,  북일면,'70,65 - 69세,1998,212,78,134
'4682036000,  북일면,'75,70 - 74세,1998,167,63,104
'4682036000,  북일면,'80,75 - 79세,1998,106,30,76
'4682036000,  북일면,'85,80 - 84세,1998,42,14,28
'4682036000,  북일면,'90,85+ ,1998,31,7,24
'4682037000,  옥천면,'00,계,1998,4806,2290,2516
'4682037000,  옥천면,'05,0 - 4세,1998,216,104,112
'4682037000,  옥천면,'10,5 - 9세,1998,180,84,96
'4682037000,  옥천면,'15,10 - 14세,1998,203,103,100
'4682037000,  옥천면,'20,15 - 19세,1998,434,216,218
'4682037000,  옥천면,'25,20 - 24세,1998,481,262,219
'4682037000,  옥천면,'30,25 - 29세,1998,283,183,100
'4682037000,  옥천면,'35,30 - 34세,1998,217,126,91
'4682037000,  옥천면,'40,35 - 39세,1998,243,137,106
'4682037000,  옥천면,'45,40 - 44세,1998,210,100,110
'4682037000,  옥천면,'50,45 - 49세,1998,241,115,126
'4682037000,  옥천면,'55,50 - 54세,1998,289,112,177
'4682037000,  옥천면,'60,55 - 59세,1998,498,217,281
'4682037000,  옥천면,'65,60 - 64세,1998,412,186,226
'4682037000,  옥천면,'70,65 - 69세,1998,353,153,200
'4682037000,  옥천면,'75,70 - 74세,1998,229,95,134
'4682037000,  옥천면,'80,75 - 79세,1998,183,63,120
'4682037000,  옥천면,'85,80 - 84세,1998,80,26,54
'4682037000,  옥천면,'90,85+ ,1998,54,8,46
'4682038000,  계곡면,'00,계,1998,3839,1813,2026
'4682038000,  계곡면,'05,0 - 4세,1998,114,58,56
'4682038000,  계곡면,'10,5 - 9세,1998,118,66,52
'4682038000,  계곡면,'15,10 - 14세,1998,170,76,94
'4682038000,  계곡면,'20,15 - 19세,1998,379,185,194
'4682038000,  계곡면,'25,20 - 24세,1998,340,208,132
'4682038000,  계곡면,'30,25 - 29세,1998,182,108,74
'4682038000,  계곡면,'35,30 - 34세,1998,137,76,61
'4682038000,  계곡면,'40,35 - 39세,1998,173,85,88
'4682038000,  계곡면,'45,40 - 44세,1998,193,107,86
'4682038000,  계곡면,'50,45 - 49세,1998,210,96,114
'4682038000,  계곡면,'55,50 - 54세,1998,202,100,102
'4682038000,  계곡면,'60,55 - 59세,1998,398,157,241
'4682038000,  계곡면,'65,60 - 64세,1998,438,186,252
'4682038000,  계곡면,'70,65 - 69세,1998,314,123,191
'4682038000,  계곡면,'75,70 - 74세,1998,197,92,105
'4682038000,  계곡면,'80,75 - 79세,1998,147,55,92
'4682038000,  계곡면,'85,80 - 84세,1998,73,25,48
'4682038000,  계곡면,'90,85+ ,1998,54,10,44
'4682039000,  마산면,'00,계,1998,3852,1905,1947
'4682039000,  마산면,'05,0 - 4세,1998,146,89,57
'4682039000,  마산면,'10,5 - 9세,1998,96,49,47
'4682039000,  마산면,'15,10 - 14세,1998,169,94,75
'4682039000,  마산면,'20,15 - 19세,1998,365,183,182
'4682039000,  마산면,'25,20 - 24세,1998,424,246,178
'4682039000,  마산면,'30,25 - 29세,1998,232,152,80
'4682039000,  마산면,'35,30 - 34세,1998,157,111,46
'4682039000,  마산면,'40,35 - 39세,1998,193,97,96
'4682039000,  마산면,'45,40 - 44세,1998,179,97,82
'4682039000,  마산면,'50,45 - 49세,1998,234,100,134
'4682039000,  마산면,'55,50 - 54세,1998,258,116,142
'4682039000,  마산면,'60,55 - 59세,1998,387,173,214
'4682039000,  마산면,'65,60 - 64세,1998,344,156,188
'4682039000,  마산면,'70,65 - 69세,1998,287,119,168
'4682039000,  마산면,'75,70 - 74세,1998,158,66,92
'4682039000,  마산면,'80,75 - 79세,1998,126,41,85
'4682039000,  마산면,'85,80 - 84세,1998,53,9,44
'4682039000,  마산면,'90,85+ ,1998,44,7,37
'4682040000,  황산면,'00,계,1998,9079,4476,4603
'4682040000,  황산면,'05,0 - 4세,1998,459,259,200
'4682040000,  황산면,'10,5 - 9세,1998,433,209,224
'4682040000,  황산면,'15,10 - 14세,1998,599,298,301
'4682040000,  황산면,'20,15 - 19세,1998,999,517,482
'4682040000,  황산면,'25,20 - 24세,1998,802,464,338
'4682040000,  황산면,'30,25 - 29세,1998,491,278,213
'4682040000,  황산면,'35,30 - 34세,1998,440,235,205
'4682040000,  황산면,'40,35 - 39세,1998,604,324,280
'4682040000,  황산면,'45,40 - 44세,1998,523,280,243
'4682040000,  황산면,'50,45 - 49세,1998,543,270,273
'4682040000,  황산면,'55,50 - 54세,1998,534,271,263
'4682040000,  황산면,'60,55 - 59세,1998,739,326,413
'4682040000,  황산면,'65,60 - 64세,1998,687,286,401
'4682040000,  황산면,'70,65 - 69세,1998,556,239,317
'4682040000,  황산면,'75,70 - 74세,1998,305,113,192
'4682040000,  황산면,'80,75 - 79세,1998,215,69,146
'4682040000,  황산면,'85,80 - 84세,1998,100,24,76
'4682040000,  황산면,'90,85+ ,1998,50,14,36
'4682041000,  산이면,'00,계,1998,6351,3170,3181
'4682041000,  산이면,'05,0 - 4세,1998,284,147,137
'4682041000,  산이면,'10,5 - 9세,1998,318,163,155
'4682041000,  산이면,'15,10 - 14세,1998,390,186,204
'4682041000,  산이면,'20,15 - 19세,1998,583,288,295
'4682041000,  산이면,'25,20 - 24세,1998,613,374,239
'4682041000,  산이면,'30,25 - 29세,1998,386,257,129
'4682041000,  산이면,'35,30 - 34세,1998,343,195,148
'4682041000,  산이면,'40,35 - 39세,1998,365,197,168
'4682041000,  산이면,'45,40 - 44세,1998,357,201,156
'4682041000,  산이면,'50,45 - 49세,1998,345,176,169
'4682041000,  산이면,'55,50 - 54세,1998,422,200,222
'4682041000,  산이면,'60,55 - 59세,1998,500,235,265
'4682041000,  산이면,'65,60 - 64세,1998,470,199,271
'4682041000,  산이면,'70,65 - 69세,1998,400,155,245
'4682041000,  산이면,'75,70 - 74세,1998,250,104,146
'4682041000,  산이면,'80,75 - 79세,1998,183,66,117
'4682041000,  산이면,'85,80 - 84세,1998,88,23,65
'4682041000,  산이면,'90,85+ ,1998,54,4,50
'4682042000,  문내면,'00,계,1998,6700,3244,3456
'4682042000,  문내면,'05,0 - 4세,1998,271,150,121
'4682042000,  문내면,'10,5 - 9세,1998,311,173,138
'4682042000,  문내면,'15,10 - 14세,1998,429,212,217
'4682042000,  문내면,'20,15 - 19세,1998,656,311,345
'4682042000,  문내면,'25,20 - 24세,1998,599,355,244
'4682042000,  문내면,'30,25 - 29세,1998,357,212,145
'4682042000,  문내면,'35,30 - 34세,1998,334,169,165
'4682042000,  문내면,'40,35 - 39세,1998,399,209,190
'4682042000,  문내면,'45,40 - 44세,1998,400,196,204
'4682042000,  문내면,'50,45 - 49세,1998,383,192,191
'4682042000,  문내면,'55,50 - 54세,1998,435,219,216
'4682042000,  문내면,'60,55 - 59세,1998,599,279,320
'4682042000,  문내면,'65,60 - 64세,1998,443,187,256
'4682042000,  문내면,'70,65 - 69세,1998,425,165,260
'4682042000,  문내면,'75,70 - 74세,1998,307,115,192
'4682042000,  문내면,'80,75 - 79세,1998,224,75,149
'4682042000,  문내면,'85,80 - 84세,1998,82,20,62
'4682042000,  문내면,'90,85+ ,1998,46,5,41
'4682043000,  화원면,'00,계,1998,5765,2792,2973
'4682043000,  화원면,'05,0 - 4세,1998,265,142,123
'4682043000,  화원면,'10,5 - 9세,1998,272,135,137
'4682043000,  화원면,'15,10 - 14세,1998,308,159,149
'4682043000,  화원면,'20,15 - 19세,1998,546,279,267
'4682043000,  화원면,'25,20 - 24세,1998,479,286,193
'4682043000,  화원면,'30,25 - 29세,1998,316,200,116
'4682043000,  화원면,'35,30 - 34세,1998,258,128,130
'4682043000,  화원면,'40,35 - 39세,1998,290,166,124
'4682043000,  화원면,'45,40 - 44세,1998,334,176,158
'4682043000,  화원면,'50,45 - 49세,1998,319,160,159
'4682043000,  화원면,'55,50 - 54세,1998,362,166,196
'4682043000,  화원면,'60,55 - 59세,1998,479,204,275
'4682043000,  화원면,'65,60 - 64세,1998,484,196,288
'4682043000,  화원면,'70,65 - 69세,1998,407,166,241
'4682043000,  화원면,'75,70 - 74세,1998,302,123,179
'4682043000,  화원면,'80,75 - 79세,1998,204,73,131
'4682043000,  화원면,'85,80 - 84세,1998,103,31,72
'4682043000,  화원면,'90,85+ ,1998,37,2,35
'46830, 영암군,'00,계,1998,65869,33015,32854
'46830, 영암군,'05,0 - 4세,1998,4350,2307,2043
'46830, 영암군,'10,5 - 9세,1998,3924,2034,1890
'46830, 영암군,'15,10 - 14세,1998,3722,1838,1884
'46830, 영암군,'20,15 - 19세,1998,5561,2799,2762
'46830, 영암군,'25,20 - 24세,1998,5658,3210,2448
'46830, 영암군,'30,25 - 29세,1998,5210,2972,2238
'46830, 영암군,'35,30 - 34세,1998,4692,2710,1982
'46830, 영암군,'40,35 - 39세,1998,4367,2436,1931
'46830, 영암군,'45,40 - 44세,1998,3704,2053,1651
'46830, 영암군,'50,45 - 49세,1998,3202,1598,1604
'46830, 영암군,'55,50 - 54세,1998,3561,1733,1828
'46830, 영암군,'60,55 - 59세,1998,4722,2104,2618
'46830, 영암군,'65,60 - 64세,1998,4700,1986,2714
'46830, 영암군,'70,65 - 69세,1998,3522,1478,2044
'46830, 영암군,'75,70 - 74세,1998,2126,846,1280
'46830, 영암군,'80,75 - 79세,1998,1585,578,1007
'46830, 영암군,'85,80 - 84세,1998,748,225,523
'46830, 영암군,'90,85+ ,1998,515,108,407
'4683025000,  영암읍,'00,계,1998,10861,5359,5502
'4683025000,  영암읍,'05,0 - 4세,1998,794,411,383
'4683025000,  영암읍,'10,5 - 9세,1998,774,387,387
'4683025000,  영암읍,'15,10 - 14세,1998,706,353,353
'4683025000,  영암읍,'20,15 - 19세,1998,904,458,446
'4683025000,  영암읍,'25,20 - 24세,1998,923,510,413
'4683025000,  영암읍,'30,25 - 29세,1998,821,417,404
'4683025000,  영암읍,'35,30 - 34세,1998,865,461,404
'4683025000,  영암읍,'40,35 - 39세,1998,821,433,388
'4683025000,  영암읍,'45,40 - 44세,1998,668,368,300
'4683025000,  영암읍,'50,45 - 49세,1998,546,256,290
'4683025000,  영암읍,'55,50 - 54세,1998,558,279,279
'4683025000,  영암읍,'60,55 - 59세,1998,635,314,321
'4683025000,  영암읍,'65,60 - 64세,1998,615,264,351
'4683025000,  영암읍,'70,65 - 69세,1998,500,211,289
'4683025000,  영암읍,'75,70 - 74세,1998,313,115,198
'4683025000,  영암읍,'80,75 - 79세,1998,221,76,145
'4683025000,  영암읍,'85,80 - 84세,1998,112,31,81
'4683025000,  영암읍,'90,85+ ,1998,85,15,70
'4683031000,  덕진면,'00,계,1998,2824,1428,1396
'4683031000,  덕진면,'05,0 - 4세,1998,101,58,43
'4683031000,  덕진면,'10,5 - 9세,1998,103,42,61
'4683031000,  덕진면,'15,10 - 14세,1998,116,61,55
'4683031000,  덕진면,'20,15 - 19세,1998,220,110,110
'4683031000,  덕진면,'25,20 - 24세,1998,247,155,92
'4683031000,  덕진면,'30,25 - 29세,1998,183,137,46
'4683031000,  덕진면,'35,30 - 34세,1998,141,92,49
'4683031000,  덕진면,'40,35 - 39세,1998,153,88,65
'4683031000,  덕진면,'45,40 - 44세,1998,115,65,50
'4683031000,  덕진면,'50,45 - 49세,1998,148,77,71
'4683031000,  덕진면,'55,50 - 54세,1998,191,88,103
'4683031000,  덕진면,'60,55 - 59세,1998,264,115,149
'4683031000,  덕진면,'65,60 - 64세,1998,308,131,177
'4683031000,  덕진면,'70,65 - 69세,1998,217,89,128
'4683031000,  덕진면,'75,70 - 74세,1998,123,53,70
'4683031000,  덕진면,'80,75 - 79세,1998,107,38,69
'4683031000,  덕진면,'85,80 - 84세,1998,49,20,29
'4683031000,  덕진면,'90,85+ ,1998,38,9,29
'4683032000,  금정면,'00,계,1998,3029,1487,1542
'4683032000,  금정면,'05,0 - 4세,1998,120,68,52
'4683032000,  금정면,'10,5 - 9세,1998,121,53,68
'4683032000,  금정면,'15,10 - 14세,1998,130,62,68
'4683032000,  금정면,'20,15 - 19세,1998,258,124,134
'4683032000,  금정면,'25,20 - 24세,1998,268,159,109
'4683032000,  금정면,'30,25 - 29세,1998,167,110,57
'4683032000,  금정면,'35,30 - 34세,1998,140,92,48
'4683032000,  금정면,'40,35 - 39세,1998,130,73,57
'4683032000,  금정면,'45,40 - 44세,1998,153,86,67
'4683032000,  금정면,'50,45 - 49세,1998,122,56,66
'4683032000,  금정면,'55,50 - 54세,1998,187,78,109
'4683032000,  금정면,'60,55 - 59세,1998,310,142,168
'4683032000,  금정면,'65,60 - 64세,1998,302,118,184
'4683032000,  금정면,'70,65 - 69세,1998,252,107,145
'4683032000,  금정면,'75,70 - 74세,1998,155,78,77
'4683032000,  금정면,'80,75 - 79세,1998,117,55,62
'4683032000,  금정면,'85,80 - 84세,1998,55,18,37
'4683032000,  금정면,'90,85+ ,1998,42,8,34
'4683033000,  신북면,'00,계,1998,6163,3042,3121
'4683033000,  신북면,'05,0 - 4세,1998,281,159,122
'4683033000,  신북면,'10,5 - 9세,1998,338,181,157
'4683033000,  신북면,'15,10 - 14세,1998,370,167,203
'4683033000,  신북면,'20,15 - 19세,1998,590,266,324
'4683033000,  신북면,'25,20 - 24세,1998,559,322,237
'4683033000,  신북면,'30,25 - 29세,1998,402,248,154
'4683033000,  신북면,'35,30 - 34세,1998,345,192,153
'4683033000,  신북면,'40,35 - 39세,1998,381,213,168
'4683033000,  신북면,'45,40 - 44세,1998,375,191,184
'4683033000,  신북면,'50,45 - 49세,1998,346,171,175
'4683033000,  신북면,'55,50 - 54세,1998,373,186,187
'4683033000,  신북면,'60,55 - 59세,1998,469,206,263
'4683033000,  신북면,'65,60 - 64세,1998,465,195,270
'4683033000,  신북면,'70,65 - 69세,1998,357,145,212
'4683033000,  신북면,'75,70 - 74세,1998,226,99,127
'4683033000,  신북면,'80,75 - 79세,1998,164,62,102
'4683033000,  신북면,'85,80 - 84세,1998,70,26,44
'4683033000,  신북면,'90,85+ ,1998,52,13,39
'4683034000,  시종면,'00,계,1998,6991,3444,3547
'4683034000,  시종면,'05,0 - 4세,1998,261,146,115
'4683034000,  시종면,'10,5 - 9세,1998,337,180,157
'4683034000,  시종면,'15,10 - 14세,1998,404,190,214
'4683034000,  시종면,'20,15 - 19세,1998,673,328,345
'4683034000,  시종면,'25,20 - 24세,1998,596,347,249
'4683034000,  시종면,'30,25 - 29세,1998,376,248,128
'4683034000,  시종면,'35,30 - 34세,1998,328,189,139
'4683034000,  시종면,'40,35 - 39세,1998,384,206,178
'4683034000,  시종면,'45,40 - 44세,1998,460,258,202
'4683034000,  시종면,'50,45 - 49세,1998,412,205,207
'4683034000,  시종면,'55,50 - 54세,1998,393,202,191
'4683034000,  시종면,'60,55 - 59세,1998,601,256,345
'4683034000,  시종면,'65,60 - 64세,1998,618,256,362
'4683034000,  시종면,'70,65 - 69세,1998,476,203,273
'4683034000,  시종면,'75,70 - 74세,1998,287,107,180
'4683034000,  시종면,'80,75 - 79세,1998,228,83,145
'4683034000,  시종면,'85,80 - 84세,1998,103,32,71
'4683034000,  시종면,'90,85+ ,1998,54,8,46
'4683035000,  도포면,'00,계,1998,3974,1987,1987
'4683035000,  도포면,'05,0 - 4세,1998,166,81,85
'4683035000,  도포면,'10,5 - 9세,1998,166,93,73
'4683035000,  도포면,'15,10 - 14세,1998,204,111,93
'4683035000,  도포면,'20,15 - 19세,1998,336,169,167
'4683035000,  도포면,'25,20 - 24세,1998,337,194,143
'4683035000,  도포면,'30,25 - 29세,1998,250,169,81
'4683035000,  도포면,'35,30 - 34세,1998,193,125,68
'4683035000,  도포면,'40,35 - 39세,1998,257,144,113
'4683035000,  도포면,'45,40 - 44세,1998,217,125,92
'4683035000,  도포면,'50,45 - 49세,1998,229,116,113
'4683035000,  도포면,'55,50 - 54세,1998,234,106,128
'4683035000,  도포면,'60,55 - 59세,1998,392,158,234
'4683035000,  도포면,'65,60 - 64세,1998,378,173,205
'4683035000,  도포면,'70,65 - 69세,1998,244,101,143
'4683035000,  도포면,'75,70 - 74세,1998,157,58,99
'4683035000,  도포면,'80,75 - 79세,1998,124,43,81
'4683035000,  도포면,'85,80 - 84세,1998,58,12,46
'4683035000,  도포면,'90,85+ ,1998,32,9,23
'4683036000,  군서면,'00,계,1998,5017,2464,2553
'4683036000,  군서면,'05,0 - 4세,1998,219,122,97
'4683036000,  군서면,'10,5 - 9세,1998,224,119,105
'4683036000,  군서면,'15,10 - 14세,1998,269,127,142
'4683036000,  군서면,'20,15 - 19세,1998,411,216,195
'4683036000,  군서면,'25,20 - 24세,1998,426,247,179
'4683036000,  군서면,'30,25 - 29세,1998,287,176,111
'4683036000,  군서면,'35,30 - 34세,1998,254,145,109
'4683036000,  군서면,'40,35 - 39세,1998,279,158,121
'4683036000,  군서면,'45,40 - 44세,1998,267,147,120
'4683036000,  군서면,'50,45 - 49세,1998,246,111,135
'4683036000,  군서면,'55,50 - 54세,1998,348,173,175
'4683036000,  군서면,'60,55 - 59세,1998,458,195,263
'4683036000,  군서면,'65,60 - 64세,1998,434,180,254
'4683036000,  군서면,'70,65 - 69세,1998,372,165,207
'4683036000,  군서면,'75,70 - 74세,1998,215,86,129
'4683036000,  군서면,'80,75 - 79세,1998,180,55,125
'4683036000,  군서면,'85,80 - 84세,1998,70,24,46
'4683036000,  군서면,'90,85+ ,1998,58,18,40
'4683037000,  서호면,'00,계,1998,3185,1577,1608
'4683037000,  서호면,'05,0 - 4세,1998,133,67,66
'4683037000,  서호면,'10,5 - 9세,1998,117,56,61
'4683037000,  서호면,'15,10 - 14세,1998,138,73,65
'4683037000,  서호면,'20,15 - 19세,1998,279,149,130
'4683037000,  서호면,'25,20 - 24세,1998,328,200,128
'4683037000,  서호면,'30,25 - 29세,1998,190,124,66
'4683037000,  서호면,'35,30 - 34세,1998,117,64,53
'4683037000,  서호면,'40,35 - 39세,1998,164,97,67
'4683037000,  서호면,'45,40 - 44세,1998,146,74,72
'4683037000,  서호면,'50,45 - 49세,1998,164,85,79
'4683037000,  서호면,'55,50 - 54세,1998,213,87,126
'4683037000,  서호면,'60,55 - 59세,1998,318,131,187
'4683037000,  서호면,'65,60 - 64세,1998,316,145,171
'4683037000,  서호면,'70,65 - 69세,1998,241,114,127
'4683037000,  서호면,'75,70 - 74세,1998,136,56,80
'4683037000,  서호면,'80,75 - 79세,1998,94,33,61
'4683037000,  서호면,'85,80 - 84세,1998,51,16,35
'4683037000,  서호면,'90,85+ ,1998,40,6,34
'4683038000,  학산면,'00,계,1998,4444,2210,2234
'4683038000,  학산면,'05,0 - 4세,1998,184,94,90
'4683038000,  학산면,'10,5 - 9세,1998,237,134,103
'4683038000,  학산면,'15,10 - 14세,1998,244,109,135
'4683038000,  학산면,'20,15 - 19세,1998,426,224,202
'4683038000,  학산면,'25,20 - 24세,1998,429,244,185
'4683038000,  학산면,'30,25 - 29세,1998,284,184,100
'4683038000,  학산면,'35,30 - 34세,1998,216,124,92
'4683038000,  학산면,'40,35 - 39세,1998,252,128,124
'4683038000,  학산면,'45,40 - 44세,1998,270,137,133
'4683038000,  학산면,'50,45 - 49세,1998,231,109,122
'4683038000,  학산면,'55,50 - 54세,1998,294,130,164
'4683038000,  학산면,'60,55 - 59세,1998,359,179,180
'4683038000,  학산면,'65,60 - 64세,1998,370,159,211
'4683038000,  학산면,'70,65 - 69세,1998,266,121,145
'4683038000,  학산면,'75,70 - 74세,1998,163,65,98
'4683038000,  학산면,'80,75 - 79세,1998,129,47,82
'4683038000,  학산면,'85,80 - 84세,1998,51,14,37
'4683038000,  학산면,'90,85+ ,1998,39,8,31
'4683039000,  미암면,'00,계,1998,3981,2002,1979
'4683039000,  미암면,'05,0 - 4세,1998,186,102,84
'4683039000,  미암면,'10,5 - 9세,1998,171,83,88
'4683039000,  미암면,'15,10 - 14세,1998,251,145,106
'4683039000,  미암면,'20,15 - 19세,1998,434,210,224
'4683039000,  미암면,'25,20 - 24세,1998,404,234,170
'4683039000,  미암면,'30,25 - 29세,1998,230,143,87
'4683039000,  미암면,'35,30 - 34세,1998,196,113,83
'4683039000,  미암면,'40,35 - 39세,1998,252,135,117
'4683039000,  미암면,'45,40 - 44세,1998,217,117,100
'4683039000,  미암면,'50,45 - 49세,1998,222,107,115
'4683039000,  미암면,'55,50 - 54세,1998,249,127,122
'4683039000,  미암면,'60,55 - 59세,1998,352,162,190
'4683039000,  미암면,'65,60 - 64세,1998,326,144,182
'4683039000,  미암면,'70,65 - 69세,1998,208,80,128
'4683039000,  미암면,'75,70 - 74세,1998,123,51,72
'4683039000,  미암면,'80,75 - 79세,1998,77,28,49
'4683039000,  미암면,'85,80 - 84세,1998,52,15,37
'4683039000,  미암면,'90,85+ ,1998,31,6,25
'4683040000,  삼호면,'00,계,1998,15400,8015,7385
'4683040000,  삼호면,'05,0 - 4세,1998,1905,999,906
'4683040000,  삼호면,'10,5 - 9세,1998,1336,706,630
'4683040000,  삼호면,'15,10 - 14세,1998,890,440,450
'4683040000,  삼호면,'20,15 - 19세,1998,1030,545,485
'4683040000,  삼호면,'25,20 - 24세,1998,1141,598,543
'4683040000,  삼호면,'30,25 - 29세,1998,2020,1016,1004
'4683040000,  삼호면,'35,30 - 34세,1998,1897,1113,784
'4683040000,  삼호면,'40,35 - 39세,1998,1294,761,533
'4683040000,  삼호면,'45,40 - 44세,1998,816,485,331
'4683040000,  삼호면,'50,45 - 49세,1998,536,305,231
'4683040000,  삼호면,'55,50 - 54세,1998,521,277,244
'4683040000,  삼호면,'60,55 - 59세,1998,564,246,318
'4683040000,  삼호면,'65,60 - 64세,1998,568,221,347
'4683040000,  삼호면,'70,65 - 69세,1998,389,142,247
'4683040000,  삼호면,'75,70 - 74세,1998,228,78,150
'4683040000,  삼호면,'80,75 - 79세,1998,144,58,86
'4683040000,  삼호면,'85,80 - 84세,1998,77,17,60
'4683040000,  삼호면,'90,85+ ,1998,44,8,36
'46840, 무안군,'00,계,1998,71334,35920,35414
'46840, 무안군,'05,0 - 4세,1998,3699,1956,1743
'46840, 무안군,'10,5 - 9세,1998,3689,1908,1781
'46840, 무안군,'15,10 - 14세,1998,4236,2204,2032
'46840, 무안군,'20,15 - 19세,1998,7033,3542,3491
'46840, 무안군,'25,20 - 24세,1998,6752,4021,2731
'46840, 무안군,'30,25 - 29세,1998,4994,3099,1895
'46840, 무안군,'35,30 - 34세,1998,4200,2369,1831
'46840, 무안군,'40,35 - 39세,1998,4674,2524,2150
'46840, 무안군,'45,40 - 44세,1998,4230,2207,2023
'46840, 무안군,'50,45 - 49세,1998,4004,2052,1952
'46840, 무안군,'55,50 - 54세,1998,4406,2174,2232
'46840, 무안군,'60,55 - 59세,1998,5522,2527,2995
'46840, 무안군,'65,60 - 64세,1998,4846,2123,2723
'46840, 무안군,'70,65 - 69세,1998,3601,1422,2179
'46840, 무안군,'75,70 - 74세,1998,2359,922,1437
'46840, 무안군,'80,75 - 79세,1998,1787,593,1194
'46840, 무안군,'85,80 - 84세,1998,781,197,584
'46840, 무안군,'90,85+ ,1998,521,80,441
'4684025000,  무안읍,'00,계,1998,11258,5570,5688
'4684025000,  무안읍,'05,0 - 4세,1998,819,440,379
'4684025000,  무안읍,'10,5 - 9세,1998,843,429,414
'4684025000,  무안읍,'15,10 - 14세,1998,777,376,401
'4684025000,  무안읍,'20,15 - 19세,1998,1060,530,530
'4684025000,  무안읍,'25,20 - 24세,1998,913,498,415
'4684025000,  무안읍,'30,25 - 29세,1998,863,454,409
'4684025000,  무안읍,'35,30 - 34세,1998,902,472,430
'4684025000,  무안읍,'40,35 - 39세,1998,924,471,453
'4684025000,  무안읍,'45,40 - 44세,1998,747,393,354
'4684025000,  무안읍,'50,45 - 49세,1998,595,302,293
'4684025000,  무안읍,'55,50 - 54세,1998,632,313,319
'4684025000,  무안읍,'60,55 - 59세,1998,669,320,349
'4684025000,  무안읍,'65,60 - 64세,1998,516,230,286
'4684025000,  무안읍,'70,65 - 69세,1998,388,142,246
'4684025000,  무안읍,'75,70 - 74세,1998,268,105,163
'4684025000,  무안읍,'80,75 - 79세,1998,188,63,125
'4684025000,  무안읍,'85,80 - 84세,1998,91,25,66
'4684025000,  무안읍,'90,85+ ,1998,63,7,56
'4684025300,  일로읍,'00,계,1998,10621,5346,5275
'4684025300,  일로읍,'05,0 - 4세,1998,500,260,240
'4684025300,  일로읍,'10,5 - 9세,1998,499,246,253
'4684025300,  일로읍,'15,10 - 14세,1998,614,329,285
'4684025300,  일로읍,'20,15 - 19세,1998,1049,524,525
'4684025300,  일로읍,'25,20 - 24세,1998,1008,602,406
'4684025300,  일로읍,'30,25 - 29세,1998,706,452,254
'4684025300,  일로읍,'35,30 - 34세,1998,598,344,254
'4684025300,  일로읍,'40,35 - 39세,1998,671,386,285
'4684025300,  일로읍,'45,40 - 44세,1998,627,328,299
'4684025300,  일로읍,'50,45 - 49세,1998,610,311,299
'4684025300,  일로읍,'55,50 - 54세,1998,601,283,318
'4684025300,  일로읍,'60,55 - 59세,1998,868,415,453
'4684025300,  일로읍,'65,60 - 64세,1998,775,340,435
'4684025300,  일로읍,'70,65 - 69세,1998,604,236,368
'4684025300,  일로읍,'75,70 - 74세,1998,380,139,241
'4684025300,  일로읍,'80,75 - 79세,1998,321,105,216
'4684025300,  일로읍,'85,80 - 84세,1998,106,30,76
'4684025300,  일로읍,'90,85+ ,1998,84,16,68
'4684031000,  삼향면,'00,계,1998,8393,4242,4151
'4684031000,  삼향면,'05,0 - 4세,1998,429,218,211
'4684031000,  삼향면,'10,5 - 9세,1998,374,208,166
'4684031000,  삼향면,'15,10 - 14세,1998,472,258,214
'4684031000,  삼향면,'20,15 - 19세,1998,790,384,406
'4684031000,  삼향면,'25,20 - 24세,1998,757,416,341
'4684031000,  삼향면,'30,25 - 29세,1998,661,424,237
'4684031000,  삼향면,'35,30 - 34세,1998,506,295,211
'4684031000,  삼향면,'40,35 - 39세,1998,581,337,244
'4684031000,  삼향면,'45,40 - 44세,1998,513,270,243
'4684031000,  삼향면,'50,45 - 49세,1998,505,259,246
'4684031000,  삼향면,'55,50 - 54세,1998,498,262,236
'4684031000,  삼향면,'60,55 - 59세,1998,600,268,332
'4684031000,  삼향면,'65,60 - 64세,1998,564,244,320
'4684031000,  삼향면,'70,65 - 69세,1998,461,177,284
'4684031000,  삼향면,'75,70 - 74세,1998,276,115,161
'4684031000,  삼향면,'80,75 - 79세,1998,238,77,161
'4684031000,  삼향면,'85,80 - 84세,1998,101,19,82
'4684031000,  삼향면,'90,85+ ,1998,67,11,56
'4684032000,  몽탄면,'00,계,1998,5530,2713,2817
'4684032000,  몽탄면,'05,0 - 4세,1998,222,114,108
'4684032000,  몽탄면,'10,5 - 9세,1998,190,95,95
'4684032000,  몽탄면,'15,10 - 14세,1998,246,130,116
'4684032000,  몽탄면,'20,15 - 19세,1998,490,253,237
'4684032000,  몽탄면,'25,20 - 24세,1998,562,354,208
'4684032000,  몽탄면,'30,25 - 29세,1998,350,238,112
'4684032000,  몽탄면,'35,30 - 34세,1998,255,152,103
'4684032000,  몽탄면,'40,35 - 39세,1998,273,151,122
'4684032000,  몽탄면,'45,40 - 44세,1998,256,122,134
'4684032000,  몽탄면,'50,45 - 49세,1998,271,142,129
'4684032000,  몽탄면,'55,50 - 54세,1998,349,154,195
'4684032000,  몽탄면,'60,55 - 59세,1998,517,230,287
'4684032000,  몽탄면,'65,60 - 64세,1998,493,204,289
'4684032000,  몽탄면,'70,65 - 69세,1998,378,144,234
'4684032000,  몽탄면,'75,70 - 74세,1998,313,131,182
'4684032000,  몽탄면,'80,75 - 79세,1998,205,63,142
'4684032000,  몽탄면,'85,80 - 84세,1998,91,22,69
'4684032000,  몽탄면,'90,85+ ,1998,69,14,55
'4684033000,  청계면,'00,계,1998,9213,4654,4559
'4684033000,  청계면,'05,0 - 4세,1998,472,262,210
'4684033000,  청계면,'10,5 - 9세,1998,452,235,217
'4684033000,  청계면,'15,10 - 14세,1998,477,249,228
'4684033000,  청계면,'20,15 - 19세,1998,952,463,489
'4684033000,  청계면,'25,20 - 24세,1998,972,575,397
'4684033000,  청계면,'30,25 - 29세,1998,704,445,259
'4684033000,  청계면,'35,30 - 34세,1998,548,308,240
'4684033000,  청계면,'40,35 - 39세,1998,586,305,281
'4684033000,  청계면,'45,40 - 44세,1998,539,272,267
'4684033000,  청계면,'50,45 - 49세,1998,508,258,250
'4684033000,  청계면,'55,50 - 54세,1998,576,289,287
'4684033000,  청계면,'60,55 - 59세,1998,686,317,369
'4684033000,  청계면,'65,60 - 64세,1998,607,266,341
'4684033000,  청계면,'70,65 - 69세,1998,460,185,275
'4684033000,  청계면,'75,70 - 74세,1998,293,112,181
'4684033000,  청계면,'80,75 - 79세,1998,219,74,145
'4684033000,  청계면,'85,80 - 84세,1998,98,28,70
'4684033000,  청계면,'90,85+ ,1998,64,11,53
'4684034000,  현경면,'00,계,1998,8085,4086,3999
'4684034000,  현경면,'05,0 - 4세,1998,382,213,169
'4684034000,  현경면,'10,5 - 9세,1998,398,201,197
'4684034000,  현경면,'15,10 - 14세,1998,474,241,233
'4684034000,  현경면,'20,15 - 19세,1998,822,406,416
'4684034000,  현경면,'25,20 - 24세,1998,785,488,297
'4684034000,  현경면,'30,25 - 29세,1998,518,349,169
'4684034000,  현경면,'35,30 - 34세,1998,427,240,187
'4684034000,  현경면,'40,35 - 39세,1998,457,247,210
'4684034000,  현경면,'45,40 - 44세,1998,449,243,206
'4684034000,  현경면,'50,45 - 49세,1998,443,217,226
'4684034000,  현경면,'55,50 - 54세,1998,541,265,276
'4684034000,  현경면,'60,55 - 59세,1998,668,300,368
'4684034000,  현경면,'65,60 - 64세,1998,632,274,358
'4684034000,  현경면,'70,65 - 69세,1998,444,187,257
'4684034000,  현경면,'75,70 - 74세,1998,290,119,171
'4684034000,  현경면,'80,75 - 79세,1998,200,70,130
'4684034000,  현경면,'85,80 - 84세,1998,92,21,71
'4684034000,  현경면,'90,85+ ,1998,63,5,58
'4684035000,  망운면,'00,계,1998,3902,2010,1892
'4684035000,  망운면,'05,0 - 4세,1998,202,104,98
'4684035000,  망운면,'10,5 - 9세,1998,209,113,96
'4684035000,  망운면,'15,10 - 14세,1998,228,114,114
'4684035000,  망운면,'20,15 - 19세,1998,429,228,201
'4684035000,  망운면,'25,20 - 24세,1998,389,245,144
'4684035000,  망운면,'30,25 - 29세,1998,279,165,114
'4684035000,  망운면,'35,30 - 34세,1998,206,120,86
'4684035000,  망운면,'40,35 - 39세,1998,248,131,117
'4684035000,  망운면,'45,40 - 44세,1998,252,133,119
'4684035000,  망운면,'50,45 - 49세,1998,232,125,107
'4684035000,  망운면,'55,50 - 54세,1998,267,142,125
'4684035000,  망운면,'60,55 - 59세,1998,275,120,155
'4684035000,  망운면,'65,60 - 64세,1998,218,97,121
'4684035000,  망운면,'70,65 - 69세,1998,174,72,102
'4684035000,  망운면,'75,70 - 74세,1998,135,49,86
'4684035000,  망운면,'80,75 - 79세,1998,94,36,58
'4684035000,  망운면,'85,80 - 84세,1998,38,12,26
'4684035000,  망운면,'90,85+ ,1998,27,4,23
'4684036000,  해제면,'00,계,1998,9072,4590,4482
'4684036000,  해제면,'05,0 - 4세,1998,411,214,197
'4684036000,  해제면,'10,5 - 9세,1998,425,214,211
'4684036000,  해제면,'15,10 - 14세,1998,571,296,275
'4684036000,  해제면,'20,15 - 19세,1998,903,474,429
'4684036000,  해제면,'25,20 - 24세,1998,893,554,339
'4684036000,  해제면,'30,25 - 29세,1998,585,374,211
'4684036000,  해제면,'35,30 - 34세,1998,433,252,181
'4684036000,  해제면,'40,35 - 39세,1998,565,296,269
'4684036000,  해제면,'45,40 - 44세,1998,526,281,245
'4684036000,  해제면,'50,45 - 49세,1998,539,279,260
'4684036000,  해제면,'55,50 - 54세,1998,611,294,317
'4684036000,  해제면,'60,55 - 59세,1998,824,361,463
'4684036000,  해제면,'65,60 - 64세,1998,700,325,375
'4684036000,  해제면,'70,65 - 69세,1998,454,176,278
'4684036000,  해제면,'75,70 - 74세,1998,256,102,154
'4684036000,  해제면,'80,75 - 79세,1998,222,64,158
'4684036000,  해제면,'85,80 - 84세,1998,103,26,77
'4684036000,  해제면,'90,85+ ,1998,51,8,43
'4684037000,  운남면,'00,계,1998,5260,2709,2551
'4684037000,  운남면,'05,0 - 4세,1998,262,131,131
'4684037000,  운남면,'10,5 - 9세,1998,299,167,132
'4684037000,  운남면,'15,10 - 14세,1998,377,211,166
'4684037000,  운남면,'20,15 - 19세,1998,538,280,258
'4684037000,  운남면,'25,20 - 24세,1998,473,289,184
'4684037000,  운남면,'30,25 - 29세,1998,328,198,130
'4684037000,  운남면,'35,30 - 34세,1998,325,186,139
'4684037000,  운남면,'40,35 - 39세,1998,369,200,169
'4684037000,  운남면,'45,40 - 44세,1998,321,165,156
'4684037000,  운남면,'50,45 - 49세,1998,301,159,142
'4684037000,  운남면,'55,50 - 54세,1998,331,172,159
'4684037000,  운남면,'60,55 - 59세,1998,415,196,219
'4684037000,  운남면,'65,60 - 64세,1998,341,143,198
'4684037000,  운남면,'70,65 - 69세,1998,238,103,135
'4684037000,  운남면,'75,70 - 74세,1998,148,50,98
'4684037000,  운남면,'80,75 - 79세,1998,100,41,59
'4684037000,  운남면,'85,80 - 84세,1998,61,14,47
'4684037000,  운남면,'90,85+ ,1998,33,4,29
'46860, 함평군,'00,계,1998,50854,25220,25634
'46860, 함평군,'05,0 - 4세,1998,2607,1342,1265
'46860, 함평군,'10,5 - 9세,1998,2337,1227,1110
'46860, 함평군,'15,10 - 14세,1998,2518,1296,1222
'46860, 함평군,'20,15 - 19세,1998,4568,2303,2265
'46860, 함평군,'25,20 - 24세,1998,4768,2791,1977
'46860, 함평군,'30,25 - 29세,1998,3563,2191,1372
'46860, 함평군,'35,30 - 34세,1998,2813,1605,1208
'46860, 함평군,'40,35 - 39세,1998,3052,1670,1382
'46860, 함평군,'45,40 - 44세,1998,2682,1474,1208
'46860, 함평군,'50,45 - 49세,1998,2613,1280,1333
'46860, 함평군,'55,50 - 54세,1998,2966,1383,1583
'46860, 함평군,'60,55 - 59세,1998,4311,1948,2363
'46860, 함평군,'65,60 - 64세,1998,4216,1769,2447
'46860, 함평군,'70,65 - 69세,1998,3068,1246,1822
'46860, 함평군,'75,70 - 74세,1998,2072,831,1241
'46860, 함평군,'80,75 - 79세,1998,1517,563,954
'46860, 함평군,'85,80 - 84세,1998,666,213,453
'46860, 함평군,'90,85+ ,1998,517,88,429
'4686025000,  함평읍,'00,계,1998,12172,5966,6206
'4686025000,  함평읍,'05,0 - 4세,1998,814,406,408
'4686025000,  함평읍,'10,5 - 9세,1998,746,394,352
'4686025000,  함평읍,'15,10 - 14세,1998,678,337,341
'4686025000,  함평읍,'20,15 - 19세,1998,1113,554,559
'4686025000,  함평읍,'25,20 - 24세,1998,1126,639,487
'4686025000,  함평읍,'30,25 - 29세,1998,872,475,397
'4686025000,  함평읍,'35,30 - 34세,1998,813,438,375
'4686025000,  함평읍,'40,35 - 39세,1998,870,447,423
'4686025000,  함평읍,'45,40 - 44세,1998,744,389,355
'4686025000,  함평읍,'50,45 - 49세,1998,597,306,291
'4686025000,  함평읍,'55,50 - 54세,1998,672,323,349
'4686025000,  함평읍,'60,55 - 59세,1998,876,401,475
'4686025000,  함평읍,'65,60 - 64세,1998,778,347,431
'4686025000,  함평읍,'70,65 - 69세,1998,558,207,351
'4686025000,  함평읍,'75,70 - 74세,1998,395,158,237
'4686025000,  함평읍,'80,75 - 79세,1998,276,94,182
'4686025000,  함평읍,'85,80 - 84세,1998,131,40,91
'4686025000,  함평읍,'90,85+ ,1998,113,11,102
'4686031000,  손불면,'00,계,1998,5960,2970,2990
'4686031000,  손불면,'05,0 - 4세,1998,262,134,128
'4686031000,  손불면,'10,5 - 9세,1998,229,114,115
'4686031000,  손불면,'15,10 - 14세,1998,294,152,142
'4686031000,  손불면,'20,15 - 19세,1998,608,315,293
'4686031000,  손불면,'25,20 - 24세,1998,550,346,204
'4686031000,  손불면,'30,25 - 29세,1998,368,223,145
'4686031000,  손불면,'35,30 - 34세,1998,267,152,115
'4686031000,  손불면,'40,35 - 39세,1998,337,177,160
'4686031000,  손불면,'45,40 - 44세,1998,290,161,129
'4686031000,  손불면,'50,45 - 49세,1998,333,159,174
'4686031000,  손불면,'55,50 - 54세,1998,399,170,229
'4686031000,  손불면,'60,55 - 59세,1998,566,266,300
'4686031000,  손불면,'65,60 - 64세,1998,555,252,303
'4686031000,  손불면,'70,65 - 69세,1998,355,157,198
'4686031000,  손불면,'75,70 - 74세,1998,206,77,129
'4686031000,  손불면,'80,75 - 79세,1998,198,76,122
'4686031000,  손불면,'85,80 - 84세,1998,81,27,54
'4686031000,  손불면,'90,85+ ,1998,62,12,50
'4686032000,  신광면,'00,계,1998,3252,1612,1640
'4686032000,  신광면,'05,0 - 4세,1998,149,81,68
'4686032000,  신광면,'10,5 - 9세,1998,137,75,62
'4686032000,  신광면,'15,10 - 14세,1998,154,74,80
'4686032000,  신광면,'20,15 - 19세,1998,289,153,136
'4686032000,  신광면,'25,20 - 24세,1998,315,179,136
'4686032000,  신광면,'30,25 - 29세,1998,230,144,86
'4686032000,  신광면,'35,30 - 34세,1998,147,89,58
'4686032000,  신광면,'40,35 - 39세,1998,161,80,81
'4686032000,  신광면,'45,40 - 44세,1998,161,89,72
'4686032000,  신광면,'50,45 - 49세,1998,170,93,77
'4686032000,  신광면,'55,50 - 54세,1998,188,85,103
'4686032000,  신광면,'60,55 - 59세,1998,317,150,167
'4686032000,  신광면,'65,60 - 64세,1998,261,104,157
'4686032000,  신광면,'70,65 - 69세,1998,238,101,137
'4686032000,  신광면,'75,70 - 74세,1998,140,49,91
'4686032000,  신광면,'80,75 - 79세,1998,114,43,71
'4686032000,  신광면,'85,80 - 84세,1998,35,13,22
'4686032000,  신광면,'90,85+ ,1998,46,10,36
'4686033000,  학교면,'00,계,1998,6770,3378,3392
'4686033000,  학교면,'05,0 - 4세,1998,299,160,139
'4686033000,  학교면,'10,5 - 9세,1998,272,141,131
'4686033000,  학교면,'15,10 - 14세,1998,354,195,159
'4686033000,  학교면,'20,15 - 19세,1998,686,335,351
'4686033000,  학교면,'25,20 - 24세,1998,610,367,243
'4686033000,  학교면,'30,25 - 29세,1998,448,301,147
'4686033000,  학교면,'35,30 - 34세,1998,367,212,155
'4686033000,  학교면,'40,35 - 39세,1998,413,235,178
'4686033000,  학교면,'45,40 - 44세,1998,373,202,171
'4686033000,  학교면,'50,45 - 49세,1998,331,165,166
'4686033000,  학교면,'55,50 - 54세,1998,351,157,194
'4686033000,  학교면,'60,55 - 59세,1998,571,260,311
'4686033000,  학교면,'65,60 - 64세,1998,598,242,356
'4686033000,  학교면,'70,65 - 69세,1998,435,157,278
'4686033000,  학교면,'75,70 - 74세,1998,313,133,180
'4686033000,  학교면,'80,75 - 79세,1998,210,84,126
'4686033000,  학교면,'85,80 - 84세,1998,77,24,53
'4686033000,  학교면,'90,85+ ,1998,62,8,54
'4686034000,  엄다면,'00,계,1998,3348,1651,1697
'4686034000,  엄다면,'05,0 - 4세,1998,146,74,72
'4686034000,  엄다면,'10,5 - 9세,1998,128,66,62
'4686034000,  엄다면,'15,10 - 14세,1998,173,92,81
'4686034000,  엄다면,'20,15 - 19세,1998,284,144,140
'4686034000,  엄다면,'25,20 - 24세,1998,297,189,108
'4686034000,  엄다면,'30,25 - 29세,1998,231,147,84
'4686034000,  엄다면,'35,30 - 34세,1998,155,87,68
'4686034000,  엄다면,'40,35 - 39세,1998,191,108,83
'4686034000,  엄다면,'45,40 - 44세,1998,156,89,67
'4686034000,  엄다면,'50,45 - 49세,1998,161,79,82
'4686034000,  엄다면,'55,50 - 54세,1998,194,86,108
'4686034000,  엄다면,'60,55 - 59세,1998,329,144,185
'4686034000,  엄다면,'65,60 - 64세,1998,301,133,168
'4686034000,  엄다면,'70,65 - 69세,1998,255,89,166
'4686034000,  엄다면,'75,70 - 74세,1998,153,58,95
'4686034000,  엄다면,'80,75 - 79세,1998,99,38,61
'4686034000,  엄다면,'85,80 - 84세,1998,61,19,42
'4686034000,  엄다면,'90,85+ ,1998,34,9,25
'4686035000,  대동면,'00,계,1998,4619,2235,2384
'4686035000,  대동면,'05,0 - 4세,1998,215,106,109
'4686035000,  대동면,'10,5 - 9세,1998,187,94,93
'4686035000,  대동면,'15,10 - 14세,1998,243,126,117
'4686035000,  대동면,'20,15 - 19세,1998,431,204,227
'4686035000,  대동면,'25,20 - 24세,1998,435,259,176
'4686035000,  대동면,'30,25 - 29세,1998,304,192,112
'4686035000,  대동면,'35,30 - 34세,1998,226,134,92
'4686035000,  대동면,'40,35 - 39세,1998,229,123,106
'4686035000,  대동면,'45,40 - 44세,1998,219,108,111
'4686035000,  대동면,'50,45 - 49세,1998,243,110,133
'4686035000,  대동면,'55,50 - 54세,1998,280,141,139
'4686035000,  대동면,'60,55 - 59세,1998,404,175,229
'4686035000,  대동면,'65,60 - 64세,1998,433,173,260
'4686035000,  대동면,'70,65 - 69세,1998,318,126,192
'4686035000,  대동면,'75,70 - 74세,1998,206,89,117
'4686035000,  대동면,'80,75 - 79세,1998,132,44,88
'4686035000,  대동면,'85,80 - 84세,1998,65,24,41
'4686035000,  대동면,'90,85+ ,1998,49,7,42
'4686036000,  나산면,'00,계,1998,4521,2197,2324
'4686036000,  나산면,'05,0 - 4세,1998,189,88,101
'4686036000,  나산면,'10,5 - 9세,1998,185,91,94
'4686036000,  나산면,'15,10 - 14세,1998,204,110,94
'4686036000,  나산면,'20,15 - 19세,1998,364,174,190
'4686036000,  나산면,'25,20 - 24세,1998,397,212,185
'4686036000,  나산면,'30,25 - 29세,1998,299,190,109
'4686036000,  나산면,'35,30 - 34세,1998,230,137,93
'4686036000,  나산면,'40,35 - 39세,1998,248,132,116
'4686036000,  나산면,'45,40 - 44세,1998,239,145,94
'4686036000,  나산면,'50,45 - 49세,1998,264,132,132
'4686036000,  나산면,'55,50 - 54세,1998,241,118,123
'4686036000,  나산면,'60,55 - 59세,1998,376,154,222
'4686036000,  나산면,'65,60 - 64세,1998,436,185,251
'4686036000,  나산면,'70,65 - 69세,1998,314,141,173
'4686036000,  나산면,'75,70 - 74세,1998,240,88,152
'4686036000,  나산면,'80,75 - 79세,1998,185,66,119
'4686036000,  나산면,'85,80 - 84세,1998,64,21,43
'4686036000,  나산면,'90,85+ ,1998,46,13,33
'4686037000,  해보면,'00,계,1998,4362,2175,2187
'4686037000,  해보면,'05,0 - 4세,1998,250,137,113
'4686037000,  해보면,'10,5 - 9세,1998,199,118,81
'4686037000,  해보면,'15,10 - 14세,1998,179,89,90
'4686037000,  해보면,'20,15 - 19세,1998,313,149,164
'4686037000,  해보면,'25,20 - 24세,1998,429,233,196
'4686037000,  해보면,'30,25 - 29세,1998,350,210,140
'4686037000,  해보면,'35,30 - 34세,1998,261,157,104
'4686037000,  해보면,'40,35 - 39세,1998,288,174,114
'4686037000,  해보면,'45,40 - 44세,1998,220,127,93
'4686037000,  해보면,'50,45 - 49세,1998,210,91,119
'4686037000,  해보면,'55,50 - 54세,1998,251,114,137
'4686037000,  해보면,'60,55 - 59세,1998,359,162,197
'4686037000,  해보면,'65,60 - 64세,1998,366,139,227
'4686037000,  해보면,'70,65 - 69세,1998,274,127,147
'4686037000,  해보면,'75,70 - 74세,1998,170,68,102
'4686037000,  해보면,'80,75 - 79세,1998,136,51,85
'4686037000,  해보면,'85,80 - 84세,1998,72,22,50
'4686037000,  해보면,'90,85+ ,1998,35,7,28
'4686038000,  월야면,'00,계,1998,5850,3036,2814
'4686038000,  월야면,'05,0 - 4세,1998,283,156,127
'4686038000,  월야면,'10,5 - 9세,1998,254,134,120
'4686038000,  월야면,'15,10 - 14세,1998,239,121,118
'4686038000,  월야면,'20,15 - 19세,1998,480,275,205
'4686038000,  월야면,'25,20 - 24세,1998,609,367,242
'4686038000,  월야면,'30,25 - 29세,1998,461,309,152
'4686038000,  월야면,'35,30 - 34세,1998,347,199,148
'4686038000,  월야면,'40,35 - 39세,1998,315,194,121
'4686038000,  월야면,'45,40 - 44세,1998,280,164,116
'4686038000,  월야면,'50,45 - 49세,1998,304,145,159
'4686038000,  월야면,'55,50 - 54세,1998,390,189,201
'4686038000,  월야면,'60,55 - 59세,1998,513,236,277
'4686038000,  월야면,'65,60 - 64세,1998,488,194,294
'4686038000,  월야면,'70,65 - 69세,1998,321,141,180
'4686038000,  월야면,'75,70 - 74세,1998,249,111,138
'4686038000,  월야면,'80,75 - 79세,1998,167,67,100
'4686038000,  월야면,'85,80 - 84세,1998,80,23,57
'4686038000,  월야면,'90,85+ ,1998,70,11,59
'46870, 영광군,'00,계,1998,75658,37832,37826
'46870, 영광군,'05,0 - 4세,1998,4569,2362,2207
'46870, 영광군,'10,5 - 9세,1998,4607,2412,2195
'46870, 영광군,'15,10 - 14세,1998,4809,2458,2351
'46870, 영광군,'20,15 - 19세,1998,7050,3481,3569
'46870, 영광군,'25,20 - 24세,1998,6875,4030,2845
'46870, 영광군,'30,25 - 29세,1998,5537,3234,2303
'46870, 영광군,'35,30 - 34세,1998,5155,2789,2366
'46870, 영광군,'40,35 - 39세,1998,5140,2687,2453
'46870, 영광군,'45,40 - 44세,1998,4422,2425,1997
'46870, 영광군,'50,45 - 49세,1998,3914,1980,1934
'46870, 영광군,'55,50 - 54세,1998,4171,2042,2129
'46870, 영광군,'60,55 - 59세,1998,5559,2482,3077
'46870, 영광군,'65,60 - 64세,1998,4955,2216,2739
'46870, 영광군,'70,65 - 69세,1998,3312,1320,1992
'46870, 영광군,'75,70 - 74세,1998,2309,894,1415
'46870, 영광군,'80,75 - 79세,1998,1784,645,1139
'46870, 영광군,'85,80 - 84세,1998,873,252,621
'46870, 영광군,'90,85+ ,1998,617,123,494
'4687025000,  영광읍,'00,계,1998,23188,11516,11672
'4687025000,  영광읍,'05,0 - 4세,1998,1857,970,887
'4687025000,  영광읍,'10,5 - 9세,1998,1791,933,858
'4687025000,  영광읍,'15,10 - 14세,1998,1682,876,806
'4687025000,  영광읍,'20,15 - 19세,1998,2123,1077,1046
'4687025000,  영광읍,'25,20 - 24세,1998,1989,1056,933
'4687025000,  영광읍,'30,25 - 29세,1998,1937,989,948
'4687025000,  영광읍,'35,30 - 34세,1998,1900,949,951
'4687025000,  영광읍,'40,35 - 39세,1998,1840,933,907
'4687025000,  영광읍,'45,40 - 44세,1998,1517,800,717
'4687025000,  영광읍,'50,45 - 49세,1998,1166,601,565
'4687025000,  영광읍,'55,50 - 54세,1998,1102,560,542
'4687025000,  영광읍,'60,55 - 59세,1998,1227,595,632
'4687025000,  영광읍,'65,60 - 64세,1998,1067,490,577
'4687025000,  영광읍,'70,65 - 69세,1998,715,276,439
'4687025000,  영광읍,'75,70 - 74세,1998,511,193,318
'4687025000,  영광읍,'80,75 - 79세,1998,394,119,275
'4687025000,  영광읍,'85,80 - 84세,1998,230,66,164
'4687025000,  영광읍,'90,85+ ,1998,140,33,107
'4687025300,  백수읍,'00,계,1998,7927,3929,3998
'4687025300,  백수읍,'05,0 - 4세,1998,254,119,135
'4687025300,  백수읍,'10,5 - 9세,1998,279,152,127
'4687025300,  백수읍,'15,10 - 14세,1998,452,241,211
'4687025300,  백수읍,'20,15 - 19세,1998,783,390,393
'4687025300,  백수읍,'25,20 - 24세,1998,776,473,303
'4687025300,  백수읍,'30,25 - 29세,1998,514,341,173
'4687025300,  백수읍,'35,30 - 34세,1998,345,208,137
'4687025300,  백수읍,'40,35 - 39세,1998,375,189,186
'4687025300,  백수읍,'45,40 - 44세,1998,453,230,223
'4687025300,  백수읍,'50,45 - 49세,1998,406,198,208
'4687025300,  백수읍,'55,50 - 54세,1998,490,225,265
'4687025300,  백수읍,'60,55 - 59세,1998,841,346,495
'4687025300,  백수읍,'65,60 - 64세,1998,709,337,372
'4687025300,  백수읍,'70,65 - 69세,1998,459,191,268
'4687025300,  백수읍,'75,70 - 74세,1998,314,138,176
'4687025300,  백수읍,'80,75 - 79세,1998,266,102,164
'4687025300,  백수읍,'85,80 - 84세,1998,115,32,83
'4687025300,  백수읍,'90,85+ ,1998,96,17,79
'4687025600,  홍농읍,'00,계,1998,12059,6111,5948
'4687025600,  홍농읍,'05,0 - 4세,1998,1236,645,591
'4687025600,  홍농읍,'10,5 - 9세,1998,1168,609,559
'4687025600,  홍농읍,'15,10 - 14세,1998,900,434,466
'4687025600,  홍농읍,'20,15 - 19세,1998,877,402,475
'4687025600,  홍농읍,'25,20 - 24세,1998,821,481,340
'4687025600,  홍농읍,'30,25 - 29세,1998,1065,544,521
'4687025600,  홍농읍,'35,30 - 34세,1998,1361,709,652
'4687025600,  홍농읍,'40,35 - 39세,1998,1162,631,531
'4687025600,  홍농읍,'45,40 - 44세,1998,697,434,263
'4687025600,  홍농읍,'50,45 - 49세,1998,495,276,219
'4687025600,  홍농읍,'55,50 - 54세,1998,455,226,229
'4687025600,  홍농읍,'60,55 - 59세,1998,578,259,319
'4687025600,  홍농읍,'65,60 - 64세,1998,456,198,258
'4687025600,  홍농읍,'70,65 - 69세,1998,317,121,196
'4687025600,  홍농읍,'75,70 - 74세,1998,195,68,127
'4687025600,  홍농읍,'80,75 - 79세,1998,171,55,116
'4687025600,  홍농읍,'85,80 - 84세,1998,55,12,43
'4687025600,  홍농읍,'90,85+ ,1998,50,7,43
'4687031000,  대마면,'00,계,1998,2783,1385,1398
'4687031000,  대마면,'05,0 - 4세,1998,92,46,46
'4687031000,  대마면,'10,5 - 9세,1998,113,63,50
'4687031000,  대마면,'15,10 - 14세,1998,144,80,64
'4687031000,  대마면,'20,15 - 19세,1998,257,123,134
'4687031000,  대마면,'25,20 - 24세,1998,263,166,97
'4687031000,  대마면,'30,25 - 29세,1998,153,102,51
'4687031000,  대마면,'35,30 - 34세,1998,126,73,53
'4687031000,  대마면,'40,35 - 39세,1998,152,76,76
'4687031000,  대마면,'45,40 - 44세,1998,127,74,53
'4687031000,  대마면,'50,45 - 49세,1998,134,70,64
'4687031000,  대마면,'55,50 - 54세,1998,163,73,90
'4687031000,  대마면,'60,55 - 59세,1998,243,110,133
'4687031000,  대마면,'65,60 - 64세,1998,272,113,159
'4687031000,  대마면,'70,65 - 69세,1998,178,59,119
'4687031000,  대마면,'75,70 - 74세,1998,145,66,79
'4687031000,  대마면,'80,75 - 79세,1998,127,57,70
'4687031000,  대마면,'85,80 - 84세,1998,61,25,36
'4687031000,  대마면,'90,85+ ,1998,33,9,24
'4687032000,  묘량면,'00,계,1998,2765,1372,1393
'4687032000,  묘량면,'05,0 - 4세,1998,69,33,36
'4687032000,  묘량면,'10,5 - 9세,1998,104,54,50
'4687032000,  묘량면,'15,10 - 14세,1998,140,71,69
'4687032000,  묘량면,'20,15 - 19세,1998,243,123,120
'4687032000,  묘량면,'25,20 - 24세,1998,251,147,104
'4687032000,  묘량면,'30,25 - 29세,1998,177,130,47
'4687032000,  묘량면,'35,30 - 34세,1998,121,71,50
'4687032000,  묘량면,'40,35 - 39세,1998,120,70,50
'4687032000,  묘량면,'45,40 - 44세,1998,116,61,55
'4687032000,  묘량면,'50,45 - 49세,1998,150,71,79
'4687032000,  묘량면,'55,50 - 54세,1998,178,93,85
'4687032000,  묘량면,'60,55 - 59세,1998,274,121,153
'4687032000,  묘량면,'65,60 - 64세,1998,297,126,171
'4687032000,  묘량면,'70,65 - 69세,1998,201,85,116
'4687032000,  묘량면,'75,70 - 74세,1998,137,54,83
'4687032000,  묘량면,'80,75 - 79세,1998,98,36,62
'4687032000,  묘량면,'85,80 - 84세,1998,51,18,33
'4687032000,  묘량면,'90,85+ ,1998,38,8,30
'4687033000,  불갑면,'00,계,1998,2089,1018,1071
'4687033000,  불갑면,'05,0 - 4세,1998,106,53,53
'4687033000,  불갑면,'10,5 - 9세,1998,69,33,36
'4687033000,  불갑면,'15,10 - 14세,1998,104,50,54
'4687033000,  불갑면,'20,15 - 19세,1998,173,83,90
'4687033000,  불갑면,'25,20 - 24세,1998,191,121,70
'4687033000,  불갑면,'30,25 - 29세,1998,135,87,48
'4687033000,  불갑면,'35,30 - 34세,1998,91,58,33
'4687033000,  불갑면,'40,35 - 39세,1998,105,52,53
'4687033000,  불갑면,'45,40 - 44세,1998,94,52,42
'4687033000,  불갑면,'50,45 - 49세,1998,127,65,62
'4687033000,  불갑면,'55,50 - 54세,1998,129,58,71
'4687033000,  불갑면,'60,55 - 59세,1998,186,80,106
'4687033000,  불갑면,'65,60 - 64세,1998,180,73,107
'4687033000,  불갑면,'70,65 - 69세,1998,148,62,86
'4687033000,  불갑면,'75,70 - 74세,1998,101,36,65
'4687033000,  불갑면,'80,75 - 79세,1998,80,35,45
'4687033000,  불갑면,'85,80 - 84세,1998,38,14,24
'4687033000,  불갑면,'90,85+ ,1998,32,6,26
'4687034000,  군서면,'00,계,1998,3474,1775,1699
'4687034000,  군서면,'05,0 - 4세,1998,120,54,66
'4687034000,  군서면,'10,5 - 9세,1998,91,51,40
'4687034000,  군서면,'15,10 - 14세,1998,147,75,72
'4687034000,  군서면,'20,15 - 19세,1998,317,152,165
'4687034000,  군서면,'25,20 - 24세,1998,385,260,125
'4687034000,  군서면,'30,25 - 29세,1998,216,146,70
'4687034000,  군서면,'35,30 - 34세,1998,153,106,47
'4687034000,  군서면,'40,35 - 39세,1998,154,85,69
'4687034000,  군서면,'45,40 - 44세,1998,183,106,77
'4687034000,  군서면,'50,45 - 49세,1998,194,86,108
'4687034000,  군서면,'55,50 - 54세,1998,246,117,129
'4687034000,  군서면,'60,55 - 59세,1998,365,162,203
'4687034000,  군서면,'65,60 - 64세,1998,351,166,185
'4687034000,  군서면,'70,65 - 69세,1998,196,81,115
'4687034000,  군서면,'75,70 - 74세,1998,133,44,89
'4687034000,  군서면,'80,75 - 79세,1998,113,49,64
'4687034000,  군서면,'85,80 - 84세,1998,57,21,36
'4687034000,  군서면,'90,85+ ,1998,53,14,39
'4687035000,  군남면,'00,계,1998,4260,2076,2184
'4687035000,  군남면,'05,0 - 4세,1998,114,48,66
'4687035000,  군남면,'10,5 - 9세,1998,122,63,59
'4687035000,  군남면,'15,10 - 14세,1998,189,94,95
'4687035000,  군남면,'20,15 - 19세,1998,364,178,186
'4687035000,  군남면,'25,20 - 24세,1998,408,262,146
'4687035000,  군남면,'30,25 - 29세,1998,240,170,70
'4687035000,  군남면,'35,30 - 34세,1998,154,97,57
'4687035000,  군남면,'40,35 - 39세,1998,171,93,78
'4687035000,  군남면,'45,40 - 44세,1998,168,88,80
'4687035000,  군남면,'50,45 - 49세,1998,232,105,127
'4687035000,  군남면,'55,50 - 54세,1998,285,129,156
'4687035000,  군남면,'60,55 - 59세,1998,492,211,281
'4687035000,  군남면,'65,60 - 64세,1998,483,218,265
'4687035000,  군남면,'70,65 - 69세,1998,316,141,175
'4687035000,  군남면,'75,70 - 74세,1998,226,89,137
'4687035000,  군남면,'80,75 - 79세,1998,159,61,98
'4687035000,  군남면,'85,80 - 84세,1998,89,19,70
'4687035000,  군남면,'90,85+ ,1998,48,10,38
'4687036000,  염산면,'00,계,1998,7331,3686,3645
'4687036000,  염산면,'05,0 - 4세,1998,239,143,96
'4687036000,  염산면,'10,5 - 9세,1998,307,153,154
'4687036000,  염산면,'15,10 - 14세,1998,468,228,240
'4687036000,  염산면,'20,15 - 19세,1998,884,461,423
'4687036000,  염산면,'25,20 - 24세,1998,801,499,302
'4687036000,  염산면,'30,25 - 29세,1998,394,265,129
'4687036000,  염산면,'35,30 - 34세,1998,316,179,137
'4687036000,  염산면,'40,35 - 39세,1998,425,206,219
'4687036000,  염산면,'45,40 - 44세,1998,463,240,223
'4687036000,  염산면,'50,45 - 49세,1998,480,218,262
'4687036000,  염산면,'55,50 - 54세,1998,520,269,251
'4687036000,  염산면,'60,55 - 59세,1998,632,290,342
'4687036000,  염산면,'65,60 - 64세,1998,509,214,295
'4687036000,  염산면,'70,65 - 69세,1998,368,145,223
'4687036000,  염산면,'75,70 - 74세,1998,250,101,149
'4687036000,  염산면,'80,75 - 79세,1998,142,46,96
'4687036000,  염산면,'85,80 - 84세,1998,79,20,59
'4687036000,  염산면,'90,85+ ,1998,54,9,45
'4687037000,  법성면,'00,계,1998,8857,4441,4416
'4687037000,  법성면,'05,0 - 4세,1998,437,228,209
'4687037000,  법성면,'10,5 - 9세,1998,513,272,241
'4687037000,  법성면,'15,10 - 14세,1998,553,293,260
'4687037000,  법성면,'20,15 - 19세,1998,946,447,499
'4687037000,  법성면,'25,20 - 24세,1998,883,494,389
'4687037000,  법성면,'30,25 - 29세,1998,626,403,223
'4687037000,  법성면,'35,30 - 34세,1998,528,300,228
'4687037000,  법성면,'40,35 - 39세,1998,558,301,257
'4687037000,  법성면,'45,40 - 44세,1998,531,295,236
'4687037000,  법성면,'50,45 - 49세,1998,476,256,220
'4687037000,  법성면,'55,50 - 54세,1998,542,259,283
'4687037000,  법성면,'60,55 - 59세,1998,673,281,392
'4687037000,  법성면,'65,60 - 64세,1998,576,253,323
'4687037000,  법성면,'70,65 - 69세,1998,377,147,230
'4687037000,  법성면,'75,70 - 74세,1998,269,98,171
'4687037000,  법성면,'80,75 - 79세,1998,216,80,136
'4687037000,  법성면,'85,80 - 84세,1998,89,25,64
'4687037000,  법성면,'90,85+ ,1998,64,9,55
'4687038000,  낙월면,'00,계,1998,925,523,402
'4687038000,  낙월면,'05,0 - 4세,1998,45,23,22
'4687038000,  낙월면,'10,5 - 9세,1998,50,29,21
'4687038000,  낙월면,'15,10 - 14세,1998,30,16,14
'4687038000,  낙월면,'20,15 - 19세,1998,83,45,38
'4687038000,  낙월면,'25,20 - 24세,1998,107,71,36
'4687038000,  낙월면,'30,25 - 29세,1998,80,57,23
'4687038000,  낙월면,'35,30 - 34세,1998,60,39,21
'4687038000,  낙월면,'40,35 - 39세,1998,78,51,27
'4687038000,  낙월면,'45,40 - 44세,1998,73,45,28
'4687038000,  낙월면,'50,45 - 49세,1998,54,34,20
'4687038000,  낙월면,'55,50 - 54세,1998,61,33,28
'4687038000,  낙월면,'60,55 - 59세,1998,48,27,21
'4687038000,  낙월면,'65,60 - 64세,1998,55,28,27
'4687038000,  낙월면,'70,65 - 69세,1998,37,12,25
'4687038000,  낙월면,'75,70 - 74세,1998,28,7,21
'4687038000,  낙월면,'80,75 - 79세,1998,18,5,13
'4687038000,  낙월면,'85,80 - 84세,1998,9,0,9
'4687038000,  낙월면,'90,85+ ,1998,9,1,8
'46880, 장성군,'00,계,1998,56992,28730,28262
'46880, 장성군,'05,0 - 4세,1998,3230,1656,1574
'46880, 장성군,'10,5 - 9세,1998,3027,1563,1464
'46880, 장성군,'15,10 - 14세,1998,2976,1497,1479
'46880, 장성군,'20,15 - 19세,1998,4893,2502,2391
'46880, 장성군,'25,20 - 24세,1998,5368,3023,2345
'46880, 장성군,'30,25 - 29세,1998,5055,3077,1978
'46880, 장성군,'35,30 - 34세,1998,3652,2077,1575
'46880, 장성군,'40,35 - 39세,1998,3678,2112,1566
'46880, 장성군,'45,40 - 44세,1998,2933,1602,1331
'46880, 장성군,'50,45 - 49세,1998,2761,1396,1365
'46880, 장성군,'55,50 - 54세,1998,3140,1515,1625
'46880, 장성군,'60,55 - 59세,1998,4354,1931,2423
'46880, 장성군,'65,60 - 64세,1998,4264,1867,2397
'46880, 장성군,'70,65 - 69세,1998,2794,1128,1666
'46880, 장성군,'75,70 - 74세,1998,2019,835,1184
'46880, 장성군,'80,75 - 79세,1998,1541,587,954
'46880, 장성군,'85,80 - 84세,1998,747,237,510
'46880, 장성군,'90,85+ ,1998,560,125,435
'4688025000,  장성읍,'00,계,1998,15244,7637,7607
'4688025000,  장성읍,'05,0 - 4세,1998,847,439,408
'4688025000,  장성읍,'10,5 - 9세,1998,872,437,435
'4688025000,  장성읍,'15,10 - 14세,1998,894,459,435
'4688025000,  장성읍,'20,15 - 19세,1998,1525,793,732
'4688025000,  장성읍,'25,20 - 24세,1998,1525,841,684
'4688025000,  장성읍,'30,25 - 29세,1998,1290,765,525
'4688025000,  장성읍,'35,30 - 34세,1998,957,529,428
'4688025000,  장성읍,'40,35 - 39세,1998,1030,547,483
'4688025000,  장성읍,'45,40 - 44세,1998,932,492,440
'4688025000,  장성읍,'50,45 - 49세,1998,840,403,437
'4688025000,  장성읍,'55,50 - 54세,1998,896,442,454
'4688025000,  장성읍,'60,55 - 59세,1998,1038,461,577
'4688025000,  장성읍,'65,60 - 64세,1998,968,432,536
'4688025000,  장성읍,'70,65 - 69세,1998,616,235,381
'4688025000,  장성읍,'75,70 - 74세,1998,426,171,255
'4688025000,  장성읍,'80,75 - 79세,1998,315,114,201
'4688025000,  장성읍,'85,80 - 84세,1998,154,49,105
'4688025000,  장성읍,'90,85+ ,1998,119,28,91
'4688031000,  진원면,'00,계,1998,3595,1824,1771
'4688031000,  진원면,'05,0 - 4세,1998,152,70,82
'4688031000,  진원면,'10,5 - 9세,1998,112,57,55
'4688031000,  진원면,'15,10 - 14세,1998,177,88,89
'4688031000,  진원면,'20,15 - 19세,1998,314,159,155
'4688031000,  진원면,'25,20 - 24세,1998,366,210,156
'4688031000,  진원면,'30,25 - 29세,1998,275,190,85
'4688031000,  진원면,'35,30 - 34세,1998,186,112,74
'4688031000,  진원면,'40,35 - 39세,1998,207,126,81
'4688031000,  진원면,'45,40 - 44세,1998,198,103,95
'4688031000,  진원면,'50,45 - 49세,1998,179,99,80
'4688031000,  진원면,'55,50 - 54세,1998,227,106,121
'4688031000,  진원면,'60,55 - 59세,1998,299,141,158
'4688031000,  진원면,'65,60 - 64세,1998,301,124,177
'4688031000,  진원면,'70,65 - 69세,1998,233,106,127
'4688031000,  진원면,'75,70 - 74세,1998,143,64,79
'4688031000,  진원면,'80,75 - 79세,1998,109,43,66
'4688031000,  진원면,'85,80 - 84세,1998,66,22,44
'4688031000,  진원면,'90,85+ ,1998,51,4,47
'4688032000,  남면,'00,계,1998,4214,2136,2078
'4688032000,  남면,'05,0 - 4세,1998,205,102,103
'4688032000,  남면,'10,5 - 9세,1998,147,83,64
'4688032000,  남면,'15,10 - 14세,1998,156,77,79
'4688032000,  남면,'20,15 - 19세,1998,334,173,161
'4688032000,  남면,'25,20 - 24세,1998,412,246,166
'4688032000,  남면,'30,25 - 29세,1998,393,260,133
'4688032000,  남면,'35,30 - 34세,1998,250,173,77
'4688032000,  남면,'40,35 - 39세,1998,219,142,77
'4688032000,  남면,'45,40 - 44세,1998,195,108,87
'4688032000,  남면,'50,45 - 49세,1998,204,99,105
'4688032000,  남면,'55,50 - 54세,1998,212,97,115
'4688032000,  남면,'60,55 - 59세,1998,355,144,211
'4688032000,  남면,'65,60 - 64세,1998,409,165,244
'4688032000,  남면,'70,65 - 69세,1998,289,115,174
'4688032000,  남면,'75,70 - 74세,1998,183,70,113
'4688032000,  남면,'80,75 - 79세,1998,138,48,90
'4688032000,  남면,'85,80 - 84세,1998,65,20,45
'4688032000,  남면,'90,85+ ,1998,48,14,34
'4688033000,  동화면,'00,계,1998,2816,1422,1394
'4688033000,  동화면,'05,0 - 4세,1998,127,66,61
'4688033000,  동화면,'10,5 - 9세,1998,103,57,46
'4688033000,  동화면,'15,10 - 14세,1998,149,72,77
'4688033000,  동화면,'20,15 - 19세,1998,257,129,128
'4688033000,  동화면,'25,20 - 24세,1998,288,169,119
'4688033000,  동화면,'30,25 - 29세,1998,200,135,65
'4688033000,  동화면,'35,30 - 34세,1998,151,93,58
'4688033000,  동화면,'40,35 - 39세,1998,133,76,57
'4688033000,  동화면,'45,40 - 44세,1998,146,81,65
'4688033000,  동화면,'50,45 - 49세,1998,133,78,55
'4688033000,  동화면,'55,50 - 54세,1998,156,72,84
'4688033000,  동화면,'60,55 - 59세,1998,245,108,137
'4688033000,  동화면,'65,60 - 64세,1998,255,103,152
'4688033000,  동화면,'70,65 - 69세,1998,181,75,106
'4688033000,  동화면,'75,70 - 74세,1998,121,52,69
'4688033000,  동화면,'80,75 - 79세,1998,91,37,54
'4688033000,  동화면,'85,80 - 84세,1998,46,13,33
'4688033000,  동화면,'90,85+ ,1998,34,6,28
'4688034000,  삼서면,'00,계,1998,4063,2083,1980
'4688034000,  삼서면,'05,0 - 4세,1998,141,74,67
'4688034000,  삼서면,'10,5 - 9세,1998,140,82,58
'4688034000,  삼서면,'15,10 - 14세,1998,175,81,94
'4688034000,  삼서면,'20,15 - 19세,1998,328,153,175
'4688034000,  삼서면,'25,20 - 24세,1998,379,234,145
'4688034000,  삼서면,'30,25 - 29세,1998,323,223,100
'4688034000,  삼서면,'35,30 - 34세,1998,182,112,70
'4688034000,  삼서면,'40,35 - 39세,1998,184,120,64
'4688034000,  삼서면,'45,40 - 44세,1998,193,117,76
'4688034000,  삼서면,'50,45 - 49세,1998,205,106,99
'4688034000,  삼서면,'55,50 - 54세,1998,255,132,123
'4688034000,  삼서면,'60,55 - 59세,1998,425,168,257
'4688034000,  삼서면,'65,60 - 64세,1998,412,185,227
'4688034000,  삼서면,'70,65 - 69세,1998,239,112,127
'4688034000,  삼서면,'75,70 - 74세,1998,194,81,113
'4688034000,  삼서면,'80,75 - 79세,1998,154,61,93
'4688034000,  삼서면,'85,80 - 84세,1998,79,29,50
'4688034000,  삼서면,'90,85+ ,1998,55,13,42
'4688035000,  삼계면,'00,계,1998,8761,4426,4335
'4688035000,  삼계면,'05,0 - 4세,1998,919,491,428
'4688035000,  삼계면,'10,5 - 9세,1998,823,428,395
'4688035000,  삼계면,'15,10 - 14세,1998,512,259,253
'4688035000,  삼계면,'20,15 - 19세,1998,478,238,240
'4688035000,  삼계면,'25,20 - 24세,1998,638,345,293
'4688035000,  삼계면,'30,25 - 29세,1998,1223,656,567
'4688035000,  삼계면,'35,30 - 34세,1998,879,466,413
'4688035000,  삼계면,'40,35 - 39세,1998,753,414,339
'4688035000,  삼계면,'45,40 - 44세,1998,361,204,157
'4688035000,  삼계면,'50,45 - 49세,1998,285,141,144
'4688035000,  삼계면,'55,50 - 54세,1998,293,149,144
'4688035000,  삼계면,'60,55 - 59세,1998,457,200,257
'4688035000,  삼계면,'65,60 - 64세,1998,400,178,222
'4688035000,  삼계면,'70,65 - 69세,1998,245,80,165
'4688035000,  삼계면,'75,70 - 74세,1998,214,87,127
'4688035000,  삼계면,'80,75 - 79세,1998,152,56,96
'4688035000,  삼계면,'85,80 - 84세,1998,71,22,49
'4688035000,  삼계면,'90,85+ ,1998,58,12,46
'4688036000,  황룡면,'00,계,1998,6423,3253,3170
'4688036000,  황룡면,'05,0 - 4세,1998,386,199,187
'4688036000,  황룡면,'10,5 - 9세,1998,354,178,176
'4688036000,  황룡면,'15,10 - 14세,1998,341,178,163
'4688036000,  황룡면,'20,15 - 19세,1998,590,306,284
'4688036000,  황룡면,'25,20 - 24세,1998,624,327,297
'4688036000,  황룡면,'30,25 - 29세,1998,543,324,219
'4688036000,  황룡면,'35,30 - 34세,1998,454,256,198
'4688036000,  황룡면,'40,35 - 39세,1998,438,253,185
'4688036000,  황룡면,'45,40 - 44세,1998,343,194,149
'4688036000,  황룡면,'50,45 - 49세,1998,328,166,162
'4688036000,  황룡면,'55,50 - 54세,1998,340,175,165
'4688036000,  황룡면,'60,55 - 59세,1998,398,187,211
'4688036000,  황룡면,'65,60 - 64세,1998,431,175,256
'4688036000,  황룡면,'70,65 - 69세,1998,325,123,202
'4688036000,  황룡면,'75,70 - 74세,1998,239,94,145
'4688036000,  황룡면,'80,75 - 79세,1998,162,74,88
'4688036000,  황룡면,'85,80 - 84세,1998,80,29,51
'4688036000,  황룡면,'90,85+ ,1998,47,15,32
'4688037000,  서삼면,'00,계,1998,2025,1049,976
'4688037000,  서삼면,'05,0 - 4세,1998,84,42,42
'4688037000,  서삼면,'10,5 - 9세,1998,69,40,29
'4688037000,  서삼면,'15,10 - 14세,1998,87,37,50
'4688037000,  서삼면,'20,15 - 19세,1998,190,110,80
'4688037000,  서삼면,'25,20 - 24세,1998,185,102,83
'4688037000,  서삼면,'30,25 - 29세,1998,146,102,44
'4688037000,  서삼면,'35,30 - 34세,1998,100,60,40
'4688037000,  서삼면,'40,35 - 39세,1998,116,74,42
'4688037000,  서삼면,'45,40 - 44세,1998,105,58,47
'4688037000,  서삼면,'50,45 - 49세,1998,111,63,48
'4688037000,  서삼면,'55,50 - 54세,1998,115,48,67
'4688037000,  서삼면,'60,55 - 59세,1998,188,89,99
'4688037000,  서삼면,'65,60 - 64세,1998,196,88,108
'4688037000,  서삼면,'70,65 - 69세,1998,127,57,70
'4688037000,  서삼면,'75,70 - 74세,1998,86,43,43
'4688037000,  서삼면,'80,75 - 79세,1998,66,22,44
'4688037000,  서삼면,'85,80 - 84세,1998,25,5,20
'4688037000,  서삼면,'90,85+ ,1998,29,9,20
'4688038000,  북일면,'00,계,1998,2300,1121,1179
'4688038000,  북일면,'05,0 - 4세,1998,100,48,52
'4688038000,  북일면,'10,5 - 9세,1998,109,51,58
'4688038000,  북일면,'15,10 - 14세,1998,111,48,63
'4688038000,  북일면,'20,15 - 19세,1998,204,114,90
'4688038000,  북일면,'25,20 - 24세,1998,203,113,90
'4688038000,  북일면,'30,25 - 29세,1998,162,99,63
'4688038000,  북일면,'35,30 - 34세,1998,110,62,48
'4688038000,  북일면,'40,35 - 39세,1998,117,73,44
'4688038000,  북일면,'45,40 - 44세,1998,101,54,47
'4688038000,  북일면,'50,45 - 49세,1998,107,59,48
'4688038000,  북일면,'55,50 - 54세,1998,143,52,91
'4688038000,  북일면,'60,55 - 59세,1998,234,119,115
'4688038000,  북일면,'65,60 - 64세,1998,209,93,116
'4688038000,  북일면,'70,65 - 69세,1998,127,51,76
'4688038000,  북일면,'75,70 - 74세,1998,95,40,55
'4688038000,  북일면,'80,75 - 79세,1998,103,31,72
'4688038000,  북일면,'85,80 - 84세,1998,42,12,30
'4688038000,  북일면,'90,85+ ,1998,23,2,21
'4688039000,  북이면,'00,계,1998,4304,2127,2177
'4688039000,  북이면,'05,0 - 4세,1998,151,72,79
'4688039000,  북이면,'10,5 - 9세,1998,171,83,88
'4688039000,  북이면,'15,10 - 14세,1998,220,116,104
'4688039000,  북이면,'20,15 - 19세,1998,382,176,206
'4688039000,  북이면,'25,20 - 24세,1998,439,252,187
'4688039000,  북이면,'30,25 - 29세,1998,289,187,102
'4688039000,  북이면,'35,30 - 34세,1998,196,109,87
'4688039000,  북이면,'40,35 - 39세,1998,249,145,104
'4688039000,  북이면,'45,40 - 44세,1998,190,96,94
'4688039000,  북이면,'50,45 - 49세,1998,212,108,104
'4688039000,  북이면,'55,50 - 54세,1998,281,135,146
'4688039000,  북이면,'60,55 - 59세,1998,447,188,259
'4688039000,  북이면,'65,60 - 64세,1998,414,203,211
'4688039000,  북이면,'70,65 - 69세,1998,222,94,128
'4688039000,  북이면,'75,70 - 74세,1998,175,74,101
'4688039000,  북이면,'80,75 - 79세,1998,151,62,89
'4688039000,  북이면,'85,80 - 84세,1998,63,17,46
'4688039000,  북이면,'90,85+ ,1998,52,10,42
'4688040000,  북하면,'00,계,1998,3247,1652,1595
'4688040000,  북하면,'05,0 - 4세,1998,118,53,65
'4688040000,  북하면,'10,5 - 9세,1998,127,67,60
'4688040000,  북하면,'15,10 - 14세,1998,154,82,72
'4688040000,  북하면,'20,15 - 19세,1998,291,151,140
'4688040000,  북하면,'25,20 - 24세,1998,309,184,125
'4688040000,  북하면,'30,25 - 29세,1998,211,136,75
'4688040000,  북하면,'35,30 - 34세,1998,187,105,82
'4688040000,  북하면,'40,35 - 39세,1998,232,142,90
'4688040000,  북하면,'45,40 - 44세,1998,169,95,74
'4688040000,  북하면,'50,45 - 49세,1998,157,74,83
'4688040000,  북하면,'55,50 - 54세,1998,222,107,115
'4688040000,  북하면,'60,55 - 59세,1998,268,126,142
'4688040000,  북하면,'65,60 - 64세,1998,269,121,148
'4688040000,  북하면,'70,65 - 69세,1998,190,80,110
'4688040000,  북하면,'75,70 - 74세,1998,143,59,84
'4688040000,  북하면,'80,75 - 79세,1998,100,39,61
'4688040000,  북하면,'85,80 - 84세,1998,56,19,37
'4688040000,  북하면,'90,85+ ,1998,44,12,32
'46890, 완도군,'00,계,1998,68915,34437,34478
'46890, 완도군,'05,0 - 4세,1998,3290,1724,1566
'46890, 완도군,'10,5 - 9세,1998,3425,1769,1656
'46890, 완도군,'15,10 - 14세,1998,4393,2217,2176
'46890, 완도군,'20,15 - 19세,1998,7362,3686,3676
'46890, 완도군,'25,20 - 24세,1998,6117,3823,2294
'46890, 완도군,'30,25 - 29세,1998,3911,2312,1599
'46890, 완도군,'35,30 - 34세,1998,3658,1996,1662
'46890, 완도군,'40,35 - 39세,1998,4554,2309,2245
'46890, 완도군,'45,40 - 44세,1998,4181,2210,1971
'46890, 완도군,'50,45 - 49세,1998,3880,1943,1937
'46890, 완도군,'55,50 - 54세,1998,4507,2264,2243
'46890, 완도군,'60,55 - 59세,1998,5743,2742,3001
'46890, 완도군,'65,60 - 64세,1998,4992,2238,2754
'46890, 완도군,'70,65 - 69세,1998,3733,1569,2164
'46890, 완도군,'75,70 - 74세,1998,2134,813,1321
'46890, 완도군,'80,75 - 79세,1998,1673,529,1144
'46890, 완도군,'85,80 - 84세,1998,829,218,611
'46890, 완도군,'90,85+ ,1998,533,75,458
'4689025000,  완도읍,'00,계,1998,22486,11287,11199
'4689025000,  완도읍,'05,0 - 4세,1998,1623,851,772
'4689025000,  완도읍,'10,5 - 9세,1998,1609,841,768
'4689025000,  완도읍,'15,10 - 14세,1998,1661,833,828
'4689025000,  완도읍,'20,15 - 19세,1998,2263,1136,1127
'4689025000,  완도읍,'25,20 - 24세,1998,1911,1081,830
'4689025000,  완도읍,'30,25 - 29세,1998,1614,851,763
'4689025000,  완도읍,'35,30 - 34세,1998,1696,879,817
'4689025000,  완도읍,'40,35 - 39세,1998,1972,975,997
'4689025000,  완도읍,'45,40 - 44세,1998,1568,834,734
'4689025000,  완도읍,'50,45 - 49세,1998,1237,635,602
'4689025000,  완도읍,'55,50 - 54세,1998,1224,633,591
'4689025000,  완도읍,'60,55 - 59세,1998,1254,628,626
'4689025000,  완도읍,'65,60 - 64세,1998,991,448,543
'4689025000,  완도읍,'70,65 - 69세,1998,743,323,420
'4689025000,  완도읍,'75,70 - 74세,1998,448,158,290
'4689025000,  완도읍,'80,75 - 79세,1998,365,114,251
'4689025000,  완도읍,'85,80 - 84세,1998,179,51,128
'4689025000,  완도읍,'90,85+ ,1998,128,16,112
'4689025300,  금일읍,'00,계,1998,5568,2821,2747
'4689025300,  금일읍,'05,0 - 4세,1998,203,102,101
'4689025300,  금일읍,'10,5 - 9세,1998,231,123,108
'4689025300,  금일읍,'15,10 - 14세,1998,308,162,146
'4689025300,  금일읍,'20,15 - 19세,1998,657,331,326
'4689025300,  금일읍,'25,20 - 24세,1998,491,328,163
'4689025300,  금일읍,'30,25 - 29세,1998,261,173,88
'4689025300,  금일읍,'35,30 - 34세,1998,277,167,110
'4689025300,  금일읍,'40,35 - 39세,1998,319,171,148
'4689025300,  금일읍,'45,40 - 44세,1998,370,203,167
'4689025300,  금일읍,'50,45 - 49세,1998,394,216,178
'4689025300,  금일읍,'55,50 - 54세,1998,378,173,205
'4689025300,  금일읍,'60,55 - 59세,1998,526,261,265
'4689025300,  금일읍,'65,60 - 64세,1998,403,149,254
'4689025300,  금일읍,'70,65 - 69세,1998,320,143,177
'4689025300,  금일읍,'75,70 - 74세,1998,192,68,124
'4689025300,  금일읍,'80,75 - 79세,1998,141,36,105
'4689025300,  금일읍,'85,80 - 84세,1998,65,10,55
'4689025300,  금일읍,'90,85+ ,1998,32,5,27
'4689025600,  노화읍,'00,계,1998,7255,3669,3586
'4689025600,  노화읍,'05,0 - 4세,1998,284,138,146
'4689025600,  노화읍,'10,5 - 9세,1998,323,171,152
'4689025600,  노화읍,'15,10 - 14세,1998,535,285,250
'4689025600,  노화읍,'20,15 - 19세,1998,844,426,418
'4689025600,  노화읍,'25,20 - 24세,1998,716,474,242
'4689025600,  노화읍,'30,25 - 29세,1998,357,217,140
'4689025600,  노화읍,'35,30 - 34세,1998,312,163,149
'4689025600,  노화읍,'40,35 - 39세,1998,462,236,226
'4689025600,  노화읍,'45,40 - 44세,1998,421,225,196
'4689025600,  노화읍,'50,45 - 49세,1998,401,199,202
'4689025600,  노화읍,'55,50 - 54세,1998,522,270,252
'4689025600,  노화읍,'60,55 - 59세,1998,638,316,322
'4689025600,  노화읍,'65,60 - 64세,1998,551,244,307
'4689025600,  노화읍,'70,65 - 69세,1998,387,155,232
'4689025600,  노화읍,'75,70 - 74세,1998,189,64,125
'4689025600,  노화읍,'80,75 - 79세,1998,167,54,113
'4689025600,  노화읍,'85,80 - 84세,1998,77,16,61
'4689025600,  노화읍,'90,85+ ,1998,69,16,53
'4689031000,  군외면,'00,계,1998,5041,2500,2541
'4689031000,  군외면,'05,0 - 4세,1998,179,88,91
'4689031000,  군외면,'10,5 - 9세,1998,147,69,78
'4689031000,  군외면,'15,10 - 14세,1998,267,144,123
'4689031000,  군외면,'20,15 - 19세,1998,577,288,289
'4689031000,  군외면,'25,20 - 24세,1998,458,286,172
'4689031000,  군외면,'30,25 - 29세,1998,297,193,104
'4689031000,  군외면,'35,30 - 34세,1998,204,118,86
'4689031000,  군외면,'40,35 - 39세,1998,263,139,124
'4689031000,  군외면,'45,40 - 44세,1998,309,143,166
'4689031000,  군외면,'50,45 - 49세,1998,285,148,137
'4689031000,  군외면,'55,50 - 54세,1998,345,192,153
'4689031000,  군외면,'60,55 - 59세,1998,461,202,259
'4689031000,  군외면,'65,60 - 64세,1998,424,204,220
'4689031000,  군외면,'70,65 - 69세,1998,339,129,210
'4689031000,  군외면,'75,70 - 74세,1998,203,73,130
'4689031000,  군외면,'80,75 - 79세,1998,172,56,116
'4689031000,  군외면,'85,80 - 84세,1998,71,23,48
'4689031000,  군외면,'90,85+ ,1998,40,5,35
'4689032000,  신지면,'00,계,1998,4971,2499,2472
'4689032000,  신지면,'05,0 - 4세,1998,179,101,78
'4689032000,  신지면,'10,5 - 9세,1998,192,102,90
'4689032000,  신지면,'15,10 - 14세,1998,254,117,137
'4689032000,  신지면,'20,15 - 19세,1998,509,258,251
'4689032000,  신지면,'25,20 - 24세,1998,466,298,168
'4689032000,  신지면,'30,25 - 29세,1998,278,195,83
'4689032000,  신지면,'35,30 - 34세,1998,240,134,106
'4689032000,  신지면,'40,35 - 39세,1998,287,145,142
'4689032000,  신지면,'45,40 - 44세,1998,262,134,128
'4689032000,  신지면,'50,45 - 49세,1998,287,130,157
'4689032000,  신지면,'55,50 - 54세,1998,388,196,192
'4689032000,  신지면,'60,55 - 59세,1998,477,232,245
'4689032000,  신지면,'65,60 - 64세,1998,443,210,233
'4689032000,  신지면,'70,65 - 69세,1998,281,125,156
'4689032000,  신지면,'75,70 - 74세,1998,171,58,113
'4689032000,  신지면,'80,75 - 79세,1998,124,39,85
'4689032000,  신지면,'85,80 - 84세,1998,77,17,60
'4689032000,  신지면,'90,85+ ,1998,56,8,48
'4689033000,  고금면,'00,계,1998,6187,3023,3164
'4689033000,  고금면,'05,0 - 4세,1998,197,98,99
'4689033000,  고금면,'10,5 - 9세,1998,214,99,115
'4689033000,  고금면,'15,10 - 14세,1998,295,152,143
'4689033000,  고금면,'20,15 - 19세,1998,664,322,342
'4689033000,  고금면,'25,20 - 24세,1998,624,393,231
'4689033000,  고금면,'30,25 - 29세,1998,287,181,106
'4689033000,  고금면,'35,30 - 34세,1998,222,138,84
'4689033000,  고금면,'40,35 - 39세,1998,230,112,118
'4689033000,  고금면,'45,40 - 44세,1998,291,145,146
'4689033000,  고금면,'50,45 - 49세,1998,334,151,183
'4689033000,  고금면,'55,50 - 54세,1998,468,215,253
'4689033000,  고금면,'60,55 - 59세,1998,711,333,378
'4689033000,  고금면,'65,60 - 64세,1998,603,293,310
'4689033000,  고금면,'70,65 - 69세,1998,426,187,239
'4689033000,  고금면,'75,70 - 74세,1998,258,104,154
'4689033000,  고금면,'80,75 - 79세,1998,196,60,136
'4689033000,  고금면,'85,80 - 84세,1998,101,33,68
'4689033000,  고금면,'90,85+ ,1998,66,7,59
'4689034000,  약산면,'00,계,1998,3524,1749,1775
'4689034000,  약산면,'05,0 - 4세,1998,116,64,52
'4689034000,  약산면,'10,5 - 9세,1998,127,62,65
'4689034000,  약산면,'15,10 - 14세,1998,179,91,88
'4689034000,  약산면,'20,15 - 19세,1998,374,188,186
'4689034000,  약산면,'25,20 - 24세,1998,329,214,115
'4689034000,  약산면,'30,25 - 29세,1998,143,80,63
'4689034000,  약산면,'35,30 - 34세,1998,142,79,63
'4689034000,  약산면,'40,35 - 39세,1998,182,92,90
'4689034000,  약산면,'45,40 - 44세,1998,192,100,92
'4689034000,  약산면,'50,45 - 49세,1998,215,101,114
'4689034000,  약산면,'55,50 - 54세,1998,269,136,133
'4689034000,  약산면,'60,55 - 59세,1998,374,179,195
'4689034000,  약산면,'65,60 - 64세,1998,335,145,190
'4689034000,  약산면,'70,65 - 69세,1998,221,99,122
'4689034000,  약산면,'75,70 - 74세,1998,144,69,75
'4689034000,  약산면,'80,75 - 79세,1998,97,31,66
'4689034000,  약산면,'85,80 - 84세,1998,56,15,41
'4689034000,  약산면,'90,85+ ,1998,29,4,25
'4689035000,  청산면,'00,계,1998,3461,1719,1742
'4689035000,  청산면,'05,0 - 4세,1998,110,71,39
'4689035000,  청산면,'10,5 - 9세,1998,134,80,54
'4689035000,  청산면,'15,10 - 14세,1998,181,91,90
'4689035000,  청산면,'20,15 - 19세,1998,266,135,131
'4689035000,  청산면,'25,20 - 24세,1998,232,150,82
'4689035000,  청산면,'30,25 - 29세,1998,151,103,48
'4689035000,  청산면,'35,30 - 34세,1998,120,71,49
'4689035000,  청산면,'40,35 - 39세,1998,203,119,84
'4689035000,  청산면,'45,40 - 44세,1998,181,99,82
'4689035000,  청산면,'50,45 - 49세,1998,165,91,74
'4689035000,  청산면,'55,50 - 54세,1998,189,91,98
'4689035000,  청산면,'60,55 - 59세,1998,369,149,220
'4689035000,  청산면,'65,60 - 64세,1998,396,182,214
'4689035000,  청산면,'70,65 - 69세,1998,344,142,202
'4689035000,  청산면,'75,70 - 74세,1998,174,71,103
'4689035000,  청산면,'80,75 - 79세,1998,138,53,85
'4689035000,  청산면,'85,80 - 84세,1998,63,18,45
'4689035000,  청산면,'90,85+ ,1998,45,3,42
'4689036000,  소안면,'00,계,1998,4168,2064,2104
'4689036000,  소안면,'05,0 - 4세,1998,145,83,62
'4689036000,  소안면,'10,5 - 9세,1998,166,81,85
'4689036000,  소안면,'15,10 - 14세,1998,246,117,129
'4689036000,  소안면,'20,15 - 19세,1998,505,257,248
'4689036000,  소안면,'25,20 - 24세,1998,372,246,126
'4689036000,  소안면,'30,25 - 29세,1998,203,129,74
'4689036000,  소안면,'35,30 - 34세,1998,164,99,65
'4689036000,  소안면,'40,35 - 39세,1998,235,113,122
'4689036000,  소안면,'45,40 - 44세,1998,212,112,100
'4689036000,  소안면,'50,45 - 49세,1998,217,98,119
'4689036000,  소안면,'55,50 - 54세,1998,302,146,156
'4689036000,  소안면,'60,55 - 59세,1998,382,192,190
'4689036000,  소안면,'65,60 - 64세,1998,340,148,192
'4689036000,  소안면,'70,65 - 69세,1998,298,108,190
'4689036000,  소안면,'75,70 - 74세,1998,160,73,87
'4689036000,  소안면,'80,75 - 79세,1998,137,42,95
'4689036000,  소안면,'85,80 - 84세,1998,57,15,42
'4689036000,  소안면,'90,85+ ,1998,27,5,22
'4689037000,  금당면,'00,계,1998,1463,727,736
'4689037000,  금당면,'05,0 - 4세,1998,64,35,29
'4689037000,  금당면,'10,5 - 9세,1998,70,35,35
'4689037000,  금당면,'15,10 - 14세,1998,74,36,38
'4689037000,  금당면,'20,15 - 19세,1998,119,49,70
'4689037000,  금당면,'25,20 - 24세,1998,94,71,23
'4689037000,  금당면,'30,25 - 29세,1998,76,43,33
'4689037000,  금당면,'35,30 - 34세,1998,65,38,27
'4689037000,  금당면,'40,35 - 39세,1998,92,54,38
'4689037000,  금당면,'45,40 - 44세,1998,70,42,28
'4689037000,  금당면,'50,45 - 49세,1998,71,28,43
'4689037000,  금당면,'55,50 - 54세,1998,113,55,58
'4689037000,  금당면,'60,55 - 59세,1998,143,69,74
'4689037000,  금당면,'65,60 - 64세,1998,162,73,89
'4689037000,  금당면,'70,65 - 69세,1998,104,51,53
'4689037000,  금당면,'75,70 - 74세,1998,66,26,40
'4689037000,  금당면,'80,75 - 79세,1998,37,12,25
'4689037000,  금당면,'85,80 - 84세,1998,31,7,24
'4689037000,  금당면,'90,85+ ,1998,12,3,9
'4689038000,  보길면,'00,계,1998,3389,1693,1696
'4689038000,  보길면,'05,0 - 4세,1998,137,70,67
'4689038000,  보길면,'10,5 - 9세,1998,158,80,78
'4689038000,  보길면,'15,10 - 14세,1998,292,144,148
'4689038000,  보길면,'20,15 - 19세,1998,436,225,211
'4689038000,  보길면,'25,20 - 24세,1998,291,199,92
'4689038000,  보길면,'30,25 - 29세,1998,165,94,71
'4689038000,  보길면,'35,30 - 34세,1998,158,78,80
'4689038000,  보길면,'40,35 - 39세,1998,222,111,111
'4689038000,  보길면,'45,40 - 44세,1998,231,128,103
'4689038000,  보길면,'50,45 - 49세,1998,188,104,84
'4689038000,  보길면,'55,50 - 54세,1998,206,103,103
'4689038000,  보길면,'60,55 - 59세,1998,280,121,159
'4689038000,  보길면,'65,60 - 64세,1998,231,93,138
'4689038000,  보길면,'70,65 - 69세,1998,198,81,117
'4689038000,  보길면,'75,70 - 74세,1998,81,33,48
'4689038000,  보길면,'80,75 - 79세,1998,64,16,48
'4689038000,  보길면,'85,80 - 84세,1998,32,10,22
'4689038000,  보길면,'90,85+ ,1998,19,3,16
'4689039000,  생일면,'00,계,1998,1402,686,716
'4689039000,  생일면,'05,0 - 4세,1998,53,23,30
'4689039000,  생일면,'10,5 - 9세,1998,54,26,28
'4689039000,  생일면,'15,10 - 14세,1998,101,45,56
'4689039000,  생일면,'20,15 - 19세,1998,148,71,77
'4689039000,  생일면,'25,20 - 24세,1998,133,83,50
'4689039000,  생일면,'30,25 - 29세,1998,79,53,26
'4689039000,  생일면,'35,30 - 34세,1998,58,32,26
'4689039000,  생일면,'40,35 - 39세,1998,87,42,45
'4689039000,  생일면,'45,40 - 44세,1998,74,45,29
'4689039000,  생일면,'50,45 - 49세,1998,86,42,44
'4689039000,  생일면,'55,50 - 54세,1998,103,54,49
'4689039000,  생일면,'60,55 - 59세,1998,128,60,68
'4689039000,  생일면,'65,60 - 64세,1998,113,49,64
'4689039000,  생일면,'70,65 - 69세,1998,72,26,46
'4689039000,  생일면,'75,70 - 74세,1998,48,16,32
'4689039000,  생일면,'80,75 - 79세,1998,35,16,19
'4689039000,  생일면,'85,80 - 84세,1998,20,3,17
'4689039000,  생일면,'90,85+ ,1998,10,0,10
'46900, 진도군,'00,계,1998,43865,21351,22514
'46900, 진도군,'05,0 - 4세,1998,1971,1040,931
'46900, 진도군,'10,5 - 9세,1998,2149,1109,1040
'46900, 진도군,'15,10 - 14세,1998,2692,1324,1368
'46900, 진도군,'20,15 - 19세,1998,4605,2316,2289
'46900, 진도군,'25,20 - 24세,1998,3819,2347,1472
'46900, 진도군,'30,25 - 29세,1998,2310,1362,948
'46900, 진도군,'35,30 - 34세,1998,2299,1227,1072
'46900, 진도군,'40,35 - 39세,1998,2603,1355,1248
'46900, 진도군,'45,40 - 44세,1998,2437,1306,1131
'46900, 진도군,'50,45 - 49세,1998,2375,1192,1183
'46900, 진도군,'55,50 - 54세,1998,2813,1381,1432
'46900, 진도군,'60,55 - 59세,1998,3975,1766,2209
'46900, 진도군,'65,60 - 64세,1998,3546,1470,2076
'46900, 진도군,'70,65 - 69세,1998,2601,978,1623
'46900, 진도군,'75,70 - 74세,1998,1542,550,992
'46900, 진도군,'80,75 - 79세,1998,1281,444,837
'46900, 진도군,'85,80 - 84세,1998,501,120,381
'46900, 진도군,'90,85+ ,1998,346,64,282
'4690025000,  진도읍,'00,계,1998,11700,5820,5880
'4690025000,  진도읍,'05,0 - 4세,1998,783,438,345
'4690025000,  진도읍,'10,5 - 9세,1998,828,450,378
'4690025000,  진도읍,'15,10 - 14세,1998,849,430,419
'4690025000,  진도읍,'20,15 - 19세,1998,1170,597,573
'4690025000,  진도읍,'25,20 - 24세,1998,940,518,422
'4690025000,  진도읍,'30,25 - 29세,1998,794,429,365
'4690025000,  진도읍,'35,30 - 34세,1998,859,433,426
'4690025000,  진도읍,'40,35 - 39세,1998,903,472,431
'4690025000,  진도읍,'45,40 - 44세,1998,774,429,345
'4690025000,  진도읍,'50,45 - 49세,1998,626,299,327
'4690025000,  진도읍,'55,50 - 54세,1998,681,354,327
'4690025000,  진도읍,'60,55 - 59세,1998,711,312,399
'4690025000,  진도읍,'65,60 - 64세,1998,604,265,339
'4690025000,  진도읍,'70,65 - 69세,1998,463,172,291
'4690025000,  진도읍,'75,70 - 74세,1998,301,98,203
'4690025000,  진도읍,'80,75 - 79세,1998,245,87,158
'4690025000,  진도읍,'85,80 - 84세,1998,111,28,83
'4690025000,  진도읍,'90,85+ ,1998,58,9,49
'4690031000,  군내면,'00,계,1998,4594,2207,2387
'4690031000,  군내면,'05,0 - 4세,1998,189,95,94
'4690031000,  군내면,'10,5 - 9세,1998,188,97,91
'4690031000,  군내면,'15,10 - 14세,1998,267,128,139
'4690031000,  군내면,'20,15 - 19세,1998,437,209,228
'4690031000,  군내면,'25,20 - 24세,1998,421,249,172
'4690031000,  군내면,'30,25 - 29세,1998,225,134,91
'4690031000,  군내면,'35,30 - 34세,1998,227,130,97
'4690031000,  군내면,'40,35 - 39세,1998,234,130,104
'4690031000,  군내면,'45,40 - 44세,1998,227,116,111
'4690031000,  군내면,'50,45 - 49세,1998,267,124,143
'4690031000,  군내면,'55,50 - 54세,1998,294,138,156
'4690031000,  군내면,'60,55 - 59세,1998,458,216,242
'4690031000,  군내면,'65,60 - 64세,1998,404,175,229
'4690031000,  군내면,'70,65 - 69세,1998,302,116,186
'4690031000,  군내면,'75,70 - 74세,1998,193,73,120
'4690031000,  군내면,'80,75 - 79세,1998,155,55,100
'4690031000,  군내면,'85,80 - 84세,1998,61,15,46
'4690031000,  군내면,'90,85+ ,1998,45,7,38
'4690032000,  고군면,'00,계,1998,5469,2620,2849
'4690032000,  고군면,'05,0 - 4세,1998,248,125,123
'4690032000,  고군면,'10,5 - 9세,1998,275,132,143
'4690032000,  고군면,'15,10 - 14세,1998,398,191,207
'4690032000,  고군면,'20,15 - 19세,1998,617,299,318
'4690032000,  고군면,'25,20 - 24세,1998,427,266,161
'4690032000,  고군면,'30,25 - 29세,1998,278,171,107
'4690032000,  고군면,'35,30 - 34세,1998,260,133,127
'4690032000,  고군면,'40,35 - 39세,1998,346,158,188
'4690032000,  고군면,'45,40 - 44세,1998,338,174,164
'4690032000,  고군면,'50,45 - 49세,1998,338,179,159
'4690032000,  고군면,'55,50 - 54세,1998,320,159,161
'4690032000,  고군면,'60,55 - 59세,1998,488,225,263
'4690032000,  고군면,'65,60 - 64세,1998,408,156,252
'4690032000,  고군면,'70,65 - 69세,1998,329,128,201
'4690032000,  고군면,'75,70 - 74세,1998,156,55,101
'4690032000,  고군면,'80,75 - 79세,1998,148,49,99
'4690032000,  고군면,'85,80 - 84세,1998,45,11,34
'4690032000,  고군면,'90,85+ ,1998,50,9,41
'4690033000,  의신면,'00,계,1998,5941,2866,3075
'4690033000,  의신면,'05,0 - 4세,1998,231,112,119
'4690033000,  의신면,'10,5 - 9세,1998,284,136,148
'4690033000,  의신면,'15,10 - 14세,1998,362,162,200
'4690033000,  의신면,'20,15 - 19세,1998,643,338,305
'4690033000,  의신면,'25,20 - 24세,1998,480,311,169
'4690033000,  의신면,'30,25 - 29세,1998,272,158,114
'4690033000,  의신면,'35,30 - 34세,1998,280,148,132
'4690033000,  의신면,'40,35 - 39세,1998,361,185,176
'4690033000,  의신면,'45,40 - 44세,1998,327,176,151
'4690033000,  의신면,'50,45 - 49세,1998,330,162,168
'4690033000,  의신면,'55,50 - 54세,1998,361,172,189
'4690033000,  의신면,'60,55 - 59세,1998,545,250,295
'4690033000,  의신면,'65,60 - 64세,1998,538,228,310
'4690033000,  의신면,'70,65 - 69세,1998,396,142,254
'4690033000,  의신면,'75,70 - 74세,1998,235,91,144
'4690033000,  의신면,'80,75 - 79세,1998,179,71,108
'4690033000,  의신면,'85,80 - 84세,1998,72,19,53
'4690033000,  의신면,'90,85+ ,1998,45,5,40
'4690034000,  임회면,'00,계,1998,5384,2571,2813
'4690034000,  임회면,'05,0 - 4세,1998,202,104,98
'4690034000,  임회면,'10,5 - 9세,1998,219,109,110
'4690034000,  임회면,'15,10 - 14세,1998,305,151,154
'4690034000,  임회면,'20,15 - 19세,1998,556,286,270
'4690034000,  임회면,'25,20 - 24세,1998,436,272,164
'4690034000,  임회면,'30,25 - 29세,1998,249,137,112
'4690034000,  임회면,'35,30 - 34세,1998,249,133,116
'4690034000,  임회면,'40,35 - 39세,1998,293,144,149
'4690034000,  임회면,'45,40 - 44세,1998,267,149,118
'4690034000,  임회면,'50,45 - 49세,1998,281,139,142
'4690034000,  임회면,'55,50 - 54세,1998,369,181,188
'4690034000,  임회면,'60,55 - 59세,1998,514,215,299
'4690034000,  임회면,'65,60 - 64세,1998,518,226,292
'4690034000,  임회면,'70,65 - 69세,1998,379,143,236
'4690034000,  임회면,'75,70 - 74세,1998,256,92,164
'4690034000,  임회면,'80,75 - 79세,1998,170,59,111
'4690034000,  임회면,'85,80 - 84세,1998,71,18,53
'4690034000,  임회면,'90,85+ ,1998,50,13,37
'4690035000,  지산면,'00,계,1998,5752,2747,3005
'4690035000,  지산면,'05,0 - 4세,1998,174,91,83
'4690035000,  지산면,'10,5 - 9세,1998,197,103,94
'4690035000,  지산면,'15,10 - 14세,1998,297,156,141
'4690035000,  지산면,'20,15 - 19세,1998,638,302,336
'4690035000,  지산면,'25,20 - 24세,1998,552,331,221
'4690035000,  지산면,'30,25 - 29세,1998,252,161,91
'4690035000,  지산면,'35,30 - 34세,1998,221,120,101
'4690035000,  지산면,'40,35 - 39세,1998,254,137,117
'4690035000,  지산면,'45,40 - 44세,1998,280,135,145
'4690035000,  지산면,'50,45 - 49세,1998,279,133,146
'4690035000,  지산면,'55,50 - 54세,1998,451,218,233
'4690035000,  지산면,'60,55 - 59세,1998,635,287,348
'4690035000,  지산면,'65,60 - 64세,1998,587,238,349
'4690035000,  지산면,'70,65 - 69세,1998,395,148,247
'4690035000,  지산면,'75,70 - 74세,1998,217,82,135
'4690035000,  지산면,'80,75 - 79세,1998,205,76,129
'4690035000,  지산면,'85,80 - 84세,1998,66,18,48
'4690035000,  지산면,'90,85+ ,1998,52,11,41
'4690036000,  조도면,'00,계,1998,5025,2520,2505
'4690036000,  조도면,'05,0 - 4세,1998,144,75,69
'4690036000,  조도면,'10,5 - 9세,1998,158,82,76
'4690036000,  조도면,'15,10 - 14세,1998,214,106,108
'4690036000,  조도면,'20,15 - 19세,1998,544,285,259
'4690036000,  조도면,'25,20 - 24세,1998,563,400,163
'4690036000,  조도면,'30,25 - 29세,1998,240,172,68
'4690036000,  조도면,'35,30 - 34세,1998,203,130,73
'4690036000,  조도면,'40,35 - 39세,1998,212,129,83
'4690036000,  조도면,'45,40 - 44세,1998,224,127,97
'4690036000,  조도면,'50,45 - 49세,1998,254,156,98
'4690036000,  조도면,'55,50 - 54세,1998,337,159,178
'4690036000,  조도면,'60,55 - 59세,1998,624,261,363
'4690036000,  조도면,'65,60 - 64세,1998,487,182,305
'4690036000,  조도면,'70,65 - 69세,1998,337,129,208
'4690036000,  조도면,'75,70 - 74세,1998,184,59,125
'4690036000,  조도면,'80,75 - 79세,1998,179,47,132
'4690036000,  조도면,'85,80 - 84세,1998,75,11,64
'4690036000,  조도면,'90,85+ ,1998,46,10,36
'46910, 신안군,'00,계,1998,56614,28585,28029
'46910, 신안군,'05,0 - 4세,1998,2067,1086,981
'46910, 신안군,'10,5 - 9세,1998,2402,1242,1160
'46910, 신안군,'15,10 - 14세,1998,3230,1639,1591
'46910, 신안군,'20,15 - 19세,1998,5942,2988,2954
'46910, 신안군,'25,20 - 24세,1998,5489,3452,2037
'46910, 신안군,'30,25 - 29세,1998,3034,2007,1027
'46910, 신안군,'35,30 - 34세,1998,2564,1503,1061
'46910, 신안군,'40,35 - 39세,1998,3196,1874,1322
'46910, 신안군,'45,40 - 44세,1998,3195,1762,1433
'46910, 신안군,'50,45 - 49세,1998,3267,1735,1532
'46910, 신안군,'55,50 - 54세,1998,3813,1926,1887
'46910, 신안군,'60,55 - 59세,1998,5281,2408,2873
'46910, 신안군,'65,60 - 64세,1998,4911,2121,2790
'46910, 신안군,'70,65 - 69세,1998,3473,1354,2119
'46910, 신안군,'75,70 - 74세,1998,1909,780,1129
'46910, 신안군,'80,75 - 79세,1998,1627,477,1150
'46910, 신안군,'85,80 - 84세,1998,748,182,566
'46910, 신안군,'90,85+ ,1998,466,49,417
'4691025000,  지도읍,'00,계,1998,6842,3488,3354
'4691025000,  지도읍,'05,0 - 4세,1998,236,131,105
'4691025000,  지도읍,'10,5 - 9세,1998,306,169,137
'4691025000,  지도읍,'15,10 - 14세,1998,394,211,183
'4691025000,  지도읍,'20,15 - 19세,1998,726,364,362
'4691025000,  지도읍,'25,20 - 24세,1998,654,416,238
'4691025000,  지도읍,'30,25 - 29세,1998,423,289,134
'4691025000,  지도읍,'35,30 - 34세,1998,303,173,130
'4691025000,  지도읍,'40,35 - 39세,1998,392,239,153
'4691025000,  지도읍,'45,40 - 44세,1998,388,209,179
'4691025000,  지도읍,'50,45 - 49세,1998,376,197,179
'4691025000,  지도읍,'55,50 - 54세,1998,482,235,247
'4691025000,  지도읍,'60,55 - 59세,1998,678,320,358
'4691025000,  지도읍,'65,60 - 64세,1998,574,247,327
'4691025000,  지도읍,'70,65 - 69세,1998,396,149,247
'4691025000,  지도읍,'75,70 - 74세,1998,189,68,121
'4691025000,  지도읍,'80,75 - 79세,1998,170,51,119
'4691025000,  지도읍,'85,80 - 84세,1998,82,11,71
'4691025000,  지도읍,'90,85+ ,1998,73,9,64
'4691031000,  증도면,'00,계,1998,2599,1364,1235
'4691031000,  증도면,'05,0 - 4세,1998,95,51,44
'4691031000,  증도면,'10,5 - 9세,1998,101,55,46
'4691031000,  증도면,'15,10 - 14세,1998,136,78,58
'4691031000,  증도면,'20,15 - 19세,1998,259,139,120
'4691031000,  증도면,'25,20 - 24세,1998,270,166,104
'4691031000,  증도면,'30,25 - 29세,1998,151,99,52
'4691031000,  증도면,'35,30 - 34세,1998,105,67,38
'4691031000,  증도면,'40,35 - 39세,1998,137,86,51
'4691031000,  증도면,'45,40 - 44세,1998,138,81,57
'4691031000,  증도면,'50,45 - 49세,1998,147,70,77
'4691031000,  증도면,'55,50 - 54세,1998,184,94,90
'4691031000,  증도면,'60,55 - 59세,1998,305,146,159
'4691031000,  증도면,'65,60 - 64세,1998,226,106,120
'4691031000,  증도면,'70,65 - 69세,1998,159,75,84
'4691031000,  증도면,'75,70 - 74세,1998,65,22,43
'4691031000,  증도면,'80,75 - 79세,1998,74,25,49
'4691031000,  증도면,'85,80 - 84세,1998,25,2,23
'4691031000,  증도면,'90,85+ ,1998,22,2,20
'4691032000,  임자면,'00,계,1998,4365,2235,2130
'4691032000,  임자면,'05,0 - 4세,1998,203,104,99
'4691032000,  임자면,'10,5 - 9세,1998,201,94,107
'4691032000,  임자면,'15,10 - 14세,1998,223,114,109
'4691032000,  임자면,'20,15 - 19세,1998,466,223,243
'4691032000,  임자면,'25,20 - 24세,1998,473,295,178
'4691032000,  임자면,'30,25 - 29세,1998,245,176,69
'4691032000,  임자면,'35,30 - 34세,1998,254,152,102
'4691032000,  임자면,'40,35 - 39세,1998,273,171,102
'4691032000,  임자면,'45,40 - 44세,1998,231,138,93
'4691032000,  임자면,'50,45 - 49세,1998,276,149,127
'4691032000,  임자면,'55,50 - 54세,1998,322,157,165
'4691032000,  임자면,'60,55 - 59세,1998,408,197,211
'4691032000,  임자면,'65,60 - 64세,1998,335,138,197
'4691032000,  임자면,'70,65 - 69세,1998,189,66,123
'4691032000,  임자면,'75,70 - 74세,1998,107,35,72
'4691032000,  임자면,'80,75 - 79세,1998,84,22,62
'4691032000,  임자면,'85,80 - 84세,1998,44,4,40
'4691032000,  임자면,'90,85+ ,1998,31,0,31
'4691033000,  자은면,'00,계,1998,3210,1601,1609
'4691033000,  자은면,'05,0 - 4세,1998,109,65,44
'4691033000,  자은면,'10,5 - 9세,1998,129,70,59
'4691033000,  자은면,'15,10 - 14세,1998,167,85,82
'4691033000,  자은면,'20,15 - 19세,1998,304,158,146
'4691033000,  자은면,'25,20 - 24세,1998,273,174,99
'4691033000,  자은면,'30,25 - 29세,1998,121,77,44
'4691033000,  자은면,'35,30 - 34세,1998,138,88,50
'4691033000,  자은면,'40,35 - 39세,1998,166,87,79
'4691033000,  자은면,'45,40 - 44세,1998,159,82,77
'4691033000,  자은면,'50,45 - 49세,1998,192,109,83
'4691033000,  자은면,'55,50 - 54세,1998,231,107,124
'4691033000,  자은면,'60,55 - 59세,1998,348,159,189
'4691033000,  자은면,'65,60 - 64세,1998,372,151,221
'4691033000,  자은면,'70,65 - 69세,1998,210,97,113
'4691033000,  자은면,'75,70 - 74세,1998,134,54,80
'4691033000,  자은면,'80,75 - 79세,1998,85,25,60
'4691033000,  자은면,'85,80 - 84세,1998,47,10,37
'4691033000,  자은면,'90,85+ ,1998,25,3,22
'4691034000,  비금면,'00,계,1998,4966,2502,2464
'4691034000,  비금면,'05,0 - 4세,1998,153,67,86
'4691034000,  비금면,'10,5 - 9세,1998,232,127,105
'4691034000,  비금면,'15,10 - 14세,1998,255,128,127
'4691034000,  비금면,'20,15 - 19세,1998,493,265,228
'4691034000,  비금면,'25,20 - 24세,1998,503,320,183
'4691034000,  비금면,'30,25 - 29세,1998,254,174,80
'4691034000,  비금면,'35,30 - 34세,1998,197,116,81
'4691034000,  비금면,'40,35 - 39세,1998,263,156,107
'4691034000,  비금면,'45,40 - 44세,1998,289,151,138
'4691034000,  비금면,'50,45 - 49세,1998,293,151,142
'4691034000,  비금면,'55,50 - 54세,1998,370,188,182
'4691034000,  비금면,'60,55 - 59세,1998,462,206,256
'4691034000,  비금면,'65,60 - 64세,1998,442,181,261
'4691034000,  비금면,'70,65 - 69세,1998,336,124,212
'4691034000,  비금면,'75,70 - 74세,1998,202,86,116
'4691034000,  비금면,'80,75 - 79세,1998,132,37,95
'4691034000,  비금면,'85,80 - 84세,1998,62,20,42
'4691034000,  비금면,'90,85+ ,1998,28,5,23
'4691035000,  도초면,'00,계,1998,3988,1967,2021
'4691035000,  도초면,'05,0 - 4세,1998,130,67,63
'4691035000,  도초면,'10,5 - 9세,1998,167,101,66
'4691035000,  도초면,'15,10 - 14세,1998,233,113,120
'4691035000,  도초면,'20,15 - 19세,1998,407,206,201
'4691035000,  도초면,'25,20 - 24세,1998,399,254,145
'4691035000,  도초면,'30,25 - 29세,1998,177,111,66
'4691035000,  도초면,'35,30 - 34세,1998,155,87,68
'4691035000,  도초면,'40,35 - 39세,1998,187,99,88
'4691035000,  도초면,'45,40 - 44세,1998,220,122,98
'4691035000,  도초면,'50,45 - 49세,1998,216,106,110
'4691035000,  도초면,'55,50 - 54세,1998,270,150,120
'4691035000,  도초면,'60,55 - 59세,1998,400,179,221
'4691035000,  도초면,'65,60 - 64세,1998,403,171,232
'4691035000,  도초면,'70,65 - 69세,1998,259,96,163
'4691035000,  도초면,'75,70 - 74세,1998,131,45,86
'4691035000,  도초면,'80,75 - 79세,1998,143,39,104
'4691035000,  도초면,'85,80 - 84세,1998,52,13,39
'4691035000,  도초면,'90,85+ ,1998,39,8,31
'4691036000,  흑산면,'00,계,1998,5044,2577,2467
'4691036000,  흑산면,'05,0 - 4세,1998,238,127,111
'4691036000,  흑산면,'10,5 - 9세,1998,269,125,144
'4691036000,  흑산면,'15,10 - 14세,1998,271,143,128
'4691036000,  흑산면,'20,15 - 19세,1998,463,222,241
'4691036000,  흑산면,'25,20 - 24세,1998,457,298,159
'4691036000,  흑산면,'30,25 - 29세,1998,362,235,127
'4691036000,  흑산면,'35,30 - 34세,1998,312,185,127
'4691036000,  흑산면,'40,35 - 39세,1998,338,217,121
'4691036000,  흑산면,'45,40 - 44세,1998,293,171,122
'4691036000,  흑산면,'50,45 - 49세,1998,298,168,130
'4691036000,  흑산면,'55,50 - 54세,1998,291,141,150
'4691036000,  흑산면,'60,55 - 59세,1998,393,170,223
'4691036000,  흑산면,'65,60 - 64세,1998,416,170,246
'4691036000,  흑산면,'70,65 - 69세,1998,247,89,158
'4691036000,  흑산면,'75,70 - 74세,1998,161,72,89
'4691036000,  흑산면,'80,75 - 79세,1998,134,28,106
'4691036000,  흑산면,'85,80 - 84세,1998,64,16,48
'4691036000,  흑산면,'90,85+ ,1998,37,0,37
'4691037000,  하의면,'00,계,1998,2602,1327,1275
'4691037000,  하의면,'05,0 - 4세,1998,61,36,25
'4691037000,  하의면,'10,5 - 9세,1998,73,41,32
'4691037000,  하의면,'15,10 - 14세,1998,117,61,56
'4691037000,  하의면,'20,15 - 19세,1998,288,156,132
'4691037000,  하의면,'25,20 - 24세,1998,266,164,102
'4691037000,  하의면,'30,25 - 29세,1998,149,108,41
'4691037000,  하의면,'35,30 - 34세,1998,90,57,33
'4691037000,  하의면,'40,35 - 39세,1998,124,79,45
'4691037000,  하의면,'45,40 - 44세,1998,131,63,68
'4691037000,  하의면,'50,45 - 49세,1998,176,93,83
'4691037000,  하의면,'55,50 - 54세,1998,190,109,81
'4691037000,  하의면,'60,55 - 59세,1998,237,112,125
'4691037000,  하의면,'65,60 - 64세,1998,235,96,139
'4691037000,  하의면,'70,65 - 69세,1998,197,68,129
'4691037000,  하의면,'75,70 - 74세,1998,89,45,44
'4691037000,  하의면,'80,75 - 79세,1998,112,29,83
'4691037000,  하의면,'85,80 - 84세,1998,42,8,34
'4691037000,  하의면,'90,85+ ,1998,25,2,23
'4691038000,  신의면,'00,계,1998,2252,1153,1099
'4691038000,  신의면,'05,0 - 4세,1998,94,48,46
'4691038000,  신의면,'10,5 - 9세,1998,94,40,54
'4691038000,  신의면,'15,10 - 14세,1998,124,62,62
'4691038000,  신의면,'20,15 - 19세,1998,265,140,125
'4691038000,  신의면,'25,20 - 24세,1998,228,151,77
'4691038000,  신의면,'30,25 - 29세,1998,131,83,48
'4691038000,  신의면,'35,30 - 34세,1998,102,58,44
'4691038000,  신의면,'40,35 - 39세,1998,127,73,54
'4691038000,  신의면,'45,40 - 44세,1998,134,77,57
'4691038000,  신의면,'50,45 - 49세,1998,138,83,55
'4691038000,  신의면,'55,50 - 54세,1998,145,75,70
'4691038000,  신의면,'60,55 - 59세,1998,192,84,108
'4691038000,  신의면,'65,60 - 64세,1998,176,80,96
'4691038000,  신의면,'70,65 - 69세,1998,135,45,90
'4691038000,  신의면,'75,70 - 74세,1998,54,24,30
'4691038000,  신의면,'80,75 - 79세,1998,66,20,46
'4691038000,  신의면,'85,80 - 84세,1998,28,8,20
'4691038000,  신의면,'90,85+ ,1998,19,2,17
'4691039000,  장산면,'00,계,1998,2527,1244,1283
'4691039000,  장산면,'05,0 - 4세,1998,76,38,38
'4691039000,  장산면,'10,5 - 9세,1998,89,48,41
'4691039000,  장산면,'15,10 - 14세,1998,156,75,81
'4691039000,  장산면,'20,15 - 19세,1998,272,133,139
'4691039000,  장산면,'25,20 - 24세,1998,250,144,106
'4691039000,  장산면,'30,25 - 29세,1998,124,79,45
'4691039000,  장산면,'35,30 - 34세,1998,115,74,41
'4691039000,  장산면,'40,35 - 39세,1998,145,78,67
'4691039000,  장산면,'45,40 - 44세,1998,120,63,57
'4691039000,  장산면,'50,45 - 49세,1998,138,73,65
'4691039000,  장산면,'55,50 - 54세,1998,162,84,78
'4691039000,  장산면,'60,55 - 59세,1998,265,110,155
'4691039000,  장산면,'65,60 - 64세,1998,219,98,121
'4691039000,  장산면,'70,65 - 69세,1998,175,74,101
'4691039000,  장산면,'75,70 - 74세,1998,99,40,59
'4691039000,  장산면,'80,75 - 79세,1998,68,23,45
'4691039000,  장산면,'85,80 - 84세,1998,38,10,28
'4691039000,  장산면,'90,85+ ,1998,16,0,16
'4691040000,  안좌면,'00,계,1998,4993,2477,2516
'4691040000,  안좌면,'05,0 - 4세,1998,164,88,76
'4691040000,  안좌면,'10,5 - 9세,1998,202,92,110
'4691040000,  안좌면,'15,10 - 14세,1998,312,164,148
'4691040000,  안좌면,'20,15 - 19세,1998,506,256,250
'4691040000,  안좌면,'25,20 - 24세,1998,479,298,181
'4691040000,  안좌면,'30,25 - 29세,1998,229,147,82
'4691040000,  안좌면,'35,30 - 34세,1998,197,109,88
'4691040000,  안좌면,'40,35 - 39세,1998,279,152,127
'4691040000,  안좌면,'45,40 - 44세,1998,269,149,120
'4691040000,  안좌면,'50,45 - 49세,1998,280,144,136
'4691040000,  안좌면,'55,50 - 54세,1998,334,173,161
'4691040000,  안좌면,'60,55 - 59세,1998,442,199,243
'4691040000,  안좌면,'65,60 - 64세,1998,427,183,244
'4691040000,  안좌면,'70,65 - 69세,1998,389,157,232
'4691040000,  안좌면,'75,70 - 74세,1998,201,88,113
'4691040000,  안좌면,'80,75 - 79세,1998,161,46,115
'4691040000,  안좌면,'85,80 - 84세,1998,75,25,50
'4691040000,  안좌면,'90,85+ ,1998,47,7,40
'4691041000,  팔금면,'00,계,1998,1682,812,870
'4691041000,  팔금면,'05,0 - 4세,1998,40,25,15
'4691041000,  팔금면,'10,5 - 9세,1998,57,31,26
'4691041000,  팔금면,'15,10 - 14세,1998,102,44,58
'4691041000,  팔금면,'20,15 - 19세,1998,177,90,87
'4691041000,  팔금면,'25,20 - 24세,1998,161,103,58
'4691041000,  팔금면,'30,25 - 29세,1998,54,30,24
'4691041000,  팔금면,'35,30 - 34세,1998,44,25,19
'4691041000,  팔금면,'40,35 - 39세,1998,71,35,36
'4691041000,  팔금면,'45,40 - 44세,1998,102,52,50
'4691041000,  팔금면,'50,45 - 49세,1998,118,64,54
'4691041000,  팔금면,'55,50 - 54세,1998,127,63,64
'4691041000,  팔금면,'60,55 - 59세,1998,174,80,94
'4691041000,  팔금면,'65,60 - 64세,1998,140,57,83
'4691041000,  팔금면,'70,65 - 69세,1998,134,54,80
'4691041000,  팔금면,'75,70 - 74세,1998,72,31,41
'4691041000,  팔금면,'80,75 - 79세,1998,62,20,42
'4691041000,  팔금면,'85,80 - 84세,1998,28,5,23
'4691041000,  팔금면,'90,85+ ,1998,19,3,16
'4691042000,  암태면,'00,계,1998,3034,1518,1516
'4691042000,  암태면,'05,0 - 4세,1998,126,72,54
'4691042000,  암태면,'10,5 - 9세,1998,117,60,57
'4691042000,  암태면,'15,10 - 14세,1998,160,78,82
'4691042000,  암태면,'20,15 - 19세,1998,325,156,169
'4691042000,  암태면,'25,20 - 24세,1998,233,149,84
'4691042000,  암태면,'30,25 - 29세,1998,131,91,40
'4691042000,  암태면,'35,30 - 34세,1998,140,79,61
'4691042000,  암태면,'40,35 - 39세,1998,174,106,68
'4691042000,  암태면,'45,40 - 44세,1998,194,106,88
'4691042000,  암태면,'50,45 - 49세,1998,147,79,68
'4691042000,  암태면,'55,50 - 54세,1998,195,93,102
'4691042000,  암태면,'60,55 - 59세,1998,285,136,149
'4691042000,  암태면,'65,60 - 64세,1998,301,126,175
'4691042000,  암태면,'70,65 - 69세,1998,217,90,127
'4691042000,  암태면,'75,70 - 74세,1998,110,47,63
'4691042000,  암태면,'80,75 - 79세,1998,104,33,71
'4691042000,  암태면,'85,80 - 84세,1998,55,16,39
'4691042000,  암태면,'90,85+ ,1998,20,1,19
'4691043000,  압해면,'00,계,1998,8510,4320,4190
'4691043000,  압해면,'05,0 - 4세,1998,342,167,175
'4691043000,  압해면,'10,5 - 9세,1998,365,189,176
'4691043000,  압해면,'15,10 - 14세,1998,580,283,297
'4691043000,  압해면,'20,15 - 19세,1998,991,480,511
'4691043000,  압해면,'25,20 - 24세,1998,843,520,323
'4691043000,  압해면,'30,25 - 29세,1998,483,308,175
'4691043000,  압해면,'35,30 - 34세,1998,412,233,179
'4691043000,  압해면,'40,35 - 39세,1998,520,296,224
'4691043000,  압해면,'45,40 - 44세,1998,527,298,229
'4691043000,  압해면,'50,45 - 49세,1998,472,249,223
'4691043000,  압해면,'55,50 - 54세,1998,510,257,253
'4691043000,  압해면,'60,55 - 59세,1998,692,310,382
'4691043000,  압해면,'65,60 - 64세,1998,645,317,328
'4691043000,  압해면,'70,65 - 69세,1998,430,170,260
'4691043000,  압해면,'75,70 - 74세,1998,295,123,172
'4691043000,  압해면,'80,75 - 79세,1998,232,79,153
'4691043000,  압해면,'85,80 - 84세,1998,106,34,72
'4691043000,  압해면,'90,85+ ,1998,65,7,58
'47,경상북도,'00,계,1998,2809595,1408418,1401177
'47,경상북도,'05,0 - 4세,1998,185342,99821,85521
'47,경상북도,'10,5 - 9세,1998,187031,102665,84366
'47,경상북도,'15,10 - 14세,1998,177886,94725,83161
'47,경상북도,'20,15 - 19세,1998,242406,122649,119757
'47,경상북도,'25,20 - 24세,1998,241106,127483,113623
'47,경상북도,'30,25 - 29세,1998,246188,130650,115538
'47,경상북도,'35,30 - 34세,1998,231771,120292,111479
'47,경상북도,'40,35 - 39세,1998,240151,125192,114959
'47,경상북도,'45,40 - 44세,1998,198971,103406,95565
'47,경상북도,'50,45 - 49세,1998,157108,79418,77690
'47,경상북도,'55,50 - 54세,1998,127293,62580,64713
'47,경상북도,'60,55 - 59세,1998,156037,71376,84661
'47,경상북도,'65,60 - 64세,1998,141031,62455,78576
'47,경상북도,'70,65 - 69세,1998,103727,42351,61376
'47,경상북도,'75,70 - 74세,1998,75770,30179,45591
'47,경상북도,'80,75 - 79세,1998,52237,19699,32538
'47,경상북도,'85,80 - 84세,1998,28945,9453,19492
'47,경상북도,'90,85+ ,1998,16595,4024,12571
'47110, 포항시,'00,계,1998,512001,259956,252045
'47110, 포항시,'05,0 - 4세,1998,35209,19076,16133
'47110, 포항시,'10,5 - 9세,1998,38920,21633,17287
'47110, 포항시,'15,10 - 14세,1998,39141,20910,18231
'47110, 포항시,'20,15 - 19세,1998,50220,25759,24461
'47110, 포항시,'25,20 - 24세,1998,40628,21607,19021
'47110, 포항시,'30,25 - 29세,1998,43451,22113,21338
'47110, 포항시,'35,30 - 34세,1998,45427,22732,22695
'47110, 포항시,'40,35 - 39세,1998,52174,25771,26403
'47110, 포항시,'45,40 - 44세,1998,46969,24069,22900
'47110, 포항시,'50,45 - 49세,1998,32744,17472,15272
'47110, 포항시,'55,50 - 54세,1998,21995,11664,10331
'47110, 포항시,'60,55 - 59세,1998,20705,10305,10400
'47110, 포항시,'65,60 - 64세,1998,15240,6867,8373
'47110, 포항시,'70,65 - 69세,1998,11033,4276,6757
'47110, 포항시,'75,70 - 74세,1998,7979,2737,5242
'47110, 포항시,'80,75 - 79세,1998,5626,1820,3806
'47110, 포항시,'85,80 - 84세,1998,2894,787,2107
'47110, 포항시,'90,85+ ,1998,1646,358,1288
'47111, 남구,'00,계,1998,264411,135271,129140
'47111, 남구,'05,0 - 4세,1998,19292,10406,8886
'47111, 남구,'10,5 - 9세,1998,19914,10988,8926
'47111, 남구,'15,10 - 14세,1998,19736,10516,9220
'47111, 남구,'20,15 - 19세,1998,26055,13360,12695
'47111, 남구,'25,20 - 24세,1998,21888,11569,10319
'47111, 남구,'30,25 - 29세,1998,24187,12451,11736
'47111, 남구,'35,30 - 34세,1998,24496,12558,11938
'47111, 남구,'40,35 - 39세,1998,26290,13239,13051
'47111, 남구,'45,40 - 44세,1998,23825,12240,11585
'47111, 남구,'50,45 - 49세,1998,16784,8952,7832
'47111, 남구,'55,50 - 54세,1998,11321,6110,5211
'47111, 남구,'60,55 - 59세,1998,10223,5222,5001
'47111, 남구,'65,60 - 64세,1998,7133,3237,3896
'47111, 남구,'70,65 - 69세,1998,5039,1942,3097
'47111, 남구,'75,70 - 74세,1998,3551,1202,2349
'47111, 남구,'80,75 - 79세,1998,2566,797,1769
'47111, 남구,'85,80 - 84세,1998,1309,318,991
'47111, 남구,'90,85+ ,1998,802,164,638
'4711125000,  구룡포읍,'00,계,1998,15509,7932,7577
'4711125000,  구룡포읍,'05,0 - 4세,1998,642,330,312
'4711125000,  구룡포읍,'10,5 - 9세,1998,705,386,319
'4711125000,  구룡포읍,'15,10 - 14세,1998,821,431,390
'4711125000,  구룡포읍,'20,15 - 19세,1998,1417,718,699
'4711125000,  구룡포읍,'25,20 - 24세,1998,1538,830,708
'4711125000,  구룡포읍,'30,25 - 29세,1998,1282,795,487
'4711125000,  구룡포읍,'35,30 - 34세,1998,964,555,409
'4711125000,  구룡포읍,'40,35 - 39세,1998,1105,620,485
'4711125000,  구룡포읍,'45,40 - 44세,1998,1222,649,573
'4711125000,  구룡포읍,'50,45 - 49세,1998,1026,529,497
'4711125000,  구룡포읍,'55,50 - 54세,1998,909,445,464
'4711125000,  구룡포읍,'60,55 - 59세,1998,1209,571,638
'4711125000,  구룡포읍,'65,60 - 64세,1998,965,440,525
'4711125000,  구룡포읍,'70,65 - 69세,1998,673,266,407
'4711125000,  구룡포읍,'75,70 - 74세,1998,445,165,280
'4711125000,  구룡포읍,'80,75 - 79세,1998,355,139,216
'4711125000,  구룡포읍,'85,80 - 84세,1998,141,48,93
'4711125000,  구룡포읍,'90,85+ ,1998,90,15,75
'4711125300,  연일읍,'00,계,1998,26605,13716,12889
'4711125300,  연일읍,'05,0 - 4세,1998,2516,1366,1150
'4711125300,  연일읍,'10,5 - 9세,1998,2432,1366,1066
'4711125300,  연일읍,'15,10 - 14세,1998,1884,965,919
'4711125300,  연일읍,'20,15 - 19세,1998,2522,1322,1200
'4711125300,  연일읍,'25,20 - 24세,1998,1712,872,840
'4711125300,  연일읍,'30,25 - 29세,1998,2434,1131,1303
'4711125300,  연일읍,'35,30 - 34세,1998,3057,1504,1553
'4711125300,  연일읍,'40,35 - 39세,1998,3009,1628,1381
'4711125300,  연일읍,'45,40 - 44세,1998,2256,1225,1031
'4711125300,  연일읍,'50,45 - 49세,1998,1390,794,596
'4711125300,  연일읍,'55,50 - 54세,1998,898,521,377
'4711125300,  연일읍,'60,55 - 59세,1998,750,374,376
'4711125300,  연일읍,'65,60 - 64세,1998,610,280,330
'4711125300,  연일읍,'70,65 - 69세,1998,454,169,285
'4711125300,  연일읍,'75,70 - 74세,1998,311,101,210
'4711125300,  연일읍,'80,75 - 79세,1998,183,49,134
'4711125300,  연일읍,'85,80 - 84세,1998,116,30,86
'4711125300,  연일읍,'90,85+ ,1998,71,19,52
'4711125600,  오천읍,'00,계,1998,38902,20129,18773
'4711125600,  오천읍,'05,0 - 4세,1998,3705,2003,1702
'4711125600,  오천읍,'10,5 - 9세,1998,3604,1967,1637
'4711125600,  오천읍,'15,10 - 14세,1998,2867,1481,1386
'4711125600,  오천읍,'20,15 - 19세,1998,3169,1609,1560
'4711125600,  오천읍,'25,20 - 24세,1998,2909,1565,1344
'4711125600,  오천읍,'30,25 - 29세,1998,3989,1963,2026
'4711125600,  오천읍,'35,30 - 34세,1998,4422,2263,2159
'4711125600,  오천읍,'40,35 - 39세,1998,4242,2290,1952
'4711125600,  오천읍,'45,40 - 44세,1998,3143,1774,1369
'4711125600,  오천읍,'50,45 - 49세,1998,1851,991,860
'4711125600,  오천읍,'55,50 - 54세,1998,1224,652,572
'4711125600,  오천읍,'60,55 - 59세,1998,1258,603,655
'4711125600,  오천읍,'65,60 - 64세,1998,897,398,499
'4711125600,  오천읍,'70,65 - 69세,1998,663,268,395
'4711125600,  오천읍,'75,70 - 74세,1998,432,170,262
'4711125600,  오천읍,'80,75 - 79세,1998,302,85,217
'4711125600,  오천읍,'85,80 - 84세,1998,139,29,110
'4711125600,  오천읍,'90,85+ ,1998,86,18,68
'4711131000,  대송면,'00,계,1998,9154,4751,4403
'4711131000,  대송면,'05,0 - 4세,1998,524,289,235
'4711131000,  대송면,'10,5 - 9세,1998,619,347,272
'4711131000,  대송면,'15,10 - 14세,1998,673,334,339
'4711131000,  대송면,'20,15 - 19세,1998,927,465,462
'4711131000,  대송면,'25,20 - 24세,1998,841,449,392
'4711131000,  대송면,'30,25 - 29세,1998,821,465,356
'4711131000,  대송면,'35,30 - 34세,1998,768,425,343
'4711131000,  대송면,'40,35 - 39세,1998,830,441,389
'4711131000,  대송면,'45,40 - 44세,1998,761,420,341
'4711131000,  대송면,'50,45 - 49세,1998,569,290,279
'4711131000,  대송면,'55,50 - 54세,1998,438,235,203
'4711131000,  대송면,'60,55 - 59세,1998,420,215,205
'4711131000,  대송면,'65,60 - 64세,1998,345,154,191
'4711131000,  대송면,'70,65 - 69세,1998,236,90,146
'4711131000,  대송면,'75,70 - 74세,1998,172,56,116
'4711131000,  대송면,'80,75 - 79세,1998,118,50,68
'4711131000,  대송면,'85,80 - 84세,1998,50,15,35
'4711131000,  대송면,'90,85+ ,1998,42,11,31
'4711132000,  동해면,'00,계,1998,16235,8332,7903
'4711132000,  동해면,'05,0 - 4세,1998,1533,839,694
'4711132000,  동해면,'10,5 - 9세,1998,1384,756,628
'4711132000,  동해면,'15,10 - 14세,1998,995,512,483
'4711132000,  동해면,'20,15 - 19세,1998,1215,621,594
'4711132000,  동해면,'25,20 - 24세,1998,1114,597,517
'4711132000,  동해면,'30,25 - 29세,1998,1682,819,863
'4711132000,  동해면,'35,30 - 34세,1998,1923,1008,915
'4711132000,  동해면,'40,35 - 39세,1998,1632,920,712
'4711132000,  동해면,'45,40 - 44세,1998,1146,630,516
'4711132000,  동해면,'50,45 - 49세,1998,760,397,363
'4711132000,  동해면,'55,50 - 54세,1998,574,284,290
'4711132000,  동해면,'60,55 - 59세,1998,652,316,336
'4711132000,  동해면,'65,60 - 64세,1998,539,244,295
'4711132000,  동해면,'70,65 - 69세,1998,401,167,234
'4711132000,  동해면,'75,70 - 74세,1998,294,111,183
'4711132000,  동해면,'80,75 - 79세,1998,216,67,149
'4711132000,  동해면,'85,80 - 84세,1998,102,30,72
'4711132000,  동해면,'90,85+ ,1998,73,14,59
'4711133000,  장기면,'00,계,1998,8005,3945,4060
'4711133000,  장기면,'05,0 - 4세,1998,254,143,111
'4711133000,  장기면,'10,5 - 9세,1998,265,136,129
'4711133000,  장기면,'15,10 - 14세,1998,343,193,150
'4711133000,  장기면,'20,15 - 19세,1998,726,369,357
'4711133000,  장기면,'25,20 - 24세,1998,793,461,332
'4711133000,  장기면,'30,25 - 29세,1998,602,394,208
'4711133000,  장기면,'35,30 - 34세,1998,376,236,140
'4711133000,  장기면,'40,35 - 39세,1998,440,230,210
'4711133000,  장기면,'45,40 - 44세,1998,444,221,223
'4711133000,  장기면,'50,45 - 49세,1998,465,229,236
'4711133000,  장기면,'55,50 - 54세,1998,431,194,237
'4711133000,  장기면,'60,55 - 59세,1998,667,315,352
'4711133000,  장기면,'65,60 - 64세,1998,660,258,402
'4711133000,  장기면,'70,65 - 69세,1998,577,223,354
'4711133000,  장기면,'75,70 - 74세,1998,394,159,235
'4711133000,  장기면,'80,75 - 79세,1998,300,115,185
'4711133000,  장기면,'85,80 - 84세,1998,158,38,120
'4711133000,  장기면,'90,85+ ,1998,110,31,79
'4711134000,  대보면,'00,계,1998,3704,1841,1863
'4711134000,  대보면,'05,0 - 4세,1998,110,52,58
'4711134000,  대보면,'10,5 - 9세,1998,121,64,57
'4711134000,  대보면,'15,10 - 14세,1998,201,114,87
'4711134000,  대보면,'20,15 - 19세,1998,317,152,165
'4711134000,  대보면,'25,20 - 24세,1998,410,228,182
'4711134000,  대보면,'30,25 - 29세,1998,321,209,112
'4711134000,  대보면,'35,30 - 34세,1998,195,114,81
'4711134000,  대보면,'40,35 - 39세,1998,226,121,105
'4711134000,  대보면,'45,40 - 44세,1998,249,130,119
'4711134000,  대보면,'50,45 - 49세,1998,250,112,138
'4711134000,  대보면,'55,50 - 54세,1998,238,126,112
'4711134000,  대보면,'60,55 - 59세,1998,263,109,154
'4711134000,  대보면,'65,60 - 64세,1998,271,129,142
'4711134000,  대보면,'70,65 - 69세,1998,194,74,120
'4711134000,  대보면,'75,70 - 74세,1998,161,58,103
'4711134000,  대보면,'80,75 - 79세,1998,107,32,75
'4711134000,  대보면,'85,80 - 84세,1998,44,12,32
'4711134000,  대보면,'90,85+ ,1998,26,5,21
'4711151000,  상대1동,'00,계,1998,24913,12724,12189
'4711151000,  상대1동,'05,0 - 4세,1998,1772,983,789
'4711151000,  상대1동,'10,5 - 9세,1998,1913,1056,857
'4711151000,  상대1동,'15,10 - 14세,1998,2047,1144,903
'4711151000,  상대1동,'20,15 - 19세,1998,2704,1364,1340
'4711151000,  상대1동,'25,20 - 24세,1998,2159,1109,1050
'4711151000,  상대1동,'30,25 - 29세,1998,2264,1106,1158
'4711151000,  상대1동,'35,30 - 34세,1998,2250,1100,1150
'4711151000,  상대1동,'40,35 - 39세,1998,2649,1272,1377
'4711151000,  상대1동,'45,40 - 44세,1998,2431,1201,1230
'4711151000,  상대1동,'50,45 - 49세,1998,1728,912,816
'4711151000,  상대1동,'55,50 - 54세,1998,1115,647,468
'4711151000,  상대1동,'60,55 - 59세,1998,748,440,308
'4711151000,  상대1동,'65,60 - 64세,1998,345,159,186
'4711151000,  상대1동,'70,65 - 69세,1998,265,93,172
'4711151000,  상대1동,'75,70 - 74세,1998,224,65,159
'4711151000,  상대1동,'80,75 - 79세,1998,163,44,119
'4711151000,  상대1동,'85,80 - 84세,1998,92,21,71
'4711151000,  상대1동,'90,85+ ,1998,44,8,36
'4711152000,  상대2동,'00,계,1998,15565,7943,7622
'4711152000,  상대2동,'05,0 - 4세,1998,943,524,419
'4711152000,  상대2동,'10,5 - 9세,1998,1086,590,496
'4711152000,  상대2동,'15,10 - 14세,1998,1239,698,541
'4711152000,  상대2동,'20,15 - 19세,1998,1729,940,789
'4711152000,  상대2동,'25,20 - 24세,1998,1499,777,722
'4711152000,  상대2동,'30,25 - 29세,1998,1381,688,693
'4711152000,  상대2동,'35,30 - 34세,1998,1228,591,637
'4711152000,  상대2동,'40,35 - 39세,1998,1514,702,812
'4711152000,  상대2동,'45,40 - 44세,1998,1539,744,795
'4711152000,  상대2동,'50,45 - 49세,1998,1245,624,621
'4711152000,  상대2동,'55,50 - 54세,1998,783,427,356
'4711152000,  상대2동,'60,55 - 59세,1998,593,346,247
'4711152000,  상대2동,'65,60 - 64세,1998,272,144,128
'4711152000,  상대2동,'70,65 - 69세,1998,180,73,107
'4711152000,  상대2동,'75,70 - 74세,1998,135,31,104
'4711152000,  상대2동,'80,75 - 79세,1998,105,25,80
'4711152000,  상대2동,'85,80 - 84세,1998,63,15,48
'4711152000,  상대2동,'90,85+ ,1998,31,4,27
'4711153000,  해도1동,'00,계,1998,16695,8283,8412
'4711153000,  해도1동,'05,0 - 4세,1998,933,488,445
'4711153000,  해도1동,'10,5 - 9세,1998,1031,572,459
'4711153000,  해도1동,'15,10 - 14세,1998,1208,628,580
'4711153000,  해도1동,'20,15 - 19세,1998,1878,949,929
'4711153000,  해도1동,'25,20 - 24세,1998,1629,820,809
'4711153000,  해도1동,'30,25 - 29세,1998,1494,802,692
'4711153000,  해도1동,'35,30 - 34세,1998,1286,617,669
'4711153000,  해도1동,'40,35 - 39세,1998,1533,706,827
'4711153000,  해도1동,'45,40 - 44세,1998,1634,753,881
'4711153000,  해도1동,'50,45 - 49세,1998,1278,648,630
'4711153000,  해도1동,'55,50 - 54세,1998,913,471,442
'4711153000,  해도1동,'60,55 - 59세,1998,746,402,344
'4711153000,  해도1동,'65,60 - 64세,1998,437,206,231
'4711153000,  해도1동,'70,65 - 69세,1998,275,108,167
'4711153000,  해도1동,'75,70 - 74세,1998,153,51,102
'4711153000,  해도1동,'80,75 - 79세,1998,144,40,104
'4711153000,  해도1동,'85,80 - 84세,1998,75,14,61
'4711153000,  해도1동,'90,85+ ,1998,48,8,40
'4711154000,  해도2동,'00,계,1998,18247,9274,8973
'4711154000,  해도2동,'05,0 - 4세,1998,1259,678,581
'4711154000,  해도2동,'10,5 - 9세,1998,1144,649,495
'4711154000,  해도2동,'15,10 - 14세,1998,1250,686,564
'4711154000,  해도2동,'20,15 - 19세,1998,2019,1004,1015
'4711154000,  해도2동,'25,20 - 24세,1998,1935,985,950
'4711154000,  해도2동,'30,25 - 29세,1998,1800,926,874
'4711154000,  해도2동,'35,30 - 34세,1998,1576,848,728
'4711154000,  해도2동,'40,35 - 39세,1998,1677,790,887
'4711154000,  해도2동,'45,40 - 44세,1998,1737,779,958
'4711154000,  해도2동,'50,45 - 49세,1998,1369,727,642
'4711154000,  해도2동,'55,50 - 54세,1998,886,476,410
'4711154000,  해도2동,'60,55 - 59세,1998,698,404,294
'4711154000,  해도2동,'65,60 - 64세,1998,361,170,191
'4711154000,  해도2동,'70,65 - 69세,1998,206,74,132
'4711154000,  해도2동,'75,70 - 74세,1998,142,39,103
'4711154000,  해도2동,'80,75 - 79세,1998,101,27,74
'4711154000,  해도2동,'85,80 - 84세,1998,57,9,48
'4711154000,  해도2동,'90,85+ ,1998,30,3,27
'4711155000,  송도동,'00,계,1998,25812,13020,12792
'4711155000,  송도동,'05,0 - 4세,1998,1471,767,704
'4711155000,  송도동,'10,5 - 9세,1998,1621,890,731
'4711155000,  송도동,'15,10 - 14세,1998,1929,1024,905
'4711155000,  송도동,'20,15 - 19세,1998,2905,1495,1410
'4711155000,  송도동,'25,20 - 24세,1998,2454,1292,1162
'4711155000,  송도동,'30,25 - 29세,1998,2270,1227,1043
'4711155000,  송도동,'35,30 - 34세,1998,2037,1020,1017
'4711155000,  송도동,'40,35 - 39세,1998,2479,1139,1340
'4711155000,  송도동,'45,40 - 44세,1998,2499,1237,1262
'4711155000,  송도동,'50,45 - 49세,1998,1880,960,920
'4711155000,  송도동,'55,50 - 54세,1998,1320,709,611
'4711155000,  송도동,'60,55 - 59세,1998,1139,557,582
'4711155000,  송도동,'65,60 - 64세,1998,734,361,373
'4711155000,  송도동,'70,65 - 69세,1998,402,165,237
'4711155000,  송도동,'75,70 - 74세,1998,295,91,204
'4711155000,  송도동,'80,75 - 79세,1998,192,55,137
'4711155000,  송도동,'85,80 - 84세,1998,112,18,94
'4711155000,  송도동,'90,85+ ,1998,73,13,60
'4711156000,  청림동,'00,계,1998,11315,5931,5384
'4711156000,  청림동,'05,0 - 4세,1998,912,472,440
'4711156000,  청림동,'10,5 - 9세,1998,853,479,374
'4711156000,  청림동,'15,10 - 14세,1998,848,452,396
'4711156000,  청림동,'20,15 - 19세,1998,967,494,473
'4711156000,  청림동,'25,20 - 24세,1998,1035,573,462
'4711156000,  청림동,'30,25 - 29세,1998,1267,693,574
'4711156000,  청림동,'35,30 - 34세,1998,1113,596,517
'4711156000,  청림동,'40,35 - 39세,1998,1145,597,548
'4711156000,  청림동,'45,40 - 44세,1998,906,476,430
'4711156000,  청림동,'50,45 - 49세,1998,642,340,302
'4711156000,  청림동,'55,50 - 54세,1998,498,267,231
'4711156000,  청림동,'60,55 - 59세,1998,415,214,201
'4711156000,  청림동,'65,60 - 64세,1998,273,129,144
'4711156000,  청림동,'70,65 - 69세,1998,190,80,110
'4711156000,  청림동,'75,70 - 74세,1998,115,29,86
'4711156000,  청림동,'80,75 - 79세,1998,75,23,52
'4711156000,  청림동,'85,80 - 84세,1998,40,13,27
'4711156000,  청림동,'90,85+ ,1998,21,4,17
'4711157000,  제철동,'00,계,1998,5219,2876,2343
'4711157000,  제철동,'05,0 - 4세,1998,643,357,286
'4711157000,  제철동,'10,5 - 9세,1998,354,190,164
'4711157000,  제철동,'15,10 - 14세,1998,333,167,166
'4711157000,  제철동,'20,15 - 19세,1998,367,195,172
'4711157000,  제철동,'25,20 - 24세,1998,367,207,160
'4711157000,  제철동,'30,25 - 29세,1998,839,449,390
'4711157000,  제철동,'35,30 - 34세,1998,744,506,238
'4711157000,  제철동,'40,35 - 39세,1998,421,221,200
'4711157000,  제철동,'45,40 - 44세,1998,389,207,182
'4711157000,  제철동,'50,45 - 49세,1998,255,144,111
'4711157000,  제철동,'55,50 - 54세,1998,151,82,69
'4711157000,  제철동,'60,55 - 59세,1998,108,58,50
'4711157000,  제철동,'65,60 - 64세,1998,93,46,47
'4711157000,  제철동,'70,65 - 69세,1998,64,20,44
'4711157000,  제철동,'75,70 - 74세,1998,41,15,26
'4711157000,  제철동,'80,75 - 79세,1998,25,7,18
'4711157000,  제철동,'85,80 - 84세,1998,16,3,13
'4711157000,  제철동,'90,85+ ,1998,9,2,7
'4711158000,  효곡동,'00,계,1998,21972,11387,10585
'4711158000,  효곡동,'05,0 - 4세,1998,1771,950,821
'4711158000,  효곡동,'10,5 - 9세,1998,2386,1326,1060
'4711158000,  효곡동,'15,10 - 14세,1998,2503,1372,1131
'4711158000,  효곡동,'20,15 - 19세,1998,2388,1247,1141
'4711158000,  효곡동,'25,20 - 24세,1998,1011,559,452
'4711158000,  효곡동,'30,25 - 29세,1998,1289,545,744
'4711158000,  효곡동,'35,30 - 34세,1998,2118,965,1153
'4711158000,  효곡동,'40,35 - 39세,1998,2744,1300,1444
'4711158000,  효곡동,'45,40 - 44세,1998,2738,1438,1300
'4711158000,  효곡동,'50,45 - 49세,1998,1496,946,550
'4711158000,  효곡동,'55,50 - 54세,1998,596,383,213
'4711158000,  효곡동,'60,55 - 59세,1998,263,164,99
'4711158000,  효곡동,'65,60 - 64세,1998,168,68,100
'4711158000,  효곡동,'70,65 - 69세,1998,162,42,120
'4711158000,  효곡동,'75,70 - 74세,1998,147,38,109
'4711158000,  효곡동,'80,75 - 79세,1998,107,23,84
'4711158000,  효곡동,'85,80 - 84세,1998,62,15,47
'4711158000,  효곡동,'90,85+ ,1998,23,6,17
'4711159000,  대이동,'00,계,1998,6559,3187,3372
'4711159000,  대이동,'05,0 - 4세,1998,304,165,139
'4711159000,  대이동,'10,5 - 9세,1998,396,214,182
'4711159000,  대이동,'15,10 - 14세,1998,595,315,280
'4711159000,  대이동,'20,15 - 19세,1998,805,416,389
'4711159000,  대이동,'25,20 - 24세,1998,482,245,237
'4711159000,  대이동,'30,25 - 29세,1998,452,239,213
'4711159000,  대이동,'35,30 - 34세,1998,439,210,229
'4711159000,  대이동,'40,35 - 39세,1998,644,262,382
'4711159000,  대이동,'45,40 - 44세,1998,731,356,375
'4711159000,  대이동,'50,45 - 49세,1998,580,309,271
'4711159000,  대이동,'55,50 - 54세,1998,347,191,156
'4711159000,  대이동,'60,55 - 59세,1998,294,134,160
'4711159000,  대이동,'65,60 - 64세,1998,163,51,112
'4711159000,  대이동,'70,65 - 69세,1998,97,30,67
'4711159000,  대이동,'75,70 - 74세,1998,90,23,67
'4711159000,  대이동,'80,75 - 79세,1998,73,16,57
'4711159000,  대이동,'85,80 - 84세,1998,42,8,34
'4711159000,  대이동,'90,85+ ,1998,25,3,22
'47113, 북구,'00,계,1998,247590,124685,122905
'47113, 북구,'05,0 - 4세,1998,15917,8670,7247
'47113, 북구,'10,5 - 9세,1998,19006,10645,8361
'47113, 북구,'15,10 - 14세,1998,19405,10394,9011
'47113, 북구,'20,15 - 19세,1998,24165,12399,11766
'47113, 북구,'25,20 - 24세,1998,18740,10038,8702
'47113, 북구,'30,25 - 29세,1998,19264,9662,9602
'47113, 북구,'35,30 - 34세,1998,20931,10174,10757
'47113, 북구,'40,35 - 39세,1998,25884,12532,13352
'47113, 북구,'45,40 - 44세,1998,23144,11829,11315
'47113, 북구,'50,45 - 49세,1998,15960,8520,7440
'47113, 북구,'55,50 - 54세,1998,10674,5554,5120
'47113, 북구,'60,55 - 59세,1998,10482,5083,5399
'47113, 북구,'65,60 - 64세,1998,8107,3630,4477
'47113, 북구,'70,65 - 69세,1998,5994,2334,3660
'47113, 북구,'75,70 - 74세,1998,4428,1535,2893
'47113, 북구,'80,75 - 79세,1998,3060,1023,2037
'47113, 북구,'85,80 - 84세,1998,1585,469,1116
'47113, 북구,'90,85+ ,1998,844,194,650
'4711325000,  흥해읍,'00,계,1998,34862,17494,17368
'4711325000,  흥해읍,'05,0 - 4세,1998,2738,1494,1244
'4711325000,  흥해읍,'10,5 - 9세,1998,2818,1490,1328
'4711325000,  흥해읍,'15,10 - 14세,1998,2164,1137,1027
'4711325000,  흥해읍,'20,15 - 19세,1998,2757,1387,1370
'4711325000,  흥해읍,'25,20 - 24세,1998,2487,1335,1152
'4711325000,  흥해읍,'30,25 - 29세,1998,3166,1564,1602
'4711325000,  흥해읍,'35,30 - 34세,1998,3603,1846,1757
'4711325000,  흥해읍,'40,35 - 39세,1998,3511,1904,1607
'4711325000,  흥해읍,'45,40 - 44세,1998,2509,1373,1136
'4711325000,  흥해읍,'50,45 - 49세,1998,1710,899,811
'4711325000,  흥해읍,'55,50 - 54세,1998,1357,659,698
'4711325000,  흥해읍,'60,55 - 59세,1998,1676,765,911
'4711325000,  흥해읍,'65,60 - 64세,1998,1477,640,837
'4711325000,  흥해읍,'70,65 - 69세,1998,1094,406,688
'4711325000,  흥해읍,'75,70 - 74세,1998,788,293,495
'4711325000,  흥해읍,'80,75 - 79세,1998,548,179,369
'4711325000,  흥해읍,'85,80 - 84세,1998,294,82,212
'4711325000,  흥해읍,'90,85+ ,1998,165,41,124
'4711331000,  신광면,'00,계,1998,4592,2294,2298
'4711331000,  신광면,'05,0 - 4세,1998,172,93,79
'4711331000,  신광면,'10,5 - 9세,1998,150,85,65
'4711331000,  신광면,'15,10 - 14세,1998,189,109,80
'4711331000,  신광면,'20,15 - 19세,1998,312,152,160
'4711331000,  신광면,'25,20 - 24세,1998,426,234,192
'4711331000,  신광면,'30,25 - 29세,1998,343,224,119
'4711331000,  신광면,'35,30 - 34세,1998,250,164,86
'4711331000,  신광면,'40,35 - 39세,1998,269,155,114
'4711331000,  신광면,'45,40 - 44세,1998,238,134,104
'4711331000,  신광면,'50,45 - 49세,1998,254,130,124
'4711331000,  신광면,'55,50 - 54세,1998,264,113,151
'4711331000,  신광면,'60,55 - 59세,1998,391,181,210
'4711331000,  신광면,'65,60 - 64세,1998,413,169,244
'4711331000,  신광면,'70,65 - 69세,1998,366,136,230
'4711331000,  신광면,'75,70 - 74세,1998,243,98,145
'4711331000,  신광면,'80,75 - 79세,1998,175,71,104
'4711331000,  신광면,'85,80 - 84세,1998,88,32,56
'4711331000,  신광면,'90,85+ ,1998,49,14,35
'4711332000,  청하면,'00,계,1998,8396,4150,4246
'4711332000,  청하면,'05,0 - 4세,1998,394,203,191
'4711332000,  청하면,'10,5 - 9세,1998,406,218,188
'4711332000,  청하면,'15,10 - 14세,1998,400,205,195
'4711332000,  청하면,'20,15 - 19세,1998,691,353,338
'4711332000,  청하면,'25,20 - 24세,1998,752,442,310
'4711332000,  청하면,'30,25 - 29세,1998,721,408,313
'4711332000,  청하면,'35,30 - 34세,1998,524,309,215
'4711332000,  청하면,'40,35 - 39세,1998,575,319,256
'4711332000,  청하면,'45,40 - 44세,1998,523,262,261
'4711332000,  청하면,'50,45 - 49세,1998,498,244,254
'4711332000,  청하면,'55,50 - 54세,1998,468,218,250
'4711332000,  청하면,'60,55 - 59세,1998,650,283,367
'4711332000,  청하면,'65,60 - 64세,1998,572,255,317
'4711332000,  청하면,'70,65 - 69세,1998,444,179,265
'4711332000,  청하면,'75,70 - 74세,1998,330,114,216
'4711332000,  청하면,'80,75 - 79세,1998,242,87,155
'4711332000,  청하면,'85,80 - 84세,1998,126,34,92
'4711332000,  청하면,'90,85+ ,1998,80,17,63
'4711333000,  송라면,'00,계,1998,4213,2051,2162
'4711333000,  송라면,'05,0 - 4세,1998,180,95,85
'4711333000,  송라면,'10,5 - 9세,1998,176,93,83
'4711333000,  송라면,'15,10 - 14세,1998,172,92,80
'4711333000,  송라면,'20,15 - 19세,1998,305,154,151
'4711333000,  송라면,'25,20 - 24세,1998,385,212,173
'4711333000,  송라면,'30,25 - 29세,1998,359,223,136
'4711333000,  송라면,'35,30 - 34세,1998,266,164,102
'4711333000,  송라면,'40,35 - 39세,1998,269,148,121
'4711333000,  송라면,'45,40 - 44세,1998,266,126,140
'4711333000,  송라면,'50,45 - 49세,1998,226,112,114
'4711333000,  송라면,'55,50 - 54세,1998,225,101,124
'4711333000,  송라면,'60,55 - 59세,1998,331,138,193
'4711333000,  송라면,'65,60 - 64세,1998,333,146,187
'4711333000,  송라면,'70,65 - 69세,1998,276,116,160
'4711333000,  송라면,'75,70 - 74세,1998,186,53,133
'4711333000,  송라면,'80,75 - 79세,1998,145,44,101
'4711333000,  송라면,'85,80 - 84세,1998,70,29,41
'4711333000,  송라면,'90,85+ ,1998,43,5,38
'4711334000,  기계면,'00,계,1998,7758,3904,3854
'4711334000,  기계면,'05,0 - 4세,1998,301,165,136
'4711334000,  기계면,'10,5 - 9세,1998,312,160,152
'4711334000,  기계면,'15,10 - 14세,1998,354,206,148
'4711334000,  기계면,'20,15 - 19세,1998,619,333,286
'4711334000,  기계면,'25,20 - 24세,1998,742,399,343
'4711334000,  기계면,'30,25 - 29세,1998,610,408,202
'4711334000,  기계면,'35,30 - 34세,1998,421,230,191
'4711334000,  기계면,'40,35 - 39세,1998,430,253,177
'4711334000,  기계면,'45,40 - 44세,1998,397,184,213
'4711334000,  기계면,'50,45 - 49세,1998,438,216,222
'4711334000,  기계면,'55,50 - 54세,1998,439,207,232
'4711334000,  기계면,'60,55 - 59세,1998,673,295,378
'4711334000,  기계면,'65,60 - 64세,1998,662,288,374
'4711334000,  기계면,'70,65 - 69세,1998,526,216,310
'4711334000,  기계면,'75,70 - 74세,1998,373,158,215
'4711334000,  기계면,'80,75 - 79세,1998,247,110,137
'4711334000,  기계면,'85,80 - 84세,1998,147,56,91
'4711334000,  기계면,'90,85+ ,1998,67,20,47
'4711335000,  죽장면,'00,계,1998,4011,1989,2022
'4711335000,  죽장면,'05,0 - 4세,1998,93,51,42
'4711335000,  죽장면,'10,5 - 9세,1998,128,73,55
'4711335000,  죽장면,'15,10 - 14세,1998,209,103,106
'4711335000,  죽장면,'20,15 - 19세,1998,325,138,187
'4711335000,  죽장면,'25,20 - 24세,1998,356,209,147
'4711335000,  죽장면,'30,25 - 29세,1998,258,170,88
'4711335000,  죽장면,'35,30 - 34세,1998,158,90,68
'4711335000,  죽장면,'40,35 - 39세,1998,186,97,89
'4711335000,  죽장면,'45,40 - 44세,1998,234,115,119
'4711335000,  죽장면,'50,45 - 49세,1998,234,127,107
'4711335000,  죽장면,'55,50 - 54세,1998,249,119,130
'4711335000,  죽장면,'60,55 - 59세,1998,399,164,235
'4711335000,  죽장면,'65,60 - 64세,1998,420,205,215
'4711335000,  죽장면,'70,65 - 69세,1998,296,120,176
'4711335000,  죽장면,'75,70 - 74세,1998,222,98,124
'4711335000,  죽장면,'80,75 - 79세,1998,143,73,70
'4711335000,  죽장면,'85,80 - 84세,1998,67,27,40
'4711335000,  죽장면,'90,85+ ,1998,34,10,24
'4711336000,  기북면,'00,계,1998,1963,975,988
'4711336000,  기북면,'05,0 - 4세,1998,52,27,25
'4711336000,  기북면,'10,5 - 9세,1998,44,18,26
'4711336000,  기북면,'15,10 - 14세,1998,73,37,36
'4711336000,  기북면,'20,15 - 19세,1998,140,75,65
'4711336000,  기북면,'25,20 - 24세,1998,188,105,83
'4711336000,  기북면,'30,25 - 29세,1998,162,110,52
'4711336000,  기북면,'35,30 - 34세,1998,74,56,18
'4711336000,  기북면,'40,35 - 39세,1998,82,47,35
'4711336000,  기북면,'45,40 - 44세,1998,91,44,47
'4711336000,  기북면,'50,45 - 49세,1998,99,53,46
'4711336000,  기북면,'55,50 - 54세,1998,103,48,55
'4711336000,  기북면,'60,55 - 59세,1998,182,70,112
'4711336000,  기북면,'65,60 - 64세,1998,228,94,134
'4711336000,  기북면,'70,65 - 69세,1998,171,76,95
'4711336000,  기북면,'75,70 - 74세,1998,125,56,69
'4711336000,  기북면,'80,75 - 79세,1998,89,37,52
'4711336000,  기북면,'85,80 - 84세,1998,41,13,28
'4711336000,  기북면,'90,85+ ,1998,19,9,10
'4711352000,  중앙동,'00,계,1998,10242,5011,5231
'4711352000,  중앙동,'05,0 - 4세,1998,419,229,190
'4711352000,  중앙동,'10,5 - 9세,1998,447,226,221
'4711352000,  중앙동,'15,10 - 14세,1998,566,280,286
'4711352000,  중앙동,'20,15 - 19세,1998,989,510,479
'4711352000,  중앙동,'25,20 - 24세,1998,1010,541,469
'4711352000,  중앙동,'30,25 - 29세,1998,959,514,445
'4711352000,  중앙동,'35,30 - 34세,1998,674,345,329
'4711352000,  중앙동,'40,35 - 39세,1998,794,360,434
'4711352000,  중앙동,'45,40 - 44세,1998,943,450,493
'4711352000,  중앙동,'50,45 - 49세,1998,841,407,434
'4711352000,  중앙동,'55,50 - 54세,1998,692,335,357
'4711352000,  중앙동,'60,55 - 59세,1998,623,312,311
'4711352000,  중앙동,'65,60 - 64세,1998,443,204,239
'4711352000,  중앙동,'70,65 - 69세,1998,319,130,189
'4711352000,  중앙동,'75,70 - 74세,1998,231,78,153
'4711352000,  중앙동,'80,75 - 79세,1998,165,53,112
'4711352000,  중앙동,'85,80 - 84세,1998,84,29,55
'4711352000,  중앙동,'90,85+ ,1998,43,8,35
'4711356000,  학산동,'00,계,1998,16760,8308,8452
'4711356000,  학산동,'05,0 - 4세,1998,814,427,387
'4711356000,  학산동,'10,5 - 9세,1998,796,454,342
'4711356000,  학산동,'15,10 - 14세,1998,1098,582,516
'4711356000,  학산동,'20,15 - 19세,1998,2023,1050,973
'4711356000,  학산동,'25,20 - 24세,1998,1741,912,829
'4711356000,  학산동,'30,25 - 29세,1998,1483,805,678
'4711356000,  학산동,'35,30 - 34세,1998,1201,636,565
'4711356000,  학산동,'40,35 - 39세,1998,1332,595,737
'4711356000,  학산동,'45,40 - 44세,1998,1511,701,810
'4711356000,  학산동,'50,45 - 49세,1998,1312,623,689
'4711356000,  학산동,'55,50 - 54세,1998,950,469,481
'4711356000,  학산동,'60,55 - 59세,1998,903,441,462
'4711356000,  학산동,'65,60 - 64세,1998,579,271,308
'4711356000,  학산동,'70,65 - 69세,1998,420,169,251
'4711356000,  학산동,'75,70 - 74세,1998,274,84,190
'4711356000,  학산동,'80,75 - 79세,1998,177,51,126
'4711356000,  학산동,'85,80 - 84세,1998,92,25,67
'4711356000,  학산동,'90,85+ ,1998,54,13,41
'4711363000,  양학동,'00,계,1998,15410,7845,7565
'4711363000,  양학동,'05,0 - 4세,1998,1215,645,570
'4711363000,  양학동,'10,5 - 9세,1998,1422,808,614
'4711363000,  양학동,'15,10 - 14세,1998,1469,777,692
'4711363000,  양학동,'20,15 - 19세,1998,1521,799,722
'4711363000,  양학동,'25,20 - 24세,1998,932,480,452
'4711363000,  양학동,'30,25 - 29세,1998,1248,559,689
'4711363000,  양학동,'35,30 - 34세,1998,1515,693,822
'4711363000,  양학동,'40,35 - 39세,1998,1954,945,1009
'4711363000,  양학동,'45,40 - 44세,1998,1589,848,741
'4711363000,  양학동,'50,45 - 49세,1998,889,540,349
'4711363000,  양학동,'55,50 - 54세,1998,504,291,213
'4711363000,  양학동,'60,55 - 59세,1998,368,204,164
'4711363000,  양학동,'65,60 - 64세,1998,250,104,146
'4711363000,  양학동,'70,65 - 69세,1998,201,74,127
'4711363000,  양학동,'75,70 - 74세,1998,149,42,107
'4711363000,  양학동,'80,75 - 79세,1998,112,24,88
'4711363000,  양학동,'85,80 - 84세,1998,51,11,40
'4711363000,  양학동,'90,85+ ,1998,21,1,20
'4711364000,  죽도1동,'00,계,1998,6365,3209,3156
'4711364000,  죽도1동,'05,0 - 4세,1998,239,131,108
'4711364000,  죽도1동,'10,5 - 9세,1998,354,188,166
'4711364000,  죽도1동,'15,10 - 14세,1998,401,200,201
'4711364000,  죽도1동,'20,15 - 19세,1998,687,377,310
'4711364000,  죽도1동,'25,20 - 24세,1998,685,394,291
'4711364000,  죽도1동,'30,25 - 29세,1998,497,271,226
'4711364000,  죽도1동,'35,30 - 34세,1998,382,183,199
'4711364000,  죽도1동,'40,35 - 39세,1998,546,248,298
'4711364000,  죽도1동,'45,40 - 44세,1998,609,291,318
'4711364000,  죽도1동,'50,45 - 49세,1998,541,263,278
'4711364000,  죽도1동,'55,50 - 54세,1998,434,225,209
'4711364000,  죽도1동,'60,55 - 59세,1998,390,202,188
'4711364000,  죽도1동,'65,60 - 64세,1998,233,106,127
'4711364000,  죽도1동,'70,65 - 69세,1998,144,58,86
'4711364000,  죽도1동,'75,70 - 74세,1998,94,37,57
'4711364000,  죽도1동,'80,75 - 79세,1998,68,24,44
'4711364000,  죽도1동,'85,80 - 84세,1998,36,6,30
'4711364000,  죽도1동,'90,85+ ,1998,25,5,20
'4711365000,  죽도2동,'00,계,1998,24848,12553,12295
'4711365000,  죽도2동,'05,0 - 4세,1998,1382,771,611
'4711365000,  죽도2동,'10,5 - 9세,1998,1598,910,688
'4711365000,  죽도2동,'15,10 - 14세,1998,1802,989,813
'4711365000,  죽도2동,'20,15 - 19세,1998,2829,1456,1373
'4711365000,  죽도2동,'25,20 - 24세,1998,2388,1219,1169
'4711365000,  죽도2동,'30,25 - 29세,1998,2128,1111,1017
'4711365000,  죽도2동,'35,30 - 34세,1998,1845,917,928
'4711365000,  죽도2동,'40,35 - 39세,1998,2287,1048,1239
'4711365000,  죽도2동,'45,40 - 44세,1998,2465,1130,1335
'4711365000,  죽도2동,'50,45 - 49세,1998,1996,1009,987
'4711365000,  죽도2동,'55,50 - 54세,1998,1384,729,655
'4711365000,  죽도2동,'60,55 - 59세,1998,1111,589,522
'4711365000,  죽도2동,'65,60 - 64세,1998,601,315,286
'4711365000,  죽도2동,'70,65 - 69세,1998,360,146,214
'4711365000,  죽도2동,'75,70 - 74세,1998,302,104,198
'4711365000,  죽도2동,'80,75 - 79세,1998,203,63,140
'4711365000,  죽도2동,'85,80 - 84세,1998,98,32,66
'4711365000,  죽도2동,'90,85+ ,1998,69,15,54
'4711366500,  용흥동,'00,계,1998,33629,17047,16582
'4711366500,  용흥동,'05,0 - 4세,1998,2087,1148,939
'4711366500,  용흥동,'10,5 - 9세,1998,2860,1622,1238
'4711366500,  용흥동,'15,10 - 14세,1998,3247,1787,1460
'4711366500,  용흥동,'20,15 - 19세,1998,3601,1819,1782
'4711366500,  용흥동,'25,20 - 24세,1998,2281,1252,1029
'4711366500,  용흥동,'30,25 - 29세,1998,2246,1067,1179
'4711366500,  용흥동,'35,30 - 34세,1998,2721,1241,1480
'4711366500,  용흥동,'40,35 - 39세,1998,3778,1728,2050
'4711366500,  용흥동,'45,40 - 44세,1998,3789,1948,1841
'4711366500,  용흥동,'50,45 - 49세,1998,2420,1322,1098
'4711366500,  용흥동,'55,50 - 54세,1998,1373,760,613
'4711366500,  용흥동,'60,55 - 59세,1998,1103,569,534
'4711366500,  용흥동,'65,60 - 64세,1998,698,317,381
'4711366500,  용흥동,'70,65 - 69세,1998,526,223,303
'4711366500,  용흥동,'75,70 - 74세,1998,411,121,290
'4711366500,  용흥동,'80,75 - 79세,1998,265,76,189
'4711366500,  용흥동,'85,80 - 84세,1998,163,39,124
'4711366500,  용흥동,'90,85+ ,1998,60,8,52
'4711368000,  우창동,'00,계,1998,27554,13963,13591
'4711368000,  우창동,'05,0 - 4세,1998,2464,1333,1131
'4711368000,  우창동,'10,5 - 9세,1998,2945,1725,1220
'4711368000,  우창동,'15,10 - 14세,1998,2538,1328,1210
'4711368000,  우창동,'20,15 - 19세,1998,2553,1320,1233
'4711368000,  우창동,'25,20 - 24세,1998,1510,776,734
'4711368000,  우창동,'30,25 - 29세,1998,1994,801,1193
'4711368000,  우창동,'35,30 - 34세,1998,3184,1504,1680
'4711368000,  우창동,'40,35 - 39세,1998,3872,1888,1984
'4711368000,  우창동,'45,40 - 44세,1998,2669,1453,1216
'4711368000,  우창동,'50,45 - 49세,1998,1407,779,628
'4711368000,  우창동,'55,50 - 54세,1998,665,380,285
'4711368000,  우창동,'60,55 - 59세,1998,549,268,281
'4711368000,  우창동,'65,60 - 64세,1998,402,151,251
'4711368000,  우창동,'70,65 - 69세,1998,291,109,182
'4711368000,  우창동,'75,70 - 74세,1998,237,74,163
'4711368000,  우창동,'80,75 - 79세,1998,160,41,119
'4711368000,  우창동,'85,80 - 84세,1998,77,23,54
'4711368000,  우창동,'90,85+ ,1998,37,10,27
'4711369000,  두호동,'00,계,1998,20877,10622,10255
'4711369000,  두호동,'05,0 - 4세,1998,1463,803,660
'4711369000,  두호동,'10,5 - 9세,1998,1854,1056,798
'4711369000,  두호동,'15,10 - 14세,1998,2043,1103,940
'4711369000,  두호동,'20,15 - 19세,1998,2179,1117,1062
'4711369000,  두호동,'25,20 - 24세,1998,1369,733,636
'4711369000,  두호동,'30,25 - 29세,1998,1408,666,742
'4711369000,  두호동,'35,30 - 34세,1998,1747,783,964
'4711369000,  두호동,'40,35 - 39세,1998,2515,1159,1356
'4711369000,  두호동,'45,40 - 44세,1998,2438,1249,1189
'4711369000,  두호동,'50,45 - 49세,1998,1426,816,610
'4711369000,  두호동,'55,50 - 54세,1998,777,432,345
'4711369000,  두호동,'60,55 - 59세,1998,567,316,251
'4711369000,  두호동,'65,60 - 64세,1998,377,175,202
'4711369000,  두호동,'70,65 - 69세,1998,270,95,175
'4711369000,  두호동,'75,70 - 74세,1998,209,54,155
'4711369000,  두호동,'80,75 - 79세,1998,132,40,92
'4711369000,  두호동,'85,80 - 84세,1998,64,16,48
'4711369000,  두호동,'90,85+ ,1998,39,9,30
'4711370000,  장량동,'00,계,1998,19539,9904,9635
'4711370000,  장량동,'05,0 - 4세,1998,1522,850,672
'4711370000,  장량동,'10,5 - 9세,1998,2084,1160,924
'4711370000,  장량동,'15,10 - 14세,1998,2021,1101,920
'4711370000,  장량동,'20,15 - 19세,1998,1940,1005,935
'4711370000,  장량동,'25,20 - 24세,1998,1018,512,506
'4711370000,  장량동,'30,25 - 29세,1998,1229,536,693
'4711370000,  장량동,'35,30 - 34세,1998,1779,745,1034
'4711370000,  장량동,'40,35 - 39세,1998,2731,1305,1426
'4711370000,  장량동,'45,40 - 44세,1998,2225,1173,1052
'4711370000,  장량동,'50,45 - 49세,1998,1233,721,512
'4711370000,  장량동,'55,50 - 54세,1998,531,335,196
'4711370000,  장량동,'60,55 - 59세,1998,363,186,177
'4711370000,  장량동,'65,60 - 64세,1998,276,126,150
'4711370000,  장량동,'70,65 - 69세,1998,210,58,152
'4711370000,  장량동,'75,70 - 74세,1998,162,49,113
'4711370000,  장량동,'80,75 - 79세,1998,121,25,96
'4711370000,  장량동,'85,80 - 84세,1998,63,10,53
'4711370000,  장량동,'90,85+ ,1998,31,7,24
'4711371000,  환여동,'00,계,1998,6571,3366,3205
'4711371000,  환여동,'05,0 - 4세,1998,382,205,177
'4711371000,  환여동,'10,5 - 9세,1998,612,359,253
'4711371000,  환여동,'15,10 - 14세,1998,659,358,301
'4711371000,  환여동,'20,15 - 19세,1998,694,354,340
'4711371000,  환여동,'25,20 - 24세,1998,470,283,187
'4711371000,  환여동,'30,25 - 29세,1998,453,225,228
'4711371000,  환여동,'35,30 - 34세,1998,587,268,319
'4711371000,  환여동,'40,35 - 39세,1998,753,333,420
'4711371000,  환여동,'45,40 - 44세,1998,648,348,300
'4711371000,  환여동,'50,45 - 49세,1998,436,259,177
'4711371000,  환여동,'55,50 - 54세,1998,259,133,126
'4711371000,  환여동,'60,55 - 59세,1998,203,100,103
'4711371000,  환여동,'65,60 - 64세,1998,143,64,79
'4711371000,  환여동,'70,65 - 69세,1998,80,23,57
'4711371000,  환여동,'75,70 - 74세,1998,92,22,70
'4711371000,  환여동,'80,75 - 79세,1998,68,25,43
'4711371000,  환여동,'85,80 - 84세,1998,24,5,19
'4711371000,  환여동,'90,85+ ,1998,8,2,6
'47130, 경주시,'00,계,1998,291414,145125,146289
'47130, 경주시,'05,0 - 4세,1998,20870,11156,9714
'47130, 경주시,'10,5 - 9세,1998,20060,10968,9092
'47130, 경주시,'15,10 - 14세,1998,17294,9252,8042
'47130, 경주시,'20,15 - 19세,1998,24097,12260,11837
'47130, 경주시,'25,20 - 24세,1998,24832,13123,11709
'47130, 경주시,'30,25 - 29세,1998,27858,14542,13316
'47130, 경주시,'35,30 - 34세,1998,26117,13604,12513
'47130, 경주시,'40,35 - 39세,1998,25063,13292,11771
'47130, 경주시,'45,40 - 44세,1998,20215,10258,9957
'47130, 경주시,'50,45 - 49세,1998,16090,7916,8174
'47130, 경주시,'55,50 - 54세,1998,13126,6385,6741
'47130, 경주시,'60,55 - 59세,1998,15246,6864,8382
'47130, 경주시,'65,60 - 64세,1998,13563,5754,7809
'47130, 경주시,'70,65 - 69세,1998,10342,4056,6286
'47130, 경주시,'75,70 - 74세,1998,7004,2660,4344
'47130, 경주시,'80,75 - 79세,1998,5168,1818,3350
'47130, 경주시,'85,80 - 84세,1998,2766,849,1917
'47130, 경주시,'90,85+ ,1998,1703,368,1335
'4713025000,  감포읍,'00,계,1998,8949,4420,4529
'4713025000,  감포읍,'05,0 - 4세,1998,388,202,186
'4713025000,  감포읍,'10,5 - 9세,1998,407,213,194
'4713025000,  감포읍,'15,10 - 14세,1998,426,232,194
'4713025000,  감포읍,'20,15 - 19세,1998,800,377,423
'4713025000,  감포읍,'25,20 - 24세,1998,838,480,358
'4713025000,  감포읍,'30,25 - 29세,1998,753,470,283
'4713025000,  감포읍,'35,30 - 34세,1998,531,286,245
'4713025000,  감포읍,'40,35 - 39세,1998,582,307,275
'4713025000,  감포읍,'45,40 - 44세,1998,589,306,283
'4713025000,  감포읍,'50,45 - 49세,1998,583,316,267
'4713025000,  감포읍,'55,50 - 54세,1998,556,248,308
'4713025000,  감포읍,'60,55 - 59세,1998,699,304,395
'4713025000,  감포읍,'65,60 - 64세,1998,567,250,317
'4713025000,  감포읍,'70,65 - 69세,1998,460,174,286
'4713025000,  감포읍,'75,70 - 74세,1998,349,117,232
'4713025000,  감포읍,'80,75 - 79세,1998,260,93,167
'4713025000,  감포읍,'85,80 - 84세,1998,107,30,77
'4713025000,  감포읍,'90,85+ ,1998,54,15,39
'4713025300,  안강읍,'00,계,1998,38425,19258,19167
'4713025300,  안강읍,'05,0 - 4세,1998,3368,1787,1581
'4713025300,  안강읍,'10,5 - 9세,1998,3051,1705,1346
'4713025300,  안강읍,'15,10 - 14세,1998,2189,1151,1038
'4713025300,  안강읍,'20,15 - 19세,1998,2962,1478,1484
'4713025300,  안강읍,'25,20 - 24세,1998,3050,1569,1481
'4713025300,  안강읍,'30,25 - 29세,1998,3862,1880,1982
'4713025300,  안강읍,'35,30 - 34세,1998,4180,2227,1953
'4713025300,  안강읍,'40,35 - 39세,1998,3430,1931,1499
'4713025300,  안강읍,'45,40 - 44세,1998,2322,1188,1134
'4713025300,  안강읍,'50,45 - 49세,1998,1841,923,918
'4713025300,  안강읍,'55,50 - 54세,1998,1485,753,732
'4713025300,  안강읍,'60,55 - 59세,1998,1815,799,1016
'4713025300,  안강읍,'65,60 - 64세,1998,1641,676,965
'4713025300,  안강읍,'70,65 - 69세,1998,1243,506,737
'4713025300,  안강읍,'75,70 - 74세,1998,829,303,526
'4713025300,  안강읍,'80,75 - 79세,1998,642,231,411
'4713025300,  안강읍,'85,80 - 84세,1998,330,98,232
'4713025300,  안강읍,'90,85+ ,1998,185,53,132
'4713025600,  건천읍,'00,계,1998,12985,6455,6530
'4713025600,  건천읍,'05,0 - 4세,1998,654,344,310
'4713025600,  건천읍,'10,5 - 9세,1998,635,352,283
'4713025600,  건천읍,'15,10 - 14세,1998,619,334,285
'4713025600,  건천읍,'20,15 - 19세,1998,1076,547,529
'4713025600,  건천읍,'25,20 - 24세,1998,1248,691,557
'4713025600,  건천읍,'30,25 - 29세,1998,1191,683,508
'4713025600,  건천읍,'35,30 - 34세,1998,897,491,406
'4713025600,  건천읍,'40,35 - 39세,1998,805,447,358
'4713025600,  건천읍,'45,40 - 44세,1998,804,407,397
'4713025600,  건천읍,'50,45 - 49세,1998,768,389,379
'4713025600,  건천읍,'55,50 - 54세,1998,700,319,381
'4713025600,  건천읍,'60,55 - 59세,1998,946,419,527
'4713025600,  건천읍,'65,60 - 64세,1998,887,386,501
'4713025600,  건천읍,'70,65 - 69세,1998,684,263,421
'4713025600,  건천읍,'75,70 - 74세,1998,474,174,300
'4713025600,  건천읍,'80,75 - 79세,1998,332,131,201
'4713025600,  건천읍,'85,80 - 84세,1998,169,56,113
'4713025600,  건천읍,'90,85+ ,1998,96,22,74
'4713025900,  외동읍,'00,계,1998,20441,10367,10074
'4713025900,  외동읍,'05,0 - 4세,1998,1446,795,651
'4713025900,  외동읍,'10,5 - 9세,1998,1385,754,631
'4713025900,  외동읍,'15,10 - 14세,1998,1129,624,505
'4713025900,  외동읍,'20,15 - 19세,1998,1486,767,719
'4713025900,  외동읍,'25,20 - 24세,1998,1802,971,831
'4713025900,  외동읍,'30,25 - 29세,1998,1924,1063,861
'4713025900,  외동읍,'35,30 - 34세,1998,1877,1016,861
'4713025900,  외동읍,'40,35 - 39세,1998,1699,988,711
'4713025900,  외동읍,'45,40 - 44세,1998,1211,618,593
'4713025900,  외동읍,'50,45 - 49세,1998,1041,530,511
'4713025900,  외동읍,'55,50 - 54세,1998,879,427,452
'4713025900,  외동읍,'60,55 - 59세,1998,1122,504,618
'4713025900,  외동읍,'65,60 - 64세,1998,1123,437,686
'4713025900,  외동읍,'70,65 - 69세,1998,879,370,509
'4713025900,  외동읍,'75,70 - 74세,1998,580,223,357
'4713025900,  외동읍,'80,75 - 79세,1998,439,157,282
'4713025900,  외동읍,'85,80 - 84세,1998,250,81,169
'4713025900,  외동읍,'90,85+ ,1998,169,42,127
'4713031000,  양북면,'00,계,1998,5620,2774,2846
'4713031000,  양북면,'05,0 - 4세,1998,198,105,93
'4713031000,  양북면,'10,5 - 9세,1998,203,127,76
'4713031000,  양북면,'15,10 - 14세,1998,247,122,125
'4713031000,  양북면,'20,15 - 19세,1998,498,257,241
'4713031000,  양북면,'25,20 - 24세,1998,575,318,257
'4713031000,  양북면,'30,25 - 29세,1998,434,286,148
'4713031000,  양북면,'35,30 - 34세,1998,286,174,112
'4713031000,  양북면,'40,35 - 39세,1998,289,154,135
'4713031000,  양북면,'45,40 - 44세,1998,342,162,180
'4713031000,  양북면,'50,45 - 49세,1998,316,155,161
'4713031000,  양북면,'55,50 - 54세,1998,320,161,159
'4713031000,  양북면,'60,55 - 59세,1998,475,201,274
'4713031000,  양북면,'65,60 - 64세,1998,473,197,276
'4713031000,  양북면,'70,65 - 69세,1998,341,133,208
'4713031000,  양북면,'75,70 - 74세,1998,258,100,158
'4713031000,  양북면,'80,75 - 79세,1998,184,66,118
'4713031000,  양북면,'85,80 - 84세,1998,98,34,64
'4713031000,  양북면,'90,85+ ,1998,83,22,61
'4713032000,  양남면,'00,계,1998,7656,3815,3841
'4713032000,  양남면,'05,0 - 4세,1998,595,305,290
'4713032000,  양남면,'10,5 - 9세,1998,522,263,259
'4713032000,  양남면,'15,10 - 14세,1998,354,167,187
'4713032000,  양남면,'20,15 - 19세,1998,482,241,241
'4713032000,  양남면,'25,20 - 24세,1998,661,356,305
'4713032000,  양남면,'30,25 - 29세,1998,871,492,379
'4713032000,  양남면,'35,30 - 34세,1998,697,413,284
'4713032000,  양남면,'40,35 - 39세,1998,559,310,249
'4713032000,  양남면,'45,40 - 44세,1998,404,217,187
'4713032000,  양남면,'50,45 - 49세,1998,346,164,182
'4713032000,  양남면,'55,50 - 54세,1998,354,173,181
'4713032000,  양남면,'60,55 - 59세,1998,459,200,259
'4713032000,  양남면,'65,60 - 64세,1998,409,179,230
'4713032000,  양남면,'70,65 - 69세,1998,358,144,214
'4713032000,  양남면,'75,70 - 74세,1998,266,92,174
'4713032000,  양남면,'80,75 - 79세,1998,179,66,113
'4713032000,  양남면,'85,80 - 84세,1998,83,25,58
'4713032000,  양남면,'90,85+ ,1998,57,8,49
'4713033000,  내남면,'00,계,1998,6973,3505,3468
'4713033000,  내남면,'05,0 - 4세,1998,283,156,127
'4713033000,  내남면,'10,5 - 9세,1998,203,118,85
'4713033000,  내남면,'15,10 - 14세,1998,299,172,127
'4713033000,  내남면,'20,15 - 19세,1998,536,285,251
'4713033000,  내남면,'25,20 - 24세,1998,735,418,317
'4713033000,  내남면,'30,25 - 29세,1998,554,355,199
'4713033000,  내남면,'35,30 - 34세,1998,385,250,135
'4713033000,  내남면,'40,35 - 39세,1998,369,205,164
'4713033000,  내남면,'45,40 - 44세,1998,385,201,184
'4713033000,  내남면,'50,45 - 49세,1998,401,186,215
'4713033000,  내남면,'55,50 - 54세,1998,384,190,194
'4713033000,  내남면,'60,55 - 59세,1998,576,254,322
'4713033000,  내남면,'65,60 - 64세,1998,624,258,366
'4713033000,  내남면,'70,65 - 69세,1998,467,179,288
'4713033000,  내남면,'75,70 - 74세,1998,303,128,175
'4713033000,  내남면,'80,75 - 79세,1998,251,91,160
'4713033000,  내남면,'85,80 - 84세,1998,137,46,91
'4713033000,  내남면,'90,85+ ,1998,81,13,68
'4713034000,  산내면,'00,계,1998,4356,2144,2212
'4713034000,  산내면,'05,0 - 4세,1998,106,58,48
'4713034000,  산내면,'10,5 - 9세,1998,147,77,70
'4713034000,  산내면,'15,10 - 14세,1998,184,91,93
'4713034000,  산내면,'20,15 - 19세,1998,300,134,166
'4713034000,  산내면,'25,20 - 24세,1998,412,235,177
'4713034000,  산내면,'30,25 - 29세,1998,306,215,91
'4713034000,  산내면,'35,30 - 34세,1998,194,121,73
'4713034000,  산내면,'40,35 - 39세,1998,254,139,115
'4713034000,  산내면,'45,40 - 44세,1998,249,134,115
'4713034000,  산내면,'50,45 - 49세,1998,265,120,145
'4713034000,  산내면,'55,50 - 54세,1998,293,138,155
'4713034000,  산내면,'60,55 - 59세,1998,434,196,238
'4713034000,  산내면,'65,60 - 64세,1998,457,204,253
'4713034000,  산내면,'70,65 - 69세,1998,287,112,175
'4713034000,  산내면,'75,70 - 74세,1998,221,84,137
'4713034000,  산내면,'80,75 - 79세,1998,124,49,75
'4713034000,  산내면,'85,80 - 84세,1998,79,29,50
'4713034000,  산내면,'90,85+ ,1998,44,8,36
'4713035000,  서면,'00,계,1998,5255,2582,2673
'4713035000,  서면,'05,0 - 4세,1998,193,103,90
'4713035000,  서면,'10,5 - 9세,1998,177,90,87
'4713035000,  서면,'15,10 - 14세,1998,212,115,97
'4713035000,  서면,'20,15 - 19세,1998,425,220,205
'4713035000,  서면,'25,20 - 24세,1998,549,307,242
'4713035000,  서면,'30,25 - 29세,1998,456,284,172
'4713035000,  서면,'35,30 - 34세,1998,285,158,127
'4713035000,  서면,'40,35 - 39세,1998,291,159,132
'4713035000,  서면,'45,40 - 44세,1998,289,161,128
'4713035000,  서면,'50,45 - 49세,1998,293,125,168
'4713035000,  서면,'55,50 - 54세,1998,335,153,182
'4713035000,  서면,'60,55 - 59세,1998,422,187,235
'4713035000,  서면,'65,60 - 64세,1998,434,181,253
'4713035000,  서면,'70,65 - 69세,1998,367,139,228
'4713035000,  서면,'75,70 - 74세,1998,247,106,141
'4713035000,  서면,'80,75 - 79세,1998,154,50,104
'4713035000,  서면,'85,80 - 84세,1998,89,34,55
'4713035000,  서면,'90,85+ ,1998,37,10,27
'4713036000,  현곡면,'00,계,1998,8904,4353,4551
'4713036000,  현곡면,'05,0 - 4세,1998,703,343,360
'4713036000,  현곡면,'10,5 - 9세,1998,506,252,254
'4713036000,  현곡면,'15,10 - 14세,1998,524,272,252
'4713036000,  현곡면,'20,15 - 19세,1998,716,348,368
'4713036000,  현곡면,'25,20 - 24세,1998,679,343,336
'4713036000,  현곡면,'30,25 - 29세,1998,962,496,466
'4713036000,  현곡면,'35,30 - 34세,1998,858,468,390
'4713036000,  현곡면,'40,35 - 39세,1998,679,363,316
'4713036000,  현곡면,'45,40 - 44세,1998,574,291,283
'4713036000,  현곡면,'50,45 - 49세,1998,453,239,214
'4713036000,  현곡면,'55,50 - 54세,1998,389,197,192
'4713036000,  현곡면,'60,55 - 59세,1998,475,202,273
'4713036000,  현곡면,'65,60 - 64세,1998,441,193,248
'4713036000,  현곡면,'70,65 - 69세,1998,360,139,221
'4713036000,  현곡면,'75,70 - 74세,1998,211,87,124
'4713036000,  현곡면,'80,75 - 79세,1998,192,75,117
'4713036000,  현곡면,'85,80 - 84세,1998,110,28,82
'4713036000,  현곡면,'90,85+ ,1998,72,17,55
'4713037000,  강동면,'00,계,1998,8169,4102,4067
'4713037000,  강동면,'05,0 - 4세,1998,519,273,246
'4713037000,  강동면,'10,5 - 9세,1998,339,191,148
'4713037000,  강동면,'15,10 - 14세,1998,357,194,163
'4713037000,  강동면,'20,15 - 19세,1998,621,300,321
'4713037000,  강동면,'25,20 - 24세,1998,799,429,370
'4713037000,  강동면,'30,25 - 29세,1998,791,457,334
'4713037000,  강동면,'35,30 - 34세,1998,643,388,255
'4713037000,  강동면,'40,35 - 39세,1998,476,268,208
'4713037000,  강동면,'45,40 - 44세,1998,434,232,202
'4713037000,  강동면,'50,45 - 49세,1998,470,214,256
'4713037000,  강동면,'55,50 - 54세,1998,451,231,220
'4713037000,  강동면,'60,55 - 59세,1998,552,228,324
'4713037000,  강동면,'65,60 - 64세,1998,567,246,321
'4713037000,  강동면,'70,65 - 69세,1998,412,178,234
'4713037000,  강동면,'75,70 - 74세,1998,301,126,175
'4713037000,  강동면,'80,75 - 79세,1998,247,92,155
'4713037000,  강동면,'85,80 - 84세,1998,119,38,81
'4713037000,  강동면,'90,85+ ,1998,71,17,54
'4713038000,  천북면,'00,계,1998,6969,3507,3462
'4713038000,  천북면,'05,0 - 4세,1998,347,189,158
'4713038000,  천북면,'10,5 - 9세,1998,298,160,138
'4713038000,  천북면,'15,10 - 14세,1998,347,191,156
'4713038000,  천북면,'20,15 - 19세,1998,615,311,304
'4713038000,  천북면,'25,20 - 24세,1998,699,376,323
'4713038000,  천북면,'30,25 - 29세,1998,647,381,266
'4713038000,  천북면,'35,30 - 34세,1998,463,278,185
'4713038000,  천북면,'40,35 - 39세,1998,465,267,198
'4713038000,  천북면,'45,40 - 44세,1998,406,211,195
'4713038000,  천북면,'50,45 - 49세,1998,428,205,223
'4713038000,  천북면,'55,50 - 54세,1998,377,184,193
'4713038000,  천북면,'60,55 - 59세,1998,539,256,283
'4713038000,  천북면,'65,60 - 64세,1998,448,202,246
'4713038000,  천북면,'70,65 - 69세,1998,328,123,205
'4713038000,  천북면,'75,70 - 74세,1998,205,72,133
'4713038000,  천북면,'80,75 - 79세,1998,183,62,121
'4713038000,  천북면,'85,80 - 84세,1998,109,28,81
'4713038000,  천북면,'90,85+ ,1998,65,11,54
'4713051500,  중부동,'00,계,1998,8491,4107,4384
'4713051500,  중부동,'05,0 - 4세,1998,365,200,165
'4713051500,  중부동,'10,5 - 9세,1998,469,269,200
'4713051500,  중부동,'15,10 - 14세,1998,546,302,244
'4713051500,  중부동,'20,15 - 19세,1998,802,393,409
'4713051500,  중부동,'25,20 - 24세,1998,845,438,407
'4713051500,  중부동,'30,25 - 29세,1998,811,429,382
'4713051500,  중부동,'35,30 - 34세,1998,557,272,285
'4713051500,  중부동,'40,35 - 39세,1998,625,292,333
'4713051500,  중부동,'45,40 - 44세,1998,654,288,366
'4713051500,  중부동,'50,45 - 49세,1998,598,272,326
'4713051500,  중부동,'55,50 - 54세,1998,492,228,264
'4713051500,  중부동,'60,55 - 59세,1998,551,258,293
'4713051500,  중부동,'65,60 - 64세,1998,397,188,209
'4713051500,  중부동,'70,65 - 69세,1998,309,125,184
'4713051500,  중부동,'75,70 - 74세,1998,188,72,116
'4713051500,  중부동,'80,75 - 79세,1998,153,48,105
'4713051500,  중부동,'85,80 - 84세,1998,79,24,55
'4713051500,  중부동,'90,85+ ,1998,50,9,41
'4713052000,  성동동,'00,계,1998,6445,3183,3262
'4713052000,  성동동,'05,0 - 4세,1998,274,147,127
'4713052000,  성동동,'10,5 - 9세,1998,360,198,162
'4713052000,  성동동,'15,10 - 14세,1998,403,224,179
'4713052000,  성동동,'20,15 - 19세,1998,673,361,312
'4713052000,  성동동,'25,20 - 24세,1998,635,350,285
'4713052000,  성동동,'30,25 - 29세,1998,566,312,254
'4713052000,  성동동,'35,30 - 34세,1998,414,214,200
'4713052000,  성동동,'40,35 - 39세,1998,509,250,259
'4713052000,  성동동,'45,40 - 44세,1998,567,255,312
'4713052000,  성동동,'50,45 - 49세,1998,455,216,239
'4713052000,  성동동,'55,50 - 54세,1998,383,178,205
'4713052000,  성동동,'60,55 - 59세,1998,379,172,207
'4713052000,  성동동,'65,60 - 64세,1998,286,129,157
'4713052000,  성동동,'70,65 - 69세,1998,208,79,129
'4713052000,  성동동,'75,70 - 74세,1998,146,54,92
'4713052000,  성동동,'80,75 - 79세,1998,89,27,62
'4713052000,  성동동,'85,80 - 84세,1998,55,10,45
'4713052000,  성동동,'90,85+ ,1998,43,7,36
'4713053000,  황오동,'00,계,1998,7695,3767,3928
'4713053000,  황오동,'05,0 - 4세,1998,363,202,161
'4713053000,  황오동,'10,5 - 9세,1998,378,203,175
'4713053000,  황오동,'15,10 - 14세,1998,445,250,195
'4713053000,  황오동,'20,15 - 19세,1998,783,405,378
'4713053000,  황오동,'25,20 - 24세,1998,780,411,369
'4713053000,  황오동,'30,25 - 29세,1998,734,426,308
'4713053000,  황오동,'35,30 - 34세,1998,518,261,257
'4713053000,  황오동,'40,35 - 39세,1998,584,285,299
'4713053000,  황오동,'45,40 - 44세,1998,646,290,356
'4713053000,  황오동,'50,45 - 49세,1998,542,232,310
'4713053000,  황오동,'55,50 - 54세,1998,434,206,228
'4713053000,  황오동,'60,55 - 59세,1998,453,194,259
'4713053000,  황오동,'65,60 - 64세,1998,346,155,191
'4713053000,  황오동,'70,65 - 69세,1998,278,111,167
'4713053000,  황오동,'75,70 - 74세,1998,172,64,108
'4713053000,  황오동,'80,75 - 79세,1998,142,47,95
'4713053000,  황오동,'85,80 - 84세,1998,61,19,42
'4713053000,  황오동,'90,85+ ,1998,36,6,30
'4713055000,  성건동,'00,계,1998,21844,10718,11126
'4713055000,  성건동,'05,0 - 4세,1998,1392,761,631
'4713055000,  성건동,'10,5 - 9세,1998,1417,774,643
'4713055000,  성건동,'15,10 - 14세,1998,1309,699,610
'4713055000,  성건동,'20,15 - 19세,1998,2212,1131,1081
'4713055000,  성건동,'25,20 - 24세,1998,2362,1175,1187
'4713055000,  성건동,'30,25 - 29세,1998,2237,1135,1102
'4713055000,  성건동,'35,30 - 34세,1998,1713,871,842
'4713055000,  성건동,'40,35 - 39세,1998,1655,778,877
'4713055000,  성건동,'45,40 - 44세,1998,1726,760,966
'4713055000,  성건동,'50,45 - 49세,1998,1534,731,803
'4713055000,  성건동,'55,50 - 54세,1998,1148,569,579
'4713055000,  성건동,'60,55 - 59세,1998,1007,511,496
'4713055000,  성건동,'65,60 - 64세,1998,709,329,380
'4713055000,  성건동,'70,65 - 69세,1998,539,201,338
'4713055000,  성건동,'75,70 - 74세,1998,366,131,235
'4713055000,  성건동,'80,75 - 79세,1998,259,97,162
'4713055000,  성건동,'85,80 - 84세,1998,158,43,115
'4713055000,  성건동,'90,85+ ,1998,101,22,79
'4713056000,  탑정동,'00,계,1998,7275,3650,3625
'4713056000,  탑정동,'05,0 - 4세,1998,390,207,183
'4713056000,  탑정동,'10,5 - 9세,1998,361,206,155
'4713056000,  탑정동,'15,10 - 14세,1998,327,177,150
'4713056000,  탑정동,'20,15 - 19세,1998,615,334,281
'4713056000,  탑정동,'25,20 - 24세,1998,711,381,330
'4713056000,  탑정동,'30,25 - 29세,1998,728,421,307
'4713056000,  탑정동,'35,30 - 34세,1998,507,265,242
'4713056000,  탑정동,'40,35 - 39세,1998,532,280,252
'4713056000,  탑정동,'45,40 - 44세,1998,480,244,236
'4713056000,  탑정동,'50,45 - 49세,1998,447,203,244
'4713056000,  탑정동,'55,50 - 54세,1998,396,189,207
'4713056000,  탑정동,'60,55 - 59세,1998,527,235,292
'4713056000,  탑정동,'65,60 - 64세,1998,436,199,237
'4713056000,  탑정동,'70,65 - 69세,1998,333,145,188
'4713056000,  탑정동,'75,70 - 74세,1998,187,67,120
'4713056000,  탑정동,'80,75 - 79세,1998,157,53,104
'4713056000,  탑정동,'85,80 - 84세,1998,84,32,52
'4713056000,  탑정동,'90,85+ ,1998,57,12,45
'4713057000,  황남동,'00,계,1998,5577,2676,2901
'4713057000,  황남동,'05,0 - 4세,1998,333,180,153
'4713057000,  황남동,'10,5 - 9세,1998,383,206,177
'4713057000,  황남동,'15,10 - 14세,1998,325,181,144
'4713057000,  황남동,'20,15 - 19세,1998,473,248,225
'4713057000,  황남동,'25,20 - 24세,1998,513,267,246
'4713057000,  황남동,'30,25 - 29세,1998,520,272,248
'4713057000,  황남동,'35,30 - 34세,1998,435,198,237
'4713057000,  황남동,'40,35 - 39세,1998,475,238,237
'4713057000,  황남동,'45,40 - 44세,1998,425,202,223
'4713057000,  황남동,'50,45 - 49세,1998,328,155,173
'4713057000,  황남동,'55,50 - 54세,1998,274,117,157
'4713057000,  황남동,'60,55 - 59세,1998,292,131,161
'4713057000,  황남동,'65,60 - 64세,1998,282,98,184
'4713057000,  황남동,'70,65 - 69세,1998,201,75,126
'4713057000,  황남동,'75,70 - 74세,1998,138,57,81
'4713057000,  황남동,'80,75 - 79세,1998,99,26,73
'4713057000,  황남동,'85,80 - 84세,1998,49,14,35
'4713057000,  황남동,'90,85+ ,1998,32,11,21
'4713059000,  선도동,'00,계,1998,11340,5665,5675
'4713059000,  선도동,'05,0 - 4세,1998,1224,669,555
'4713059000,  선도동,'10,5 - 9세,1998,905,483,422
'4713059000,  선도동,'15,10 - 14세,1998,599,319,280
'4713059000,  선도동,'20,15 - 19세,1998,776,417,359
'4713059000,  선도동,'25,20 - 24세,1998,781,401,380
'4713059000,  선도동,'30,25 - 29세,1998,1262,538,724
'4713059000,  선도동,'35,30 - 34세,1998,1435,748,687
'4713059000,  선도동,'40,35 - 39세,1998,1132,629,503
'4713059000,  선도동,'45,40 - 44세,1998,728,390,338
'4713059000,  선도동,'50,45 - 49세,1998,541,252,289
'4713059000,  선도동,'55,50 - 54세,1998,400,191,209
'4713059000,  선도동,'60,55 - 59세,1998,433,187,246
'4713059000,  선도동,'65,60 - 64세,1998,413,180,233
'4713059000,  선도동,'70,65 - 69세,1998,298,126,172
'4713059000,  선도동,'75,70 - 74세,1998,161,59,102
'4713059000,  선도동,'80,75 - 79세,1998,137,48,89
'4713059000,  선도동,'85,80 - 84세,1998,67,16,51
'4713059000,  선도동,'90,85+ ,1998,48,12,36
'4713060500,  월성동,'00,계,1998,8166,4031,4135
'4713060500,  월성동,'05,0 - 4세,1998,364,187,177
'4713060500,  월성동,'10,5 - 9세,1998,348,187,161
'4713060500,  월성동,'15,10 - 14세,1998,359,211,148
'4713060500,  월성동,'20,15 - 19세,1998,683,353,330
'4713060500,  월성동,'25,20 - 24세,1998,855,437,418
'4713060500,  월성동,'30,25 - 29세,1998,865,508,357
'4713060500,  월성동,'35,30 - 34세,1998,541,341,200
'4713060500,  월성동,'40,35 - 39세,1998,486,264,222
'4713060500,  월성동,'45,40 - 44세,1998,532,249,283
'4713060500,  월성동,'50,45 - 49세,1998,510,223,287
'4713060500,  월성동,'55,50 - 54세,1998,480,225,255
'4713060500,  월성동,'60,55 - 59세,1998,588,265,323
'4713060500,  월성동,'65,60 - 64세,1998,554,228,326
'4713060500,  월성동,'70,65 - 69세,1998,386,150,236
'4713060500,  월성동,'75,70 - 74세,1998,258,103,155
'4713060500,  월성동,'80,75 - 79세,1998,200,65,135
'4713060500,  월성동,'85,80 - 84세,1998,98,28,70
'4713060500,  월성동,'90,85+ ,1998,59,7,52
'4713061500,  용강동,'00,계,1998,14624,7342,7282
'4713061500,  용강동,'05,0 - 4세,1998,1352,746,606
'4713061500,  용강동,'10,5 - 9세,1998,1661,907,754
'4713061500,  용강동,'15,10 - 14세,1998,1111,593,518
'4713061500,  용강동,'20,15 - 19세,1998,1189,594,595
'4713061500,  용강동,'25,20 - 24세,1998,934,512,422
'4713061500,  용강동,'30,25 - 29세,1998,1264,603,661
'4713061500,  용강동,'35,30 - 34세,1998,1701,731,970
'4713061500,  용강동,'40,35 - 39세,1998,1854,998,856
'4713061500,  용강동,'45,40 - 44세,1998,1131,612,519
'4713061500,  용강동,'50,45 - 49세,1998,633,320,313
'4713061500,  용강동,'55,50 - 54세,1998,420,202,218
'4713061500,  용강동,'60,55 - 59세,1998,417,176,241
'4713061500,  용강동,'65,60 - 64세,1998,335,125,210
'4713061500,  용강동,'70,65 - 69세,1998,249,90,159
'4713061500,  용강동,'75,70 - 74세,1998,183,80,103
'4713061500,  용강동,'80,75 - 79세,1998,104,33,71
'4713061500,  용강동,'85,80 - 84세,1998,54,16,38
'4713061500,  용강동,'90,85+ ,1998,32,4,28
'4713062100,  황성동,'00,계,1998,29164,14640,14524
'4713062100,  황성동,'05,0 - 4세,1998,3165,1703,1462
'4713062100,  황성동,'10,5 - 9세,1998,3164,1712,1452
'4713062100,  황성동,'15,10 - 14세,1998,2571,1359,1212
'4713062100,  황성동,'20,15 - 19세,1998,2199,1129,1070
'4713062100,  황성동,'25,20 - 24세,1998,1428,728,700
'4713062100,  황성동,'30,25 - 29세,1998,2638,1083,1555
'4713062100,  황성동,'35,30 - 34세,1998,3535,1682,1853
'4713062100,  황성동,'40,35 - 39세,1998,3850,1969,1881
'4713062100,  황성동,'45,40 - 44세,1998,2510,1371,1139
'4713062100,  황성동,'50,45 - 49세,1998,1343,784,559
'4713062100,  황성동,'55,50 - 54세,1998,666,339,327
'4713062100,  황성동,'60,55 - 59세,1998,579,259,320
'4713062100,  황성동,'65,60 - 64세,1998,487,194,293
'4713062100,  황성동,'70,65 - 69세,1998,400,139,261
'4713062100,  황성동,'75,70 - 74세,1998,300,93,207
'4713062100,  황성동,'80,75 - 79세,1998,172,51,121
'4713062100,  황성동,'85,80 - 84세,1998,97,31,66
'4713062100,  황성동,'90,85+ ,1998,60,14,46
'4713063000,  동천동,'00,계,1998,24042,12058,11984
'4713063000,  동천동,'05,0 - 4세,1998,2168,1134,1034
'4713063000,  동천동,'10,5 - 9세,1998,2139,1199,940
'4713063000,  동천동,'15,10 - 14세,1998,1864,984,880
'4713063000,  동천동,'20,15 - 19세,1998,2119,1097,1022
'4713063000,  동천동,'25,20 - 24세,1998,1764,887,877
'4713063000,  동천동,'30,25 - 29세,1998,2332,1083,1249
'4713063000,  동천동,'35,30 - 34세,1998,2579,1240,1339
'4713063000,  동천동,'40,35 - 39세,1998,2675,1348,1327
'4713063000,  동천동,'45,40 - 44세,1998,2030,1061,969
'4713063000,  동천동,'50,45 - 49세,1998,1251,636,615
'4713063000,  동천동,'55,50 - 54세,1998,861,456,405
'4713063000,  동천동,'60,55 - 59세,1998,710,358,352
'4713063000,  동천동,'65,60 - 64세,1998,525,225,300
'4713063000,  동천동,'70,65 - 69세,1998,395,146,249
'4713063000,  동천동,'75,70 - 74세,1998,286,105,181
'4713063000,  동천동,'80,75 - 79세,1998,182,63,119
'4713063000,  동천동,'85,80 - 84세,1998,99,26,73
'4713063000,  동천동,'90,85+ ,1998,63,10,53
'4713065000,  불국동,'00,계,1998,9290,4615,4675
'4713065000,  불국동,'05,0 - 4세,1998,547,283,264
'4713065000,  불국동,'10,5 - 9세,1998,485,261,224
'4713065000,  불국동,'15,10 - 14세,1998,420,217,203
'4713065000,  불국동,'20,15 - 19세,1998,825,435,390
'4713065000,  불국동,'25,20 - 24세,1998,886,470,416
'4713065000,  불국동,'30,25 - 29세,1998,849,490,359
'4713065000,  불국동,'35,30 - 34세,1998,691,388,303
'4713065000,  불국동,'40,35 - 39세,1998,614,332,282
'4713065000,  불국동,'45,40 - 44세,1998,589,309,280
'4713065000,  불국동,'50,45 - 49세,1998,548,253,295
'4713065000,  불국동,'55,50 - 54세,1998,489,234,255
'4713065000,  불국동,'60,55 - 59세,1998,617,281,336
'4713065000,  불국동,'65,60 - 64세,1998,573,238,335
'4713065000,  불국동,'70,65 - 69세,1998,429,156,273
'4713065000,  불국동,'75,70 - 74세,1998,292,134,158
'4713065000,  불국동,'80,75 - 79세,1998,202,68,134
'4713065000,  불국동,'85,80 - 84세,1998,146,52,94
'4713065000,  불국동,'90,85+ ,1998,88,14,74
'4713066000,  보덕동,'00,계,1998,2759,1391,1368
'4713066000,  보덕동,'05,0 - 4세,1998,133,77,56
'4713066000,  보덕동,'10,5 - 9세,1998,117,61,56
'4713066000,  보덕동,'15,10 - 14세,1998,128,71,57
'4713066000,  보덕동,'20,15 - 19세,1998,231,98,133
'4713066000,  보덕동,'25,20 - 24세,1998,291,173,118
'4713066000,  보덕동,'30,25 - 29세,1998,301,180,121
'4713066000,  보덕동,'35,30 - 34세,1998,195,123,72
'4713066000,  보덕동,'40,35 - 39세,1998,174,91,83
'4713066000,  보덕동,'45,40 - 44세,1998,188,99,89
'4713066000,  보덕동,'50,45 - 49세,1998,155,73,82
'4713066000,  보덕동,'55,50 - 54세,1998,160,77,83
'4713066000,  보덕동,'60,55 - 59세,1998,179,87,92
'4713066000,  보덕동,'65,60 - 64세,1998,149,57,92
'4713066000,  보덕동,'70,65 - 69세,1998,131,53,78
'4713066000,  보덕동,'75,70 - 74세,1998,83,29,54
'4713066000,  보덕동,'80,75 - 79세,1998,85,29,56
'4713066000,  보덕동,'85,80 - 84세,1998,39,11,28
'4713066000,  보덕동,'90,85+ ,1998,20,2,18
'47150, 김천시,'00,계,1998,150144,74445,75699
'47150, 김천시,'05,0 - 4세,1998,8690,4681,4009
'47150, 김천시,'10,5 - 9세,1998,9297,5032,4265
'47150, 김천시,'15,10 - 14세,1998,9442,5057,4385
'47150, 김천시,'20,15 - 19세,1998,13735,7016,6719
'47150, 김천시,'25,20 - 24세,1998,13570,7352,6218
'47150, 김천시,'30,25 - 29세,1998,12609,6795,5814
'47150, 김천시,'35,30 - 34세,1998,10653,5580,5073
'47150, 김천시,'40,35 - 39세,1998,11831,6056,5775
'47150, 김천시,'45,40 - 44세,1998,10386,5168,5218
'47150, 김천시,'50,45 - 49세,1998,8854,4345,4509
'47150, 김천시,'55,50 - 54세,1998,7156,3487,3669
'47150, 김천시,'60,55 - 59세,1998,8735,3765,4970
'47150, 김천시,'65,60 - 64세,1998,8465,3707,4758
'47150, 김천시,'70,65 - 69세,1998,6271,2612,3659
'47150, 김천시,'75,70 - 74세,1998,4487,1835,2652
'47150, 김천시,'80,75 - 79세,1998,3214,1173,2041
'47150, 김천시,'85,80 - 84세,1998,1686,554,1132
'47150, 김천시,'90,85+ ,1998,1063,230,833
'4715025000,  아포읍,'00,계,1998,8468,4215,4253
'4715025000,  아포읍,'05,0 - 4세,1998,444,226,218
'4715025000,  아포읍,'10,5 - 9세,1998,460,264,196
'4715025000,  아포읍,'15,10 - 14세,1998,446,238,208
'4715025000,  아포읍,'20,15 - 19세,1998,714,372,342
'4715025000,  아포읍,'25,20 - 24세,1998,781,405,376
'4715025000,  아포읍,'30,25 - 29세,1998,747,433,314
'4715025000,  아포읍,'35,30 - 34세,1998,565,312,253
'4715025000,  아포읍,'40,35 - 39세,1998,576,308,268
'4715025000,  아포읍,'45,40 - 44세,1998,544,283,261
'4715025000,  아포읍,'50,45 - 49세,1998,492,242,250
'4715025000,  아포읍,'55,50 - 54세,1998,429,208,221
'4715025000,  아포읍,'60,55 - 59세,1998,531,226,305
'4715025000,  아포읍,'65,60 - 64세,1998,605,276,329
'4715025000,  아포읍,'70,65 - 69세,1998,441,189,252
'4715025000,  아포읍,'75,70 - 74세,1998,293,121,172
'4715025000,  아포읍,'80,75 - 79세,1998,197,63,134
'4715025000,  아포읍,'85,80 - 84세,1998,124,37,87
'4715025000,  아포읍,'90,85+ ,1998,79,12,67
'4715031000,  농소면,'00,계,1998,4263,2103,2160
'4715031000,  농소면,'05,0 - 4세,1998,195,97,98
'4715031000,  농소면,'10,5 - 9세,1998,139,67,72
'4715031000,  농소면,'15,10 - 14세,1998,190,94,96
'4715031000,  농소면,'20,15 - 19세,1998,400,203,197
'4715031000,  농소면,'25,20 - 24세,1998,426,233,193
'4715031000,  농소면,'30,25 - 29세,1998,358,218,140
'4715031000,  농소면,'35,30 - 34세,1998,231,142,89
'4715031000,  농소면,'40,35 - 39세,1998,209,109,100
'4715031000,  농소면,'45,40 - 44세,1998,272,144,128
'4715031000,  농소면,'50,45 - 49세,1998,267,112,155
'4715031000,  농소면,'55,50 - 54세,1998,225,101,124
'4715031000,  농소면,'60,55 - 59세,1998,339,146,193
'4715031000,  농소면,'65,60 - 64세,1998,342,159,183
'4715031000,  농소면,'70,65 - 69세,1998,225,105,120
'4715031000,  농소면,'75,70 - 74세,1998,171,68,103
'4715031000,  농소면,'80,75 - 79세,1998,153,58,95
'4715031000,  농소면,'85,80 - 84세,1998,85,35,50
'4715031000,  농소면,'90,85+ ,1998,36,12,24
'4715032000,  남면,'00,계,1998,4652,2276,2376
'4715032000,  남면,'05,0 - 4세,1998,170,70,100
'4715032000,  남면,'10,5 - 9세,1998,191,102,89
'4715032000,  남면,'15,10 - 14세,1998,241,114,127
'4715032000,  남면,'20,15 - 19세,1998,402,211,191
'4715032000,  남면,'25,20 - 24세,1998,464,247,217
'4715032000,  남면,'30,25 - 29세,1998,317,202,115
'4715032000,  남면,'35,30 - 34세,1998,218,132,86
'4715032000,  남면,'40,35 - 39세,1998,290,157,133
'4715032000,  남면,'45,40 - 44세,1998,301,153,148
'4715032000,  남면,'50,45 - 49세,1998,291,149,142
'4715032000,  남면,'55,50 - 54세,1998,267,122,145
'4715032000,  남면,'60,55 - 59세,1998,371,146,225
'4715032000,  남면,'65,60 - 64세,1998,344,166,178
'4715032000,  남면,'70,65 - 69세,1998,281,122,159
'4715032000,  남면,'75,70 - 74세,1998,197,74,123
'4715032000,  남면,'80,75 - 79세,1998,154,64,90
'4715032000,  남면,'85,80 - 84세,1998,87,29,58
'4715032000,  남면,'90,85+ ,1998,66,16,50
'4715034000,  개령면,'00,계,1998,3736,1861,1875
'4715034000,  개령면,'05,0 - 4세,1998,139,85,54
'4715034000,  개령면,'10,5 - 9세,1998,183,116,67
'4715034000,  개령면,'15,10 - 14세,1998,212,123,89
'4715034000,  개령면,'20,15 - 19세,1998,355,163,192
'4715034000,  개령면,'25,20 - 24세,1998,338,185,153
'4715034000,  개령면,'30,25 - 29세,1998,285,183,102
'4715034000,  개령면,'35,30 - 34세,1998,188,104,84
'4715034000,  개령면,'40,35 - 39세,1998,243,137,106
'4715034000,  개령면,'45,40 - 44세,1998,247,127,120
'4715034000,  개령면,'50,45 - 49세,1998,238,124,114
'4715034000,  개령면,'55,50 - 54세,1998,175,79,96
'4715034000,  개령면,'60,55 - 59세,1998,263,103,160
'4715034000,  개령면,'65,60 - 64세,1998,253,104,149
'4715034000,  개령면,'70,65 - 69세,1998,227,98,129
'4715034000,  개령면,'75,70 - 74세,1998,171,70,101
'4715034000,  개령면,'80,75 - 79세,1998,115,34,81
'4715034000,  개령면,'85,80 - 84세,1998,61,23,38
'4715034000,  개령면,'90,85+ ,1998,43,3,40
'4715035000,  감문면,'00,계,1998,5519,2715,2804
'4715035000,  감문면,'05,0 - 4세,1998,184,104,80
'4715035000,  감문면,'10,5 - 9세,1998,211,115,96
'4715035000,  감문면,'15,10 - 14세,1998,276,146,130
'4715035000,  감문면,'20,15 - 19세,1998,453,250,203
'4715035000,  감문면,'25,20 - 24세,1998,538,300,238
'4715035000,  감문면,'30,25 - 29세,1998,354,218,136
'4715035000,  감문면,'35,30 - 34세,1998,239,136,103
'4715035000,  감문면,'40,35 - 39세,1998,321,181,140
'4715035000,  감문면,'45,40 - 44세,1998,310,160,150
'4715035000,  감문면,'50,45 - 49세,1998,314,157,157
'4715035000,  감문면,'55,50 - 54세,1998,299,134,165
'4715035000,  감문면,'60,55 - 59세,1998,409,164,245
'4715035000,  감문면,'65,60 - 64세,1998,499,212,287
'4715035000,  감문면,'70,65 - 69세,1998,442,186,256
'4715035000,  감문면,'75,70 - 74세,1998,286,126,160
'4715035000,  감문면,'80,75 - 79세,1998,210,76,134
'4715035000,  감문면,'85,80 - 84세,1998,108,35,73
'4715035000,  감문면,'90,85+ ,1998,66,15,51
'4715036000,  어모면,'00,계,1998,6027,2971,3056
'4715036000,  어모면,'05,0 - 4세,1998,285,136,149
'4715036000,  어모면,'10,5 - 9세,1998,260,131,129
'4715036000,  어모면,'15,10 - 14세,1998,284,166,118
'4715036000,  어모면,'20,15 - 19세,1998,486,239,247
'4715036000,  어모면,'25,20 - 24세,1998,554,315,239
'4715036000,  어모면,'30,25 - 29세,1998,449,248,201
'4715036000,  어모면,'35,30 - 34세,1998,339,188,151
'4715036000,  어모면,'40,35 - 39세,1998,399,234,165
'4715036000,  어모면,'45,40 - 44세,1998,340,177,163
'4715036000,  어모면,'50,45 - 49세,1998,356,177,179
'4715036000,  어모면,'55,50 - 54세,1998,362,176,186
'4715036000,  어모면,'60,55 - 59세,1998,454,203,251
'4715036000,  어모면,'65,60 - 64세,1998,467,200,267
'4715036000,  어모면,'70,65 - 69세,1998,346,145,201
'4715036000,  어모면,'75,70 - 74세,1998,288,116,172
'4715036000,  어모면,'80,75 - 79세,1998,184,74,110
'4715036000,  어모면,'85,80 - 84세,1998,110,31,79
'4715036000,  어모면,'90,85+ ,1998,64,15,49
'4715037000,  봉산면,'00,계,1998,4553,2264,2289
'4715037000,  봉산면,'05,0 - 4세,1998,184,104,80
'4715037000,  봉산면,'10,5 - 9세,1998,180,89,91
'4715037000,  봉산면,'15,10 - 14세,1998,281,143,138
'4715037000,  봉산면,'20,15 - 19세,1998,433,220,213
'4715037000,  봉산면,'25,20 - 24세,1998,469,256,213
'4715037000,  봉산면,'30,25 - 29세,1998,337,214,123
'4715037000,  봉산면,'35,30 - 34세,1998,258,154,104
'4715037000,  봉산면,'40,35 - 39세,1998,294,153,141
'4715037000,  봉산면,'45,40 - 44세,1998,308,155,153
'4715037000,  봉산면,'50,45 - 49세,1998,282,138,144
'4715037000,  봉산면,'55,50 - 54세,1998,255,125,130
'4715037000,  봉산면,'60,55 - 59세,1998,306,142,164
'4715037000,  봉산면,'65,60 - 64세,1998,291,121,170
'4715037000,  봉산면,'70,65 - 69세,1998,246,106,140
'4715037000,  봉산면,'75,70 - 74세,1998,168,71,97
'4715037000,  봉산면,'80,75 - 79세,1998,133,47,86
'4715037000,  봉산면,'85,80 - 84세,1998,76,18,58
'4715037000,  봉산면,'90,85+ ,1998,52,8,44
'4715038000,  대항면,'00,계,1998,5091,2531,2560
'4715038000,  대항면,'05,0 - 4세,1998,231,118,113
'4715038000,  대항면,'10,5 - 9세,1998,226,107,119
'4715038000,  대항면,'15,10 - 14세,1998,311,161,150
'4715038000,  대항면,'20,15 - 19세,1998,461,249,212
'4715038000,  대항면,'25,20 - 24세,1998,477,254,223
'4715038000,  대항면,'30,25 - 29세,1998,423,252,171
'4715038000,  대항면,'35,30 - 34세,1998,322,174,148
'4715038000,  대항면,'40,35 - 39세,1998,353,194,159
'4715038000,  대항면,'45,40 - 44세,1998,332,177,155
'4715038000,  대항면,'50,45 - 49세,1998,292,148,144
'4715038000,  대항면,'55,50 - 54세,1998,251,118,133
'4715038000,  대항면,'60,55 - 59세,1998,331,141,190
'4715038000,  대항면,'65,60 - 64세,1998,372,155,217
'4715038000,  대항면,'70,65 - 69세,1998,258,121,137
'4715038000,  대항면,'75,70 - 74세,1998,193,70,123
'4715038000,  대항면,'80,75 - 79세,1998,134,55,79
'4715038000,  대항면,'85,80 - 84세,1998,73,30,43
'4715038000,  대항면,'90,85+ ,1998,51,7,44
'4715039000,  감천면,'00,계,1998,2923,1498,1425
'4715039000,  감천면,'05,0 - 4세,1998,105,64,41
'4715039000,  감천면,'10,5 - 9세,1998,139,73,66
'4715039000,  감천면,'15,10 - 14세,1998,161,85,76
'4715039000,  감천면,'20,15 - 19세,1998,264,147,117
'4715039000,  감천면,'25,20 - 24세,1998,276,156,120
'4715039000,  감천면,'30,25 - 29세,1998,218,136,82
'4715039000,  감천면,'35,30 - 34세,1998,154,88,66
'4715039000,  감천면,'40,35 - 39세,1998,191,99,92
'4715039000,  감천면,'45,40 - 44세,1998,153,80,73
'4715039000,  감천면,'50,45 - 49세,1998,188,95,93
'4715039000,  감천면,'55,50 - 54세,1998,135,74,61
'4715039000,  감천면,'60,55 - 59세,1998,222,92,130
'4715039000,  감천면,'65,60 - 64세,1998,248,122,126
'4715039000,  감천면,'70,65 - 69세,1998,188,73,115
'4715039000,  감천면,'75,70 - 74세,1998,124,57,67
'4715039000,  감천면,'80,75 - 79세,1998,94,36,58
'4715039000,  감천면,'85,80 - 84세,1998,41,16,25
'4715039000,  감천면,'90,85+ ,1998,22,5,17
'4715040000,  조마면,'00,계,1998,3535,1755,1780
'4715040000,  조마면,'05,0 - 4세,1998,117,68,49
'4715040000,  조마면,'10,5 - 9세,1998,138,67,71
'4715040000,  조마면,'15,10 - 14세,1998,180,80,100
'4715040000,  조마면,'20,15 - 19세,1998,357,174,183
'4715040000,  조마면,'25,20 - 24세,1998,358,186,172
'4715040000,  조마면,'30,25 - 29세,1998,278,184,94
'4715040000,  조마면,'35,30 - 34세,1998,155,89,66
'4715040000,  조마면,'40,35 - 39세,1998,207,116,91
'4715040000,  조마면,'45,40 - 44세,1998,216,109,107
'4715040000,  조마면,'50,45 - 49세,1998,204,110,94
'4715040000,  조마면,'55,50 - 54세,1998,173,89,84
'4715040000,  조마면,'60,55 - 59세,1998,264,120,144
'4715040000,  조마면,'65,60 - 64세,1998,300,111,189
'4715040000,  조마면,'70,65 - 69세,1998,203,95,108
'4715040000,  조마면,'75,70 - 74세,1998,152,67,85
'4715040000,  조마면,'80,75 - 79세,1998,127,50,77
'4715040000,  조마면,'85,80 - 84세,1998,65,27,38
'4715040000,  조마면,'90,85+ ,1998,41,13,28
'4715041000,  구성면,'00,계,1998,4722,2307,2415
'4715041000,  구성면,'05,0 - 4세,1998,158,90,68
'4715041000,  구성면,'10,5 - 9세,1998,154,79,75
'4715041000,  구성면,'15,10 - 14세,1998,207,109,98
'4715041000,  구성면,'20,15 - 19세,1998,381,188,193
'4715041000,  구성면,'25,20 - 24세,1998,443,252,191
'4715041000,  구성면,'30,25 - 29세,1998,323,205,118
'4715041000,  구성면,'35,30 - 34세,1998,210,134,76
'4715041000,  구성면,'40,35 - 39세,1998,260,150,110
'4715041000,  구성면,'45,40 - 44세,1998,223,121,102
'4715041000,  구성면,'50,45 - 49세,1998,298,138,160
'4715041000,  구성면,'55,50 - 54세,1998,255,131,124
'4715041000,  구성면,'60,55 - 59세,1998,381,158,223
'4715041000,  구성면,'65,60 - 64세,1998,433,173,260
'4715041000,  구성면,'70,65 - 69세,1998,361,139,222
'4715041000,  구성면,'75,70 - 74세,1998,258,103,155
'4715041000,  구성면,'80,75 - 79세,1998,213,84,129
'4715041000,  구성면,'85,80 - 84세,1998,106,32,74
'4715041000,  구성면,'90,85+ ,1998,58,21,37
'4715042000,  지례면,'00,계,1998,2783,1391,1392
'4715042000,  지례면,'05,0 - 4세,1998,84,46,38
'4715042000,  지례면,'10,5 - 9세,1998,93,59,34
'4715042000,  지례면,'15,10 - 14세,1998,125,67,58
'4715042000,  지례면,'20,15 - 19세,1998,214,121,93
'4715042000,  지례면,'25,20 - 24세,1998,275,163,112
'4715042000,  지례면,'30,25 - 29세,1998,215,136,79
'4715042000,  지례면,'35,30 - 34세,1998,123,78,45
'4715042000,  지례면,'40,35 - 39세,1998,147,84,63
'4715042000,  지례면,'45,40 - 44세,1998,147,78,69
'4715042000,  지례면,'50,45 - 49세,1998,153,67,86
'4715042000,  지례면,'55,50 - 54세,1998,158,67,91
'4715042000,  지례면,'60,55 - 59세,1998,254,105,149
'4715042000,  지례면,'65,60 - 64세,1998,267,112,155
'4715042000,  지례면,'70,65 - 69세,1998,198,84,114
'4715042000,  지례면,'75,70 - 74세,1998,128,66,62
'4715042000,  지례면,'80,75 - 79세,1998,103,34,69
'4715042000,  지례면,'85,80 - 84세,1998,59,14,45
'4715042000,  지례면,'90,85+ ,1998,40,10,30
'4715043000,  부항면,'00,계,1998,2341,1159,1182
'4715043000,  부항면,'05,0 - 4세,1998,52,25,27
'4715043000,  부항면,'10,5 - 9세,1998,69,38,31
'4715043000,  부항면,'15,10 - 14세,1998,103,54,49
'4715043000,  부항면,'20,15 - 19세,1998,194,90,104
'4715043000,  부항면,'25,20 - 24세,1998,227,146,81
'4715043000,  부항면,'30,25 - 29세,1998,152,107,45
'4715043000,  부항면,'35,30 - 34세,1998,84,52,32
'4715043000,  부항면,'40,35 - 39세,1998,101,58,43
'4715043000,  부항면,'45,40 - 44세,1998,99,53,46
'4715043000,  부항면,'50,45 - 49세,1998,116,59,57
'4715043000,  부항면,'55,50 - 54세,1998,127,52,75
'4715043000,  부항면,'60,55 - 59세,1998,229,93,136
'4715043000,  부항면,'65,60 - 64세,1998,263,113,150
'4715043000,  부항면,'70,65 - 69세,1998,190,79,111
'4715043000,  부항면,'75,70 - 74세,1998,127,65,62
'4715043000,  부항면,'80,75 - 79세,1998,118,46,72
'4715043000,  부항면,'85,80 - 84세,1998,59,22,37
'4715043000,  부항면,'90,85+ ,1998,31,7,24
'4715044000,  대덕면,'00,계,1998,3371,1652,1719
'4715044000,  대덕면,'05,0 - 4세,1998,95,57,38
'4715044000,  대덕면,'10,5 - 9세,1998,149,73,76
'4715044000,  대덕면,'15,10 - 14세,1998,182,85,97
'4715044000,  대덕면,'20,15 - 19세,1998,288,142,146
'4715044000,  대덕면,'25,20 - 24세,1998,294,185,109
'4715044000,  대덕면,'30,25 - 29세,1998,207,142,65
'4715044000,  대덕면,'35,30 - 34세,1998,132,70,62
'4715044000,  대덕면,'40,35 - 39세,1998,205,99,106
'4715044000,  대덕면,'45,40 - 44세,1998,193,107,86
'4715044000,  대덕면,'50,45 - 49세,1998,172,81,91
'4715044000,  대덕면,'55,50 - 54세,1998,185,82,103
'4715044000,  대덕면,'60,55 - 59세,1998,307,138,169
'4715044000,  대덕면,'65,60 - 64세,1998,329,138,191
'4715044000,  대덕면,'70,65 - 69세,1998,253,105,148
'4715044000,  대덕면,'75,70 - 74세,1998,155,70,85
'4715044000,  대덕면,'80,75 - 79세,1998,138,56,82
'4715044000,  대덕면,'85,80 - 84세,1998,57,15,42
'4715044000,  대덕면,'90,85+ ,1998,30,7,23
'4715045000,  증산면,'00,계,1998,1683,808,875
'4715045000,  증산면,'05,0 - 4세,1998,42,21,21
'4715045000,  증산면,'10,5 - 9세,1998,42,21,21
'4715045000,  증산면,'15,10 - 14세,1998,61,30,31
'4715045000,  증산면,'20,15 - 19세,1998,122,64,58
'4715045000,  증산면,'25,20 - 24세,1998,182,115,67
'4715045000,  증산면,'30,25 - 29세,1998,137,75,62
'4715045000,  증산면,'35,30 - 34세,1998,104,52,52
'4715045000,  증산면,'40,35 - 39세,1998,103,49,54
'4715045000,  증산면,'45,40 - 44세,1998,81,41,40
'4715045000,  증산면,'50,45 - 49세,1998,92,44,48
'4715045000,  증산면,'55,50 - 54세,1998,83,35,48
'4715045000,  증산면,'60,55 - 59세,1998,138,52,86
'4715045000,  증산면,'65,60 - 64세,1998,167,62,105
'4715045000,  증산면,'70,65 - 69세,1998,126,56,70
'4715045000,  증산면,'75,70 - 74세,1998,98,50,48
'4715045000,  증산면,'80,75 - 79세,1998,57,22,35
'4715045000,  증산면,'85,80 - 84세,1998,26,11,15
'4715045000,  증산면,'90,85+ ,1998,22,8,14
'4715051500,  용암동,'00,계,1998,8804,4335,4469
'4715051500,  용암동,'05,0 - 4세,1998,504,262,242
'4715051500,  용암동,'10,5 - 9세,1998,572,313,259
'4715051500,  용암동,'15,10 - 14세,1998,612,331,281
'4715051500,  용암동,'20,15 - 19세,1998,938,465,473
'4715051500,  용암동,'25,20 - 24세,1998,880,487,393
'4715051500,  용암동,'30,25 - 29세,1998,747,390,357
'4715051500,  용암동,'35,30 - 34세,1998,585,277,308
'4715051500,  용암동,'40,35 - 39세,1998,726,347,379
'4715051500,  용암동,'45,40 - 44세,1998,745,345,400
'4715051500,  용암동,'50,45 - 49세,1998,624,295,329
'4715051500,  용암동,'55,50 - 54세,1998,468,242,226
'4715051500,  용암동,'60,55 - 59세,1998,441,196,245
'4715051500,  용암동,'65,60 - 64세,1998,360,162,198
'4715051500,  용암동,'70,65 - 69세,1998,251,102,149
'4715051500,  용암동,'75,70 - 74세,1998,155,57,98
'4715051500,  용암동,'80,75 - 79세,1998,104,39,65
'4715051500,  용암동,'85,80 - 84세,1998,54,15,39
'4715051500,  용암동,'90,85+ ,1998,38,10,28
'4715053000,  성내동,'00,계,1998,5319,2629,2690
'4715053000,  성내동,'05,0 - 4세,1998,234,137,97
'4715053000,  성내동,'10,5 - 9세,1998,322,179,143
'4715053000,  성내동,'15,10 - 14세,1998,398,204,194
'4715053000,  성내동,'20,15 - 19세,1998,612,308,304
'4715053000,  성내동,'25,20 - 24세,1998,547,300,247
'4715053000,  성내동,'30,25 - 29세,1998,387,203,184
'4715053000,  성내동,'35,30 - 34세,1998,296,157,139
'4715053000,  성내동,'40,35 - 39세,1998,434,188,246
'4715053000,  성내동,'45,40 - 44세,1998,484,231,253
'4715053000,  성내동,'50,45 - 49세,1998,394,196,198
'4715053000,  성내동,'55,50 - 54세,1998,286,147,139
'4715053000,  성내동,'60,55 - 59세,1998,288,127,161
'4715053000,  성내동,'65,60 - 64세,1998,212,99,113
'4715053000,  성내동,'70,65 - 69세,1998,150,55,95
'4715053000,  성내동,'75,70 - 74세,1998,124,46,78
'4715053000,  성내동,'80,75 - 79세,1998,78,32,46
'4715053000,  성내동,'85,80 - 84세,1998,43,14,29
'4715053000,  성내동,'90,85+ ,1998,30,6,24
'4715054000,  평화동,'00,계,1998,11092,5465,5627
'4715054000,  평화동,'05,0 - 4세,1998,663,359,304
'4715054000,  평화동,'10,5 - 9세,1998,758,433,325
'4715054000,  평화동,'15,10 - 14세,1998,745,396,349
'4715054000,  평화동,'20,15 - 19세,1998,1151,582,569
'4715054000,  평화동,'25,20 - 24세,1998,1037,550,487
'4715054000,  평화동,'30,25 - 29세,1998,955,473,482
'4715054000,  평화동,'35,30 - 34세,1998,799,421,378
'4715054000,  평화동,'40,35 - 39세,1998,928,426,502
'4715054000,  평화동,'45,40 - 44세,1998,885,396,489
'4715054000,  평화동,'50,45 - 49세,1998,753,374,379
'4715054000,  평화동,'55,50 - 54세,1998,547,257,290
'4715054000,  평화동,'60,55 - 59세,1998,602,269,333
'4715054000,  평화동,'65,60 - 64세,1998,486,233,253
'4715054000,  평화동,'70,65 - 69세,1998,290,123,167
'4715054000,  평화동,'75,70 - 74세,1998,236,92,144
'4715054000,  평화동,'80,75 - 79세,1998,129,51,78
'4715054000,  평화동,'85,80 - 84세,1998,77,23,54
'4715054000,  평화동,'90,85+ ,1998,51,7,44
'4715055000,  남산동,'00,계,1998,4903,2431,2472
'4715055000,  남산동,'05,0 - 4세,1998,252,132,120
'4715055000,  남산동,'10,5 - 9세,1998,302,176,126
'4715055000,  남산동,'15,10 - 14세,1998,371,206,165
'4715055000,  남산동,'20,15 - 19세,1998,508,252,256
'4715055000,  남산동,'25,20 - 24세,1998,494,260,234
'4715055000,  남산동,'30,25 - 29세,1998,432,239,193
'4715055000,  남산동,'35,30 - 34세,1998,291,148,143
'4715055000,  남산동,'40,35 - 39세,1998,408,178,230
'4715055000,  남산동,'45,40 - 44세,1998,388,197,191
'4715055000,  남산동,'50,45 - 49세,1998,301,138,163
'4715055000,  남산동,'55,50 - 54세,1998,260,129,131
'4715055000,  남산동,'60,55 - 59세,1998,301,127,174
'4715055000,  남산동,'65,60 - 64세,1998,232,108,124
'4715055000,  남산동,'70,65 - 69세,1998,127,57,70
'4715055000,  남산동,'75,70 - 74세,1998,110,44,66
'4715055000,  남산동,'80,75 - 79세,1998,71,25,46
'4715055000,  남산동,'85,80 - 84세,1998,34,12,22
'4715055000,  남산동,'90,85+ ,1998,21,3,18
'4715056500,  양금동,'00,계,1998,8458,4183,4275
'4715056500,  양금동,'05,0 - 4세,1998,409,226,183
'4715056500,  양금동,'10,5 - 9세,1998,571,333,238
'4715056500,  양금동,'15,10 - 14세,1998,603,322,281
'4715056500,  양금동,'20,15 - 19세,1998,820,419,401
'4715056500,  양금동,'25,20 - 24세,1998,811,412,399
'4715056500,  양금동,'30,25 - 29세,1998,714,407,307
'4715056500,  양금동,'35,30 - 34세,1998,538,287,251
'4715056500,  양금동,'40,35 - 39세,1998,676,320,356
'4715056500,  양금동,'45,40 - 44세,1998,649,304,345
'4715056500,  양금동,'50,45 - 49세,1998,527,241,286
'4715056500,  양금동,'55,50 - 54세,1998,443,211,232
'4715056500,  양금동,'60,55 - 59세,1998,512,222,290
'4715056500,  양금동,'65,60 - 64세,1998,408,193,215
'4715056500,  양금동,'70,65 - 69세,1998,299,112,187
'4715056500,  양금동,'75,70 - 74세,1998,213,96,117
'4715056500,  양금동,'80,75 - 79세,1998,143,43,100
'4715056500,  양금동,'85,80 - 84세,1998,77,23,54
'4715056500,  양금동,'90,85+ ,1998,45,12,33
'4715057500,  대신동,'00,계,1998,19047,9495,9552
'4715057500,  대신동,'05,0 - 4세,1998,1893,1030,863
'4715057500,  대신동,'10,5 - 9세,1998,1858,976,882
'4715057500,  대신동,'15,10 - 14세,1998,1319,703,616
'4715057500,  대신동,'20,15 - 19세,1998,1475,730,745
'4715057500,  대신동,'25,20 - 24세,1998,1289,675,614
'4715057500,  대신동,'30,25 - 29세,1998,1783,812,971
'4715057500,  대신동,'35,30 - 34세,1998,2167,1085,1082
'4715057500,  대신동,'40,35 - 39세,1998,1966,1057,909
'4715057500,  대신동,'45,40 - 44세,1998,1258,666,592
'4715057500,  대신동,'50,45 - 49세,1998,861,433,428
'4715057500,  대신동,'55,50 - 54세,1998,604,322,282
'4715057500,  대신동,'60,55 - 59세,1998,708,284,424
'4715057500,  대신동,'65,60 - 64세,1998,633,278,355
'4715057500,  대신동,'70,65 - 69세,1998,494,194,300
'4715057500,  대신동,'75,70 - 74세,1998,338,128,210
'4715057500,  대신동,'80,75 - 79세,1998,230,76,154
'4715057500,  대신동,'85,80 - 84세,1998,100,34,66
'4715057500,  대신동,'90,85+ ,1998,71,12,59
'4715059500,  대곡동,'00,계,1998,20509,10219,10290
'4715059500,  대곡동,'05,0 - 4세,1998,1629,886,743
'4715059500,  대곡동,'10,5 - 9세,1998,1556,840,716
'4715059500,  대곡동,'15,10 - 14세,1998,1496,839,657
'4715059500,  대곡동,'20,15 - 19세,1998,1922,1004,918
'4715059500,  대곡동,'25,20 - 24세,1998,1741,916,825
'4715059500,  대곡동,'30,25 - 29세,1998,2115,1000,1115
'4715059500,  대곡동,'35,30 - 34세,1998,1895,948,947
'4715059500,  대곡동,'40,35 - 39세,1998,1936,949,987
'4715059500,  대곡동,'45,40 - 44세,1998,1565,754,811
'4715059500,  대곡동,'50,45 - 49세,1998,1189,585,604
'4715059500,  대곡동,'55,50 - 54세,1998,869,425,444
'4715059500,  대곡동,'60,55 - 59세,1998,760,374,386
'4715059500,  대곡동,'65,60 - 64세,1998,638,280,358
'4715059500,  대곡동,'70,65 - 69세,1998,453,179,274
'4715059500,  대곡동,'75,70 - 74세,1998,334,121,213
'4715059500,  대곡동,'80,75 - 79세,1998,223,67,156
'4715059500,  대곡동,'85,80 - 84세,1998,107,38,69
'4715059500,  대곡동,'90,85+ ,1998,81,14,67
'4715061000,  지좌동,'00,계,1998,8345,4182,4163
'4715061000,  지좌동,'05,0 - 4세,1998,621,338,283
'4715061000,  지좌동,'10,5 - 9세,1998,724,381,343
'4715061000,  지좌동,'15,10 - 14세,1998,638,361,277
'4715061000,  지좌동,'20,15 - 19세,1998,785,423,362
'4715061000,  지좌동,'25,20 - 24세,1998,669,354,315
'4715061000,  지좌동,'30,25 - 29세,1998,676,318,358
'4715061000,  지좌동,'35,30 - 34세,1998,760,352,408
'4715061000,  지좌동,'40,35 - 39세,1998,858,463,395
'4715061000,  지좌동,'45,40 - 44세,1998,646,310,336
'4715061000,  지좌동,'50,45 - 49세,1998,450,242,208
'4715061000,  지좌동,'55,50 - 54세,1998,300,161,139
'4715061000,  지좌동,'60,55 - 59세,1998,324,137,187
'4715061000,  지좌동,'65,60 - 64세,1998,316,130,186
'4715061000,  지좌동,'70,65 - 69세,1998,222,87,135
'4715061000,  지좌동,'75,70 - 74세,1998,168,57,111
'4715061000,  지좌동,'80,75 - 79세,1998,106,41,65
'4715061000,  지좌동,'85,80 - 84세,1998,57,20,37
'4715061000,  지좌동,'90,85+ ,1998,25,7,18
'47170, 안동시,'00,계,1998,187515,93913,93602
'47170, 안동시,'05,0 - 4세,1998,10077,5453,4624
'47170, 안동시,'10,5 - 9세,1998,10637,6034,4603
'47170, 안동시,'15,10 - 14세,1998,12014,6515,5499
'47170, 안동시,'20,15 - 19세,1998,17931,9199,8732
'47170, 안동시,'25,20 - 24세,1998,18362,9964,8398
'47170, 안동시,'30,25 - 29세,1998,15028,8247,6781
'47170, 안동시,'35,30 - 34세,1998,12850,6606,6244
'47170, 안동시,'40,35 - 39세,1998,14582,7234,7348
'47170, 안동시,'45,40 - 44세,1998,13326,6651,6675
'47170, 안동시,'50,45 - 49세,1998,10973,5295,5678
'47170, 안동시,'55,50 - 54세,1998,9344,4585,4759
'47170, 안동시,'60,55 - 59세,1998,11603,5469,6134
'47170, 안동시,'65,60 - 64세,1998,9899,4552,5347
'47170, 안동시,'70,65 - 69세,1998,7381,3048,4333
'47170, 안동시,'75,70 - 74세,1998,5881,2348,3533
'47170, 안동시,'80,75 - 79세,1998,3948,1557,2391
'47170, 안동시,'85,80 - 84세,1998,2354,791,1563
'47170, 안동시,'90,85+ ,1998,1325,365,960
'4717025000,  풍산읍,'00,계,1998,10444,5182,5262
'4717025000,  풍산읍,'05,0 - 4세,1998,401,214,187
'4717025000,  풍산읍,'10,5 - 9세,1998,390,214,176
'4717025000,  풍산읍,'15,10 - 14세,1998,544,295,249
'4717025000,  풍산읍,'20,15 - 19세,1998,909,464,445
'4717025000,  풍산읍,'25,20 - 24세,1998,1070,598,472
'4717025000,  풍산읍,'30,25 - 29세,1998,744,456,288
'4717025000,  풍산읍,'35,30 - 34세,1998,510,277,233
'4717025000,  풍산읍,'40,35 - 39세,1998,603,317,286
'4717025000,  풍산읍,'45,40 - 44세,1998,622,310,312
'4717025000,  풍산읍,'50,45 - 49세,1998,607,302,305
'4717025000,  풍산읍,'55,50 - 54세,1998,603,291,312
'4717025000,  풍산읍,'60,55 - 59세,1998,841,376,465
'4717025000,  풍산읍,'65,60 - 64세,1998,826,382,444
'4717025000,  풍산읍,'70,65 - 69세,1998,646,264,382
'4717025000,  풍산읍,'75,70 - 74세,1998,438,189,249
'4717025000,  풍산읍,'80,75 - 79세,1998,364,145,219
'4717025000,  풍산읍,'85,80 - 84세,1998,205,61,144
'4717025000,  풍산읍,'90,85+ ,1998,121,27,94
'4717031000,  와룡면,'00,계,1998,5812,2984,2828
'4717031000,  와룡면,'05,0 - 4세,1998,175,83,92
'4717031000,  와룡면,'10,5 - 9세,1998,124,76,48
'4717031000,  와룡면,'15,10 - 14세,1998,216,111,105
'4717031000,  와룡면,'20,15 - 19세,1998,496,267,229
'4717031000,  와룡면,'25,20 - 24세,1998,599,364,235
'4717031000,  와룡면,'30,25 - 29세,1998,396,281,115
'4717031000,  와룡면,'35,30 - 34세,1998,221,143,78
'4717031000,  와룡면,'40,35 - 39세,1998,220,116,104
'4717031000,  와룡면,'45,40 - 44세,1998,322,168,154
'4717031000,  와룡면,'50,45 - 49세,1998,329,159,170
'4717031000,  와룡면,'55,50 - 54세,1998,360,167,193
'4717031000,  와룡면,'60,55 - 59세,1998,590,284,306
'4717031000,  와룡면,'65,60 - 64세,1998,542,262,280
'4717031000,  와룡면,'70,65 - 69세,1998,428,185,243
'4717031000,  와룡면,'75,70 - 74세,1998,348,157,191
'4717031000,  와룡면,'80,75 - 79세,1998,225,84,141
'4717031000,  와룡면,'85,80 - 84세,1998,131,54,77
'4717031000,  와룡면,'90,85+ ,1998,90,23,67
'4717032000,  북후면,'00,계,1998,5000,2529,2471
'4717032000,  북후면,'05,0 - 4세,1998,127,65,62
'4717032000,  북후면,'10,5 - 9세,1998,142,85,57
'4717032000,  북후면,'15,10 - 14세,1998,205,93,112
'4717032000,  북후면,'20,15 - 19세,1998,421,221,200
'4717032000,  북후면,'25,20 - 24세,1998,587,358,229
'4717032000,  북후면,'30,25 - 29세,1998,392,253,139
'4717032000,  북후면,'35,30 - 34세,1998,217,142,75
'4717032000,  북후면,'40,35 - 39세,1998,239,125,114
'4717032000,  북후면,'45,40 - 44세,1998,261,135,126
'4717032000,  북후면,'50,45 - 49세,1998,268,113,155
'4717032000,  북후면,'55,50 - 54세,1998,284,147,137
'4717032000,  북후면,'60,55 - 59세,1998,458,215,243
'4717032000,  북후면,'65,60 - 64세,1998,421,190,231
'4717032000,  북후면,'70,65 - 69세,1998,303,132,171
'4717032000,  북후면,'75,70 - 74세,1998,292,106,186
'4717032000,  북후면,'80,75 - 79세,1998,202,90,112
'4717032000,  북후면,'85,80 - 84세,1998,110,39,71
'4717032000,  북후면,'90,85+ ,1998,71,20,51
'4717033000,  서후면,'00,계,1998,4626,2365,2261
'4717033000,  서후면,'05,0 - 4세,1998,116,71,45
'4717033000,  서후면,'10,5 - 9세,1998,130,79,51
'4717033000,  서후면,'15,10 - 14세,1998,235,129,106
'4717033000,  서후면,'20,15 - 19세,1998,406,209,197
'4717033000,  서후면,'25,20 - 24세,1998,505,292,213
'4717033000,  서후면,'30,25 - 29세,1998,304,206,98
'4717033000,  서후면,'35,30 - 34세,1998,193,113,80
'4717033000,  서후면,'40,35 - 39세,1998,252,140,112
'4717033000,  서후면,'45,40 - 44세,1998,279,147,132
'4717033000,  서후면,'50,45 - 49세,1998,265,125,140
'4717033000,  서후면,'55,50 - 54세,1998,246,115,131
'4717033000,  서후면,'60,55 - 59세,1998,362,182,180
'4717033000,  서후면,'65,60 - 64세,1998,403,194,209
'4717033000,  서후면,'70,65 - 69세,1998,317,120,197
'4717033000,  서후면,'75,70 - 74세,1998,259,112,147
'4717033000,  서후면,'80,75 - 79세,1998,181,78,103
'4717033000,  서후면,'85,80 - 84세,1998,106,35,71
'4717033000,  서후면,'90,85+ ,1998,67,18,49
'4717034000,  풍천면,'00,계,1998,6539,3239,3300
'4717034000,  풍천면,'05,0 - 4세,1998,194,108,86
'4717034000,  풍천면,'10,5 - 9세,1998,211,120,91
'4717034000,  풍천면,'15,10 - 14세,1998,339,167,172
'4717034000,  풍천면,'20,15 - 19세,1998,584,293,291
'4717034000,  풍천면,'25,20 - 24세,1998,653,368,285
'4717034000,  풍천면,'30,25 - 29세,1998,400,252,148
'4717034000,  풍천면,'35,30 - 34세,1998,276,169,107
'4717034000,  풍천면,'40,35 - 39세,1998,312,157,155
'4717034000,  풍천면,'45,40 - 44세,1998,398,201,197
'4717034000,  풍천면,'50,45 - 49세,1998,389,183,206
'4717034000,  풍천면,'55,50 - 54세,1998,407,209,198
'4717034000,  풍천면,'60,55 - 59세,1998,575,255,320
'4717034000,  풍천면,'65,60 - 64세,1998,585,279,306
'4717034000,  풍천면,'70,65 - 69세,1998,383,155,228
'4717034000,  풍천면,'75,70 - 74세,1998,336,147,189
'4717034000,  풍천면,'80,75 - 79세,1998,251,104,147
'4717034000,  풍천면,'85,80 - 84세,1998,160,53,107
'4717034000,  풍천면,'90,85+ ,1998,86,19,67
'4717035000,  일직면,'00,계,1998,4890,2416,2474
'4717035000,  일직면,'05,0 - 4세,1998,159,85,74
'4717035000,  일직면,'10,5 - 9세,1998,156,84,72
'4717035000,  일직면,'15,10 - 14세,1998,193,92,101
'4717035000,  일직면,'20,15 - 19세,1998,376,202,174
'4717035000,  일직면,'25,20 - 24세,1998,543,313,230
'4717035000,  일직면,'30,25 - 29세,1998,350,229,121
'4717035000,  일직면,'35,30 - 34세,1998,216,135,81
'4717035000,  일직면,'40,35 - 39세,1998,231,127,104
'4717035000,  일직면,'45,40 - 44세,1998,226,103,123
'4717035000,  일직면,'50,45 - 49세,1998,311,133,178
'4717035000,  일직면,'55,50 - 54세,1998,309,148,161
'4717035000,  일직면,'60,55 - 59세,1998,438,197,241
'4717035000,  일직면,'65,60 - 64세,1998,462,216,246
'4717035000,  일직면,'70,65 - 69세,1998,340,138,202
'4717035000,  일직면,'75,70 - 74세,1998,292,118,174
'4717035000,  일직면,'80,75 - 79세,1998,144,50,94
'4717035000,  일직면,'85,80 - 84세,1998,95,29,66
'4717035000,  일직면,'90,85+ ,1998,49,17,32
'4717036000,  남후면,'00,계,1998,3010,1492,1518
'4717036000,  남후면,'05,0 - 4세,1998,75,38,37
'4717036000,  남후면,'10,5 - 9세,1998,82,46,36
'4717036000,  남후면,'15,10 - 14세,1998,129,62,67
'4717036000,  남후면,'20,15 - 19세,1998,282,140,142
'4717036000,  남후면,'25,20 - 24세,1998,329,196,133
'4717036000,  남후면,'30,25 - 29세,1998,215,138,77
'4717036000,  남후면,'35,30 - 34세,1998,87,63,24
'4717036000,  남후면,'40,35 - 39세,1998,143,76,67
'4717036000,  남후면,'45,40 - 44세,1998,162,78,84
'4717036000,  남후면,'50,45 - 49세,1998,164,75,89
'4717036000,  남후면,'55,50 - 54세,1998,189,89,100
'4717036000,  남후면,'60,55 - 59세,1998,285,131,154
'4717036000,  남후면,'65,60 - 64세,1998,285,125,160
'4717036000,  남후면,'70,65 - 69세,1998,198,84,114
'4717036000,  남후면,'75,70 - 74세,1998,170,64,106
'4717036000,  남후면,'80,75 - 79세,1998,107,50,57
'4717036000,  남후면,'85,80 - 84세,1998,79,31,48
'4717036000,  남후면,'90,85+ ,1998,29,6,23
'4717037000,  남선면,'00,계,1998,3447,1747,1700
'4717037000,  남선면,'05,0 - 4세,1998,216,106,110
'4717037000,  남선면,'10,5 - 9세,1998,94,53,41
'4717037000,  남선면,'15,10 - 14세,1998,121,68,53
'4717037000,  남선면,'20,15 - 19세,1998,300,159,141
'4717037000,  남선면,'25,20 - 24세,1998,329,176,153
'4717037000,  남선면,'30,25 - 29세,1998,351,200,151
'4717037000,  남선면,'35,30 - 34세,1998,256,164,92
'4717037000,  남선면,'40,35 - 39세,1998,191,93,98
'4717037000,  남선면,'45,40 - 44세,1998,183,97,86
'4717037000,  남선면,'50,45 - 49세,1998,154,77,77
'4717037000,  남선면,'55,50 - 54세,1998,178,79,99
'4717037000,  남선면,'60,55 - 59세,1998,256,123,133
'4717037000,  남선면,'65,60 - 64세,1998,246,105,141
'4717037000,  남선면,'70,65 - 69세,1998,204,86,118
'4717037000,  남선면,'75,70 - 74세,1998,153,72,81
'4717037000,  남선면,'80,75 - 79세,1998,117,50,67
'4717037000,  남선면,'85,80 - 84세,1998,66,25,41
'4717037000,  남선면,'90,85+ ,1998,32,14,18
'4717038000,  임하면,'00,계,1998,4487,2316,2171
'4717038000,  임하면,'05,0 - 4세,1998,111,58,53
'4717038000,  임하면,'10,5 - 9세,1998,113,57,56
'4717038000,  임하면,'15,10 - 14세,1998,189,109,80
'4717038000,  임하면,'20,15 - 19세,1998,392,185,207
'4717038000,  임하면,'25,20 - 24세,1998,479,280,199
'4717038000,  임하면,'30,25 - 29세,1998,341,212,129
'4717038000,  임하면,'35,30 - 34세,1998,223,149,74
'4717038000,  임하면,'40,35 - 39세,1998,271,152,119
'4717038000,  임하면,'45,40 - 44세,1998,328,174,154
'4717038000,  임하면,'50,45 - 49세,1998,291,162,129
'4717038000,  임하면,'55,50 - 54세,1998,243,120,123
'4717038000,  임하면,'60,55 - 59세,1998,364,173,191
'4717038000,  임하면,'65,60 - 64세,1998,355,157,198
'4717038000,  임하면,'70,65 - 69세,1998,302,133,169
'4717038000,  임하면,'75,70 - 74세,1998,216,81,135
'4717038000,  임하면,'80,75 - 79세,1998,161,77,84
'4717038000,  임하면,'85,80 - 84세,1998,75,26,49
'4717038000,  임하면,'90,85+ ,1998,33,11,22
'4717039000,  길안면,'00,계,1998,4783,2477,2306
'4717039000,  길안면,'05,0 - 4세,1998,147,87,60
'4717039000,  길안면,'10,5 - 9세,1998,172,98,74
'4717039000,  길안면,'15,10 - 14세,1998,200,108,92
'4717039000,  길안면,'20,15 - 19세,1998,433,226,207
'4717039000,  길안면,'25,20 - 24세,1998,499,290,209
'4717039000,  길안면,'30,25 - 29세,1998,311,211,100
'4717039000,  길안면,'35,30 - 34세,1998,231,134,97
'4717039000,  길안면,'40,35 - 39세,1998,240,134,106
'4717039000,  길안면,'45,40 - 44세,1998,283,145,138
'4717039000,  길안면,'50,45 - 49세,1998,281,157,124
'4717039000,  길안면,'55,50 - 54세,1998,283,117,166
'4717039000,  길안면,'60,55 - 59세,1998,467,200,267
'4717039000,  길안면,'65,60 - 64세,1998,425,196,229
'4717039000,  길안면,'70,65 - 69세,1998,324,160,164
'4717039000,  길안면,'75,70 - 74세,1998,214,96,118
'4717039000,  길안면,'80,75 - 79세,1998,155,75,80
'4717039000,  길안면,'85,80 - 84세,1998,76,31,45
'4717039000,  길안면,'90,85+ ,1998,42,12,30
'4717040000,  임동면,'00,계,1998,3145,1628,1517
'4717040000,  임동면,'05,0 - 4세,1998,97,43,54
'4717040000,  임동면,'10,5 - 9세,1998,91,61,30
'4717040000,  임동면,'15,10 - 14세,1998,121,70,51
'4717040000,  임동면,'20,15 - 19세,1998,250,128,122
'4717040000,  임동면,'25,20 - 24세,1998,355,183,172
'4717040000,  임동면,'30,25 - 29세,1998,218,154,64
'4717040000,  임동면,'35,30 - 34세,1998,143,90,53
'4717040000,  임동면,'40,35 - 39세,1998,172,91,81
'4717040000,  임동면,'45,40 - 44세,1998,172,95,77
'4717040000,  임동면,'50,45 - 49세,1998,162,82,80
'4717040000,  임동면,'55,50 - 54세,1998,209,98,111
'4717040000,  임동면,'60,55 - 59세,1998,314,144,170
'4717040000,  임동면,'65,60 - 64세,1998,308,143,165
'4717040000,  임동면,'70,65 - 69세,1998,213,100,113
'4717040000,  임동면,'75,70 - 74세,1998,144,75,69
'4717040000,  임동면,'80,75 - 79세,1998,98,43,55
'4717040000,  임동면,'85,80 - 84세,1998,54,21,33
'4717040000,  임동면,'90,85+ ,1998,24,7,17
'4717041000,  예안면,'00,계,1998,3102,1597,1505
'4717041000,  예안면,'05,0 - 4세,1998,67,38,29
'4717041000,  예안면,'10,5 - 9세,1998,106,56,50
'4717041000,  예안면,'15,10 - 14세,1998,137,63,74
'4717041000,  예안면,'20,15 - 19세,1998,277,129,148
'4717041000,  예안면,'25,20 - 24세,1998,343,212,131
'4717041000,  예안면,'30,25 - 29세,1998,184,126,58
'4717041000,  예안면,'35,30 - 34세,1998,126,63,63
'4717041000,  예안면,'40,35 - 39세,1998,163,104,59
'4717041000,  예안면,'45,40 - 44세,1998,166,91,75
'4717041000,  예안면,'50,45 - 49세,1998,174,87,87
'4717041000,  예안면,'55,50 - 54세,1998,188,84,104
'4717041000,  예안면,'60,55 - 59세,1998,340,162,178
'4717041000,  예안면,'65,60 - 64세,1998,294,150,144
'4717041000,  예안면,'70,65 - 69세,1998,192,91,101
'4717041000,  예안면,'75,70 - 74세,1998,157,69,88
'4717041000,  예안면,'80,75 - 79세,1998,92,38,54
'4717041000,  예안면,'85,80 - 84세,1998,61,23,38
'4717041000,  예안면,'90,85+ ,1998,35,11,24
'4717042000,  도산면,'00,계,1998,3023,1578,1445
'4717042000,  도산면,'05,0 - 4세,1998,87,54,33
'4717042000,  도산면,'10,5 - 9세,1998,97,59,38
'4717042000,  도산면,'15,10 - 14세,1998,151,86,65
'4717042000,  도산면,'20,15 - 19세,1998,277,132,145
'4717042000,  도산면,'25,20 - 24세,1998,347,210,137
'4717042000,  도산면,'30,25 - 29세,1998,176,120,56
'4717042000,  도산면,'35,30 - 34세,1998,128,77,51
'4717042000,  도산면,'40,35 - 39세,1998,159,91,68
'4717042000,  도산면,'45,40 - 44세,1998,173,81,92
'4717042000,  도산면,'50,45 - 49세,1998,174,82,92
'4717042000,  도산면,'55,50 - 54세,1998,186,102,84
'4717042000,  도산면,'60,55 - 59세,1998,281,125,156
'4717042000,  도산면,'65,60 - 64세,1998,261,134,127
'4717042000,  도산면,'70,65 - 69세,1998,169,71,98
'4717042000,  도산면,'75,70 - 74세,1998,155,65,90
'4717042000,  도산면,'80,75 - 79세,1998,108,51,57
'4717042000,  도산면,'85,80 - 84세,1998,64,28,36
'4717042000,  도산면,'90,85+ ,1998,30,10,20
'4717043000,  녹전면,'00,계,1998,2995,1541,1454
'4717043000,  녹전면,'05,0 - 4세,1998,63,29,34
'4717043000,  녹전면,'10,5 - 9세,1998,77,46,31
'4717043000,  녹전면,'15,10 - 14세,1998,141,71,70
'4717043000,  녹전면,'20,15 - 19세,1998,290,149,141
'4717043000,  녹전면,'25,20 - 24세,1998,343,198,145
'4717043000,  녹전면,'30,25 - 29세,1998,171,122,49
'4717043000,  녹전면,'35,30 - 34세,1998,100,63,37
'4717043000,  녹전면,'40,35 - 39세,1998,173,95,78
'4717043000,  녹전면,'45,40 - 44세,1998,189,96,93
'4717043000,  녹전면,'50,45 - 49세,1998,195,98,97
'4717043000,  녹전면,'55,50 - 54세,1998,194,101,93
'4717043000,  녹전면,'60,55 - 59세,1998,264,123,141
'4717043000,  녹전면,'65,60 - 64세,1998,268,122,146
'4717043000,  녹전면,'70,65 - 69세,1998,191,91,100
'4717043000,  녹전면,'75,70 - 74세,1998,157,64,93
'4717043000,  녹전면,'80,75 - 79세,1998,94,40,54
'4717043000,  녹전면,'85,80 - 84세,1998,58,26,32
'4717043000,  녹전면,'90,85+ ,1998,27,7,20
'4717051000,  중구동,'00,계,1998,9582,4697,4885
'4717051000,  중구동,'05,0 - 4세,1998,380,213,167
'4717051000,  중구동,'10,5 - 9세,1998,514,316,198
'4717051000,  중구동,'15,10 - 14세,1998,644,353,291
'4717051000,  중구동,'20,15 - 19세,1998,984,505,479
'4717051000,  중구동,'25,20 - 24세,1998,946,466,480
'4717051000,  중구동,'30,25 - 29세,1998,782,443,339
'4717051000,  중구동,'35,30 - 34세,1998,545,267,278
'4717051000,  중구동,'40,35 - 39세,1998,778,347,431
'4717051000,  중구동,'45,40 - 44세,1998,756,364,392
'4717051000,  중구동,'50,45 - 49세,1998,672,305,367
'4717051000,  중구동,'55,50 - 54세,1998,565,270,295
'4717051000,  중구동,'60,55 - 59세,1998,643,303,340
'4717051000,  중구동,'65,60 - 64세,1998,421,203,218
'4717051000,  중구동,'70,65 - 69세,1998,323,129,194
'4717051000,  중구동,'75,70 - 74세,1998,293,100,193
'4717051000,  중구동,'80,75 - 79세,1998,183,63,120
'4717051000,  중구동,'85,80 - 84세,1998,107,38,69
'4717051000,  중구동,'90,85+ ,1998,46,12,34
'4717052000,  명륜동,'00,계,1998,8333,4135,4198
'4717052000,  명륜동,'05,0 - 4세,1998,580,317,263
'4717052000,  명륜동,'10,5 - 9세,1998,595,321,274
'4717052000,  명륜동,'15,10 - 14세,1998,646,361,285
'4717052000,  명륜동,'20,15 - 19세,1998,876,423,453
'4717052000,  명륜동,'25,20 - 24세,1998,709,360,349
'4717052000,  명륜동,'30,25 - 29세,1998,658,314,344
'4717052000,  명륜동,'35,30 - 34세,1998,709,351,358
'4717052000,  명륜동,'40,35 - 39세,1998,834,420,414
'4717052000,  명륜동,'45,40 - 44세,1998,644,317,327
'4717052000,  명륜동,'50,45 - 49세,1998,445,238,207
'4717052000,  명륜동,'55,50 - 54세,1998,364,181,183
'4717052000,  명륜동,'60,55 - 59세,1998,427,209,218
'4717052000,  명륜동,'65,60 - 64세,1998,298,131,167
'4717052000,  명륜동,'70,65 - 69세,1998,202,80,122
'4717052000,  명륜동,'75,70 - 74세,1998,160,56,104
'4717052000,  명륜동,'80,75 - 79세,1998,90,27,63
'4717052000,  명륜동,'85,80 - 84세,1998,57,15,42
'4717052000,  명륜동,'90,85+ ,1998,39,14,25
'4717055500,  용상동,'00,계,1998,26368,13216,13152
'4717055500,  용상동,'05,0 - 4세,1998,2096,1115,981
'4717055500,  용상동,'10,5 - 9세,1998,2124,1197,927
'4717055500,  용상동,'15,10 - 14세,1998,1942,1073,869
'4717055500,  용상동,'20,15 - 19세,1998,2411,1260,1151
'4717055500,  용상동,'25,20 - 24세,1998,2286,1168,1118
'4717055500,  용상동,'30,25 - 29세,1998,2514,1216,1298
'4717055500,  용상동,'35,30 - 34세,1998,2523,1253,1270
'4717055500,  용상동,'40,35 - 39세,1998,2542,1268,1274
'4717055500,  용상동,'45,40 - 44세,1998,1951,992,959
'4717055500,  용상동,'50,45 - 49세,1998,1404,699,705
'4717055500,  용상동,'55,50 - 54세,1998,974,497,477
'4717055500,  용상동,'60,55 - 59세,1998,1041,494,547
'4717055500,  용상동,'65,60 - 64세,1998,802,349,453
'4717055500,  용상동,'70,65 - 69세,1998,657,242,415
'4717055500,  용상동,'75,70 - 74세,1998,482,182,300
'4717055500,  용상동,'80,75 - 79세,1998,307,120,187
'4717055500,  용상동,'85,80 - 84세,1998,196,58,138
'4717055500,  용상동,'90,85+ ,1998,116,33,83
'4717058500,  서구동,'00,계,1998,10213,5023,5190
'4717058500,  서구동,'05,0 - 4세,1998,449,239,210
'4717058500,  서구동,'10,5 - 9세,1998,474,267,207
'4717058500,  서구동,'15,10 - 14세,1998,644,331,313
'4717058500,  서구동,'20,15 - 19세,1998,1095,552,543
'4717058500,  서구동,'25,20 - 24세,1998,1137,627,510
'4717058500,  서구동,'30,25 - 29세,1998,837,489,348
'4717058500,  서구동,'35,30 - 34세,1998,616,308,308
'4717058500,  서구동,'40,35 - 39세,1998,738,366,372
'4717058500,  서구동,'45,40 - 44세,1998,763,349,414
'4717058500,  서구동,'50,45 - 49세,1998,696,308,388
'4717058500,  서구동,'55,50 - 54세,1998,604,294,310
'4717058500,  서구동,'60,55 - 59세,1998,648,311,337
'4717058500,  서구동,'65,60 - 64세,1998,522,230,292
'4717058500,  서구동,'70,65 - 69세,1998,372,129,243
'4717058500,  서구동,'75,70 - 74세,1998,299,119,180
'4717058500,  서구동,'80,75 - 79세,1998,171,65,106
'4717058500,  서구동,'85,80 - 84세,1998,86,20,66
'4717058500,  서구동,'90,85+ ,1998,62,19,43
'4717060000,  태화동,'00,계,1998,19595,9792,9803
'4717060000,  태화동,'05,0 - 4세,1998,1204,654,550
'4717060000,  태화동,'10,5 - 9세,1998,1170,655,515
'4717060000,  태화동,'15,10 - 14세,1998,1372,775,597
'4717060000,  태화동,'20,15 - 19세,1998,2062,1088,974
'4717060000,  태화동,'25,20 - 24세,1998,2183,1133,1050
'4717060000,  태화동,'30,25 - 29세,1998,1849,968,881
'4717060000,  태화동,'35,30 - 34세,1998,1399,701,698
'4717060000,  태화동,'40,35 - 39세,1998,1595,748,847
'4717060000,  태화동,'45,40 - 44세,1998,1507,701,806
'4717060000,  태화동,'50,45 - 49세,1998,1314,615,699
'4717060000,  태화동,'55,50 - 54세,1998,994,482,512
'4717060000,  태화동,'60,55 - 59세,1998,1021,515,506
'4717060000,  태화동,'65,60 - 64세,1998,651,319,332
'4717060000,  태화동,'70,65 - 69세,1998,455,180,275
'4717060000,  태화동,'75,70 - 74세,1998,336,121,215
'4717060000,  태화동,'80,75 - 79세,1998,233,78,155
'4717060000,  태화동,'85,80 - 84세,1998,171,40,131
'4717060000,  태화동,'90,85+ ,1998,79,19,60
'4717061000,  법상동,'00,계,1998,5895,2962,2933
'4717061000,  법상동,'05,0 - 4세,1998,308,176,132
'4717061000,  법상동,'10,5 - 9세,1998,341,210,131
'4717061000,  법상동,'15,10 - 14세,1998,402,234,168
'4717061000,  법상동,'20,15 - 19세,1998,654,338,316
'4717061000,  법상동,'25,20 - 24세,1998,605,321,284
'4717061000,  법상동,'30,25 - 29세,1998,479,248,231
'4717061000,  법상동,'35,30 - 34세,1998,393,193,200
'4717061000,  법상동,'40,35 - 39세,1998,396,184,212
'4717061000,  법상동,'45,40 - 44세,1998,501,238,263
'4717061000,  법상동,'50,45 - 49세,1998,396,189,207
'4717061000,  법상동,'55,50 - 54세,1998,332,168,164
'4717061000,  법상동,'60,55 - 59세,1998,332,153,179
'4717061000,  법상동,'65,60 - 64세,1998,243,115,128
'4717061000,  법상동,'70,65 - 69세,1998,189,82,107
'4717061000,  법상동,'75,70 - 74세,1998,145,57,88
'4717061000,  법상동,'80,75 - 79세,1998,78,23,55
'4717061000,  법상동,'85,80 - 84세,1998,69,24,45
'4717061000,  법상동,'90,85+ ,1998,32,9,23
'4717062000,  평화동,'00,계,1998,10171,5089,5082
'4717062000,  평화동,'05,0 - 4세,1998,547,308,239
'4717062000,  평화동,'10,5 - 9세,1998,676,407,269
'4717062000,  평화동,'15,10 - 14세,1998,815,459,356
'4717062000,  평화동,'20,15 - 19세,1998,1082,547,535
'4717062000,  평화동,'25,20 - 24세,1998,1008,529,479
'4717062000,  평화동,'30,25 - 29세,1998,785,408,377
'4717062000,  평화동,'35,30 - 34세,1998,697,332,365
'4717062000,  평화동,'40,35 - 39세,1998,928,419,509
'4717062000,  평화동,'45,40 - 44세,1998,820,406,414
'4717062000,  평화동,'50,45 - 49세,1998,681,317,364
'4717062000,  평화동,'55,50 - 54세,1998,513,261,252
'4717062000,  평화동,'60,55 - 59세,1998,479,241,238
'4717062000,  평화동,'65,60 - 64세,1998,367,172,195
'4717062000,  평화동,'70,65 - 69세,1998,259,118,141
'4717062000,  평화동,'75,70 - 74세,1998,208,68,140
'4717062000,  평화동,'80,75 - 79세,1998,163,53,110
'4717062000,  평화동,'85,80 - 84세,1998,83,28,55
'4717062000,  평화동,'90,85+ ,1998,60,16,44
'4717063000,  안기동,'00,계,1998,10470,5226,5244
'4717063000,  안기동,'05,0 - 4세,1998,790,427,363
'4717063000,  안기동,'10,5 - 9세,1998,881,499,382
'4717063000,  안기동,'15,10 - 14세,1998,826,452,374
'4717063000,  안기동,'20,15 - 19세,1998,1095,547,548
'4717063000,  안기동,'25,20 - 24세,1998,835,427,408
'4717063000,  안기동,'30,25 - 29세,1998,863,403,460
'4717063000,  안기동,'35,30 - 34세,1998,972,447,525
'4717063000,  안기동,'40,35 - 39세,1998,1064,522,542
'4717063000,  안기동,'45,40 - 44세,1998,891,455,436
'4717063000,  안기동,'50,45 - 49세,1998,598,302,296
'4717063000,  안기동,'55,50 - 54세,1998,385,204,181
'4717063000,  안기동,'60,55 - 59세,1998,391,198,193
'4717063000,  안기동,'65,60 - 64세,1998,275,123,152
'4717063000,  안기동,'70,65 - 69세,1998,182,85,97
'4717063000,  안기동,'75,70 - 74세,1998,193,65,128
'4717063000,  안기동,'80,75 - 79세,1998,106,33,73
'4717063000,  안기동,'85,80 - 84세,1998,81,25,56
'4717063000,  안기동,'90,85+ ,1998,42,12,30
'4717065000,  옥동,'00,계,1998,11051,5395,5656
'4717065000,  옥동,'05,0 - 4세,1998,904,495,409
'4717065000,  옥동,'10,5 - 9세,1998,965,552,413
'4717065000,  옥동,'15,10 - 14세,1998,853,427,426
'4717065000,  옥동,'20,15 - 19세,1998,1023,527,496
'4717065000,  옥동,'25,20 - 24세,1998,851,465,386
'4717065000,  옥동,'30,25 - 29세,1998,838,384,454
'4717065000,  옥동,'35,30 - 34세,1998,1139,538,601
'4717065000,  옥동,'40,35 - 39세,1998,1133,578,555
'4717065000,  옥동,'45,40 - 44세,1998,806,419,387
'4717065000,  옥동,'50,45 - 49세,1998,486,218,268
'4717065000,  옥동,'55,50 - 54세,1998,350,155,195
'4717065000,  옥동,'60,55 - 59세,1998,414,168,246
'4717065000,  옥동,'65,60 - 64세,1998,342,120,222
'4717065000,  옥동,'70,65 - 69세,1998,326,115,211
'4717065000,  옥동,'75,70 - 74세,1998,253,100,153
'4717065000,  옥동,'80,75 - 79세,1998,202,83,119
'4717065000,  옥동,'85,80 - 84세,1998,101,35,66
'4717065000,  옥동,'90,85+ ,1998,65,16,49
'4717066000,  송하동,'00,계,1998,10534,5287,5247
'4717066000,  송하동,'05,0 - 4세,1998,784,430,354
'4717066000,  송하동,'10,5 - 9세,1998,912,476,436
'4717066000,  송하동,'15,10 - 14세,1998,949,526,423
'4717066000,  송하동,'20,15 - 19세,1998,956,508,448
'4717066000,  송하동,'25,20 - 24세,1998,821,430,391
'4717066000,  송하동,'30,25 - 29세,1998,870,414,456
'4717066000,  송하동,'35,30 - 34세,1998,930,434,496
'4717066000,  송하동,'40,35 - 39세,1998,1205,564,641
'4717066000,  송하동,'45,40 - 44세,1998,923,489,434
'4717066000,  송하동,'50,45 - 49세,1998,517,269,248
'4717066000,  송하동,'55,50 - 54세,1998,384,206,178
'4717066000,  송하동,'60,55 - 59세,1998,372,187,185
'4717066000,  송하동,'65,60 - 64세,1998,297,135,162
'4717066000,  송하동,'70,65 - 69세,1998,206,78,128
'4717066000,  송하동,'75,70 - 74세,1998,181,65,116
'4717066000,  송하동,'80,75 - 79세,1998,116,37,79
'4717066000,  송하동,'85,80 - 84세,1998,63,26,37
'4717066000,  송하동,'90,85+ ,1998,48,13,35
'47190, 구미시,'00,계,1998,328659,166430,162229
'47190, 구미시,'05,0 - 4세,1998,33095,17936,15159
'47190, 구미시,'10,5 - 9세,1998,31296,17118,14178
'47190, 구미시,'15,10 - 14세,1998,24045,12893,11152
'47190, 구미시,'20,15 - 19세,1998,24921,12079,12842
'47190, 구미시,'25,20 - 24세,1998,27547,11309,16238
'47190, 구미시,'30,25 - 29세,1998,38627,19346,19281
'47190, 구미시,'35,30 - 34세,1998,39218,20034,19184
'47190, 구미시,'40,35 - 39세,1998,35561,19549,16012
'47190, 구미시,'45,40 - 44세,1998,21644,12124,9520
'47190, 구미시,'50,45 - 49세,1998,12887,6973,5914
'47190, 구미시,'55,50 - 54세,1998,8424,4364,4060
'47190, 구미시,'60,55 - 59세,1998,8920,4067,4853
'47190, 구미시,'65,60 - 64세,1998,7655,3340,4315
'47190, 구미시,'70,65 - 69세,1998,5488,2167,3321
'47190, 구미시,'75,70 - 74세,1998,4063,1487,2576
'47190, 구미시,'80,75 - 79세,1998,2823,974,1849
'47190, 구미시,'85,80 - 84세,1998,1527,463,1064
'47190, 구미시,'90,85+ ,1998,918,207,711
'4719025000,  선산읍,'00,계,1998,20522,10211,10311
'4719025000,  선산읍,'05,0 - 4세,1998,1531,835,696
'4719025000,  선산읍,'10,5 - 9세,1998,1649,861,788
'4719025000,  선산읍,'15,10 - 14세,1998,1470,781,689
'4719025000,  선산읍,'20,15 - 19세,1998,1677,862,815
'4719025000,  선산읍,'25,20 - 24세,1998,1561,824,737
'4719025000,  선산읍,'30,25 - 29세,1998,1749,856,893
'4719025000,  선산읍,'35,30 - 34세,1998,1900,919,981
'4719025000,  선산읍,'40,35 - 39세,1998,1938,1051,887
'4719025000,  선산읍,'45,40 - 44세,1998,1389,742,647
'4719025000,  선산읍,'50,45 - 49세,1998,1025,535,490
'4719025000,  선산읍,'55,50 - 54세,1998,807,391,416
'4719025000,  선산읍,'60,55 - 59세,1998,940,431,509
'4719025000,  선산읍,'65,60 - 64세,1998,908,398,510
'4719025000,  선산읍,'70,65 - 69세,1998,703,273,430
'4719025000,  선산읍,'75,70 - 74세,1998,528,207,321
'4719025000,  선산읍,'80,75 - 79세,1998,380,138,242
'4719025000,  선산읍,'85,80 - 84세,1998,230,76,154
'4719025000,  선산읍,'90,85+ ,1998,137,31,106
'4719025300,  고아읍,'00,계,1998,34292,17615,16677
'4719025300,  고아읍,'05,0 - 4세,1998,4165,2266,1899
'4719025300,  고아읍,'10,5 - 9세,1998,3465,1868,1597
'4719025300,  고아읍,'15,10 - 14세,1998,2303,1253,1050
'4719025300,  고아읍,'20,15 - 19세,1998,2196,1142,1054
'4719025300,  고아읍,'25,20 - 24세,1998,2028,981,1047
'4719025300,  고아읍,'30,25 - 29세,1998,4057,1826,2231
'4719025300,  고아읍,'35,30 - 34세,1998,4747,2480,2267
'4719025300,  고아읍,'40,35 - 39세,1998,3703,2148,1555
'4719025300,  고아읍,'45,40 - 44세,1998,2100,1206,894
'4719025300,  고아읍,'50,45 - 49세,1998,1155,637,518
'4719025300,  고아읍,'55,50 - 54세,1998,796,374,422
'4719025300,  고아읍,'60,55 - 59세,1998,961,427,534
'4719025300,  고아읍,'65,60 - 64세,1998,875,384,491
'4719025300,  고아읍,'70,65 - 69세,1998,636,255,381
'4719025300,  고아읍,'75,70 - 74세,1998,494,176,318
'4719025300,  고아읍,'80,75 - 79세,1998,315,110,205
'4719025300,  고아읍,'85,80 - 84세,1998,174,52,122
'4719025300,  고아읍,'90,85+ ,1998,122,30,92
'4719031000,  무을면,'00,계,1998,3241,1628,1613
'4719031000,  무을면,'05,0 - 4세,1998,137,75,62
'4719031000,  무을면,'10,5 - 9세,1998,129,71,58
'4719031000,  무을면,'15,10 - 14세,1998,164,89,75
'4719031000,  무을면,'20,15 - 19세,1998,258,147,111
'4719031000,  무을면,'25,20 - 24세,1998,293,165,128
'4719031000,  무을면,'30,25 - 29세,1998,213,128,85
'4719031000,  무을면,'35,30 - 34세,1998,178,107,71
'4719031000,  무을면,'40,35 - 39세,1998,206,124,82
'4719031000,  무을면,'45,40 - 44세,1998,191,104,87
'4719031000,  무을면,'50,45 - 49세,1998,191,97,94
'4719031000,  무을면,'55,50 - 54세,1998,158,74,84
'4719031000,  무을면,'60,55 - 59세,1998,226,100,126
'4719031000,  무을면,'65,60 - 64세,1998,263,106,157
'4719031000,  무을면,'70,65 - 69세,1998,223,86,137
'4719031000,  무을면,'75,70 - 74세,1998,173,75,98
'4719031000,  무을면,'80,75 - 79세,1998,125,43,82
'4719031000,  무을면,'85,80 - 84세,1998,69,27,42
'4719031000,  무을면,'90,85+ ,1998,44,10,34
'4719032000,  옥성면,'00,계,1998,2742,1353,1389
'4719032000,  옥성면,'05,0 - 4세,1998,112,56,56
'4719032000,  옥성면,'10,5 - 9세,1998,99,55,44
'4719032000,  옥성면,'15,10 - 14세,1998,109,64,45
'4719032000,  옥성면,'20,15 - 19세,1998,216,108,108
'4719032000,  옥성면,'25,20 - 24세,1998,250,163,87
'4719032000,  옥성면,'30,25 - 29세,1998,199,123,76
'4719032000,  옥성면,'35,30 - 34세,1998,140,84,56
'4719032000,  옥성면,'40,35 - 39세,1998,159,84,75
'4719032000,  옥성면,'45,40 - 44세,1998,153,72,81
'4719032000,  옥성면,'50,45 - 49세,1998,147,69,78
'4719032000,  옥성면,'55,50 - 54세,1998,130,59,71
'4719032000,  옥성면,'60,55 - 59세,1998,213,85,128
'4719032000,  옥성면,'65,60 - 64세,1998,250,104,146
'4719032000,  옥성면,'70,65 - 69세,1998,204,85,119
'4719032000,  옥성면,'75,70 - 74세,1998,145,67,78
'4719032000,  옥성면,'80,75 - 79세,1998,110,40,70
'4719032000,  옥성면,'85,80 - 84세,1998,62,24,38
'4719032000,  옥성면,'90,85+ ,1998,44,11,33
'4719033000,  도개면,'00,계,1998,3757,1847,1910
'4719033000,  도개면,'05,0 - 4세,1998,155,77,78
'4719033000,  도개면,'10,5 - 9세,1998,139,73,66
'4719033000,  도개면,'15,10 - 14세,1998,201,99,102
'4719033000,  도개면,'20,15 - 19세,1998,316,149,167
'4719033000,  도개면,'25,20 - 24세,1998,321,186,135
'4719033000,  도개면,'30,25 - 29세,1998,286,183,103
'4719033000,  도개면,'35,30 - 34세,1998,201,126,75
'4719033000,  도개면,'40,35 - 39세,1998,211,116,95
'4719033000,  도개면,'45,40 - 44세,1998,236,108,128
'4719033000,  도개면,'50,45 - 49세,1998,221,97,124
'4719033000,  도개면,'55,50 - 54세,1998,190,104,86
'4719033000,  도개면,'60,55 - 59세,1998,327,132,195
'4719033000,  도개면,'65,60 - 64세,1998,321,144,177
'4719033000,  도개면,'70,65 - 69세,1998,239,115,124
'4719033000,  도개면,'75,70 - 74세,1998,162,58,104
'4719033000,  도개면,'80,75 - 79세,1998,135,56,79
'4719033000,  도개면,'85,80 - 84세,1998,64,19,45
'4719033000,  도개면,'90,85+ ,1998,32,5,27
'4719034000,  해평면,'00,계,1998,7160,3614,3546
'4719034000,  해평면,'05,0 - 4세,1998,373,186,187
'4719034000,  해평면,'10,5 - 9세,1998,323,182,141
'4719034000,  해평면,'15,10 - 14세,1998,331,185,146
'4719034000,  해평면,'20,15 - 19세,1998,544,286,258
'4719034000,  해평면,'25,20 - 24세,1998,652,361,291
'4719034000,  해평면,'30,25 - 29세,1998,615,362,253
'4719034000,  해평면,'35,30 - 34세,1998,469,277,192
'4719034000,  해평면,'40,35 - 39세,1998,445,266,179
'4719034000,  해평면,'45,40 - 44세,1998,406,214,192
'4719034000,  해평면,'50,45 - 49세,1998,369,189,180
'4719034000,  해평면,'55,50 - 54세,1998,371,172,199
'4719034000,  해평면,'60,55 - 59세,1998,538,214,324
'4719034000,  해평면,'65,60 - 64세,1998,560,241,319
'4719034000,  해평면,'70,65 - 69세,1998,450,207,243
'4719034000,  해평면,'75,70 - 74세,1998,297,127,170
'4719034000,  해평면,'80,75 - 79세,1998,228,90,138
'4719034000,  해평면,'85,80 - 84세,1998,115,38,77
'4719034000,  해평면,'90,85+ ,1998,74,17,57
'4719035000,  산동면,'00,계,1998,4508,2288,2220
'4719035000,  산동면,'05,0 - 4세,1998,225,112,113
'4719035000,  산동면,'10,5 - 9세,1998,214,121,93
'4719035000,  산동면,'15,10 - 14세,1998,282,151,131
'4719035000,  산동면,'20,15 - 19세,1998,385,202,183
'4719035000,  산동면,'25,20 - 24세,1998,361,196,165
'4719035000,  산동면,'30,25 - 29세,1998,399,246,153
'4719035000,  산동면,'35,30 - 34세,1998,300,177,123
'4719035000,  산동면,'40,35 - 39세,1998,290,161,129
'4719035000,  산동면,'45,40 - 44세,1998,293,159,134
'4719035000,  산동면,'50,45 - 49세,1998,236,130,106
'4719035000,  산동면,'55,50 - 54세,1998,177,82,95
'4719035000,  산동면,'60,55 - 59세,1998,328,137,191
'4719035000,  산동면,'65,60 - 64세,1998,343,137,206
'4719035000,  산동면,'70,65 - 69세,1998,254,107,147
'4719035000,  산동면,'75,70 - 74세,1998,204,85,119
'4719035000,  산동면,'80,75 - 79세,1998,121,53,68
'4719035000,  산동면,'85,80 - 84세,1998,64,24,40
'4719035000,  산동면,'90,85+ ,1998,32,8,24
'4719036000,  장천면,'00,계,1998,4628,2316,2312
'4719036000,  장천면,'05,0 - 4세,1998,254,133,121
'4719036000,  장천면,'10,5 - 9세,1998,254,126,128
'4719036000,  장천면,'15,10 - 14세,1998,246,139,107
'4719036000,  장천면,'20,15 - 19세,1998,357,183,174
'4719036000,  장천면,'25,20 - 24세,1998,406,234,172
'4719036000,  장천면,'30,25 - 29세,1998,346,196,150
'4719036000,  장천면,'35,30 - 34세,1998,326,174,152
'4719036000,  장천면,'40,35 - 39세,1998,315,180,135
'4719036000,  장천면,'45,40 - 44세,1998,256,134,122
'4719036000,  장천면,'50,45 - 49세,1998,266,130,136
'4719036000,  장천면,'55,50 - 54세,1998,218,103,115
'4719036000,  장천면,'60,55 - 59세,1998,327,137,190
'4719036000,  장천면,'65,60 - 64세,1998,348,161,187
'4719036000,  장천면,'70,65 - 69세,1998,255,108,147
'4719036000,  장천면,'75,70 - 74세,1998,202,86,116
'4719036000,  장천면,'80,75 - 79세,1998,119,52,67
'4719036000,  장천면,'85,80 - 84세,1998,86,29,57
'4719036000,  장천면,'90,85+ ,1998,47,11,36
'4719051000,  송정동,'00,계,1998,23813,11745,12068
'4719051000,  송정동,'05,0 - 4세,1998,2457,1366,1091
'4719051000,  송정동,'10,5 - 9세,1998,2244,1217,1027
'4719051000,  송정동,'15,10 - 14세,1998,2004,1092,912
'4719051000,  송정동,'20,15 - 19세,1998,2096,906,1190
'4719051000,  송정동,'25,20 - 24세,1998,1993,713,1280
'4719051000,  송정동,'30,25 - 29세,1998,2653,1213,1440
'4719051000,  송정동,'35,30 - 34세,1998,2762,1399,1363
'4719051000,  송정동,'40,35 - 39세,1998,2739,1359,1380
'4719051000,  송정동,'45,40 - 44세,1998,1932,1026,906
'4719051000,  송정동,'50,45 - 49세,1998,1116,625,491
'4719051000,  송정동,'55,50 - 54세,1998,586,347,239
'4719051000,  송정동,'60,55 - 59세,1998,399,198,201
'4719051000,  송정동,'65,60 - 64세,1998,290,126,164
'4719051000,  송정동,'70,65 - 69세,1998,187,65,122
'4719051000,  송정동,'75,70 - 74세,1998,153,39,114
'4719051000,  송정동,'80,75 - 79세,1998,111,32,79
'4719051000,  송정동,'85,80 - 84세,1998,63,17,46
'4719051000,  송정동,'90,85+ ,1998,28,5,23
'4719052000,  원평1동,'00,계,1998,6080,3012,3068
'4719052000,  원평1동,'05,0 - 4세,1998,390,218,172
'4719052000,  원평1동,'10,5 - 9세,1998,447,244,203
'4719052000,  원평1동,'15,10 - 14세,1998,375,191,184
'4719052000,  원평1동,'20,15 - 19세,1998,526,273,253
'4719052000,  원평1동,'25,20 - 24세,1998,597,280,317
'4719052000,  원평1동,'30,25 - 29세,1998,673,327,346
'4719052000,  원평1동,'35,30 - 34세,1998,648,317,331
'4719052000,  원평1동,'40,35 - 39세,1998,616,303,313
'4719052000,  원평1동,'45,40 - 44세,1998,508,246,262
'4719052000,  원평1동,'50,45 - 49세,1998,359,187,172
'4719052000,  원평1동,'55,50 - 54세,1998,293,140,153
'4719052000,  원평1동,'60,55 - 59세,1998,236,114,122
'4719052000,  원평1동,'65,60 - 64세,1998,176,82,94
'4719052000,  원평1동,'70,65 - 69세,1998,83,37,46
'4719052000,  원평1동,'75,70 - 74세,1998,70,30,40
'4719052000,  원평1동,'80,75 - 79세,1998,45,14,31
'4719052000,  원평1동,'85,80 - 84세,1998,19,6,13
'4719052000,  원평1동,'90,85+ ,1998,19,3,16
'4719053000,  원평2동,'00,계,1998,3804,1929,1875
'4719053000,  원평2동,'05,0 - 4세,1998,205,113,92
'4719053000,  원평2동,'10,5 - 9세,1998,245,132,113
'4719053000,  원평2동,'15,10 - 14세,1998,287,174,113
'4719053000,  원평2동,'20,15 - 19세,1998,375,190,185
'4719053000,  원평2동,'25,20 - 24세,1998,377,178,199
'4719053000,  원평2동,'30,25 - 29세,1998,362,199,163
'4719053000,  원평2동,'35,30 - 34세,1998,315,153,162
'4719053000,  원평2동,'40,35 - 39세,1998,357,180,177
'4719053000,  원평2동,'45,40 - 44세,1998,328,156,172
'4719053000,  원평2동,'50,45 - 49세,1998,250,130,120
'4719053000,  원평2동,'55,50 - 54세,1998,188,83,105
'4719053000,  원평2동,'60,55 - 59세,1998,199,98,101
'4719053000,  원평2동,'65,60 - 64세,1998,124,59,65
'4719053000,  원평2동,'70,65 - 69세,1998,74,36,38
'4719053000,  원평2동,'75,70 - 74세,1998,62,24,38
'4719053000,  원평2동,'80,75 - 79세,1998,25,11,14
'4719053000,  원평2동,'85,80 - 84세,1998,22,8,14
'4719053000,  원평2동,'90,85+ ,1998,9,5,4
'4719054000,  원평3동,'00,계,1998,4479,2241,2238
'4719054000,  원평3동,'05,0 - 4세,1998,251,140,111
'4719054000,  원평3동,'10,5 - 9세,1998,291,168,123
'4719054000,  원평3동,'15,10 - 14세,1998,296,160,136
'4719054000,  원평3동,'20,15 - 19세,1998,446,230,216
'4719054000,  원평3동,'25,20 - 24세,1998,495,234,261
'4719054000,  원평3동,'30,25 - 29세,1998,466,259,207
'4719054000,  원평3동,'35,30 - 34세,1998,370,200,170
'4719054000,  원평3동,'40,35 - 39세,1998,425,207,218
'4719054000,  원평3동,'45,40 - 44세,1998,368,183,185
'4719054000,  원평3동,'50,45 - 49세,1998,282,127,155
'4719054000,  원평3동,'55,50 - 54세,1998,220,104,116
'4719054000,  원평3동,'60,55 - 59세,1998,216,101,115
'4719054000,  원평3동,'65,60 - 64세,1998,130,56,74
'4719054000,  원평3동,'70,65 - 69세,1998,92,37,55
'4719054000,  원평3동,'75,70 - 74세,1998,52,11,41
'4719054000,  원평3동,'80,75 - 79세,1998,42,16,26
'4719054000,  원평3동,'85,80 - 84세,1998,26,5,21
'4719054000,  원평3동,'90,85+ ,1998,11,3,8
'4719055100,  도량동,'00,계,1998,32630,16684,15946
'4719055100,  도량동,'05,0 - 4세,1998,3402,1852,1550
'4719055100,  도량동,'10,5 - 9세,1998,3847,2094,1753
'4719055100,  도량동,'15,10 - 14세,1998,2991,1608,1383
'4719055100,  도량동,'20,15 - 19세,1998,2363,1243,1120
'4719055100,  도량동,'25,20 - 24세,1998,1867,784,1083
'4719055100,  도량동,'30,25 - 29세,1998,3472,1561,1911
'4719055100,  도량동,'35,30 - 34세,1998,4095,1927,2168
'4719055100,  도량동,'40,35 - 39세,1998,4387,2335,2052
'4719055100,  도량동,'45,40 - 44세,1998,2613,1530,1083
'4719055100,  도량동,'50,45 - 49세,1998,1259,723,536
'4719055100,  도량동,'55,50 - 54세,1998,641,368,273
'4719055100,  도량동,'60,55 - 59세,1998,537,257,280
'4719055100,  도량동,'65,60 - 64세,1998,394,165,229
'4719055100,  도량동,'70,65 - 69세,1998,304,106,198
'4719055100,  도량동,'75,70 - 74세,1998,188,53,135
'4719055100,  도량동,'80,75 - 79세,1998,160,50,110
'4719055100,  도량동,'85,80 - 84세,1998,77,22,55
'4719055100,  도량동,'90,85+ ,1998,33,6,27
'4719055500,  지산동,'00,계,1998,5477,2832,2645
'4719055500,  지산동,'05,0 - 4세,1998,478,272,206
'4719055500,  지산동,'10,5 - 9세,1998,444,240,204
'4719055500,  지산동,'15,10 - 14세,1998,398,224,174
'4719055500,  지산동,'20,15 - 19세,1998,514,259,255
'4719055500,  지산동,'25,20 - 24세,1998,496,231,265
'4719055500,  지산동,'30,25 - 29세,1998,686,371,315
'4719055500,  지산동,'35,30 - 34세,1998,567,304,263
'4719055500,  지산동,'40,35 - 39세,1998,510,254,256
'4719055500,  지산동,'45,40 - 44세,1998,369,196,173
'4719055500,  지산동,'50,45 - 49세,1998,281,160,121
'4719055500,  지산동,'55,50 - 54세,1998,186,102,84
'4719055500,  지산동,'60,55 - 59세,1998,167,80,87
'4719055500,  지산동,'65,60 - 64세,1998,132,56,76
'4719055500,  지산동,'70,65 - 69세,1998,96,37,59
'4719055500,  지산동,'75,70 - 74세,1998,77,29,48
'4719055500,  지산동,'80,75 - 79세,1998,40,11,29
'4719055500,  지산동,'85,80 - 84세,1998,21,3,18
'4719055500,  지산동,'90,85+ ,1998,15,3,12
'4719056000,  선주동,'00,계,1998,2787,1408,1379
'4719056000,  선주동,'05,0 - 4세,1998,180,99,81
'4719056000,  선주동,'10,5 - 9세,1998,161,93,68
'4719056000,  선주동,'15,10 - 14세,1998,176,92,84
'4719056000,  선주동,'20,15 - 19세,1998,208,99,109
'4719056000,  선주동,'25,20 - 24세,1998,369,150,219
'4719056000,  선주동,'30,25 - 29세,1998,311,187,124
'4719056000,  선주동,'35,30 - 34세,1998,254,138,116
'4719056000,  선주동,'40,35 - 39세,1998,223,128,95
'4719056000,  선주동,'45,40 - 44세,1998,177,95,82
'4719056000,  선주동,'50,45 - 49세,1998,145,71,74
'4719056000,  선주동,'55,50 - 54세,1998,99,50,49
'4719056000,  선주동,'60,55 - 59세,1998,141,66,75
'4719056000,  선주동,'65,60 - 64세,1998,111,57,54
'4719056000,  선주동,'70,65 - 69세,1998,95,42,53
'4719056000,  선주동,'75,70 - 74세,1998,63,22,41
'4719056000,  선주동,'80,75 - 79세,1998,40,14,26
'4719056000,  선주동,'85,80 - 84세,1998,20,3,17
'4719056000,  선주동,'90,85+ ,1998,14,2,12
'4719057000,  원남동,'00,계,1998,13854,7010,6844
'4719057000,  원남동,'05,0 - 4세,1998,1319,711,608
'4719057000,  원남동,'10,5 - 9세,1998,1435,831,604
'4719057000,  원남동,'15,10 - 14세,1998,1107,604,503
'4719057000,  원남동,'20,15 - 19세,1998,1104,518,586
'4719057000,  원남동,'25,20 - 24세,1998,1021,452,569
'4719057000,  원남동,'30,25 - 29세,1998,1442,677,765
'4719057000,  원남동,'35,30 - 34세,1998,1642,789,853
'4719057000,  원남동,'40,35 - 39세,1998,1673,887,786
'4719057000,  원남동,'45,40 - 44세,1998,1058,587,471
'4719057000,  원남동,'50,45 - 49세,1998,648,335,313
'4719057000,  원남동,'55,50 - 54세,1998,408,229,179
'4719057000,  원남동,'60,55 - 59세,1998,353,154,199
'4719057000,  원남동,'65,60 - 64세,1998,231,117,114
'4719057000,  원남동,'70,65 - 69세,1998,158,58,100
'4719057000,  원남동,'75,70 - 74세,1998,97,21,76
'4719057000,  원남동,'80,75 - 79세,1998,86,27,59
'4719057000,  원남동,'85,80 - 84세,1998,44,9,35
'4719057000,  원남동,'90,85+ ,1998,28,4,24
'4719058200,  형곡1동,'00,계,1998,17769,9010,8759
'4719058200,  형곡1동,'05,0 - 4세,1998,1647,895,752
'4719058200,  형곡1동,'10,5 - 9세,1998,1994,1143,851
'4719058200,  형곡1동,'15,10 - 14세,1998,1867,1004,863
'4719058200,  형곡1동,'20,15 - 19세,1998,1502,734,768
'4719058200,  형곡1동,'25,20 - 24세,1998,1004,454,550
'4719058200,  형곡1동,'30,25 - 29세,1998,1565,691,874
'4719058200,  형곡1동,'35,30 - 34세,1998,2032,935,1097
'4719058200,  형곡1동,'40,35 - 39세,1998,2395,1179,1216
'4719058200,  형곡1동,'45,40 - 44세,1998,1654,919,735
'4719058200,  형곡1동,'50,45 - 49세,1998,805,467,338
'4719058200,  형곡1동,'55,50 - 54세,1998,404,253,151
'4719058200,  형곡1동,'60,55 - 59세,1998,295,155,140
'4719058200,  형곡1동,'65,60 - 64세,1998,212,84,128
'4719058200,  형곡1동,'70,65 - 69세,1998,132,32,100
'4719058200,  형곡1동,'75,70 - 74세,1998,105,22,83
'4719058200,  형곡1동,'80,75 - 79세,1998,73,20,53
'4719058200,  형곡1동,'85,80 - 84세,1998,57,19,38
'4719058200,  형곡1동,'90,85+ ,1998,26,4,22
'4719058300,  형곡2동,'00,계,1998,23441,11990,11451
'4719058300,  형곡2동,'05,0 - 4세,1998,2422,1355,1067
'4719058300,  형곡2동,'10,5 - 9세,1998,2833,1578,1255
'4719058300,  형곡2동,'15,10 - 14세,1998,2598,1402,1196
'4719058300,  형곡2동,'20,15 - 19세,1998,1778,913,865
'4719058300,  형곡2동,'25,20 - 24세,1998,1086,461,625
'4719058300,  형곡2동,'30,25 - 29세,1998,2084,850,1234
'4719058300,  형곡2동,'35,30 - 34세,1998,3014,1392,1622
'4719058300,  형곡2동,'40,35 - 39세,1998,3462,1749,1713
'4719058300,  형곡2동,'45,40 - 44세,1998,1983,1197,786
'4719058300,  형곡2동,'50,45 - 49세,1998,849,516,333
'4719058300,  형곡2동,'55,50 - 54세,1998,374,212,162
'4719058300,  형곡2동,'60,55 - 59세,1998,301,153,148
'4719058300,  형곡2동,'65,60 - 64세,1998,214,89,125
'4719058300,  형곡2동,'70,65 - 69세,1998,166,55,111
'4719058300,  형곡2동,'75,70 - 74세,1998,118,32,86
'4719058300,  형곡2동,'80,75 - 79세,1998,103,26,77
'4719058300,  형곡2동,'85,80 - 84세,1998,37,5,32
'4719058300,  형곡2동,'90,85+ ,1998,19,5,14
'4719059000,  신평1동,'00,계,1998,8136,4067,4069
'4719059000,  신평1동,'05,0 - 4세,1998,858,478,380
'4719059000,  신평1동,'10,5 - 9세,1998,622,362,260
'4719059000,  신평1동,'15,10 - 14세,1998,490,255,235
'4719059000,  신평1동,'20,15 - 19세,1998,639,282,357
'4719059000,  신평1동,'25,20 - 24세,1998,1034,335,699
'4719059000,  신평1동,'30,25 - 29세,1998,1240,675,565
'4719059000,  신평1동,'35,30 - 34세,1998,955,516,439
'4719059000,  신평1동,'40,35 - 39세,1998,740,421,319
'4719059000,  신평1동,'45,40 - 44세,1998,470,243,227
'4719059000,  신평1동,'50,45 - 49세,1998,323,170,153
'4719059000,  신평1동,'55,50 - 54세,1998,209,95,114
'4719059000,  신평1동,'60,55 - 59세,1998,199,97,102
'4719059000,  신평1동,'65,60 - 64세,1998,142,66,76
'4719059000,  신평1동,'70,65 - 69세,1998,73,26,47
'4719059000,  신평1동,'75,70 - 74세,1998,70,24,46
'4719059000,  신평1동,'80,75 - 79세,1998,44,13,31
'4719059000,  신평1동,'85,80 - 84세,1998,14,4,10
'4719059000,  신평1동,'90,85+ ,1998,14,5,9
'4719060000,  신평2동,'00,계,1998,5017,2646,2371
'4719060000,  신평2동,'05,0 - 4세,1998,445,239,206
'4719060000,  신평2동,'10,5 - 9세,1998,448,262,186
'4719060000,  신평2동,'15,10 - 14세,1998,357,202,155
'4719060000,  신평2동,'20,15 - 19세,1998,353,167,186
'4719060000,  신평2동,'25,20 - 24세,1998,593,288,305
'4719060000,  신평2동,'30,25 - 29세,1998,695,401,294
'4719060000,  신평2동,'35,30 - 34세,1998,557,286,271
'4719060000,  신평2동,'40,35 - 39세,1998,505,291,214
'4719060000,  신평2동,'45,40 - 44세,1998,318,160,158
'4719060000,  신평2동,'50,45 - 49세,1998,193,101,92
'4719060000,  신평2동,'55,50 - 54세,1998,137,77,60
'4719060000,  신평2동,'60,55 - 59세,1998,153,66,87
'4719060000,  신평2동,'65,60 - 64세,1998,110,49,61
'4719060000,  신평2동,'70,65 - 69세,1998,55,25,30
'4719060000,  신평2동,'75,70 - 74세,1998,39,13,26
'4719060000,  신평2동,'80,75 - 79세,1998,33,11,22
'4719060000,  신평2동,'85,80 - 84세,1998,11,6,5
'4719060000,  신평2동,'90,85+ ,1998,15,2,13
'4719061000,  비산동,'00,계,1998,5437,2805,2632
'4719061000,  비산동,'05,0 - 4세,1998,712,372,340
'4719061000,  비산동,'10,5 - 9세,1998,525,272,253
'4719061000,  비산동,'15,10 - 14세,1998,342,182,160
'4719061000,  비산동,'20,15 - 19세,1998,293,153,140
'4719061000,  비산동,'25,20 - 24세,1998,462,166,296
'4719061000,  비산동,'30,25 - 29세,1998,840,416,424
'4719061000,  비산동,'35,30 - 34세,1998,809,455,354
'4719061000,  비산동,'40,35 - 39세,1998,585,343,242
'4719061000,  비산동,'45,40 - 44세,1998,291,170,121
'4719061000,  비산동,'50,45 - 49세,1998,174,102,72
'4719061000,  비산동,'55,50 - 54세,1998,108,52,56
'4719061000,  비산동,'60,55 - 59세,1998,90,45,45
'4719061000,  비산동,'65,60 - 64세,1998,85,40,45
'4719061000,  비산동,'70,65 - 69세,1998,47,15,32
'4719061000,  비산동,'75,70 - 74세,1998,28,11,17
'4719061000,  비산동,'80,75 - 79세,1998,25,8,17
'4719061000,  비산동,'85,80 - 84세,1998,13,2,11
'4719061000,  비산동,'90,85+ ,1998,8,1,7
'4719062100,  공단1동,'00,계,1998,9094,4613,4481
'4719062100,  공단1동,'05,0 - 4세,1998,1114,605,509
'4719062100,  공단1동,'10,5 - 9세,1998,817,461,356
'4719062100,  공단1동,'15,10 - 14세,1998,456,250,206
'4719062100,  공단1동,'20,15 - 19세,1998,756,488,268
'4719062100,  공단1동,'25,20 - 24세,1998,1291,340,951
'4719062100,  공단1동,'30,25 - 29세,1998,1507,786,721
'4719062100,  공단1동,'35,30 - 34세,1998,1163,626,537
'4719062100,  공단1동,'40,35 - 39세,1998,817,471,346
'4719062100,  공단1동,'45,40 - 44세,1998,450,237,213
'4719062100,  공단1동,'50,45 - 49세,1998,265,147,118
'4719062100,  공단1동,'55,50 - 54세,1998,138,80,58
'4719062100,  공단1동,'60,55 - 59세,1998,94,44,50
'4719062100,  공단1동,'65,60 - 64세,1998,87,36,51
'4719062100,  공단1동,'70,65 - 69세,1998,59,24,35
'4719062100,  공단1동,'75,70 - 74세,1998,32,9,23
'4719062100,  공단1동,'80,75 - 79세,1998,23,5,18
'4719062100,  공단1동,'85,80 - 84세,1998,19,4,15
'4719062100,  공단1동,'90,85+ ,1998,6,0,6
'4719062200,  공단2동,'00,계,1998,11138,5589,5549
'4719062200,  공단2동,'05,0 - 4세,1998,1317,696,621
'4719062200,  공단2동,'10,5 - 9세,1998,804,420,384
'4719062200,  공단2동,'15,10 - 14세,1998,329,181,148
'4719062200,  공단2동,'20,15 - 19세,1998,908,277,631
'4719062200,  공단2동,'25,20 - 24세,1998,2366,705,1661
'4719062200,  공단2동,'30,25 - 29세,1998,2486,1552,934
'4719062200,  공단2동,'35,30 - 34세,1998,1435,864,571
'4719062200,  공단2동,'40,35 - 39세,1998,743,478,265
'4719062200,  공단2동,'45,40 - 44세,1998,298,196,102
'4719062200,  공단2동,'50,45 - 49세,1998,153,79,74
'4719062200,  공단2동,'55,50 - 54세,1998,87,52,35
'4719062200,  공단2동,'60,55 - 59세,1998,75,39,36
'4719062200,  공단2동,'65,60 - 64세,1998,66,27,39
'4719062200,  공단2동,'70,65 - 69세,1998,33,11,22
'4719062200,  공단2동,'75,70 - 74세,1998,23,10,13
'4719062200,  공단2동,'80,75 - 79세,1998,9,1,8
'4719062200,  공단2동,'85,80 - 84세,1998,4,0,4
'4719062200,  공단2동,'90,85+ ,1998,2,1,1
'4719063000,  광평동,'00,계,1998,5647,2941,2706
'4719063000,  광평동,'05,0 - 4세,1998,651,337,314
'4719063000,  광평동,'10,5 - 9세,1998,550,315,235
'4719063000,  광평동,'15,10 - 14세,1998,391,201,190
'4719063000,  광평동,'20,15 - 19세,1998,409,197,212
'4719063000,  광평동,'25,20 - 24세,1998,439,215,224
'4719063000,  광평동,'30,25 - 29세,1998,658,320,338
'4719063000,  광평동,'35,30 - 34세,1998,763,407,356
'4719063000,  광평동,'40,35 - 39세,1998,605,358,247
'4719063000,  광평동,'45,40 - 44세,1998,350,198,152
'4719063000,  광평동,'50,45 - 49세,1998,215,112,103
'4719063000,  광평동,'55,50 - 54세,1998,166,88,78
'4719063000,  광평동,'60,55 - 59세,1998,136,69,67
'4719063000,  광평동,'65,60 - 64세,1998,104,50,54
'4719063000,  광평동,'70,65 - 69세,1998,65,23,42
'4719063000,  광평동,'75,70 - 74세,1998,68,28,40
'4719063000,  광평동,'80,75 - 79세,1998,41,13,28
'4719063000,  광평동,'85,80 - 84세,1998,25,7,18
'4719063000,  광평동,'90,85+ ,1998,11,3,8
'4719064000,  사곡동,'00,계,1998,5413,2765,2648
'4719064000,  사곡동,'05,0 - 4세,1998,486,268,218
'4719064000,  사곡동,'10,5 - 9세,1998,431,227,204
'4719064000,  사곡동,'15,10 - 14세,1998,344,179,165
'4719064000,  사곡동,'20,15 - 19세,1998,452,200,252
'4719064000,  사곡동,'25,20 - 24세,1998,558,243,315
'4719064000,  사곡동,'30,25 - 29세,1998,708,384,324
'4719064000,  사곡동,'35,30 - 34세,1998,583,322,261
'4719064000,  사곡동,'40,35 - 39세,1998,490,277,213
'4719064000,  사곡동,'45,40 - 44세,1998,342,179,163
'4719064000,  사곡동,'50,45 - 49세,1998,278,140,138
'4719064000,  사곡동,'55,50 - 54세,1998,186,102,84
'4719064000,  사곡동,'60,55 - 59세,1998,193,97,96
'4719064000,  사곡동,'65,60 - 64세,1998,156,70,86
'4719064000,  사곡동,'70,65 - 69세,1998,82,34,48
'4719064000,  사곡동,'75,70 - 74세,1998,61,21,40
'4719064000,  사곡동,'80,75 - 79세,1998,31,11,20
'4719064000,  사곡동,'85,80 - 84세,1998,13,4,9
'4719064000,  사곡동,'90,85+ ,1998,19,7,12
'4719065000,  상모동,'00,계,1998,3193,1653,1540
'4719065000,  상모동,'05,0 - 4세,1998,344,185,159
'4719065000,  상모동,'10,5 - 9세,1998,306,156,150
'4719065000,  상모동,'15,10 - 14세,1998,218,117,101
'4719065000,  상모동,'20,15 - 19세,1998,237,113,124
'4719065000,  상모동,'25,20 - 24세,1998,255,121,134
'4719065000,  상모동,'30,25 - 29세,1998,390,214,176
'4719065000,  상모동,'35,30 - 34세,1998,409,221,188
'4719065000,  상모동,'40,35 - 39세,1998,306,169,137
'4719065000,  상모동,'45,40 - 44세,1998,183,106,77
'4719065000,  상모동,'50,45 - 49세,1998,129,63,66
'4719065000,  상모동,'55,50 - 54세,1998,102,52,50
'4719065000,  상모동,'60,55 - 59세,1998,112,52,60
'4719065000,  상모동,'65,60 - 64세,1998,66,30,36
'4719065000,  상모동,'70,65 - 69세,1998,51,16,35
'4719065000,  상모동,'75,70 - 74세,1998,37,21,16
'4719065000,  상모동,'80,75 - 79세,1998,29,7,22
'4719065000,  상모동,'85,80 - 84세,1998,14,9,5
'4719065000,  상모동,'90,85+ ,1998,5,1,4
'4719066000,  임오동,'00,계,1998,11492,5906,5586
'4719066000,  임오동,'05,0 - 4세,1998,1674,912,762
'4719066000,  임오동,'10,5 - 9세,1998,1459,769,690
'4719066000,  임오동,'15,10 - 14세,1998,703,364,339
'4719066000,  임오동,'20,15 - 19세,1998,520,267,253
'4719066000,  임오동,'25,20 - 24세,1998,695,262,433
'4719066000,  임오동,'30,25 - 29세,1998,1465,639,826
'4719066000,  임오동,'35,30 - 34세,1998,1986,1040,946
'4719066000,  임오동,'40,35 - 39세,1998,1360,846,514
'4719066000,  임오동,'45,40 - 44세,1998,522,330,192
'4719066000,  임오동,'50,45 - 49세,1998,254,132,122
'4719066000,  임오동,'55,50 - 54세,1998,182,93,89
'4719066000,  임오동,'60,55 - 59세,1998,203,81,122
'4719066000,  임오동,'65,60 - 64세,1998,181,76,105
'4719066000,  임오동,'70,65 - 69세,1998,119,50,69
'4719066000,  임오동,'75,70 - 74세,1998,82,25,57
'4719066000,  임오동,'80,75 - 79세,1998,48,15,33
'4719066000,  임오동,'85,80 - 84세,1998,21,2,19
'4719066000,  임오동,'90,85+ ,1998,18,3,15
'4719067000,  인동동,'00,계,1998,27321,13977,13344
'4719067000,  인동동,'05,0 - 4세,1998,3025,1631,1394
'4719067000,  인동동,'10,5 - 9세,1998,3117,1731,1386
'4719067000,  인동동,'15,10 - 14세,1998,2287,1186,1101
'4719067000,  인동동,'20,15 - 19세,1998,1626,796,830
'4719067000,  인동동,'25,20 - 24세,1998,1812,781,1031
'4719067000,  인동동,'30,25 - 29세,1998,3366,1651,1715
'4719067000,  인동동,'35,30 - 34세,1998,3601,1754,1847
'4719067000,  인동동,'40,35 - 39세,1998,3410,1935,1475
'4719067000,  인동동,'45,40 - 44세,1998,1683,994,689
'4719067000,  인동동,'50,45 - 49세,1998,887,482,405
'4719067000,  인동동,'55,50 - 54세,1998,570,290,280
'4719067000,  인동동,'60,55 - 59세,1998,602,275,327
'4719067000,  인동동,'65,60 - 64세,1998,478,190,288
'4719067000,  인동동,'70,65 - 69세,1998,320,118,202
'4719067000,  인동동,'75,70 - 74세,1998,252,91,161
'4719067000,  인동동,'80,75 - 79세,1998,155,44,111
'4719067000,  인동동,'85,80 - 84세,1998,76,15,61
'4719067000,  인동동,'90,85+ ,1998,54,13,41
'4719068000,  진미동,'00,계,1998,7857,3558,4299
'4719068000,  진미동,'05,0 - 4세,1998,434,243,191
'4719068000,  진미동,'10,5 - 9세,1998,336,173,163
'4719068000,  진미동,'15,10 - 14세,1998,260,131,129
'4719068000,  진미동,'20,15 - 19세,1998,1481,488,993
'4719068000,  진미동,'25,20 - 24세,1998,2137,523,1614
'4719068000,  진미동,'30,25 - 29세,1998,1259,946,313
'4719068000,  진미동,'35,30 - 34세,1998,540,321,219
'4719068000,  진미동,'40,35 - 39세,1998,417,245,172
'4719068000,  진미동,'45,40 - 44세,1998,266,142,124
'4719068000,  진미동,'50,45 - 49세,1998,184,111,73
'4719068000,  진미동,'55,50 - 54세,1998,126,65,61
'4719068000,  진미동,'60,55 - 59세,1998,124,63,61
'4719068000,  진미동,'65,60 - 64세,1998,83,38,45
'4719068000,  진미동,'70,65 - 69세,1998,73,25,48
'4719068000,  진미동,'75,70 - 74세,1998,63,20,43
'4719068000,  진미동,'80,75 - 79세,1998,41,16,25
'4719068000,  진미동,'85,80 - 84세,1998,23,6,17
'4719068000,  진미동,'90,85+ ,1998,10,2,8
'4719069000,  양포동,'00,계,1998,13930,7177,6753
'4719069000,  양포동,'05,0 - 4세,1998,2332,1209,1123
'4719069000,  양포동,'10,5 - 9세,1998,1668,873,795
'4719069000,  양포동,'15,10 - 14세,1998,663,333,330
'4719069000,  양포동,'20,15 - 19세,1998,386,207,179
'4719069000,  양포동,'25,20 - 24세,1998,728,283,445
'4719069000,  양포동,'30,25 - 29세,1998,2435,1107,1328
'4719069000,  양포동,'35,30 - 34세,1998,2457,1324,1133
'4719069000,  양포동,'40,35 - 39세,1998,1529,1004,525
'4719069000,  양포동,'45,40 - 44세,1998,457,295,162
'4719069000,  양포동,'50,45 - 49세,1998,228,109,119
'4719069000,  양포동,'55,50 - 54세,1998,167,71,96
'4719069000,  양포동,'60,55 - 59세,1998,235,100,135
'4719069000,  양포동,'65,60 - 64세,1998,215,102,113
'4719069000,  양포동,'70,65 - 69세,1998,160,59,101
'4719069000,  양포동,'75,70 - 74세,1998,118,50,68
'4719069000,  양포동,'80,75 - 79세,1998,86,27,59
'4719069000,  양포동,'85,80 - 84세,1998,44,18,26
'4719069000,  양포동,'90,85+ ,1998,22,6,16
'47210, 영주시,'00,계,1998,134774,67462,67312
'47210, 영주시,'05,0 - 4세,1998,7343,3953,3390
'47210, 영주시,'10,5 - 9세,1998,7685,4253,3432
'47210, 영주시,'15,10 - 14세,1998,8880,4749,4131
'47210, 영주시,'20,15 - 19세,1998,13584,7077,6507
'47210, 영주시,'25,20 - 24세,1998,13045,7123,5922
'47210, 영주시,'30,25 - 29세,1998,10255,5668,4587
'47210, 영주시,'35,30 - 34세,1998,9114,4665,4449
'47210, 영주시,'40,35 - 39세,1998,10676,5279,5397
'47210, 영주시,'45,40 - 44세,1998,9937,4921,5016
'47210, 영주시,'50,45 - 49세,1998,8198,3988,4210
'47210, 영주시,'55,50 - 54세,1998,6662,3278,3384
'47210, 영주시,'60,55 - 59세,1998,8168,3805,4363
'47210, 영주시,'65,60 - 64세,1998,7114,3270,3844
'47210, 영주시,'70,65 - 69세,1998,5091,2044,3047
'47210, 영주시,'75,70 - 74세,1998,3793,1507,2286
'47210, 영주시,'80,75 - 79세,1998,2572,1041,1531
'47210, 영주시,'85,80 - 84세,1998,1688,576,1112
'47210, 영주시,'90,85+ ,1998,969,265,704
'4721025000,  풍기읍,'00,계,1998,17123,8511,8612
'4721025000,  풍기읍,'05,0 - 4세,1998,967,525,442
'4721025000,  풍기읍,'10,5 - 9세,1998,1035,584,451
'4721025000,  풍기읍,'15,10 - 14세,1998,1100,587,513
'4721025000,  풍기읍,'20,15 - 19세,1998,1712,904,808
'4721025000,  풍기읍,'25,20 - 24세,1998,1608,846,762
'4721025000,  풍기읍,'30,25 - 29세,1998,1296,684,612
'4721025000,  풍기읍,'35,30 - 34세,1998,1141,574,567
'4721025000,  풍기읍,'40,35 - 39세,1998,1401,694,707
'4721025000,  풍기읍,'45,40 - 44세,1998,1235,642,593
'4721025000,  풍기읍,'50,45 - 49세,1998,1032,513,519
'4721025000,  풍기읍,'55,50 - 54세,1998,818,382,436
'4721025000,  풍기읍,'60,55 - 59세,1998,1016,455,561
'4721025000,  풍기읍,'65,60 - 64세,1998,902,389,513
'4721025000,  풍기읍,'70,65 - 69세,1998,686,280,406
'4721025000,  풍기읍,'75,70 - 74세,1998,512,195,317
'4721025000,  풍기읍,'80,75 - 79세,1998,345,154,191
'4721025000,  풍기읍,'85,80 - 84세,1998,205,72,133
'4721025000,  풍기읍,'90,85+ ,1998,112,31,81
'4721031000,  이산면,'00,계,1998,3752,1922,1830
'4721031000,  이산면,'05,0 - 4세,1998,147,78,69
'4721031000,  이산면,'10,5 - 9세,1998,116,67,49
'4721031000,  이산면,'15,10 - 14세,1998,171,84,87
'4721031000,  이산면,'20,15 - 19세,1998,327,174,153
'4721031000,  이산면,'25,20 - 24세,1998,389,229,160
'4721031000,  이산면,'30,25 - 29세,1998,231,150,81
'4721031000,  이산면,'35,30 - 34세,1998,163,99,64
'4721031000,  이산면,'40,35 - 39세,1998,225,133,92
'4721031000,  이산면,'45,40 - 44세,1998,184,93,91
'4721031000,  이산면,'50,45 - 49세,1998,203,97,106
'4721031000,  이산면,'55,50 - 54세,1998,200,105,95
'4721031000,  이산면,'60,55 - 59세,1998,296,137,159
'4721031000,  이산면,'65,60 - 64세,1998,388,186,202
'4721031000,  이산면,'70,65 - 69세,1998,251,108,143
'4721031000,  이산면,'75,70 - 74세,1998,188,73,115
'4721031000,  이산면,'80,75 - 79세,1998,127,57,70
'4721031000,  이산면,'85,80 - 84세,1998,90,38,52
'4721031000,  이산면,'90,85+ ,1998,56,14,42
'4721032000,  평은면,'00,계,1998,2881,1467,1414
'4721032000,  평은면,'05,0 - 4세,1998,69,41,28
'4721032000,  평은면,'10,5 - 9세,1998,86,43,43
'4721032000,  평은면,'15,10 - 14세,1998,126,62,64
'4721032000,  평은면,'20,15 - 19세,1998,247,129,118
'4721032000,  평은면,'25,20 - 24세,1998,290,172,118
'4721032000,  평은면,'30,25 - 29세,1998,163,112,51
'4721032000,  평은면,'35,30 - 34세,1998,111,72,39
'4721032000,  평은면,'40,35 - 39세,1998,143,85,58
'4721032000,  평은면,'45,40 - 44세,1998,163,80,83
'4721032000,  평은면,'50,45 - 49세,1998,157,75,82
'4721032000,  평은면,'55,50 - 54세,1998,170,75,95
'4721032000,  평은면,'60,55 - 59세,1998,269,136,133
'4721032000,  평은면,'65,60 - 64세,1998,266,130,136
'4721032000,  평은면,'70,65 - 69세,1998,237,101,136
'4721032000,  평은면,'75,70 - 74세,1998,170,71,99
'4721032000,  평은면,'80,75 - 79세,1998,98,44,54
'4721032000,  평은면,'85,80 - 84세,1998,76,28,48
'4721032000,  평은면,'90,85+ ,1998,40,11,29
'4721033000,  문수면,'00,계,1998,2658,1345,1313
'4721033000,  문수면,'05,0 - 4세,1998,58,32,26
'4721033000,  문수면,'10,5 - 9세,1998,59,34,25
'4721033000,  문수면,'15,10 - 14세,1998,133,69,64
'4721033000,  문수면,'20,15 - 19세,1998,236,118,118
'4721033000,  문수면,'25,20 - 24세,1998,279,172,107
'4721033000,  문수면,'30,25 - 29세,1998,157,119,38
'4721033000,  문수면,'35,30 - 34세,1998,83,46,37
'4721033000,  문수면,'40,35 - 39세,1998,129,68,61
'4721033000,  문수면,'45,40 - 44세,1998,170,90,80
'4721033000,  문수면,'50,45 - 49세,1998,155,80,75
'4721033000,  문수면,'55,50 - 54세,1998,151,73,78
'4721033000,  문수면,'60,55 - 59세,1998,215,96,119
'4721033000,  문수면,'65,60 - 64세,1998,255,114,141
'4721033000,  문수면,'70,65 - 69세,1998,190,74,116
'4721033000,  문수면,'75,70 - 74세,1998,149,66,83
'4721033000,  문수면,'80,75 - 79세,1998,118,45,73
'4721033000,  문수면,'85,80 - 84세,1998,68,31,37
'4721033000,  문수면,'90,85+ ,1998,53,18,35
'4721034000,  장수면,'00,계,1998,3308,1692,1616
'4721034000,  장수면,'05,0 - 4세,1998,94,54,40
'4721034000,  장수면,'10,5 - 9세,1998,111,61,50
'4721034000,  장수면,'15,10 - 14세,1998,146,76,70
'4721034000,  장수면,'20,15 - 19세,1998,302,174,128
'4721034000,  장수면,'25,20 - 24세,1998,359,201,158
'4721034000,  장수면,'30,25 - 29세,1998,212,139,73
'4721034000,  장수면,'35,30 - 34세,1998,130,80,50
'4721034000,  장수면,'40,35 - 39세,1998,175,86,89
'4721034000,  장수면,'45,40 - 44세,1998,188,99,89
'4721034000,  장수면,'50,45 - 49세,1998,176,94,82
'4721034000,  장수면,'55,50 - 54세,1998,191,96,95
'4721034000,  장수면,'60,55 - 59세,1998,308,149,159
'4721034000,  장수면,'65,60 - 64세,1998,245,107,138
'4721034000,  장수면,'70,65 - 69세,1998,220,87,133
'4721034000,  장수면,'75,70 - 74세,1998,180,87,93
'4721034000,  장수면,'80,75 - 79세,1998,136,61,75
'4721034000,  장수면,'85,80 - 84세,1998,91,31,60
'4721034000,  장수면,'90,85+ ,1998,44,10,34
'4721035000,  안정면,'00,계,1998,4597,2323,2274
'4721035000,  안정면,'05,0 - 4세,1998,136,61,75
'4721035000,  안정면,'10,5 - 9세,1998,157,92,65
'4721035000,  안정면,'15,10 - 14세,1998,243,125,118
'4721035000,  안정면,'20,15 - 19세,1998,446,236,210
'4721035000,  안정면,'25,20 - 24세,1998,487,269,218
'4721035000,  안정면,'30,25 - 29세,1998,298,207,91
'4721035000,  안정면,'35,30 - 34세,1998,195,124,71
'4721035000,  안정면,'40,35 - 39세,1998,235,127,108
'4721035000,  안정면,'45,40 - 44세,1998,291,154,137
'4721035000,  안정면,'50,45 - 49세,1998,267,123,144
'4721035000,  안정면,'55,50 - 54세,1998,240,120,120
'4721035000,  안정면,'60,55 - 59세,1998,402,172,230
'4721035000,  안정면,'65,60 - 64세,1998,394,181,213
'4721035000,  안정면,'70,65 - 69세,1998,297,123,174
'4721035000,  안정면,'75,70 - 74세,1998,198,91,107
'4721035000,  안정면,'80,75 - 79세,1998,149,70,79
'4721035000,  안정면,'85,80 - 84세,1998,106,32,74
'4721035000,  안정면,'90,85+ ,1998,56,16,40
'4721036000,  봉현면,'00,계,1998,3977,2042,1935
'4721036000,  봉현면,'05,0 - 4세,1998,110,61,49
'4721036000,  봉현면,'10,5 - 9세,1998,130,60,70
'4721036000,  봉현면,'15,10 - 14세,1998,207,110,97
'4721036000,  봉현면,'20,15 - 19세,1998,412,232,180
'4721036000,  봉현면,'25,20 - 24세,1998,423,235,188
'4721036000,  봉현면,'30,25 - 29세,1998,243,172,71
'4721036000,  봉현면,'35,30 - 34세,1998,178,102,76
'4721036000,  봉현면,'40,35 - 39세,1998,246,135,111
'4721036000,  봉현면,'45,40 - 44세,1998,252,123,129
'4721036000,  봉현면,'50,45 - 49세,1998,284,137,147
'4721036000,  봉현면,'55,50 - 54세,1998,246,128,118
'4721036000,  봉현면,'60,55 - 59세,1998,284,140,144
'4721036000,  봉현면,'65,60 - 64세,1998,297,133,164
'4721036000,  봉현면,'70,65 - 69세,1998,226,89,137
'4721036000,  봉현면,'75,70 - 74세,1998,182,84,98
'4721036000,  봉현면,'80,75 - 79세,1998,124,50,74
'4721036000,  봉현면,'85,80 - 84세,1998,85,32,53
'4721036000,  봉현면,'90,85+ ,1998,48,19,29
'4721037000,  순흥면,'00,계,1998,3287,1661,1626
'4721037000,  순흥면,'05,0 - 4세,1998,105,54,51
'4721037000,  순흥면,'10,5 - 9세,1998,156,94,62
'4721037000,  순흥면,'15,10 - 14세,1998,168,75,93
'4721037000,  순흥면,'20,15 - 19세,1998,305,169,136
'4721037000,  순흥면,'25,20 - 24세,1998,326,181,145
'4721037000,  순흥면,'30,25 - 29세,1998,192,120,72
'4721037000,  순흥면,'35,30 - 34세,1998,166,85,81
'4721037000,  순흥면,'40,35 - 39세,1998,203,116,87
'4721037000,  순흥면,'45,40 - 44세,1998,210,107,103
'4721037000,  순흥면,'50,45 - 49세,1998,199,112,87
'4721037000,  순흥면,'55,50 - 54세,1998,158,75,83
'4721037000,  순흥면,'60,55 - 59세,1998,253,105,148
'4721037000,  순흥면,'65,60 - 64세,1998,266,121,145
'4721037000,  순흥면,'70,65 - 69세,1998,177,71,106
'4721037000,  순흥면,'75,70 - 74세,1998,167,77,90
'4721037000,  순흥면,'80,75 - 79세,1998,111,47,64
'4721037000,  순흥면,'85,80 - 84세,1998,89,38,51
'4721037000,  순흥면,'90,85+ ,1998,36,14,22
'4721038000,  단산면,'00,계,1998,3124,1571,1553
'4721038000,  단산면,'05,0 - 4세,1998,79,44,35
'4721038000,  단산면,'10,5 - 9세,1998,90,55,35
'4721038000,  단산면,'15,10 - 14세,1998,153,70,83
'4721038000,  단산면,'20,15 - 19세,1998,277,155,122
'4721038000,  단산면,'25,20 - 24세,1998,315,183,132
'4721038000,  단산면,'30,25 - 29세,1998,185,125,60
'4721038000,  단산면,'35,30 - 34세,1998,135,76,59
'4721038000,  단산면,'40,35 - 39세,1998,173,90,83
'4721038000,  단산면,'45,40 - 44세,1998,175,95,80
'4721038000,  단산면,'50,45 - 49세,1998,193,80,113
'4721038000,  단산면,'55,50 - 54세,1998,177,94,83
'4721038000,  단산면,'60,55 - 59세,1998,271,119,152
'4721038000,  단산면,'65,60 - 64세,1998,261,119,142
'4721038000,  단산면,'70,65 - 69세,1998,262,112,150
'4721038000,  단산면,'75,70 - 74세,1998,161,65,96
'4721038000,  단산면,'80,75 - 79세,1998,115,48,67
'4721038000,  단산면,'85,80 - 84세,1998,59,26,33
'4721038000,  단산면,'90,85+ ,1998,43,15,28
'4721039000,  부석면,'00,계,1998,5119,2622,2497
'4721039000,  부석면,'05,0 - 4세,1998,130,73,57
'4721039000,  부석면,'10,5 - 9세,1998,167,91,76
'4721039000,  부석면,'15,10 - 14세,1998,294,150,144
'4721039000,  부석면,'20,15 - 19세,1998,538,282,256
'4721039000,  부석면,'25,20 - 24세,1998,559,332,227
'4721039000,  부석면,'30,25 - 29세,1998,303,210,93
'4721039000,  부석면,'35,30 - 34세,1998,222,126,96
'4721039000,  부석면,'40,35 - 39세,1998,324,177,147
'4721039000,  부석면,'45,40 - 44세,1998,351,169,182
'4721039000,  부석면,'50,45 - 49세,1998,293,150,143
'4721039000,  부석면,'55,50 - 54세,1998,311,158,153
'4721039000,  부석면,'60,55 - 59세,1998,419,189,230
'4721039000,  부석면,'65,60 - 64세,1998,418,184,234
'4721039000,  부석면,'70,65 - 69세,1998,281,132,149
'4721039000,  부석면,'75,70 - 74세,1998,210,86,124
'4721039000,  부석면,'80,75 - 79세,1998,159,64,95
'4721039000,  부석면,'85,80 - 84세,1998,93,35,58
'4721039000,  부석면,'90,85+ ,1998,47,14,33
'4721051000,  상망동,'00,계,1998,8432,4324,4108
'4721051000,  상망동,'05,0 - 4세,1998,619,347,272
'4721051000,  상망동,'10,5 - 9세,1998,498,286,212
'4721051000,  상망동,'15,10 - 14세,1998,528,299,229
'4721051000,  상망동,'20,15 - 19세,1998,811,412,399
'4721051000,  상망동,'25,20 - 24세,1998,796,452,344
'4721051000,  상망동,'30,25 - 29세,1998,806,398,408
'4721051000,  상망동,'35,30 - 34세,1998,726,398,328
'4721051000,  상망동,'40,35 - 39세,1998,674,347,327
'4721051000,  상망동,'45,40 - 44세,1998,570,277,293
'4721051000,  상망동,'50,45 - 49세,1998,474,240,234
'4721051000,  상망동,'55,50 - 54세,1998,386,194,192
'4721051000,  상망동,'60,55 - 59세,1998,500,236,264
'4721051000,  상망동,'65,60 - 64세,1998,372,195,177
'4721051000,  상망동,'70,65 - 69세,1998,223,81,142
'4721051000,  상망동,'75,70 - 74세,1998,186,72,114
'4721051000,  상망동,'80,75 - 79세,1998,122,50,72
'4721051000,  상망동,'85,80 - 84세,1998,91,27,64
'4721051000,  상망동,'90,85+ ,1998,50,13,37
'4721052500,  하망동,'00,계,1998,8322,4127,4195
'4721052500,  하망동,'05,0 - 4세,1998,406,228,178
'4721052500,  하망동,'10,5 - 9세,1998,508,297,211
'4721052500,  하망동,'15,10 - 14세,1998,617,335,282
'4721052500,  하망동,'20,15 - 19세,1998,920,484,436
'4721052500,  하망동,'25,20 - 24세,1998,841,445,396
'4721052500,  하망동,'30,25 - 29세,1998,611,332,279
'4721052500,  하망동,'35,30 - 34세,1998,513,276,237
'4721052500,  하망동,'40,35 - 39세,1998,708,305,403
'4721052500,  하망동,'45,40 - 44세,1998,714,332,382
'4721052500,  하망동,'50,45 - 49세,1998,585,280,305
'4721052500,  하망동,'55,50 - 54세,1998,436,216,220
'4721052500,  하망동,'60,55 - 59세,1998,453,209,244
'4721052500,  하망동,'65,60 - 64세,1998,357,161,196
'4721052500,  하망동,'70,65 - 69세,1998,240,86,154
'4721052500,  하망동,'75,70 - 74세,1998,162,54,108
'4721052500,  하망동,'80,75 - 79세,1998,136,49,87
'4721052500,  하망동,'85,80 - 84세,1998,60,18,42
'4721052500,  하망동,'90,85+ ,1998,55,20,35
'4721055000,  영주1동,'00,계,1998,9134,4520,4614
'4721055000,  영주1동,'05,0 - 4세,1998,364,189,175
'4721055000,  영주1동,'10,5 - 9세,1998,462,244,218
'4721055000,  영주1동,'15,10 - 14세,1998,617,337,280
'4721055000,  영주1동,'20,15 - 19세,1998,1033,513,520
'4721055000,  영주1동,'25,20 - 24세,1998,941,525,416
'4721055000,  영주1동,'30,25 - 29세,1998,678,402,276
'4721055000,  영주1동,'35,30 - 34세,1998,536,279,257
'4721055000,  영주1동,'40,35 - 39세,1998,725,329,396
'4721055000,  영주1동,'45,40 - 44세,1998,734,360,374
'4721055000,  영주1동,'50,45 - 49세,1998,644,302,342
'4721055000,  영주1동,'55,50 - 54세,1998,513,220,293
'4721055000,  영주1동,'60,55 - 59세,1998,631,305,326
'4721055000,  영주1동,'65,60 - 64세,1998,453,222,231
'4721055000,  영주1동,'70,65 - 69세,1998,323,130,193
'4721055000,  영주1동,'75,70 - 74세,1998,212,81,131
'4721055000,  영주1동,'80,75 - 79세,1998,121,47,74
'4721055000,  영주1동,'85,80 - 84세,1998,94,24,70
'4721055000,  영주1동,'90,85+ ,1998,53,11,42
'4721056000,  영주2동,'00,계,1998,6880,3395,3485
'4721056000,  영주2동,'05,0 - 4세,1998,390,214,176
'4721056000,  영주2동,'10,5 - 9세,1998,438,244,194
'4721056000,  영주2동,'15,10 - 14세,1998,505,259,246
'4721056000,  영주2동,'20,15 - 19세,1998,781,412,369
'4721056000,  영주2동,'25,20 - 24세,1998,637,330,307
'4721056000,  영주2동,'30,25 - 29세,1998,511,284,227
'4721056000,  영주2동,'35,30 - 34세,1998,472,215,257
'4721056000,  영주2동,'40,35 - 39세,1998,606,279,327
'4721056000,  영주2동,'45,40 - 44세,1998,632,289,343
'4721056000,  영주2동,'50,45 - 49세,1998,440,225,215
'4721056000,  영주2동,'55,50 - 54세,1998,366,175,191
'4721056000,  영주2동,'60,55 - 59세,1998,343,170,173
'4721056000,  영주2동,'65,60 - 64세,1998,258,113,145
'4721056000,  영주2동,'70,65 - 69세,1998,194,76,118
'4721056000,  영주2동,'75,70 - 74세,1998,136,51,85
'4721056000,  영주2동,'80,75 - 79세,1998,92,36,56
'4721056000,  영주2동,'85,80 - 84세,1998,41,12,29
'4721056000,  영주2동,'90,85+ ,1998,38,11,27
'4721059000,  휴천1동,'00,계,1998,6626,3306,3320
'4721059000,  휴천1동,'05,0 - 4세,1998,512,276,236
'4721059000,  휴천1동,'10,5 - 9세,1998,427,236,191
'4721059000,  휴천1동,'15,10 - 14세,1998,457,259,198
'4721059000,  휴천1동,'20,15 - 19세,1998,657,342,315
'4721059000,  휴천1동,'25,20 - 24세,1998,637,315,322
'4721059000,  휴천1동,'30,25 - 29세,1998,681,332,349
'4721059000,  휴천1동,'35,30 - 34세,1998,597,326,271
'4721059000,  휴천1동,'40,35 - 39세,1998,522,258,264
'4721059000,  휴천1동,'45,40 - 44세,1998,496,233,263
'4721059000,  휴천1동,'50,45 - 49세,1998,391,188,203
'4721059000,  휴천1동,'55,50 - 54세,1998,280,147,133
'4721059000,  휴천1동,'60,55 - 59세,1998,317,151,166
'4721059000,  휴천1동,'65,60 - 64세,1998,235,99,136
'4721059000,  휴천1동,'70,65 - 69세,1998,132,45,87
'4721059000,  휴천1동,'75,70 - 74세,1998,111,43,68
'4721059000,  휴천1동,'80,75 - 79세,1998,63,26,37
'4721059000,  휴천1동,'85,80 - 84세,1998,72,22,50
'4721059000,  휴천1동,'90,85+ ,1998,39,8,31
'4721060000,  휴천2동,'00,계,1998,14425,7125,7300
'4721060000,  휴천2동,'05,0 - 4세,1998,1055,550,505
'4721060000,  휴천2동,'10,5 - 9세,1998,1100,598,502
'4721060000,  휴천2동,'15,10 - 14세,1998,1101,607,494
'4721060000,  휴천2동,'20,15 - 19세,1998,1390,704,686
'4721060000,  휴천2동,'25,20 - 24세,1998,1249,665,584
'4721060000,  휴천2동,'30,25 - 29세,1998,1125,555,570
'4721060000,  휴천2동,'35,30 - 34세,1998,1187,535,652
'4721060000,  휴천2동,'40,35 - 39세,1998,1439,702,737
'4721060000,  휴천2동,'45,40 - 44세,1998,1168,593,575
'4721060000,  휴천2동,'50,45 - 49세,1998,848,387,461
'4721060000,  휴천2동,'55,50 - 54세,1998,650,334,316
'4721060000,  휴천2동,'60,55 - 59세,1998,692,321,371
'4721060000,  휴천2동,'65,60 - 64세,1998,512,251,261
'4721060000,  휴천2동,'70,65 - 69세,1998,328,128,200
'4721060000,  휴천2동,'75,70 - 74세,1998,254,97,157
'4721060000,  휴천2동,'80,75 - 79세,1998,167,58,109
'4721060000,  휴천2동,'85,80 - 84세,1998,107,31,76
'4721060000,  휴천2동,'90,85+ ,1998,53,9,44
'4721061000,  휴천3동,'00,계,1998,11995,5989,6006
'4721061000,  휴천3동,'05,0 - 4세,1998,956,525,431
'4721061000,  휴천3동,'10,5 - 9세,1998,925,496,429
'4721061000,  휴천3동,'15,10 - 14세,1998,915,498,417
'4721061000,  휴천3동,'20,15 - 19세,1998,1170,601,569
'4721061000,  휴천3동,'25,20 - 24세,1998,1008,521,487
'4721061000,  휴천3동,'30,25 - 29세,1998,993,485,508
'4721061000,  휴천3동,'35,30 - 34세,1998,1124,556,568
'4721061000,  휴천3동,'40,35 - 39세,1998,1113,542,571
'4721061000,  휴천3동,'45,40 - 44세,1998,949,474,475
'4721061000,  휴천3동,'50,45 - 49세,1998,709,364,345
'4721061000,  휴천3동,'55,50 - 54세,1998,476,253,223
'4721061000,  휴천3동,'60,55 - 59세,1998,504,226,278
'4721061000,  휴천3동,'65,60 - 64세,1998,369,181,188
'4721061000,  휴천3동,'70,65 - 69세,1998,287,114,173
'4721061000,  휴천3동,'75,70 - 74세,1998,214,64,150
'4721061000,  휴천3동,'80,75 - 79세,1998,154,55,99
'4721061000,  휴천3동,'85,80 - 84세,1998,89,27,62
'4721061000,  휴천3동,'90,85+ ,1998,40,7,33
'4721062000,  가흥1동,'00,계,1998,13161,6518,6643
'4721062000,  가흥1동,'05,0 - 4세,1998,796,425,371
'4721062000,  가흥1동,'10,5 - 9세,1998,788,428,360
'4721062000,  가흥1동,'15,10 - 14세,1998,934,500,434
'4721062000,  가흥1동,'20,15 - 19세,1998,1460,757,703
'4721062000,  가흥1동,'25,20 - 24세,1998,1362,760,602
'4721062000,  가흥1동,'30,25 - 29세,1998,1082,571,511
'4721062000,  가흥1동,'35,30 - 34세,1998,1010,498,512
'4721062000,  가흥1동,'40,35 - 39세,1998,1063,522,541
'4721062000,  가흥1동,'45,40 - 44세,1998,999,462,537
'4721062000,  가흥1동,'50,45 - 49세,1998,824,378,446
'4721062000,  가흥1동,'55,50 - 54세,1998,642,307,335
'4721062000,  가흥1동,'60,55 - 59세,1998,681,338,343
'4721062000,  가흥1동,'65,60 - 64세,1998,577,259,318
'4721062000,  가흥1동,'70,65 - 69세,1998,373,142,231
'4721062000,  가흥1동,'75,70 - 74세,1998,233,77,156
'4721062000,  가흥1동,'80,75 - 79세,1998,155,51,104
'4721062000,  가흥1동,'85,80 - 84세,1998,117,31,86
'4721062000,  가흥1동,'90,85+ ,1998,65,12,53
'4721063000,  가흥2동,'00,계,1998,5973,3002,2971
'4721063000,  가흥2동,'05,0 - 4세,1998,350,176,174
'4721063000,  가흥2동,'10,5 - 9세,1998,432,243,189
'4721063000,  가흥2동,'15,10 - 14세,1998,465,247,218
'4721063000,  가흥2동,'20,15 - 19세,1998,560,279,281
'4721063000,  가흥2동,'25,20 - 24세,1998,539,290,249
'4721063000,  가흥2동,'30,25 - 29세,1998,488,271,217
'4721063000,  가흥2동,'35,30 - 34세,1998,425,198,227
'4721063000,  가흥2동,'40,35 - 39세,1998,572,284,288
'4721063000,  가흥2동,'45,40 - 44세,1998,456,249,207
'4721063000,  가흥2동,'50,45 - 49세,1998,324,163,161
'4721063000,  가흥2동,'55,50 - 54세,1998,251,126,125
'4721063000,  가흥2동,'60,55 - 59세,1998,314,151,163
'4721063000,  가흥2동,'65,60 - 64세,1998,289,125,164
'4721063000,  가흥2동,'70,65 - 69세,1998,164,65,99
'4721063000,  가흥2동,'75,70 - 74세,1998,168,73,95
'4721063000,  가흥2동,'80,75 - 79세,1998,80,29,51
'4721063000,  가흥2동,'85,80 - 84세,1998,55,21,34
'4721063000,  가흥2동,'90,85+ ,1998,41,12,29
'47230, 영천시,'00,계,1998,122609,61317,61292
'47230, 영천시,'05,0 - 4세,1998,7267,3835,3432
'47230, 영천시,'10,5 - 9세,1998,7043,3918,3125
'47230, 영천시,'15,10 - 14세,1998,6716,3581,3135
'47230, 영천시,'20,15 - 19세,1998,9709,4844,4865
'47230, 영천시,'25,20 - 24세,1998,10685,5728,4957
'47230, 영천시,'30,25 - 29세,1998,11089,6079,5010
'47230, 영천시,'35,30 - 34세,1998,9420,5147,4273
'47230, 영천시,'40,35 - 39세,1998,9172,4827,4345
'47230, 영천시,'45,40 - 44세,1998,7713,4071,3642
'47230, 영천시,'50,45 - 49세,1998,6874,3359,3515
'47230, 영천시,'55,50 - 54세,1998,6306,3014,3292
'47230, 영천시,'60,55 - 59세,1998,8458,3733,4725
'47230, 영천시,'65,60 - 64세,1998,7855,3407,4448
'47230, 영천시,'70,65 - 69세,1998,5966,2467,3499
'47230, 영천시,'75,70 - 74세,1998,4024,1723,2301
'47230, 영천시,'80,75 - 79세,1998,2452,982,1470
'47230, 영천시,'85,80 - 84세,1998,1262,444,818
'47230, 영천시,'90,85+ ,1998,598,158,440
'4723025000,  금호읍,'00,계,1998,15168,7615,7553
'4723025000,  금호읍,'05,0 - 4세,1998,960,505,455
'4723025000,  금호읍,'10,5 - 9세,1998,794,460,334
'4723025000,  금호읍,'15,10 - 14세,1998,595,315,280
'4723025000,  금호읍,'20,15 - 19세,1998,1058,524,534
'4723025000,  금호읍,'25,20 - 24세,1998,1402,706,696
'4723025000,  금호읍,'30,25 - 29세,1998,1790,972,818
'4723025000,  금호읍,'35,30 - 34세,1998,1322,743,579
'4723025000,  금호읍,'40,35 - 39세,1998,1083,605,478
'4723025000,  금호읍,'45,40 - 44세,1998,868,450,418
'4723025000,  금호읍,'50,45 - 49세,1998,788,379,409
'4723025000,  금호읍,'55,50 - 54세,1998,771,366,405
'4723025000,  금호읍,'60,55 - 59세,1998,1132,478,654
'4723025000,  금호읍,'65,60 - 64세,1998,991,452,539
'4723025000,  금호읍,'70,65 - 69세,1998,679,289,390
'4723025000,  금호읍,'75,70 - 74세,1998,461,201,260
'4723025000,  금호읍,'80,75 - 79세,1998,280,108,172
'4723025000,  금호읍,'85,80 - 84세,1998,129,47,82
'4723025000,  금호읍,'90,85+ ,1998,65,15,50
'4723031000,  청통면,'00,계,1998,6097,3119,2978
'4723031000,  청통면,'05,0 - 4세,1998,241,121,120
'4723031000,  청통면,'10,5 - 9세,1998,251,150,101
'4723031000,  청통면,'15,10 - 14세,1998,289,149,140
'4723031000,  청통면,'20,15 - 19세,1998,482,242,240
'4723031000,  청통면,'25,20 - 24세,1998,589,333,256
'4723031000,  청통면,'30,25 - 29세,1998,485,291,194
'4723031000,  청통면,'35,30 - 34세,1998,353,206,147
'4723031000,  청통면,'40,35 - 39세,1998,373,209,164
'4723031000,  청통면,'45,40 - 44세,1998,397,227,170
'4723031000,  청통면,'50,45 - 49세,1998,400,182,218
'4723031000,  청통면,'55,50 - 54세,1998,408,219,189
'4723031000,  청통면,'60,55 - 59세,1998,501,215,286
'4723031000,  청통면,'65,60 - 64세,1998,475,230,245
'4723031000,  청통면,'70,65 - 69세,1998,357,140,217
'4723031000,  청통면,'75,70 - 74세,1998,226,107,119
'4723031000,  청통면,'80,75 - 79세,1998,137,51,86
'4723031000,  청통면,'85,80 - 84세,1998,97,37,60
'4723031000,  청통면,'90,85+ ,1998,36,10,26
'4723032000,  신녕면,'00,계,1998,6317,3181,3136
'4723032000,  신녕면,'05,0 - 4세,1998,242,133,109
'4723032000,  신녕면,'10,5 - 9세,1998,293,161,132
'4723032000,  신녕면,'15,10 - 14세,1998,286,144,142
'4723032000,  신녕면,'20,15 - 19세,1998,532,275,257
'4723032000,  신녕면,'25,20 - 24세,1998,601,351,250
'4723032000,  신녕면,'30,25 - 29세,1998,446,276,170
'4723032000,  신녕면,'35,30 - 34세,1998,307,172,135
'4723032000,  신녕면,'40,35 - 39세,1998,403,216,187
'4723032000,  신녕면,'45,40 - 44세,1998,417,226,191
'4723032000,  신녕면,'50,45 - 49세,1998,375,187,188
'4723032000,  신녕면,'55,50 - 54세,1998,355,170,185
'4723032000,  신녕면,'60,55 - 59세,1998,521,218,303
'4723032000,  신녕면,'65,60 - 64세,1998,496,224,272
'4723032000,  신녕면,'70,65 - 69세,1998,435,171,264
'4723032000,  신녕면,'75,70 - 74세,1998,291,128,163
'4723032000,  신녕면,'80,75 - 79세,1998,185,81,104
'4723032000,  신녕면,'85,80 - 84세,1998,89,27,62
'4723032000,  신녕면,'90,85+ ,1998,43,21,22
'4723033000,  화산면,'00,계,1998,4702,2373,2329
'4723033000,  화산면,'05,0 - 4세,1998,163,96,67
'4723033000,  화산면,'10,5 - 9세,1998,159,88,71
'4723033000,  화산면,'15,10 - 14세,1998,179,100,79
'4723033000,  화산면,'20,15 - 19세,1998,371,171,200
'4723033000,  화산면,'25,20 - 24세,1998,446,273,173
'4723033000,  화산면,'30,25 - 29세,1998,346,225,121
'4723033000,  화산면,'35,30 - 34세,1998,222,139,83
'4723033000,  화산면,'40,35 - 39세,1998,234,133,101
'4723033000,  화산면,'45,40 - 44세,1998,270,142,128
'4723033000,  화산면,'50,45 - 49세,1998,287,138,149
'4723033000,  화산면,'55,50 - 54세,1998,311,144,167
'4723033000,  화산면,'60,55 - 59세,1998,441,188,253
'4723033000,  화산면,'65,60 - 64세,1998,474,197,277
'4723033000,  화산면,'70,65 - 69세,1998,340,158,182
'4723033000,  화산면,'75,70 - 74세,1998,231,94,137
'4723033000,  화산면,'80,75 - 79세,1998,131,55,76
'4723033000,  화산면,'85,80 - 84세,1998,74,24,50
'4723033000,  화산면,'90,85+ ,1998,23,8,15
'4723034000,  화북면,'00,계,1998,3166,1621,1545
'4723034000,  화북면,'05,0 - 4세,1998,70,38,32
'4723034000,  화북면,'10,5 - 9세,1998,97,51,46
'4723034000,  화북면,'15,10 - 14세,1998,144,82,62
'4723034000,  화북면,'20,15 - 19세,1998,264,134,130
'4723034000,  화북면,'25,20 - 24세,1998,271,155,116
'4723034000,  화북면,'30,25 - 29세,1998,197,146,51
'4723034000,  화북면,'35,30 - 34세,1998,141,88,53
'4723034000,  화북면,'40,35 - 39세,1998,180,88,92
'4723034000,  화북면,'45,40 - 44세,1998,179,102,77
'4723034000,  화북면,'50,45 - 49세,1998,190,102,88
'4723034000,  화북면,'55,50 - 54세,1998,166,77,89
'4723034000,  화북면,'60,55 - 59세,1998,272,113,159
'4723034000,  화북면,'65,60 - 64세,1998,321,146,175
'4723034000,  화북면,'70,65 - 69세,1998,269,121,148
'4723034000,  화북면,'75,70 - 74세,1998,189,84,105
'4723034000,  화북면,'80,75 - 79세,1998,121,57,64
'4723034000,  화북면,'85,80 - 84세,1998,63,29,34
'4723034000,  화북면,'90,85+ ,1998,32,8,24
'4723035000,  화남면,'00,계,1998,4100,2086,2014
'4723035000,  화남면,'05,0 - 4세,1998,113,60,53
'4723035000,  화남면,'10,5 - 9세,1998,95,57,38
'4723035000,  화남면,'15,10 - 14세,1998,164,88,76
'4723035000,  화남면,'20,15 - 19세,1998,320,152,168
'4723035000,  화남면,'25,20 - 24세,1998,398,249,149
'4723035000,  화남면,'30,25 - 29세,1998,295,189,106
'4723035000,  화남면,'35,30 - 34세,1998,186,118,68
'4723035000,  화남면,'40,35 - 39세,1998,202,113,89
'4723035000,  화남면,'45,40 - 44세,1998,208,105,103
'4723035000,  화남면,'50,45 - 49세,1998,270,142,128
'4723035000,  화남면,'55,50 - 54세,1998,248,124,124
'4723035000,  화남면,'60,55 - 59세,1998,409,168,241
'4723035000,  화남면,'65,60 - 64세,1998,419,187,232
'4723035000,  화남면,'70,65 - 69세,1998,343,146,197
'4723035000,  화남면,'75,70 - 74세,1998,208,91,117
'4723035000,  화남면,'80,75 - 79세,1998,139,67,72
'4723035000,  화남면,'85,80 - 84세,1998,52,25,27
'4723035000,  화남면,'90,85+ ,1998,31,5,26
'4723036000,  자양면,'00,계,1998,1448,708,740
'4723036000,  자양면,'05,0 - 4세,1998,54,25,29
'4723036000,  자양면,'10,5 - 9세,1998,39,27,12
'4723036000,  자양면,'15,10 - 14세,1998,59,30,29
'4723036000,  자양면,'20,15 - 19세,1998,94,37,57
'4723036000,  자양면,'25,20 - 24세,1998,135,77,58
'4723036000,  자양면,'30,25 - 29세,1998,93,60,33
'4723036000,  자양면,'35,30 - 34세,1998,64,39,25
'4723036000,  자양면,'40,35 - 39세,1998,69,42,27
'4723036000,  자양면,'45,40 - 44세,1998,62,34,28
'4723036000,  자양면,'50,45 - 49세,1998,66,26,40
'4723036000,  자양면,'55,50 - 54세,1998,83,36,47
'4723036000,  자양면,'60,55 - 59세,1998,142,56,86
'4723036000,  자양면,'65,60 - 64세,1998,174,75,99
'4723036000,  자양면,'70,65 - 69세,1998,132,67,65
'4723036000,  자양면,'75,70 - 74세,1998,103,46,57
'4723036000,  자양면,'80,75 - 79세,1998,36,17,19
'4723036000,  자양면,'85,80 - 84세,1998,28,10,18
'4723036000,  자양면,'90,85+ ,1998,15,4,11
'4723037000,  임고면,'00,계,1998,5793,2924,2869
'4723037000,  임고면,'05,0 - 4세,1998,135,69,66
'4723037000,  임고면,'10,5 - 9세,1998,144,80,64
'4723037000,  임고면,'15,10 - 14세,1998,244,148,96
'4723037000,  임고면,'20,15 - 19세,1998,523,261,262
'4723037000,  임고면,'25,20 - 24세,1998,594,346,248
'4723037000,  임고면,'30,25 - 29세,1998,421,286,135
'4723037000,  임고면,'35,30 - 34세,1998,226,135,91
'4723037000,  임고면,'40,35 - 39세,1998,253,139,114
'4723037000,  임고면,'45,40 - 44세,1998,294,153,141
'4723037000,  임고면,'50,45 - 49세,1998,408,179,229
'4723037000,  임고면,'55,50 - 54세,1998,402,183,219
'4723037000,  임고면,'60,55 - 59세,1998,563,248,315
'4723037000,  임고면,'65,60 - 64세,1998,553,277,276
'4723037000,  임고면,'70,65 - 69세,1998,430,170,260
'4723037000,  임고면,'75,70 - 74세,1998,284,131,153
'4723037000,  임고면,'80,75 - 79세,1998,175,75,100
'4723037000,  임고면,'85,80 - 84세,1998,86,26,60
'4723037000,  임고면,'90,85+ ,1998,58,18,40
'4723038000,  고경면,'00,계,1998,8318,4094,4224
'4723038000,  고경면,'05,0 - 4세,1998,349,172,177
'4723038000,  고경면,'10,5 - 9세,1998,396,214,182
'4723038000,  고경면,'15,10 - 14세,1998,428,213,215
'4723038000,  고경면,'20,15 - 19세,1998,673,342,331
'4723038000,  고경면,'25,20 - 24세,1998,731,410,321
'4723038000,  고경면,'30,25 - 29세,1998,577,351,226
'4723038000,  고경면,'35,30 - 34세,1998,526,292,234
'4723038000,  고경면,'40,35 - 39세,1998,505,276,229
'4723038000,  고경면,'45,40 - 44세,1998,467,236,231
'4723038000,  고경면,'50,45 - 49세,1998,487,237,250
'4723038000,  고경면,'55,50 - 54세,1998,483,231,252
'4723038000,  고경면,'60,55 - 59세,1998,734,326,408
'4723038000,  고경면,'65,60 - 64세,1998,657,269,388
'4723038000,  고경면,'70,65 - 69세,1998,573,235,338
'4723038000,  고경면,'75,70 - 74세,1998,368,167,201
'4723038000,  고경면,'80,75 - 79세,1998,203,78,125
'4723038000,  고경면,'85,80 - 84세,1998,101,27,74
'4723038000,  고경면,'90,85+ ,1998,60,18,42
'4723039000,  북안면,'00,계,1998,6021,3057,2964
'4723039000,  북안면,'05,0 - 4세,1998,208,114,94
'4723039000,  북안면,'10,5 - 9세,1998,194,108,86
'4723039000,  북안면,'15,10 - 14세,1998,271,156,115
'4723039000,  북안면,'20,15 - 19세,1998,431,224,207
'4723039000,  북안면,'25,20 - 24세,1998,595,325,270
'4723039000,  북안면,'30,25 - 29세,1998,490,326,164
'4723039000,  북안면,'35,30 - 34세,1998,331,222,109
'4723039000,  북안면,'40,35 - 39세,1998,321,178,143
'4723039000,  북안면,'45,40 - 44세,1998,310,149,161
'4723039000,  북안면,'50,45 - 49세,1998,373,175,198
'4723039000,  북안면,'55,50 - 54세,1998,377,185,192
'4723039000,  북안면,'60,55 - 59세,1998,583,256,327
'4723039000,  북안면,'65,60 - 64세,1998,535,223,312
'4723039000,  북안면,'70,65 - 69세,1998,410,176,234
'4723039000,  북안면,'75,70 - 74세,1998,304,134,170
'4723039000,  북안면,'80,75 - 79세,1998,163,60,103
'4723039000,  북안면,'85,80 - 84세,1998,89,34,55
'4723039000,  북안면,'90,85+ ,1998,36,12,24
'4723040000,  대창면,'00,계,1998,4252,2161,2091
'4723040000,  대창면,'05,0 - 4세,1998,165,80,85
'4723040000,  대창면,'10,5 - 9세,1998,134,79,55
'4723040000,  대창면,'15,10 - 14세,1998,187,96,91
'4723040000,  대창면,'20,15 - 19세,1998,365,197,168
'4723040000,  대창면,'25,20 - 24세,1998,368,199,169
'4723040000,  대창면,'30,25 - 29세,1998,333,216,117
'4723040000,  대창면,'35,30 - 34세,1998,216,135,81
'4723040000,  대창면,'40,35 - 39세,1998,230,122,108
'4723040000,  대창면,'45,40 - 44세,1998,278,157,121
'4723040000,  대창면,'50,45 - 49세,1998,278,144,134
'4723040000,  대창면,'55,50 - 54세,1998,248,129,119
'4723040000,  대창면,'60,55 - 59세,1998,350,150,200
'4723040000,  대창면,'65,60 - 64세,1998,348,140,208
'4723040000,  대창면,'70,65 - 69세,1998,284,111,173
'4723040000,  대창면,'75,70 - 74세,1998,206,93,113
'4723040000,  대창면,'80,75 - 79세,1998,144,69,75
'4723040000,  대창면,'85,80 - 84세,1998,90,32,58
'4723040000,  대창면,'90,85+ ,1998,28,12,16
'4723051000,  동부동,'00,계,1998,26045,12923,13122
'4723051000,  동부동,'05,0 - 4세,1998,2858,1500,1358
'4723051000,  동부동,'10,5 - 9세,1998,2357,1269,1088
'4723051000,  동부동,'15,10 - 14세,1998,1886,1008,878
'4723051000,  동부동,'20,15 - 19세,1998,1834,944,890
'4723051000,  동부동,'25,20 - 24세,1998,1741,824,917
'4723051000,  동부동,'30,25 - 29세,1998,2854,1233,1621
'4723051000,  동부동,'35,30 - 34세,1998,3214,1691,1523
'4723051000,  동부동,'40,35 - 39세,1998,2846,1464,1382
'4723051000,  동부동,'45,40 - 44세,1998,1835,981,854
'4723051000,  동부동,'50,45 - 49세,1998,1048,535,513
'4723051000,  동부동,'55,50 - 54세,1998,768,379,389
'4723051000,  동부동,'60,55 - 59세,1998,821,373,448
'4723051000,  동부동,'65,60 - 64세,1998,750,288,462
'4723051000,  동부동,'70,65 - 69세,1998,521,194,327
'4723051000,  동부동,'75,70 - 74세,1998,339,126,213
'4723051000,  동부동,'80,75 - 79세,1998,218,75,143
'4723051000,  동부동,'85,80 - 84세,1998,106,35,71
'4723051000,  동부동,'90,85+ ,1998,49,4,45
'4723052000,  중앙동,'00,계,1998,10209,5047,5162
'4723052000,  중앙동,'05,0 - 4세,1998,665,357,308
'4723052000,  중앙동,'10,5 - 9세,1998,845,465,380
'4723052000,  중앙동,'15,10 - 14세,1998,694,373,321
'4723052000,  중앙동,'20,15 - 19세,1998,819,382,437
'4723052000,  중앙동,'25,20 - 24세,1998,823,449,374
'4723052000,  중앙동,'30,25 - 29세,1998,902,464,438
'4723052000,  중앙동,'35,30 - 34세,1998,852,414,438
'4723052000,  중앙동,'40,35 - 39세,1998,896,452,444
'4723052000,  중앙동,'45,40 - 44세,1998,718,375,343
'4723052000,  중앙동,'50,45 - 49세,1998,552,272,280
'4723052000,  중앙동,'55,50 - 54세,1998,491,215,276
'4723052000,  중앙동,'60,55 - 59세,1998,578,281,297
'4723052000,  중앙동,'65,60 - 64세,1998,498,226,272
'4723052000,  중앙동,'70,65 - 69세,1998,343,134,209
'4723052000,  중앙동,'75,70 - 74세,1998,263,98,165
'4723052000,  중앙동,'80,75 - 79세,1998,163,53,110
'4723052000,  중앙동,'85,80 - 84세,1998,73,32,41
'4723052000,  중앙동,'90,85+ ,1998,34,5,29
'4723053500,  서부동,'00,계,1998,8777,4292,4485
'4723053500,  서부동,'05,0 - 4세,1998,432,218,214
'4723053500,  서부동,'10,5 - 9세,1998,512,297,215
'4723053500,  서부동,'15,10 - 14세,1998,581,295,286
'4723053500,  서부동,'20,15 - 19세,1998,861,413,448
'4723053500,  서부동,'25,20 - 24세,1998,819,427,392
'4723053500,  서부동,'30,25 - 29세,1998,744,405,339
'4723053500,  서부동,'35,30 - 34세,1998,611,319,292
'4723053500,  서부동,'40,35 - 39세,1998,673,327,346
'4723053500,  서부동,'45,40 - 44세,1998,612,320,292
'4723053500,  서부동,'50,45 - 49세,1998,558,265,293
'4723053500,  서부동,'55,50 - 54세,1998,498,241,257
'4723053500,  서부동,'60,55 - 59세,1998,533,245,288
'4723053500,  서부동,'65,60 - 64세,1998,467,186,281
'4723053500,  서부동,'70,65 - 69세,1998,348,148,200
'4723053500,  서부동,'75,70 - 74세,1998,239,94,145
'4723053500,  서부동,'80,75 - 79세,1998,169,67,102
'4723053500,  서부동,'85,80 - 84세,1998,85,20,65
'4723053500,  서부동,'90,85+ ,1998,35,5,30
'4723054000,  완산동,'00,계,1998,6193,3074,3119
'4723054000,  완산동,'05,0 - 4세,1998,305,177,128
'4723054000,  완산동,'10,5 - 9세,1998,392,223,169
'4723054000,  완산동,'15,10 - 14세,1998,384,194,190
'4723054000,  완산동,'20,15 - 19세,1998,546,288,258
'4723054000,  완산동,'25,20 - 24세,1998,581,282,299
'4723054000,  완산동,'30,25 - 29세,1998,556,316,240
'4723054000,  완산동,'35,30 - 34세,1998,418,196,222
'4723054000,  완산동,'40,35 - 39세,1998,493,242,251
'4723054000,  완산동,'45,40 - 44세,1998,433,221,212
'4723054000,  완산동,'50,45 - 49세,1998,442,214,228
'4723054000,  완산동,'55,50 - 54세,1998,372,156,216
'4723054000,  완산동,'60,55 - 59세,1998,441,216,225
'4723054000,  완산동,'65,60 - 64세,1998,320,134,186
'4723054000,  완산동,'70,65 - 69세,1998,222,95,127
'4723054000,  완산동,'75,70 - 74세,1998,135,60,75
'4723054000,  완산동,'80,75 - 79세,1998,81,33,48
'4723054000,  완산동,'85,80 - 84세,1998,43,16,27
'4723054000,  완산동,'90,85+ ,1998,29,11,18
'4723055500,  남부동,'00,계,1998,6003,3042,2961
'4723055500,  남부동,'05,0 - 4세,1998,307,170,137
'4723055500,  남부동,'10,5 - 9세,1998,341,189,152
'4723055500,  남부동,'15,10 - 14세,1998,325,190,135
'4723055500,  남부동,'20,15 - 19세,1998,536,258,278
'4723055500,  남부동,'25,20 - 24세,1998,591,322,269
'4723055500,  남부동,'30,25 - 29세,1998,560,323,237
'4723055500,  남부동,'35,30 - 34세,1998,431,238,193
'4723055500,  남부동,'40,35 - 39세,1998,411,221,190
'4723055500,  남부동,'45,40 - 44세,1998,365,193,172
'4723055500,  남부동,'50,45 - 49세,1998,352,182,170
'4723055500,  남부동,'55,50 - 54세,1998,325,159,166
'4723055500,  남부동,'60,55 - 59세,1998,437,202,235
'4723055500,  남부동,'65,60 - 64세,1998,377,153,224
'4723055500,  남부동,'70,65 - 69세,1998,280,112,168
'4723055500,  남부동,'75,70 - 74세,1998,177,69,108
'4723055500,  남부동,'80,75 - 79세,1998,107,36,71
'4723055500,  남부동,'85,80 - 84세,1998,57,23,34
'4723055500,  남부동,'90,85+ ,1998,24,2,22
'47250, 상주시,'00,계,1998,129259,64018,65241
'47250, 상주시,'05,0 - 4세,1998,6078,3233,2845
'47250, 상주시,'10,5 - 9세,1998,6689,3605,3084
'47250, 상주시,'15,10 - 14세,1998,8116,4221,3895
'47250, 상주시,'20,15 - 19세,1998,11655,6025,5630
'47250, 상주시,'25,20 - 24세,1998,11342,6650,4692
'47250, 상주시,'30,25 - 29세,1998,8721,5041,3680
'47250, 상주시,'35,30 - 34세,1998,7701,4013,3688
'47250, 상주시,'40,35 - 39세,1998,9027,4515,4512
'47250, 상주시,'45,40 - 44세,1998,8723,4402,4321
'47250, 상주시,'50,45 - 49세,1998,7579,3719,3860
'47250, 상주시,'55,50 - 54세,1998,6555,3062,3493
'47250, 상주시,'60,55 - 59세,1998,9275,4117,5158
'47250, 상주시,'65,60 - 64세,1998,9138,4061,5077
'47250, 상주시,'70,65 - 69세,1998,6749,2812,3937
'47250, 상주시,'75,70 - 74세,1998,5169,2199,2970
'47250, 상주시,'80,75 - 79세,1998,3602,1388,2214
'47250, 상주시,'85,80 - 84세,1998,2030,686,1344
'47250, 상주시,'90,85+ ,1998,1110,269,841
'4725025000,  함창읍,'00,계,1998,9767,4862,4905
'4725025000,  함창읍,'05,0 - 4세,1998,332,178,154
'4725025000,  함창읍,'10,5 - 9세,1998,413,234,179
'4725025000,  함창읍,'15,10 - 14세,1998,574,302,272
'4725025000,  함창읍,'20,15 - 19세,1998,990,529,461
'4725025000,  함창읍,'25,20 - 24세,1998,964,569,395
'4725025000,  함창읍,'30,25 - 29세,1998,592,382,210
'4725025000,  함창읍,'35,30 - 34세,1998,440,237,203
'4725025000,  함창읍,'40,35 - 39세,1998,672,319,353
'4725025000,  함창읍,'45,40 - 44세,1998,676,349,327
'4725025000,  함창읍,'50,45 - 49세,1998,646,310,336
'4725025000,  함창읍,'55,50 - 54세,1998,553,255,298
'4725025000,  함창읍,'60,55 - 59세,1998,727,326,401
'4725025000,  함창읍,'65,60 - 64세,1998,758,322,436
'4725025000,  함창읍,'70,65 - 69세,1998,517,224,293
'4725025000,  함창읍,'75,70 - 74세,1998,385,151,234
'4725025000,  함창읍,'80,75 - 79세,1998,271,107,164
'4725025000,  함창읍,'85,80 - 84세,1998,163,57,106
'4725025000,  함창읍,'90,85+ ,1998,94,11,83
'4725031000,  중동면,'00,계,1998,2371,1166,1205
'4725031000,  중동면,'05,0 - 4세,1998,50,28,22
'4725031000,  중동면,'10,5 - 9세,1998,73,49,24
'4725031000,  중동면,'15,10 - 14세,1998,116,46,70
'4725031000,  중동면,'20,15 - 19세,1998,199,111,88
'4725031000,  중동면,'25,20 - 24세,1998,229,134,95
'4725031000,  중동면,'30,25 - 29세,1998,149,106,43
'4725031000,  중동면,'35,30 - 34세,1998,83,48,35
'4725031000,  중동면,'40,35 - 39세,1998,101,57,44
'4725031000,  중동면,'45,40 - 44세,1998,130,68,62
'4725031000,  중동면,'50,45 - 49세,1998,153,67,86
'4725031000,  중동면,'55,50 - 54세,1998,148,64,84
'4725031000,  중동면,'60,55 - 59세,1998,226,94,132
'4725031000,  중동면,'65,60 - 64세,1998,234,111,123
'4725031000,  중동면,'70,65 - 69세,1998,170,65,105
'4725031000,  중동면,'75,70 - 74세,1998,139,61,78
'4725031000,  중동면,'80,75 - 79세,1998,86,34,52
'4725031000,  중동면,'85,80 - 84세,1998,58,19,39
'4725031000,  중동면,'90,85+ ,1998,27,4,23
'4725032000,  사벌면,'00,계,1998,5871,2907,2964
'4725032000,  사벌면,'05,0 - 4세,1998,163,81,82
'4725032000,  사벌면,'10,5 - 9세,1998,190,112,78
'4725032000,  사벌면,'15,10 - 14세,1998,292,160,132
'4725032000,  사벌면,'20,15 - 19세,1998,542,289,253
'4725032000,  사벌면,'25,20 - 24세,1998,537,345,192
'4725032000,  사벌면,'30,25 - 29세,1998,310,196,114
'4725032000,  사벌면,'35,30 - 34세,1998,242,139,103
'4725032000,  사벌면,'40,35 - 39세,1998,309,167,142
'4725032000,  사벌면,'45,40 - 44세,1998,356,169,187
'4725032000,  사벌면,'50,45 - 49세,1998,355,172,183
'4725032000,  사벌면,'55,50 - 54세,1998,323,148,175
'4725032000,  사벌면,'60,55 - 59세,1998,583,240,343
'4725032000,  사벌면,'65,60 - 64세,1998,583,252,331
'4725032000,  사벌면,'70,65 - 69세,1998,374,156,218
'4725032000,  사벌면,'75,70 - 74세,1998,322,140,182
'4725032000,  사벌면,'80,75 - 79세,1998,220,80,140
'4725032000,  사벌면,'85,80 - 84세,1998,109,45,64
'4725032000,  사벌면,'90,85+ ,1998,61,16,45
'4725033000,  낙동면,'00,계,1998,6237,3099,3138
'4725033000,  낙동면,'05,0 - 4세,1998,202,94,108
'4725033000,  낙동면,'10,5 - 9세,1998,200,109,91
'4725033000,  낙동면,'15,10 - 14세,1998,320,169,151
'4725033000,  낙동면,'20,15 - 19세,1998,519,271,248
'4725033000,  낙동면,'25,20 - 24세,1998,535,327,208
'4725033000,  낙동면,'30,25 - 29세,1998,347,222,125
'4725033000,  낙동면,'35,30 - 34세,1998,290,185,105
'4725033000,  낙동면,'40,35 - 39세,1998,349,190,159
'4725033000,  낙동면,'45,40 - 44세,1998,359,185,174
'4725033000,  낙동면,'50,45 - 49세,1998,332,135,197
'4725033000,  낙동면,'55,50 - 54세,1998,342,164,178
'4725033000,  낙동면,'60,55 - 59세,1998,604,262,342
'4725033000,  낙동면,'65,60 - 64세,1998,648,281,367
'4725033000,  낙동면,'70,65 - 69세,1998,457,203,254
'4725033000,  낙동면,'75,70 - 74세,1998,304,152,152
'4725033000,  낙동면,'80,75 - 79세,1998,249,95,154
'4725033000,  낙동면,'85,80 - 84세,1998,129,46,83
'4725033000,  낙동면,'90,85+ ,1998,51,9,42
'4725034000,  청리면,'00,계,1998,4827,2326,2501
'4725034000,  청리면,'05,0 - 4세,1998,137,74,63
'4725034000,  청리면,'10,5 - 9세,1998,199,95,104
'4725034000,  청리면,'15,10 - 14세,1998,318,159,159
'4725034000,  청리면,'20,15 - 19세,1998,430,206,224
'4725034000,  청리면,'25,20 - 24세,1998,406,248,158
'4725034000,  청리면,'30,25 - 29세,1998,238,160,78
'4725034000,  청리면,'35,30 - 34세,1998,202,123,79
'4725034000,  청리면,'40,35 - 39세,1998,286,121,165
'4725034000,  청리면,'45,40 - 44세,1998,295,165,130
'4725034000,  청리면,'50,45 - 49세,1998,284,133,151
'4725034000,  청리면,'55,50 - 54세,1998,252,112,140
'4725034000,  청리면,'60,55 - 59세,1998,412,172,240
'4725034000,  청리면,'65,60 - 64세,1998,455,214,241
'4725034000,  청리면,'70,65 - 69세,1998,315,117,198
'4725034000,  청리면,'75,70 - 74세,1998,241,105,136
'4725034000,  청리면,'80,75 - 79세,1998,188,80,108
'4725034000,  청리면,'85,80 - 84세,1998,105,31,74
'4725034000,  청리면,'90,85+ ,1998,64,11,53
'4725035000,  공성면,'00,계,1998,7027,3490,3537
'4725035000,  공성면,'05,0 - 4세,1998,220,126,94
'4725035000,  공성면,'10,5 - 9세,1998,259,130,129
'4725035000,  공성면,'15,10 - 14세,1998,406,212,194
'4725035000,  공성면,'20,15 - 19세,1998,694,344,350
'4725035000,  공성면,'25,20 - 24세,1998,662,396,266
'4725035000,  공성면,'30,25 - 29세,1998,412,260,152
'4725035000,  공성면,'35,30 - 34세,1998,308,190,118
'4725035000,  공성면,'40,35 - 39세,1998,384,195,189
'4725035000,  공성면,'45,40 - 44세,1998,460,210,250
'4725035000,  공성면,'50,45 - 49세,1998,423,221,202
'4725035000,  공성면,'55,50 - 54세,1998,398,198,200
'4725035000,  공성면,'60,55 - 59세,1998,563,244,319
'4725035000,  공성면,'65,60 - 64세,1998,575,259,316
'4725035000,  공성면,'70,65 - 69세,1998,442,179,263
'4725035000,  공성면,'75,70 - 74세,1998,379,161,218
'4725035000,  공성면,'80,75 - 79세,1998,246,98,148
'4725035000,  공성면,'85,80 - 84세,1998,120,46,74
'4725035000,  공성면,'90,85+ ,1998,76,21,55
'4725036000,  외남면,'00,계,1998,2579,1268,1311
'4725036000,  외남면,'05,0 - 4세,1998,63,24,39
'4725036000,  외남면,'10,5 - 9세,1998,61,32,29
'4725036000,  외남면,'15,10 - 14세,1998,138,70,68
'4725036000,  외남면,'20,15 - 19세,1998,208,113,95
'4725036000,  외남면,'25,20 - 24세,1998,245,144,101
'4725036000,  외남면,'30,25 - 29세,1998,143,101,42
'4725036000,  외남면,'35,30 - 34세,1998,103,61,42
'4725036000,  외남면,'40,35 - 39세,1998,134,73,61
'4725036000,  외남면,'45,40 - 44세,1998,145,78,67
'4725036000,  외남면,'50,45 - 49세,1998,165,80,85
'4725036000,  외남면,'55,50 - 54세,1998,140,61,79
'4725036000,  외남면,'60,55 - 59세,1998,242,106,136
'4725036000,  외남면,'65,60 - 64세,1998,247,120,127
'4725036000,  외남면,'70,65 - 69세,1998,191,64,127
'4725036000,  외남면,'75,70 - 74세,1998,149,65,84
'4725036000,  외남면,'80,75 - 79세,1998,119,46,73
'4725036000,  외남면,'85,80 - 84세,1998,55,22,33
'4725036000,  외남면,'90,85+ ,1998,31,8,23
'4725037000,  내서면,'00,계,1998,2692,1342,1350
'4725037000,  내서면,'05,0 - 4세,1998,82,40,42
'4725037000,  내서면,'10,5 - 9세,1998,96,52,44
'4725037000,  내서면,'15,10 - 14세,1998,144,60,84
'4725037000,  내서면,'20,15 - 19세,1998,207,108,99
'4725037000,  내서면,'25,20 - 24세,1998,230,153,77
'4725037000,  내서면,'30,25 - 29세,1998,132,87,45
'4725037000,  내서면,'35,30 - 34세,1998,118,70,48
'4725037000,  내서면,'40,35 - 39세,1998,146,71,75
'4725037000,  내서면,'45,40 - 44세,1998,168,91,77
'4725037000,  내서면,'50,45 - 49세,1998,142,74,68
'4725037000,  내서면,'55,50 - 54세,1998,143,68,75
'4725037000,  내서면,'60,55 - 59세,1998,229,106,123
'4725037000,  내서면,'65,60 - 64세,1998,263,109,154
'4725037000,  내서면,'70,65 - 69세,1998,216,90,126
'4725037000,  내서면,'75,70 - 74세,1998,172,87,85
'4725037000,  내서면,'80,75 - 79세,1998,103,42,61
'4725037000,  내서면,'85,80 - 84세,1998,63,26,37
'4725037000,  내서면,'90,85+ ,1998,38,8,30
'4725038000,  모동면,'00,계,1998,3616,1796,1820
'4725038000,  모동면,'05,0 - 4세,1998,131,74,57
'4725038000,  모동면,'10,5 - 9세,1998,177,86,91
'4725038000,  모동면,'15,10 - 14세,1998,211,99,112
'4725038000,  모동면,'20,15 - 19세,1998,309,143,166
'4725038000,  모동면,'25,20 - 24세,1998,301,203,98
'4725038000,  모동면,'30,25 - 29세,1998,197,128,69
'4725038000,  모동면,'35,30 - 34세,1998,176,90,86
'4725038000,  모동면,'40,35 - 39세,1998,240,126,114
'4725038000,  모동면,'45,40 - 44세,1998,244,124,120
'4725038000,  모동면,'50,45 - 49세,1998,221,116,105
'4725038000,  모동면,'55,50 - 54세,1998,212,98,114
'4725038000,  모동면,'60,55 - 59세,1998,280,121,159
'4725038000,  모동면,'65,60 - 64세,1998,294,143,151
'4725038000,  모동면,'70,65 - 69세,1998,222,94,128
'4725038000,  모동면,'75,70 - 74세,1998,195,77,118
'4725038000,  모동면,'80,75 - 79세,1998,122,50,72
'4725038000,  모동면,'85,80 - 84세,1998,55,15,40
'4725038000,  모동면,'90,85+ ,1998,29,9,20
'4725039000,  모서면,'00,계,1998,3749,1885,1864
'4725039000,  모서면,'05,0 - 4세,1998,99,52,47
'4725039000,  모서면,'10,5 - 9세,1998,153,79,74
'4725039000,  모서면,'15,10 - 14세,1998,204,96,108
'4725039000,  모서면,'20,15 - 19세,1998,344,171,173
'4725039000,  모서면,'25,20 - 24세,1998,339,218,121
'4725039000,  모서면,'30,25 - 29세,1998,206,142,64
'4725039000,  모서면,'35,30 - 34세,1998,161,93,68
'4725039000,  모서면,'40,35 - 39세,1998,221,120,101
'4725039000,  모서면,'45,40 - 44세,1998,214,104,110
'4725039000,  모서면,'50,45 - 49세,1998,221,124,97
'4725039000,  모서면,'55,50 - 54세,1998,209,88,121
'4725039000,  모서면,'60,55 - 59세,1998,319,136,183
'4725039000,  모서면,'65,60 - 64세,1998,349,158,191
'4725039000,  모서면,'70,65 - 69세,1998,279,121,158
'4725039000,  모서면,'75,70 - 74세,1998,197,94,103
'4725039000,  모서면,'80,75 - 79세,1998,135,55,80
'4725039000,  모서면,'85,80 - 84세,1998,64,16,48
'4725039000,  모서면,'90,85+ ,1998,35,18,17
'4725040000,  화동면,'00,계,1998,2859,1421,1438
'4725040000,  화동면,'05,0 - 4세,1998,70,29,41
'4725040000,  화동면,'10,5 - 9세,1998,115,54,61
'4725040000,  화동면,'15,10 - 14세,1998,159,87,72
'4725040000,  화동면,'20,15 - 19세,1998,262,135,127
'4725040000,  화동면,'25,20 - 24세,1998,257,159,98
'4725040000,  화동면,'30,25 - 29세,1998,128,83,45
'4725040000,  화동면,'35,30 - 34세,1998,111,57,54
'4725040000,  화동면,'40,35 - 39세,1998,157,84,73
'4725040000,  화동면,'45,40 - 44세,1998,191,102,89
'4725040000,  화동면,'50,45 - 49세,1998,175,85,90
'4725040000,  화동면,'55,50 - 54세,1998,180,87,93
'4725040000,  화동면,'60,55 - 59세,1998,264,139,125
'4725040000,  화동면,'65,60 - 64세,1998,244,108,136
'4725040000,  화동면,'70,65 - 69세,1998,165,66,99
'4725040000,  화동면,'75,70 - 74세,1998,140,54,86
'4725040000,  화동면,'80,75 - 79세,1998,126,55,71
'4725040000,  화동면,'85,80 - 84세,1998,78,25,53
'4725040000,  화동면,'90,85+ ,1998,37,12,25
'4725041000,  화서면,'00,계,1998,4099,2016,2083
'4725041000,  화서면,'05,0 - 4세,1998,138,80,58
'4725041000,  화서면,'10,5 - 9세,1998,154,85,69
'4725041000,  화서면,'15,10 - 14세,1998,254,123,131
'4725041000,  화서면,'20,15 - 19세,1998,375,179,196
'4725041000,  화서면,'25,20 - 24세,1998,371,218,153
'4725041000,  화서면,'30,25 - 29세,1998,241,160,81
'4725041000,  화서면,'35,30 - 34세,1998,196,105,91
'4725041000,  화서면,'40,35 - 39세,1998,219,111,108
'4725041000,  화서면,'45,40 - 44세,1998,263,136,127
'4725041000,  화서면,'50,45 - 49세,1998,210,109,101
'4725041000,  화서면,'55,50 - 54세,1998,222,99,123
'4725041000,  화서면,'60,55 - 59세,1998,339,144,195
'4725041000,  화서면,'65,60 - 64세,1998,359,165,194
'4725041000,  화서면,'70,65 - 69세,1998,281,112,169
'4725041000,  화서면,'75,70 - 74세,1998,214,82,132
'4725041000,  화서면,'80,75 - 79세,1998,148,71,77
'4725041000,  화서면,'85,80 - 84세,1998,69,22,47
'4725041000,  화서면,'90,85+ ,1998,46,15,31
'4725042000,  화북면,'00,계,1998,2099,1053,1046
'4725042000,  화북면,'05,0 - 4세,1998,67,30,37
'4725042000,  화북면,'10,5 - 9세,1998,98,63,35
'4725042000,  화북면,'15,10 - 14세,1998,143,68,75
'4725042000,  화북면,'20,15 - 19세,1998,173,80,93
'4725042000,  화북면,'25,20 - 24세,1998,148,92,56
'4725042000,  화북면,'30,25 - 29세,1998,111,67,44
'4725042000,  화북면,'35,30 - 34세,1998,123,70,53
'4725042000,  화북면,'40,35 - 39세,1998,136,71,65
'4725042000,  화북면,'45,40 - 44세,1998,134,73,61
'4725042000,  화북면,'50,45 - 49세,1998,119,63,56
'4725042000,  화북면,'55,50 - 54세,1998,96,46,50
'4725042000,  화북면,'60,55 - 59세,1998,215,101,114
'4725042000,  화북면,'65,60 - 64세,1998,165,69,96
'4725042000,  화북면,'70,65 - 69세,1998,142,66,76
'4725042000,  화북면,'75,70 - 74세,1998,101,43,58
'4725042000,  화북면,'80,75 - 79세,1998,63,27,36
'4725042000,  화북면,'85,80 - 84세,1998,43,17,26
'4725042000,  화북면,'90,85+ ,1998,22,7,15
'4725043000,  외서면,'00,계,1998,3799,1884,1915
'4725043000,  외서면,'05,0 - 4세,1998,108,60,48
'4725043000,  외서면,'10,5 - 9세,1998,102,59,43
'4725043000,  외서면,'15,10 - 14세,1998,185,102,83
'4725043000,  외서면,'20,15 - 19세,1998,321,166,155
'4725043000,  외서면,'25,20 - 24세,1998,360,236,124
'4725043000,  외서면,'30,25 - 29세,1998,263,164,99
'4725043000,  외서면,'35,30 - 34세,1998,164,85,79
'4725043000,  외서면,'40,35 - 39세,1998,200,95,105
'4725043000,  외서면,'45,40 - 44세,1998,246,131,115
'4725043000,  외서면,'50,45 - 49세,1998,220,94,126
'4725043000,  외서면,'55,50 - 54세,1998,227,107,120
'4725043000,  외서면,'60,55 - 59세,1998,312,128,184
'4725043000,  외서면,'65,60 - 64세,1998,354,157,197
'4725043000,  외서면,'70,65 - 69세,1998,257,113,144
'4725043000,  외서면,'75,70 - 74세,1998,214,92,122
'4725043000,  외서면,'80,75 - 79세,1998,140,55,85
'4725043000,  외서면,'85,80 - 84세,1998,81,28,53
'4725043000,  외서면,'90,85+ ,1998,45,12,33
'4725044000,  은척면,'00,계,1998,2582,1304,1278
'4725044000,  은척면,'05,0 - 4세,1998,40,22,18
'4725044000,  은척면,'10,5 - 9세,1998,72,32,40
'4725044000,  은척면,'15,10 - 14세,1998,122,68,54
'4725044000,  은척면,'20,15 - 19세,1998,225,121,104
'4725044000,  은척면,'25,20 - 24세,1998,226,144,82
'4725044000,  은척면,'30,25 - 29세,1998,119,96,23
'4725044000,  은척면,'35,30 - 34세,1998,70,31,39
'4725044000,  은척면,'40,35 - 39세,1998,114,60,54
'4725044000,  은척면,'45,40 - 44세,1998,150,78,72
'4725044000,  은척면,'50,45 - 49세,1998,144,70,74
'4725044000,  은척면,'55,50 - 54세,1998,164,68,96
'4725044000,  은척면,'60,55 - 59세,1998,283,130,153
'4725044000,  은척면,'65,60 - 64세,1998,279,135,144
'4725044000,  은척면,'70,65 - 69세,1998,194,95,99
'4725044000,  은척면,'75,70 - 74세,1998,153,62,91
'4725044000,  은척면,'80,75 - 79세,1998,128,54,74
'4725044000,  은척면,'85,80 - 84세,1998,59,22,37
'4725044000,  은척면,'90,85+ ,1998,40,16,24
'4725045000,  공검면,'00,계,1998,3855,1894,1961
'4725045000,  공검면,'05,0 - 4세,1998,95,45,50
'4725045000,  공검면,'10,5 - 9세,1998,134,80,54
'4725045000,  공검면,'15,10 - 14세,1998,187,86,101
'4725045000,  공검면,'20,15 - 19세,1998,345,177,168
'4725045000,  공검면,'25,20 - 24세,1998,385,236,149
'4725045000,  공검면,'30,25 - 29세,1998,202,140,62
'4725045000,  공검면,'35,30 - 34세,1998,160,93,67
'4725045000,  공검면,'40,35 - 39세,1998,173,89,84
'4725045000,  공검면,'45,40 - 44세,1998,231,111,120
'4725045000,  공검면,'50,45 - 49세,1998,245,125,120
'4725045000,  공검면,'55,50 - 54세,1998,216,99,117
'4725045000,  공검면,'60,55 - 59세,1998,348,154,194
'4725045000,  공검면,'65,60 - 64세,1998,366,159,207
'4725045000,  공검면,'70,65 - 69세,1998,279,117,162
'4725045000,  공검면,'75,70 - 74세,1998,230,102,128
'4725045000,  공검면,'80,75 - 79세,1998,127,44,83
'4725045000,  공검면,'85,80 - 84세,1998,90,33,57
'4725045000,  공검면,'90,85+ ,1998,42,4,38
'4725046000,  이안면,'00,계,1998,3410,1682,1728
'4725046000,  이안면,'05,0 - 4세,1998,77,42,35
'4725046000,  이안면,'10,5 - 9세,1998,83,45,38
'4725046000,  이안면,'15,10 - 14세,1998,150,86,64
'4725046000,  이안면,'20,15 - 19세,1998,296,150,146
'4725046000,  이안면,'25,20 - 24세,1998,316,195,121
'4725046000,  이안면,'30,25 - 29세,1998,182,127,55
'4725046000,  이안면,'35,30 - 34세,1998,108,67,41
'4725046000,  이안면,'40,35 - 39세,1998,139,66,73
'4725046000,  이안면,'45,40 - 44세,1998,173,85,88
'4725046000,  이안면,'50,45 - 49세,1998,187,85,102
'4725046000,  이안면,'55,50 - 54세,1998,197,89,108
'4725046000,  이안면,'60,55 - 59세,1998,353,160,193
'4725046000,  이안면,'65,60 - 64세,1998,341,154,187
'4725046000,  이안면,'70,65 - 69세,1998,280,122,158
'4725046000,  이안면,'75,70 - 74세,1998,213,100,113
'4725046000,  이안면,'80,75 - 79세,1998,162,52,110
'4725046000,  이안면,'85,80 - 84세,1998,89,39,50
'4725046000,  이안면,'90,85+ ,1998,64,18,46
'4725047000,  화남면,'00,계,1998,1189,601,588
'4725047000,  화남면,'05,0 - 4세,1998,33,15,18
'4725047000,  화남면,'10,5 - 9세,1998,33,11,22
'4725047000,  화남면,'15,10 - 14세,1998,47,22,25
'4725047000,  화남면,'20,15 - 19세,1998,96,45,51
'4725047000,  화남면,'25,20 - 24세,1998,122,78,44
'4725047000,  화남면,'30,25 - 29세,1998,76,51,25
'4725047000,  화남면,'35,30 - 34세,1998,52,32,20
'4725047000,  화남면,'40,35 - 39세,1998,57,42,15
'4725047000,  화남면,'45,40 - 44세,1998,52,28,24
'4725047000,  화남면,'50,45 - 49세,1998,57,21,36
'4725047000,  화남면,'55,50 - 54세,1998,64,30,34
'4725047000,  화남면,'60,55 - 59세,1998,112,52,60
'4725047000,  화남면,'65,60 - 64세,1998,130,55,75
'4725047000,  화남면,'70,65 - 69세,1998,106,48,58
'4725047000,  화남면,'75,70 - 74세,1998,80,40,40
'4725047000,  화남면,'80,75 - 79세,1998,29,16,13
'4725047000,  화남면,'85,80 - 84세,1998,23,8,15
'4725047000,  화남면,'90,85+ ,1998,20,7,13
'4725052000,  남원동,'00,계,1998,14849,7382,7467
'4725052000,  남원동,'05,0 - 4세,1998,1017,524,493
'4725052000,  남원동,'10,5 - 9세,1998,1161,628,533
'4725052000,  남원동,'15,10 - 14세,1998,1124,607,517
'4725052000,  남원동,'20,15 - 19세,1998,1406,776,630
'4725052000,  남원동,'25,20 - 24세,1998,1193,655,538
'4725052000,  남원동,'30,25 - 29세,1998,1238,617,621
'4725052000,  남원동,'35,30 - 34세,1998,1219,582,637
'4725052000,  남원동,'40,35 - 39세,1998,1367,634,733
'4725052000,  남원동,'45,40 - 44세,1998,1153,603,550
'4725052000,  남원동,'50,45 - 49세,1998,872,433,439
'4725052000,  남원동,'55,50 - 54세,1998,637,313,324
'4725052000,  남원동,'60,55 - 59세,1998,730,335,395
'4725052000,  남원동,'65,60 - 64세,1998,585,262,323
'4725052000,  남원동,'70,65 - 69세,1998,415,168,247
'4725052000,  남원동,'75,70 - 74세,1998,295,104,191
'4725052000,  남원동,'80,75 - 79세,1998,239,86,153
'4725052000,  남원동,'85,80 - 84세,1998,133,40,93
'4725052000,  남원동,'90,85+ ,1998,65,15,50
'4725053000,  북문동,'00,계,1998,7010,3498,3512
'4725053000,  북문동,'05,0 - 4세,1998,415,250,165
'4725053000,  북문동,'10,5 - 9세,1998,444,238,206
'4725053000,  북문동,'15,10 - 14세,1998,559,287,272
'4725053000,  북문동,'20,15 - 19세,1998,639,318,321
'4725053000,  북문동,'25,20 - 24세,1998,616,336,280
'4725053000,  북문동,'30,25 - 29세,1998,510,282,228
'4725053000,  북문동,'35,30 - 34세,1998,459,228,231
'4725053000,  북문동,'40,35 - 39세,1998,605,309,296
'4725053000,  북문동,'45,40 - 44세,1998,531,270,261
'4725053000,  북문동,'50,45 - 49세,1998,420,212,208
'4725053000,  북문동,'55,50 - 54세,1998,343,160,183
'4725053000,  북문동,'60,55 - 59세,1998,419,178,241
'4725053000,  북문동,'65,60 - 64세,1998,355,159,196
'4725053000,  북문동,'70,65 - 69세,1998,260,111,149
'4725053000,  북문동,'75,70 - 74세,1998,191,86,105
'4725053000,  북문동,'80,75 - 79세,1998,116,32,84
'4725053000,  북문동,'85,80 - 84세,1998,91,28,63
'4725053000,  북문동,'90,85+ ,1998,37,14,23
'4725054000,  계림동,'00,계,1998,9369,4557,4812
'4725054000,  계림동,'05,0 - 4세,1998,661,359,302
'4725054000,  계림동,'10,5 - 9세,1998,693,382,311
'4725054000,  계림동,'15,10 - 14세,1998,702,371,331
'4725054000,  계림동,'20,15 - 19세,1998,843,425,418
'4725054000,  계림동,'25,20 - 24세,1998,848,436,412
'4725054000,  계림동,'30,25 - 29세,1998,837,400,437
'4725054000,  계림동,'35,30 - 34세,1998,795,396,399
'4725054000,  계림동,'40,35 - 39세,1998,825,408,417
'4725054000,  계림동,'45,40 - 44세,1998,660,311,349
'4725054000,  계림동,'50,45 - 49세,1998,517,247,270
'4725054000,  계림동,'55,50 - 54세,1998,398,180,218
'4725054000,  계림동,'60,55 - 59세,1998,425,194,231
'4725054000,  계림동,'65,60 - 64세,1998,395,168,227
'4725054000,  계림동,'70,65 - 69세,1998,296,123,173
'4725054000,  계림동,'75,70 - 74세,1998,216,82,134
'4725054000,  계림동,'80,75 - 79세,1998,135,48,87
'4725054000,  계림동,'85,80 - 84세,1998,78,21,57
'4725054000,  계림동,'90,85+ ,1998,45,6,39
'4725055000,  동문동,'00,계,1998,11579,5716,5863
'4725055000,  동문동,'05,0 - 4세,1998,903,477,426
'4725055000,  동문동,'10,5 - 9세,1998,792,398,394
'4725055000,  동문동,'15,10 - 14세,1998,798,428,370
'4725055000,  동문동,'20,15 - 19세,1998,1049,551,498
'4725055000,  동문동,'25,20 - 24세,1998,963,516,447
'4725055000,  동문동,'30,25 - 29세,1998,973,504,469
'4725055000,  동문동,'35,30 - 34세,1998,980,472,508
'4725055000,  동문동,'40,35 - 39세,1998,1001,508,493
'4725055000,  동문동,'45,40 - 44세,1998,847,407,440
'4725055000,  동문동,'50,45 - 49세,1998,714,350,364
'4725055000,  동문동,'55,50 - 54세,1998,520,261,259
'4725055000,  동문동,'60,55 - 59세,1998,579,275,304
'4725055000,  동문동,'65,60 - 64세,1998,476,212,264
'4725055000,  동문동,'70,65 - 69세,1998,356,131,225
'4725055000,  동문동,'75,70 - 74세,1998,268,118,150
'4725055000,  동문동,'80,75 - 79세,1998,187,60,127
'4725055000,  동문동,'85,80 - 84세,1998,114,36,78
'4725055000,  동문동,'90,85+ ,1998,59,12,47
'4725056000,  동성동,'00,계,1998,5658,2784,2874
'4725056000,  동성동,'05,0 - 4세,1998,377,201,176
'4725056000,  동성동,'10,5 - 9세,1998,341,186,155
'4725056000,  동성동,'15,10 - 14세,1998,343,186,157
'4725056000,  동성동,'20,15 - 19세,1998,472,238,234
'4725056000,  동성동,'25,20 - 24세,1998,522,282,240
'4725056000,  동성동,'30,25 - 29세,1998,503,272,231
'4725056000,  동성동,'35,30 - 34세,1998,466,238,228
'4725056000,  동성동,'40,35 - 39세,1998,409,205,204
'4725056000,  동성동,'45,40 - 44세,1998,378,175,203
'4725056000,  동성동,'50,45 - 49세,1998,318,151,167
'4725056000,  동성동,'55,50 - 54세,1998,295,140,155
'4725056000,  동성동,'60,55 - 59세,1998,341,153,188
'4725056000,  동성동,'65,60 - 64세,1998,316,137,179
'4725056000,  동성동,'70,65 - 69세,1998,236,107,129
'4725056000,  동성동,'75,70 - 74세,1998,148,57,91
'4725056000,  동성동,'80,75 - 79세,1998,99,38,61
'4725056000,  동성동,'85,80 - 84세,1998,61,11,50
'4725056000,  동성동,'90,85+ ,1998,33,7,26
'4725057000,  신흥동,'00,계,1998,8166,4085,4081
'4725057000,  신흥동,'05,0 - 4세,1998,598,328,270
'4725057000,  신흥동,'10,5 - 9세,1998,646,366,280
'4725057000,  신흥동,'15,10 - 14세,1998,620,327,293
'4725057000,  신흥동,'20,15 - 19세,1998,711,379,332
'4725057000,  신흥동,'25,20 - 24세,1998,567,330,237
'4725057000,  신흥동,'30,25 - 29세,1998,612,294,318
'4725057000,  신흥동,'35,30 - 34세,1998,675,321,354
'4725057000,  신흥동,'40,35 - 39세,1998,783,394,389
'4725057000,  신흥동,'45,40 - 44세,1998,667,349,318
'4725057000,  신흥동,'50,45 - 49세,1998,439,242,197
'4725057000,  신흥동,'55,50 - 54세,1998,276,127,149
'4725057000,  신흥동,'60,55 - 59세,1998,370,167,203
'4725057000,  신흥동,'65,60 - 64세,1998,367,152,215
'4725057000,  신흥동,'70,65 - 69세,1998,299,120,179
'4725057000,  신흥동,'75,70 - 74세,1998,223,84,139
'4725057000,  신흥동,'80,75 - 79세,1998,164,63,101
'4725057000,  신흥동,'85,80 - 84세,1998,100,33,67
'4725057000,  신흥동,'90,85+ ,1998,49,9,40
'47280, 문경시,'00,계,1998,91163,45341,45822
'47280, 문경시,'05,0 - 4세,1998,4075,2237,1838
'47280, 문경시,'10,5 - 9세,1998,4685,2543,2142
'47280, 문경시,'15,10 - 14세,1998,5993,3226,2767
'47280, 문경시,'20,15 - 19세,1998,9196,4700,4496
'47280, 문경시,'25,20 - 24세,1998,8675,4965,3710
'47280, 문경시,'30,25 - 29세,1998,5955,3398,2557
'47280, 문경시,'35,30 - 34세,1998,5247,2682,2565
'47280, 문경시,'40,35 - 39세,1998,6562,3271,3291
'47280, 문경시,'45,40 - 44세,1998,6446,3209,3237
'47280, 문경시,'50,45 - 49세,1998,5597,2699,2898
'47280, 문경시,'55,50 - 54세,1998,4892,2315,2577
'47280, 문경시,'60,55 - 59세,1998,6476,2975,3501
'47280, 문경시,'65,60 - 64세,1998,6084,2738,3346
'47280, 문경시,'70,65 - 69세,1998,4018,1651,2367
'47280, 문경시,'75,70 - 74세,1998,2969,1224,1745
'47280, 문경시,'80,75 - 79세,1998,2226,878,1348
'47280, 문경시,'85,80 - 84세,1998,1314,437,877
'47280, 문경시,'90,85+ ,1998,753,193,560
'4728025000,  문경읍,'00,계,1998,9646,4795,4851
'4728025000,  문경읍,'05,0 - 4세,1998,322,174,148
'4728025000,  문경읍,'10,5 - 9세,1998,436,219,217
'4728025000,  문경읍,'15,10 - 14세,1998,579,303,276
'4728025000,  문경읍,'20,15 - 19세,1998,984,503,481
'4728025000,  문경읍,'25,20 - 24세,1998,963,560,403
'4728025000,  문경읍,'30,25 - 29세,1998,608,386,222
'4728025000,  문경읍,'35,30 - 34세,1998,488,257,231
'4728025000,  문경읍,'40,35 - 39세,1998,615,320,295
'4728025000,  문경읍,'45,40 - 44세,1998,606,305,301
'4728025000,  문경읍,'50,45 - 49세,1998,564,261,303
'4728025000,  문경읍,'55,50 - 54세,1998,569,248,321
'4728025000,  문경읍,'60,55 - 59세,1998,834,377,457
'4728025000,  문경읍,'65,60 - 64세,1998,708,321,387
'4728025000,  문경읍,'70,65 - 69세,1998,483,212,271
'4728025000,  문경읍,'75,70 - 74세,1998,372,156,216
'4728025000,  문경읍,'80,75 - 79세,1998,258,105,153
'4728025000,  문경읍,'85,80 - 84세,1998,170,64,106
'4728025000,  문경읍,'90,85+ ,1998,87,24,63
'4728025300,  가은읍,'00,계,1998,5884,2876,3008
'4728025300,  가은읍,'05,0 - 4세,1998,125,65,60
'4728025300,  가은읍,'10,5 - 9세,1998,224,128,96
'4728025300,  가은읍,'15,10 - 14세,1998,305,165,140
'4728025300,  가은읍,'20,15 - 19세,1998,516,275,241
'4728025300,  가은읍,'25,20 - 24세,1998,473,289,184
'4728025300,  가은읍,'30,25 - 29세,1998,258,163,95
'4728025300,  가은읍,'35,30 - 34세,1998,229,121,108
'4728025300,  가은읍,'40,35 - 39세,1998,330,184,146
'4728025300,  가은읍,'45,40 - 44세,1998,356,189,167
'4728025300,  가은읍,'50,45 - 49세,1998,297,134,163
'4728025300,  가은읍,'55,50 - 54세,1998,331,150,181
'4728025300,  가은읍,'60,55 - 59세,1998,579,264,315
'4728025300,  가은읍,'65,60 - 64세,1998,570,264,306
'4728025300,  가은읍,'70,65 - 69세,1998,433,167,266
'4728025300,  가은읍,'75,70 - 74세,1998,356,137,219
'4728025300,  가은읍,'80,75 - 79세,1998,278,110,168
'4728025300,  가은읍,'85,80 - 84세,1998,144,49,95
'4728025300,  가은읍,'90,85+ ,1998,80,22,58
'4728031000,  영순면,'00,계,1998,3701,1837,1864
'4728031000,  영순면,'05,0 - 4세,1998,105,54,51
'4728031000,  영순면,'10,5 - 9세,1998,99,57,42
'4728031000,  영순면,'15,10 - 14세,1998,179,100,79
'4728031000,  영순면,'20,15 - 19세,1998,348,176,172
'4728031000,  영순면,'25,20 - 24세,1998,349,200,149
'4728031000,  영순면,'30,25 - 29세,1998,215,139,76
'4728031000,  영순면,'35,30 - 34세,1998,122,80,42
'4728031000,  영순면,'40,35 - 39세,1998,196,102,94
'4728031000,  영순면,'45,40 - 44세,1998,219,113,106
'4728031000,  영순면,'50,45 - 49세,1998,208,113,95
'4728031000,  영순면,'55,50 - 54세,1998,195,96,99
'4728031000,  영순면,'60,55 - 59세,1998,328,156,172
'4728031000,  영순면,'65,60 - 64세,1998,393,170,223
'4728031000,  영순면,'70,65 - 69세,1998,253,111,142
'4728031000,  영순면,'75,70 - 74세,1998,172,65,107
'4728031000,  영순면,'80,75 - 79세,1998,166,64,102
'4728031000,  영순면,'85,80 - 84세,1998,92,30,62
'4728031000,  영순면,'90,85+ ,1998,62,11,51
'4728032000,  산양면,'00,계,1998,4917,2442,2475
'4728032000,  산양면,'05,0 - 4세,1998,118,66,52
'4728032000,  산양면,'10,5 - 9세,1998,159,84,75
'4728032000,  산양면,'15,10 - 14세,1998,249,134,115
'4728032000,  산양면,'20,15 - 19세,1998,468,251,217
'4728032000,  산양면,'25,20 - 24세,1998,489,300,189
'4728032000,  산양면,'30,25 - 29세,1998,247,159,88
'4728032000,  산양면,'35,30 - 34세,1998,189,106,83
'4728032000,  산양면,'40,35 - 39세,1998,243,130,113
'4728032000,  산양면,'45,40 - 44세,1998,301,142,159
'4728032000,  산양면,'50,45 - 49세,1998,280,143,137
'4728032000,  산양면,'55,50 - 54세,1998,275,133,142
'4728032000,  산양면,'60,55 - 59세,1998,406,181,225
'4728032000,  산양면,'65,60 - 64세,1998,474,211,263
'4728032000,  산양면,'70,65 - 69세,1998,404,160,244
'4728032000,  산양면,'75,70 - 74세,1998,224,106,118
'4728032000,  산양면,'80,75 - 79세,1998,211,76,135
'4728032000,  산양면,'85,80 - 84세,1998,103,38,65
'4728032000,  산양면,'90,85+ ,1998,77,22,55
'4728033000,  호계면,'00,계,1998,3287,1615,1672
'4728033000,  호계면,'05,0 - 4세,1998,90,52,38
'4728033000,  호계면,'10,5 - 9세,1998,101,51,50
'4728033000,  호계면,'15,10 - 14세,1998,147,72,75
'4728033000,  호계면,'20,15 - 19세,1998,339,164,175
'4728033000,  호계면,'25,20 - 24세,1998,333,182,151
'4728033000,  호계면,'30,25 - 29세,1998,202,143,59
'4728033000,  호계면,'35,30 - 34세,1998,113,65,48
'4728033000,  호계면,'40,35 - 39세,1998,169,96,73
'4728033000,  호계면,'45,40 - 44세,1998,201,111,90
'4728033000,  호계면,'50,45 - 49세,1998,199,103,96
'4728033000,  호계면,'55,50 - 54세,1998,197,87,110
'4728033000,  호계면,'60,55 - 59세,1998,325,141,184
'4728033000,  호계면,'65,60 - 64세,1998,311,145,166
'4728033000,  호계면,'70,65 - 69세,1998,192,68,124
'4728033000,  호계면,'75,70 - 74세,1998,127,51,76
'4728033000,  호계면,'80,75 - 79세,1998,124,50,74
'4728033000,  호계면,'85,80 - 84세,1998,78,21,57
'4728033000,  호계면,'90,85+ ,1998,39,13,26
'4728034000,  산북면,'00,계,1998,4267,2121,2146
'4728034000,  산북면,'05,0 - 4세,1998,117,67,50
'4728034000,  산북면,'10,5 - 9세,1998,127,58,69
'4728034000,  산북면,'15,10 - 14세,1998,183,95,88
'4728034000,  산북면,'20,15 - 19세,1998,372,195,177
'4728034000,  산북면,'25,20 - 24세,1998,447,282,165
'4728034000,  산북면,'30,25 - 29세,1998,214,140,74
'4728034000,  산북면,'35,30 - 34세,1998,161,97,64
'4728034000,  산북면,'40,35 - 39세,1998,206,112,94
'4728034000,  산북면,'45,40 - 44세,1998,192,94,98
'4728034000,  산북면,'50,45 - 49세,1998,234,109,125
'4728034000,  산북면,'55,50 - 54세,1998,278,123,155
'4728034000,  산북면,'60,55 - 59세,1998,408,183,225
'4728034000,  산북면,'65,60 - 64세,1998,493,221,272
'4728034000,  산북면,'70,65 - 69세,1998,304,137,167
'4728034000,  산북면,'75,70 - 74세,1998,180,71,109
'4728034000,  산북면,'80,75 - 79세,1998,180,76,104
'4728034000,  산북면,'85,80 - 84세,1998,104,39,65
'4728034000,  산북면,'90,85+ ,1998,67,22,45
'4728035000,  동로면,'00,계,1998,2281,1130,1151
'4728035000,  동로면,'05,0 - 4세,1998,60,31,29
'4728035000,  동로면,'10,5 - 9세,1998,58,34,24
'4728035000,  동로면,'15,10 - 14세,1998,116,62,54
'4728035000,  동로면,'20,15 - 19세,1998,182,90,92
'4728035000,  동로면,'25,20 - 24세,1998,248,156,92
'4728035000,  동로면,'30,25 - 29세,1998,118,77,41
'4728035000,  동로면,'35,30 - 34세,1998,75,41,34
'4728035000,  동로면,'40,35 - 39세,1998,100,50,50
'4728035000,  동로면,'45,40 - 44세,1998,125,70,55
'4728035000,  동로면,'50,45 - 49세,1998,112,51,61
'4728035000,  동로면,'55,50 - 54세,1998,160,71,89
'4728035000,  동로면,'60,55 - 59세,1998,236,96,140
'4728035000,  동로면,'65,60 - 64세,1998,239,101,138
'4728035000,  동로면,'70,65 - 69세,1998,152,73,79
'4728035000,  동로면,'75,70 - 74세,1998,125,52,73
'4728035000,  동로면,'80,75 - 79세,1998,96,43,53
'4728035000,  동로면,'85,80 - 84세,1998,52,24,28
'4728035000,  동로면,'90,85+ ,1998,27,8,19
'4728036000,  마성면,'00,계,1998,5699,2847,2852
'4728036000,  마성면,'05,0 - 4세,1998,167,97,70
'4728036000,  마성면,'10,5 - 9세,1998,208,99,109
'4728036000,  마성면,'15,10 - 14세,1998,296,153,143
'4728036000,  마성면,'20,15 - 19세,1998,537,277,260
'4728036000,  마성면,'25,20 - 24세,1998,603,340,263
'4728036000,  마성면,'30,25 - 29세,1998,369,250,119
'4728036000,  마성면,'35,30 - 34세,1998,256,143,113
'4728036000,  마성면,'40,35 - 39세,1998,312,183,129
'4728036000,  마성면,'45,40 - 44세,1998,348,185,163
'4728036000,  마성면,'50,45 - 49세,1998,336,138,198
'4728036000,  마성면,'55,50 - 54세,1998,373,175,198
'4728036000,  마성면,'60,55 - 59세,1998,571,237,334
'4728036000,  마성면,'65,60 - 64세,1998,536,252,284
'4728036000,  마성면,'70,65 - 69세,1998,318,139,179
'4728036000,  마성면,'75,70 - 74세,1998,204,85,119
'4728036000,  마성면,'80,75 - 79세,1998,136,58,78
'4728036000,  마성면,'85,80 - 84세,1998,79,25,54
'4728036000,  마성면,'90,85+ ,1998,50,11,39
'4728037000,  농암면,'00,계,1998,3643,1781,1862
'4728037000,  농암면,'05,0 - 4세,1998,105,62,43
'4728037000,  농암면,'10,5 - 9세,1998,142,87,55
'4728037000,  농암면,'15,10 - 14세,1998,199,96,103
'4728037000,  농암면,'20,15 - 19세,1998,301,147,154
'4728037000,  농암면,'25,20 - 24세,1998,323,200,123
'4728037000,  농암면,'30,25 - 29세,1998,186,122,64
'4728037000,  농암면,'35,30 - 34세,1998,159,80,79
'4728037000,  농암면,'40,35 - 39세,1998,201,107,94
'4728037000,  농암면,'45,40 - 44세,1998,204,97,107
'4728037000,  농암면,'50,45 - 49세,1998,208,105,103
'4728037000,  농암면,'55,50 - 54세,1998,227,100,127
'4728037000,  농암면,'60,55 - 59세,1998,305,140,165
'4728037000,  농암면,'65,60 - 64세,1998,315,132,183
'4728037000,  농암면,'70,65 - 69세,1998,273,109,164
'4728037000,  농암면,'75,70 - 74세,1998,211,88,123
'4728037000,  농암면,'80,75 - 79세,1998,141,68,73
'4728037000,  농암면,'85,80 - 84세,1998,77,22,55
'4728037000,  농암면,'90,85+ ,1998,66,19,47
'4728051500,  점촌동,'00,계,1998,6561,3283,3278
'4728051500,  점촌동,'05,0 - 4세,1998,268,155,113
'4728051500,  점촌동,'10,5 - 9세,1998,338,211,127
'4728051500,  점촌동,'15,10 - 14세,1998,504,285,219
'4728051500,  점촌동,'20,15 - 19세,1998,748,373,375
'4728051500,  점촌동,'25,20 - 24세,1998,674,370,304
'4728051500,  점촌동,'30,25 - 29세,1998,439,248,191
'4728051500,  점촌동,'35,30 - 34세,1998,378,178,200
'4728051500,  점촌동,'40,35 - 39세,1998,500,218,282
'4728051500,  점촌동,'45,40 - 44세,1998,600,280,320
'4728051500,  점촌동,'50,45 - 49세,1998,499,240,259
'4728051500,  점촌동,'55,50 - 54세,1998,373,190,183
'4728051500,  점촌동,'60,55 - 59세,1998,374,187,187
'4728051500,  점촌동,'65,60 - 64세,1998,305,137,168
'4728051500,  점촌동,'70,65 - 69세,1998,217,85,132
'4728051500,  점촌동,'75,70 - 74세,1998,164,69,95
'4728051500,  점촌동,'80,75 - 79세,1998,85,35,50
'4728051500,  점촌동,'85,80 - 84세,1998,67,18,49
'4728051500,  점촌동,'90,85+ ,1998,28,4,24
'4728052000,  중앙동,'00,계,1998,7199,3544,3655
'4728052000,  중앙동,'05,0 - 4세,1998,327,161,166
'4728052000,  중앙동,'10,5 - 9세,1998,452,248,204
'4728052000,  중앙동,'15,10 - 14세,1998,538,300,238
'4728052000,  중앙동,'20,15 - 19세,1998,797,395,402
'4728052000,  중앙동,'25,20 - 24세,1998,736,407,329
'4728052000,  중앙동,'30,25 - 29세,1998,492,270,222
'4728052000,  중앙동,'35,30 - 34세,1998,448,225,223
'4728052000,  중앙동,'40,35 - 39세,1998,565,257,308
'4728052000,  중앙동,'45,40 - 44세,1998,567,251,316
'4728052000,  중앙동,'50,45 - 49세,1998,510,233,277
'4728052000,  중앙동,'55,50 - 54세,1998,437,208,229
'4728052000,  중앙동,'60,55 - 59세,1998,467,235,232
'4728052000,  중앙동,'65,60 - 64세,1998,361,163,198
'4728052000,  중앙동,'70,65 - 69세,1998,164,74,90
'4728052000,  중앙동,'75,70 - 74세,1998,132,56,76
'4728052000,  중앙동,'80,75 - 79세,1998,106,40,66
'4728052000,  중앙동,'85,80 - 84세,1998,69,13,56
'4728052000,  중앙동,'90,85+ ,1998,31,8,23
'4728053000,  신흥동,'00,계,1998,12011,6058,5953
'4728053000,  신흥동,'05,0 - 4세,1998,731,415,316
'4728053000,  신흥동,'10,5 - 9세,1998,870,469,401
'4728053000,  신흥동,'15,10 - 14세,1998,1094,594,500
'4728053000,  신흥동,'20,15 - 19세,1998,1287,710,577
'4728053000,  신흥동,'25,20 - 24세,1998,1050,585,465
'4728053000,  신흥동,'30,25 - 29세,1998,816,414,402
'4728053000,  신흥동,'35,30 - 34세,1998,853,386,467
'4728053000,  신흥동,'40,35 - 39세,1998,1204,556,648
'4728053000,  신흥동,'45,40 - 44세,1998,1057,536,521
'4728053000,  신흥동,'50,45 - 49세,1998,757,375,382
'4728053000,  신흥동,'55,50 - 54세,1998,538,271,267
'4728053000,  신흥동,'60,55 - 59세,1998,524,248,276
'4728053000,  신흥동,'65,60 - 64세,1998,410,199,211
'4728053000,  신흥동,'70,65 - 69세,1998,280,95,185
'4728053000,  신흥동,'75,70 - 74세,1998,258,111,147
'4728053000,  신흥동,'80,75 - 79세,1998,149,51,98
'4728053000,  신흥동,'85,80 - 84세,1998,87,32,55
'4728053000,  신흥동,'90,85+ ,1998,46,11,35
'4728054000,  신기동,'00,계,1998,2305,1139,1166
'4728054000,  신기동,'05,0 - 4세,1998,82,32,50
'4728054000,  신기동,'10,5 - 9세,1998,82,48,34
'4728054000,  신기동,'15,10 - 14세,1998,137,74,63
'4728054000,  신기동,'20,15 - 19세,1998,247,124,123
'4728054000,  신기동,'25,20 - 24세,1998,237,131,106
'4728054000,  신기동,'30,25 - 29세,1998,180,110,70
'4728054000,  신기동,'35,30 - 34세,1998,113,72,41
'4728054000,  신기동,'40,35 - 39세,1998,133,59,74
'4728054000,  신기동,'45,40 - 44세,1998,148,74,74
'4728054000,  신기동,'50,45 - 49세,1998,142,65,77
'4728054000,  신기동,'55,50 - 54세,1998,132,57,75
'4728054000,  신기동,'60,55 - 59세,1998,201,94,107
'4728054000,  신기동,'65,60 - 64세,1998,179,80,99
'4728054000,  신기동,'70,65 - 69세,1998,120,50,70
'4728054000,  신기동,'75,70 - 74세,1998,77,31,46
'4728054000,  신기동,'80,75 - 79세,1998,45,20,25
'4728054000,  신기동,'85,80 - 84세,1998,42,16,26
'4728054000,  신기동,'90,85+ ,1998,8,2,6
'4728055000,  대성동,'00,계,1998,1625,800,825
'4728055000,  대성동,'05,0 - 4세,1998,44,19,25
'4728055000,  대성동,'10,5 - 9세,1998,53,21,32
'4728055000,  대성동,'15,10 - 14세,1998,95,40,55
'4728055000,  대성동,'20,15 - 19세,1998,171,86,85
'4728055000,  대성동,'25,20 - 24세,1998,192,116,76
'4728055000,  대성동,'30,25 - 29세,1998,103,71,32
'4728055000,  대성동,'35,30 - 34세,1998,82,48,34
'4728055000,  대성동,'40,35 - 39세,1998,90,50,40
'4728055000,  대성동,'45,40 - 44세,1998,105,47,58
'4728055000,  대성동,'50,45 - 49세,1998,119,63,56
'4728055000,  대성동,'55,50 - 54세,1998,107,47,60
'4728055000,  대성동,'60,55 - 59세,1998,140,59,81
'4728055000,  대성동,'65,60 - 64세,1998,136,59,77
'4728055000,  대성동,'70,65 - 69세,1998,61,32,29
'4728055000,  대성동,'75,70 - 74세,1998,61,19,42
'4728055000,  대성동,'80,75 - 79세,1998,38,16,22
'4728055000,  대성동,'85,80 - 84세,1998,18,5,13
'4728055000,  대성동,'90,85+ ,1998,10,2,8
'4728056000,  모전동,'00,계,1998,18137,9073,9064
'4728056000,  모전동,'05,0 - 4세,1998,1414,787,627
'4728056000,  모전동,'10,5 - 9세,1998,1336,729,607
'4728056000,  모전동,'15,10 - 14세,1998,1372,753,619
'4728056000,  모전동,'20,15 - 19세,1998,1899,934,965
'4728056000,  모전동,'25,20 - 24세,1998,1558,847,711
'4728056000,  모전동,'30,25 - 29세,1998,1508,706,802
'4728056000,  모전동,'35,30 - 34세,1998,1581,783,798
'4728056000,  모전동,'40,35 - 39세,1998,1698,847,851
'4728056000,  모전동,'45,40 - 44세,1998,1417,715,702
'4728056000,  모전동,'50,45 - 49세,1998,1132,566,566
'4728056000,  모전동,'55,50 - 54세,1998,700,359,341
'4728056000,  모전동,'60,55 - 59세,1998,778,377,401
'4728056000,  모전동,'65,60 - 64세,1998,654,283,371
'4728056000,  모전동,'70,65 - 69세,1998,364,139,225
'4728056000,  모전동,'75,70 - 74세,1998,306,127,179
'4728056000,  모전동,'80,75 - 79세,1998,213,66,147
'4728056000,  모전동,'85,80 - 84세,1998,132,41,91
'4728056000,  모전동,'90,85+ ,1998,75,14,61
'47290, 경산시,'00,계,1998,207444,103997,103447
'47290, 경산시,'05,0 - 4세,1998,19227,10222,9005
'47290, 경산시,'10,5 - 9세,1998,16521,8915,7606
'47290, 경산시,'15,10 - 14세,1998,10700,5584,5116
'47290, 경산시,'20,15 - 19세,1998,14081,7100,6981
'47290, 경산시,'25,20 - 24세,1998,16808,8409,8399
'47290, 경산시,'30,25 - 29세,1998,23597,11431,12166
'47290, 경산시,'35,30 - 34세,1998,23189,12060,11129
'47290, 경산시,'40,35 - 39세,1998,19546,10879,8667
'47290, 경산시,'45,40 - 44세,1998,13024,7140,5884
'47290, 경산시,'50,45 - 49세,1998,10339,5129,5210
'47290, 경산시,'55,50 - 54세,1998,8396,3994,4402
'47290, 경산시,'60,55 - 59세,1998,9530,4344,5186
'47290, 경산시,'65,60 - 64세,1998,8167,3499,4668
'47290, 경산시,'70,65 - 69세,1998,5730,2281,3449
'47290, 경산시,'75,70 - 74세,1998,4003,1523,2480
'47290, 경산시,'80,75 - 79세,1998,2595,924,1671
'47290, 경산시,'85,80 - 84세,1998,1299,401,898
'47290, 경산시,'90,85+ ,1998,692,162,530
'4729025000,  하양읍,'00,계,1998,27435,13505,13930
'4729025000,  하양읍,'05,0 - 4세,1998,1867,973,894
'4729025000,  하양읍,'10,5 - 9세,1998,2036,1116,920
'4729025000,  하양읍,'15,10 - 14세,1998,1863,1044,819
'4729025000,  하양읍,'20,15 - 19세,1998,2223,1122,1101
'4729025000,  하양읍,'25,20 - 24세,1998,2569,1203,1366
'4729025000,  하양읍,'30,25 - 29세,1998,2714,1421,1293
'4729025000,  하양읍,'35,30 - 34세,1998,2383,1208,1175
'4729025000,  하양읍,'40,35 - 39세,1998,2422,1198,1224
'4729025000,  하양읍,'45,40 - 44세,1998,1898,954,944
'4729025000,  하양읍,'50,45 - 49세,1998,1551,753,798
'4729025000,  하양읍,'55,50 - 54세,1998,1281,614,667
'4729025000,  하양읍,'60,55 - 59세,1998,1429,656,773
'4729025000,  하양읍,'65,60 - 64세,1998,1216,522,694
'4729025000,  하양읍,'70,65 - 69세,1998,802,326,476
'4729025000,  하양읍,'75,70 - 74세,1998,536,200,336
'4729025000,  하양읍,'80,75 - 79세,1998,384,120,264
'4729025000,  하양읍,'85,80 - 84세,1998,180,53,127
'4729025000,  하양읍,'90,85+ ,1998,81,22,59
'4729025300,  진량읍,'00,계,1998,35640,18075,17565
'4729025300,  진량읍,'05,0 - 4세,1998,4629,2426,2203
'4729025300,  진량읍,'10,5 - 9세,1998,2930,1559,1371
'4729025300,  진량읍,'15,10 - 14세,1998,1404,725,679
'4729025300,  진량읍,'20,15 - 19세,1998,1657,839,818
'4729025300,  진량읍,'25,20 - 24세,1998,2620,1279,1341
'4729025300,  진량읍,'30,25 - 29세,1998,5442,2496,2946
'4729025300,  진량읍,'35,30 - 34세,1998,5383,2985,2398
'4729025300,  진량읍,'40,35 - 39세,1998,3219,1964,1255
'4729025300,  진량읍,'45,40 - 44세,1998,1691,942,749
'4729025300,  진량읍,'50,45 - 49세,1998,1284,621,663
'4729025300,  진량읍,'55,50 - 54세,1998,1110,497,613
'4729025300,  진량읍,'60,55 - 59세,1998,1331,592,739
'4729025300,  진량읍,'65,60 - 64세,1998,1173,489,684
'4729025300,  진량읍,'70,65 - 69세,1998,714,281,433
'4729025300,  진량읍,'75,70 - 74세,1998,507,211,296
'4729025300,  진량읍,'80,75 - 79세,1998,297,112,185
'4729025300,  진량읍,'85,80 - 84세,1998,165,38,127
'4729025300,  진량읍,'90,85+ ,1998,84,19,65
'4729031000,  와촌면,'00,계,1998,7665,3933,3732
'4729031000,  와촌면,'05,0 - 4세,1998,367,190,177
'4729031000,  와촌면,'10,5 - 9세,1998,322,180,142
'4729031000,  와촌면,'15,10 - 14세,1998,404,235,169
'4729031000,  와촌면,'20,15 - 19세,1998,648,332,316
'4729031000,  와촌면,'25,20 - 24세,1998,723,403,320
'4729031000,  와촌면,'30,25 - 29세,1998,644,379,265
'4729031000,  와촌면,'35,30 - 34세,1998,495,292,203
'4729031000,  와촌면,'40,35 - 39세,1998,553,304,249
'4729031000,  와촌면,'45,40 - 44세,1998,530,283,247
'4729031000,  와촌면,'50,45 - 49세,1998,496,245,251
'4729031000,  와촌면,'55,50 - 54세,1998,427,219,208
'4729031000,  와촌면,'60,55 - 59세,1998,539,246,293
'4729031000,  와촌면,'65,60 - 64세,1998,547,249,298
'4729031000,  와촌면,'70,65 - 69세,1998,382,162,220
'4729031000,  와촌면,'75,70 - 74세,1998,257,97,160
'4729031000,  와촌면,'80,75 - 79세,1998,172,61,111
'4729031000,  와촌면,'85,80 - 84세,1998,98,39,59
'4729031000,  와촌면,'90,85+ ,1998,61,17,44
'4729033000,  자인면,'00,계,1998,8610,4374,4236
'4729033000,  자인면,'05,0 - 4세,1998,482,249,233
'4729033000,  자인면,'10,5 - 9세,1998,510,265,245
'4729033000,  자인면,'15,10 - 14세,1998,427,229,198
'4729033000,  자인면,'20,15 - 19세,1998,729,379,350
'4729033000,  자인면,'25,20 - 24세,1998,793,421,372
'4729033000,  자인면,'30,25 - 29세,1998,746,415,331
'4729033000,  자인면,'35,30 - 34세,1998,635,359,276
'4729033000,  자인면,'40,35 - 39세,1998,678,393,285
'4729033000,  자인면,'45,40 - 44세,1998,562,303,259
'4729033000,  자인면,'50,45 - 49세,1998,583,311,272
'4729033000,  자인면,'55,50 - 54세,1998,463,225,238
'4729033000,  자인면,'60,55 - 59세,1998,546,241,305
'4729033000,  자인면,'65,60 - 64세,1998,486,191,295
'4729033000,  자인면,'70,65 - 69세,1998,375,160,215
'4729033000,  자인면,'75,70 - 74세,1998,275,112,163
'4729033000,  자인면,'80,75 - 79세,1998,187,77,110
'4729033000,  자인면,'85,80 - 84세,1998,93,38,55
'4729033000,  자인면,'90,85+ ,1998,40,6,34
'4729034000,  용성면,'00,계,1998,5005,2523,2482
'4729034000,  용성면,'05,0 - 4세,1998,190,98,92
'4729034000,  용성면,'10,5 - 9세,1998,156,92,64
'4729034000,  용성면,'15,10 - 14세,1998,205,111,94
'4729034000,  용성면,'20,15 - 19세,1998,442,222,220
'4729034000,  용성면,'25,20 - 24세,1998,430,254,176
'4729034000,  용성면,'30,25 - 29세,1998,371,235,136
'4729034000,  용성면,'35,30 - 34세,1998,243,147,96
'4729034000,  용성면,'40,35 - 39세,1998,265,157,108
'4729034000,  용성면,'45,40 - 44세,1998,295,153,142
'4729034000,  용성면,'50,45 - 49세,1998,312,162,150
'4729034000,  용성면,'55,50 - 54세,1998,284,138,146
'4729034000,  용성면,'60,55 - 59세,1998,371,168,203
'4729034000,  용성면,'65,60 - 64세,1998,438,199,239
'4729034000,  용성면,'70,65 - 69세,1998,381,135,246
'4729034000,  용성면,'75,70 - 74세,1998,269,109,160
'4729034000,  용성면,'80,75 - 79세,1998,194,82,112
'4729034000,  용성면,'85,80 - 84세,1998,105,44,61
'4729034000,  용성면,'90,85+ ,1998,54,17,37
'4729035000,  남산면,'00,계,1998,4818,2479,2339
'4729035000,  남산면,'05,0 - 4세,1998,208,115,93
'4729035000,  남산면,'10,5 - 9세,1998,167,82,85
'4729035000,  남산면,'15,10 - 14세,1998,192,110,82
'4729035000,  남산면,'20,15 - 19세,1998,348,187,161
'4729035000,  남산면,'25,20 - 24세,1998,449,246,203
'4729035000,  남산면,'30,25 - 29세,1998,399,246,153
'4729035000,  남산면,'35,30 - 34세,1998,289,164,125
'4729035000,  남산면,'40,35 - 39세,1998,291,183,108
'4729035000,  남산면,'45,40 - 44세,1998,310,178,132
'4729035000,  남산면,'50,45 - 49세,1998,329,158,171
'4729035000,  남산면,'55,50 - 54세,1998,293,156,137
'4729035000,  남산면,'60,55 - 59세,1998,380,194,186
'4729035000,  남산면,'65,60 - 64세,1998,401,174,227
'4729035000,  남산면,'70,65 - 69세,1998,290,104,186
'4729035000,  남산면,'75,70 - 74세,1998,197,72,125
'4729035000,  남산면,'80,75 - 79세,1998,161,74,87
'4729035000,  남산면,'85,80 - 84세,1998,77,26,51
'4729035000,  남산면,'90,85+ ,1998,37,10,27
'4729036000,  압량면,'00,계,1998,13267,6733,6534
'4729036000,  압량면,'05,0 - 4세,1998,1085,598,487
'4729036000,  압량면,'10,5 - 9세,1998,907,472,435
'4729036000,  압량면,'15,10 - 14세,1998,734,374,360
'4729036000,  압량면,'20,15 - 19세,1998,975,492,483
'4729036000,  압량면,'25,20 - 24세,1998,1142,569,573
'4729036000,  압량면,'30,25 - 29세,1998,1526,796,730
'4729036000,  압량면,'35,30 - 34세,1998,1404,763,641
'4729036000,  압량면,'40,35 - 39세,1998,1091,617,474
'4729036000,  압량면,'45,40 - 44세,1998,844,453,391
'4729036000,  압량면,'50,45 - 49세,1998,674,358,316
'4729036000,  압량면,'55,50 - 54세,1998,557,272,285
'4729036000,  압량면,'60,55 - 59세,1998,696,308,388
'4729036000,  압량면,'65,60 - 64세,1998,578,251,327
'4729036000,  압량면,'70,65 - 69세,1998,441,202,239
'4729036000,  압량면,'75,70 - 74세,1998,332,117,215
'4729036000,  압량면,'80,75 - 79세,1998,157,63,94
'4729036000,  압량면,'85,80 - 84세,1998,79,18,61
'4729036000,  압량면,'90,85+ ,1998,45,10,35
'4729037000,  남천면,'00,계,1998,4427,2228,2199
'4729037000,  남천면,'05,0 - 4세,1998,151,82,69
'4729037000,  남천면,'10,5 - 9세,1998,186,107,79
'4729037000,  남천면,'15,10 - 14세,1998,241,136,105
'4729037000,  남천면,'20,15 - 19세,1998,448,230,218
'4729037000,  남천면,'25,20 - 24세,1998,449,244,205
'4729037000,  남천면,'30,25 - 29세,1998,373,240,133
'4729037000,  남천면,'35,30 - 34세,1998,238,132,106
'4729037000,  남천면,'40,35 - 39세,1998,308,154,154
'4729037000,  남천면,'45,40 - 44세,1998,269,152,117
'4729037000,  남천면,'50,45 - 49세,1998,312,157,155
'4729037000,  남천면,'55,50 - 54세,1998,236,114,122
'4729037000,  남천면,'60,55 - 59세,1998,319,146,173
'4729037000,  남천면,'65,60 - 64세,1998,281,119,162
'4729037000,  남천면,'70,65 - 69세,1998,209,66,143
'4729037000,  남천면,'75,70 - 74세,1998,180,79,101
'4729037000,  남천면,'80,75 - 79세,1998,128,42,86
'4729037000,  남천면,'85,80 - 84세,1998,66,20,46
'4729037000,  남천면,'90,85+ ,1998,33,8,25
'4729051000,  중방동,'00,계,1998,8521,4169,4352
'4729051000,  중방동,'05,0 - 4세,1998,557,295,262
'4729051000,  중방동,'10,5 - 9세,1998,711,410,301
'4729051000,  중방동,'15,10 - 14세,1998,497,244,253
'4729051000,  중방동,'20,15 - 19세,1998,764,347,417
'4729051000,  중방동,'25,20 - 24세,1998,821,394,427
'4729051000,  중방동,'30,25 - 29세,1998,876,442,434
'4729051000,  중방동,'35,30 - 34세,1998,749,363,386
'4729051000,  중방동,'40,35 - 39세,1998,777,388,389
'4729051000,  중방동,'45,40 - 44세,1998,680,347,333
'4729051000,  중방동,'50,45 - 49세,1998,537,273,264
'4729051000,  중방동,'55,50 - 54세,1998,421,201,220
'4729051000,  중방동,'60,55 - 59세,1998,405,192,213
'4729051000,  중방동,'65,60 - 64세,1998,266,112,154
'4729051000,  중방동,'70,65 - 69세,1998,182,75,107
'4729051000,  중방동,'75,70 - 74세,1998,121,45,76
'4729051000,  중방동,'80,75 - 79세,1998,83,27,56
'4729051000,  중방동,'85,80 - 84세,1998,46,12,34
'4729051000,  중방동,'90,85+ ,1998,28,2,26
'4729052000,  중앙동,'00,계,1998,9013,4462,4551
'4729052000,  중앙동,'05,0 - 4세,1998,798,424,374
'4729052000,  중앙동,'10,5 - 9세,1998,681,354,327
'4729052000,  중앙동,'15,10 - 14세,1998,442,224,218
'4729052000,  중앙동,'20,15 - 19세,1998,656,325,331
'4729052000,  중앙동,'25,20 - 24세,1998,791,390,401
'4729052000,  중앙동,'30,25 - 29세,1998,1043,500,543
'4729052000,  중앙동,'35,30 - 34세,1998,1014,531,483
'4729052000,  중앙동,'40,35 - 39세,1998,825,465,360
'4729052000,  중앙동,'45,40 - 44세,1998,575,313,262
'4729052000,  중앙동,'50,45 - 49세,1998,482,234,248
'4729052000,  중앙동,'55,50 - 54세,1998,388,175,213
'4729052000,  중앙동,'60,55 - 59세,1998,438,174,264
'4729052000,  중앙동,'65,60 - 64세,1998,357,158,199
'4729052000,  중앙동,'70,65 - 69세,1998,244,109,135
'4729052000,  중앙동,'75,70 - 74세,1998,129,48,81
'4729052000,  중앙동,'80,75 - 79세,1998,78,25,53
'4729052000,  중앙동,'85,80 - 84세,1998,44,7,37
'4729052000,  중앙동,'90,85+ ,1998,28,6,22
'4729053000,  남부동,'00,계,1998,10092,4993,5099
'4729053000,  남부동,'05,0 - 4세,1998,759,392,367
'4729053000,  남부동,'10,5 - 9세,1998,874,493,381
'4729053000,  남부동,'15,10 - 14세,1998,646,354,292
'4729053000,  남부동,'20,15 - 19세,1998,848,439,409
'4729053000,  남부동,'25,20 - 24세,1998,800,387,413
'4729053000,  남부동,'30,25 - 29세,1998,976,453,523
'4729053000,  남부동,'35,30 - 34세,1998,1037,519,518
'4729053000,  남부동,'40,35 - 39세,1998,996,534,462
'4729053000,  남부동,'45,40 - 44세,1998,691,358,333
'4729053000,  남부동,'50,45 - 49세,1998,536,266,270
'4729053000,  남부동,'55,50 - 54세,1998,433,203,230
'4729053000,  남부동,'60,55 - 59세,1998,419,193,226
'4729053000,  남부동,'65,60 - 64세,1998,357,149,208
'4729053000,  남부동,'70,65 - 69세,1998,286,98,188
'4729053000,  남부동,'75,70 - 74세,1998,210,78,132
'4729053000,  남부동,'80,75 - 79세,1998,137,44,93
'4729053000,  남부동,'85,80 - 84세,1998,52,20,32
'4729053000,  남부동,'90,85+ ,1998,35,13,22
'4729054000,  서부동,'00,계,1998,50572,25218,25354
'4729054000,  서부동,'05,0 - 4세,1998,6093,3276,2817
'4729054000,  서부동,'10,5 - 9세,1998,5062,2704,2358
'4729054000,  서부동,'15,10 - 14세,1998,2321,1117,1204
'4729054000,  서부동,'20,15 - 19세,1998,2858,1433,1425
'4729054000,  서부동,'25,20 - 24세,1998,3413,1692,1721
'4729054000,  서부동,'30,25 - 29세,1998,5979,2567,3412
'4729054000,  서부동,'35,30 - 34세,1998,6789,3347,3442
'4729054000,  서부동,'40,35 - 39세,1998,5706,3187,2519
'4729054000,  서부동,'45,40 - 44세,1998,3178,1819,1359
'4729054000,  서부동,'50,45 - 49세,1998,2273,1097,1176
'4729054000,  서부동,'55,50 - 54세,1998,1701,809,892
'4729054000,  서부동,'60,55 - 59세,1998,1732,835,897
'4729054000,  서부동,'65,60 - 64세,1998,1328,582,746
'4729054000,  서부동,'70,65 - 69세,1998,892,345,547
'4729054000,  서부동,'75,70 - 74세,1998,598,230,368
'4729054000,  서부동,'80,75 - 79세,1998,372,108,264
'4729054000,  서부동,'85,80 - 84세,1998,182,51,131
'4729054000,  서부동,'90,85+ ,1998,95,19,76
'4729055000,  북부동,'00,계,1998,5177,2655,2522
'4729055000,  북부동,'05,0 - 4세,1998,293,156,137
'4729055000,  북부동,'10,5 - 9세,1998,260,141,119
'4729055000,  북부동,'15,10 - 14세,1998,183,100,83
'4729055000,  북부동,'20,15 - 19세,1998,407,206,201
'4729055000,  북부동,'25,20 - 24세,1998,678,347,331
'4729055000,  북부동,'30,25 - 29세,1998,595,363,232
'4729055000,  북부동,'35,30 - 34세,1998,378,212,166
'4729055000,  북부동,'40,35 - 39세,1998,384,233,151
'4729055000,  북부동,'45,40 - 44세,1998,301,171,130
'4729055000,  북부동,'50,45 - 49세,1998,284,132,152
'4729055000,  북부동,'55,50 - 54세,1998,278,132,146
'4729055000,  북부동,'60,55 - 59세,1998,313,137,176
'4729055000,  북부동,'65,60 - 64세,1998,295,132,163
'4729055000,  북부동,'70,65 - 69세,1998,191,83,108
'4729055000,  북부동,'75,70 - 74세,1998,158,53,105
'4729055000,  북부동,'80,75 - 79세,1998,101,38,63
'4729055000,  북부동,'85,80 - 84세,1998,40,11,29
'4729055000,  북부동,'90,85+ ,1998,38,8,30
'4729056000,  동부동,'00,계,1998,17202,8650,8552
'4729056000,  동부동,'05,0 - 4세,1998,1748,948,800
'4729056000,  동부동,'10,5 - 9세,1998,1719,940,779
'4729056000,  동부동,'15,10 - 14세,1998,1141,581,560
'4729056000,  동부동,'20,15 - 19세,1998,1078,547,531
'4729056000,  동부동,'25,20 - 24세,1998,1130,580,550
'4729056000,  동부동,'30,25 - 29세,1998,1913,878,1035
'4729056000,  동부동,'35,30 - 34세,1998,2152,1038,1114
'4729056000,  동부동,'40,35 - 39세,1998,2031,1102,929
'4729056000,  동부동,'45,40 - 44세,1998,1200,714,486
'4729056000,  동부동,'50,45 - 49세,1998,686,362,324
'4729056000,  동부동,'55,50 - 54세,1998,524,239,285
'4729056000,  동부동,'60,55 - 59세,1998,612,262,350
'4729056000,  동부동,'65,60 - 64세,1998,444,172,272
'4729056000,  동부동,'70,65 - 69세,1998,341,135,206
'4729056000,  동부동,'75,70 - 74세,1998,234,72,162
'4729056000,  동부동,'80,75 - 79세,1998,144,51,93
'4729056000,  동부동,'85,80 - 84세,1998,72,24,48
'4729056000,  동부동,'90,85+ ,1998,33,5,28
'47720, 군위군,'00,계,1998,31490,15826,15664
'47720, 군위군,'05,0 - 4세,1998,1218,666,552
'47720, 군위군,'10,5 - 9세,1998,1467,822,645
'47720, 군위군,'15,10 - 14세,1998,1539,845,694
'47720, 군위군,'20,15 - 19세,1998,2140,1056,1084
'47720, 군위군,'25,20 - 24세,1998,2447,1407,1040
'47720, 군위군,'30,25 - 29세,1998,2053,1271,782
'47720, 군위군,'35,30 - 34세,1998,1715,944,771
'47720, 군위군,'40,35 - 39세,1998,1982,1059,923
'47720, 군위군,'45,40 - 44세,1998,1877,1047,830
'47720, 군위군,'50,45 - 49세,1998,1812,934,878
'47720, 군위군,'55,50 - 54세,1998,1864,888,976
'47720, 군위군,'60,55 - 59세,1998,2760,1254,1506
'47720, 군위군,'65,60 - 64세,1998,2873,1279,1594
'47720, 군위군,'70,65 - 69세,1998,2126,930,1196
'47720, 군위군,'75,70 - 74세,1998,1602,659,943
'47720, 군위군,'80,75 - 79세,1998,1097,453,644
'47720, 군위군,'85,80 - 84세,1998,593,213,380
'47720, 군위군,'90,85+ ,1998,325,99,226
'4772025000,  군위읍,'00,계,1998,9737,4955,4782
'4772025000,  군위읍,'05,0 - 4세,1998,546,297,249
'4772025000,  군위읍,'10,5 - 9세,1998,611,341,270
'4772025000,  군위읍,'15,10 - 14세,1998,552,317,235
'4772025000,  군위읍,'20,15 - 19세,1998,706,359,347
'4772025000,  군위읍,'25,20 - 24세,1998,774,430,344
'4772025000,  군위읍,'30,25 - 29세,1998,791,431,360
'4772025000,  군위읍,'35,30 - 34세,1998,724,367,357
'4772025000,  군위읍,'40,35 - 39세,1998,763,402,361
'4772025000,  군위읍,'45,40 - 44세,1998,619,357,262
'4772025000,  군위읍,'50,45 - 49세,1998,550,277,273
'4772025000,  군위읍,'55,50 - 54세,1998,515,256,259
'4772025000,  군위읍,'60,55 - 59세,1998,645,300,345
'4772025000,  군위읍,'65,60 - 64세,1998,645,288,357
'4772025000,  군위읍,'70,65 - 69세,1998,446,199,247
'4772025000,  군위읍,'75,70 - 74세,1998,363,149,214
'4772025000,  군위읍,'80,75 - 79세,1998,264,109,155
'4772025000,  군위읍,'85,80 - 84세,1998,145,53,92
'4772025000,  군위읍,'90,85+ ,1998,78,23,55
'4772031000,  소보면,'00,계,1998,3395,1703,1692
'4772031000,  소보면,'05,0 - 4세,1998,90,49,41
'4772031000,  소보면,'10,5 - 9세,1998,107,61,46
'4772031000,  소보면,'15,10 - 14세,1998,121,69,52
'4772031000,  소보면,'20,15 - 19세,1998,233,118,115
'4772031000,  소보면,'25,20 - 24세,1998,298,166,132
'4772031000,  소보면,'30,25 - 29세,1998,171,127,44
'4772031000,  소보면,'35,30 - 34세,1998,150,86,64
'4772031000,  소보면,'40,35 - 39세,1998,149,85,64
'4772031000,  소보면,'45,40 - 44세,1998,163,82,81
'4772031000,  소보면,'50,45 - 49세,1998,187,91,96
'4772031000,  소보면,'55,50 - 54세,1998,206,96,110
'4772031000,  소보면,'60,55 - 59세,1998,327,140,187
'4772031000,  소보면,'65,60 - 64세,1998,383,187,196
'4772031000,  소보면,'70,65 - 69세,1998,314,134,180
'4772031000,  소보면,'75,70 - 74세,1998,220,95,125
'4772031000,  소보면,'80,75 - 79세,1998,150,71,79
'4772031000,  소보면,'85,80 - 84세,1998,81,31,50
'4772031000,  소보면,'90,85+ ,1998,45,15,30
'4772032000,  효령면,'00,계,1998,4850,2534,2316
'4772032000,  효령면,'05,0 - 4세,1998,176,98,78
'4772032000,  효령면,'10,5 - 9세,1998,215,123,92
'4772032000,  효령면,'15,10 - 14세,1998,228,126,102
'4772032000,  효령면,'20,15 - 19세,1998,304,156,148
'4772032000,  효령면,'25,20 - 24세,1998,375,226,149
'4772032000,  효령면,'30,25 - 29세,1998,354,221,133
'4772032000,  효령면,'35,30 - 34세,1998,297,184,113
'4772032000,  효령면,'40,35 - 39세,1998,299,167,132
'4772032000,  효령면,'45,40 - 44세,1998,307,179,128
'4772032000,  효령면,'50,45 - 49세,1998,266,144,122
'4772032000,  효령면,'55,50 - 54세,1998,297,146,151
'4772032000,  효령면,'60,55 - 59세,1998,454,212,242
'4772032000,  효령면,'65,60 - 64세,1998,477,213,264
'4772032000,  효령면,'70,65 - 69세,1998,306,138,168
'4772032000,  효령면,'75,70 - 74세,1998,218,85,133
'4772032000,  효령면,'80,75 - 79세,1998,165,64,101
'4772032000,  효령면,'85,80 - 84세,1998,72,35,37
'4772032000,  효령면,'90,85+ ,1998,40,17,23
'4772033000,  부계면,'00,계,1998,2863,1408,1455
'4772033000,  부계면,'05,0 - 4세,1998,131,70,61
'4772033000,  부계면,'10,5 - 9세,1998,148,79,69
'4772033000,  부계면,'15,10 - 14세,1998,133,74,59
'4772033000,  부계면,'20,15 - 19세,1998,193,88,105
'4772033000,  부계면,'25,20 - 24세,1998,196,113,83
'4772033000,  부계면,'30,25 - 29세,1998,205,123,82
'4772033000,  부계면,'35,30 - 34세,1998,135,82,53
'4772033000,  부계면,'40,35 - 39세,1998,173,91,82
'4772033000,  부계면,'45,40 - 44세,1998,177,88,89
'4772033000,  부계면,'50,45 - 49세,1998,168,100,68
'4772033000,  부계면,'55,50 - 54세,1998,170,73,97
'4772033000,  부계면,'60,55 - 59세,1998,246,106,140
'4772033000,  부계면,'65,60 - 64세,1998,241,103,138
'4772033000,  부계면,'70,65 - 69세,1998,200,90,110
'4772033000,  부계면,'75,70 - 74세,1998,143,59,84
'4772033000,  부계면,'80,75 - 79세,1998,111,40,71
'4772033000,  부계면,'85,80 - 84세,1998,57,21,36
'4772033000,  부계면,'90,85+ ,1998,36,8,28
'4772034000,  우보면,'00,계,1998,2825,1371,1454
'4772034000,  우보면,'05,0 - 4세,1998,59,33,26
'4772034000,  우보면,'10,5 - 9세,1998,95,48,47
'4772034000,  우보면,'15,10 - 14세,1998,127,64,63
'4772034000,  우보면,'20,15 - 19세,1998,176,81,95
'4772034000,  우보면,'25,20 - 24세,1998,195,108,87
'4772034000,  우보면,'30,25 - 29세,1998,142,100,42
'4772034000,  우보면,'35,30 - 34세,1998,105,57,48
'4772034000,  우보면,'40,35 - 39세,1998,149,89,60
'4772034000,  우보면,'45,40 - 44세,1998,129,72,57
'4772034000,  우보면,'50,45 - 49세,1998,157,67,90
'4772034000,  우보면,'55,50 - 54세,1998,176,84,92
'4772034000,  우보면,'60,55 - 59세,1998,295,134,161
'4772034000,  우보면,'65,60 - 64세,1998,327,152,175
'4772034000,  우보면,'70,65 - 69세,1998,260,113,147
'4772034000,  우보면,'75,70 - 74세,1998,194,82,112
'4772034000,  우보면,'80,75 - 79세,1998,123,49,74
'4772034000,  우보면,'85,80 - 84세,1998,72,25,47
'4772034000,  우보면,'90,85+ ,1998,44,13,31
'4772035000,  의흥면,'00,계,1998,3730,1837,1893
'4772035000,  의흥면,'05,0 - 4세,1998,116,65,51
'4772035000,  의흥면,'10,5 - 9세,1998,157,90,67
'4772035000,  의흥면,'15,10 - 14세,1998,185,93,92
'4772035000,  의흥면,'20,15 - 19세,1998,258,123,135
'4772035000,  의흥면,'25,20 - 24세,1998,265,148,117
'4772035000,  의흥면,'30,25 - 29세,1998,188,125,63
'4772035000,  의흥면,'35,30 - 34세,1998,150,76,74
'4772035000,  의흥면,'40,35 - 39세,1998,228,109,119
'4772035000,  의흥면,'45,40 - 44세,1998,258,147,111
'4772035000,  의흥면,'50,45 - 49세,1998,234,132,102
'4772035000,  의흥면,'55,50 - 54세,1998,236,113,123
'4772035000,  의흥면,'60,55 - 59세,1998,362,171,191
'4772035000,  의흥면,'65,60 - 64세,1998,384,168,216
'4772035000,  의흥면,'70,65 - 69세,1998,268,110,158
'4772035000,  의흥면,'75,70 - 74세,1998,199,81,118
'4772035000,  의흥면,'80,75 - 79세,1998,128,49,79
'4772035000,  의흥면,'85,80 - 84세,1998,82,28,54
'4772035000,  의흥면,'90,85+ ,1998,32,9,23
'4772036000,  산성면,'00,계,1998,1947,964,983
'4772036000,  산성면,'05,0 - 4세,1998,46,27,19
'4772036000,  산성면,'10,5 - 9세,1998,51,33,18
'4772036000,  산성면,'15,10 - 14세,1998,97,53,44
'4772036000,  산성면,'20,15 - 19세,1998,119,59,60
'4772036000,  산성면,'25,20 - 24세,1998,163,102,61
'4772036000,  산성면,'30,25 - 29세,1998,100,75,25
'4772036000,  산성면,'35,30 - 34세,1998,62,35,27
'4772036000,  산성면,'40,35 - 39세,1998,110,58,52
'4772036000,  산성면,'45,40 - 44세,1998,104,53,51
'4772036000,  산성면,'50,45 - 49세,1998,110,56,54
'4772036000,  산성면,'55,50 - 54세,1998,115,48,67
'4772036000,  산성면,'60,55 - 59세,1998,216,97,119
'4772036000,  산성면,'65,60 - 64세,1998,226,95,131
'4772036000,  산성면,'70,65 - 69세,1998,159,70,89
'4772036000,  산성면,'75,70 - 74세,1998,133,49,84
'4772036000,  산성면,'80,75 - 79세,1998,74,37,37
'4772036000,  산성면,'85,80 - 84세,1998,41,12,29
'4772036000,  산성면,'90,85+ ,1998,21,5,16
'4772037000,  고로면,'00,계,1998,2143,1054,1089
'4772037000,  고로면,'05,0 - 4세,1998,54,27,27
'4772037000,  고로면,'10,5 - 9세,1998,83,47,36
'4772037000,  고로면,'15,10 - 14세,1998,96,49,47
'4772037000,  고로면,'20,15 - 19세,1998,151,72,79
'4772037000,  고로면,'25,20 - 24세,1998,181,114,67
'4772037000,  고로면,'30,25 - 29세,1998,102,69,33
'4772037000,  고로면,'35,30 - 34세,1998,92,57,35
'4772037000,  고로면,'40,35 - 39세,1998,111,58,53
'4772037000,  고로면,'45,40 - 44세,1998,120,69,51
'4772037000,  고로면,'50,45 - 49세,1998,140,67,73
'4772037000,  고로면,'55,50 - 54세,1998,149,72,77
'4772037000,  고로면,'60,55 - 59세,1998,215,94,121
'4772037000,  고로면,'65,60 - 64세,1998,190,73,117
'4772037000,  고로면,'70,65 - 69세,1998,173,76,97
'4772037000,  고로면,'75,70 - 74세,1998,132,59,73
'4772037000,  고로면,'80,75 - 79세,1998,82,34,48
'4772037000,  고로면,'85,80 - 84세,1998,43,8,35
'4772037000,  고로면,'90,85+ ,1998,29,9,20
'47730, 의성군,'00,계,1998,80559,40053,40506
'47730, 의성군,'05,0 - 4세,1998,2684,1442,1242
'47730, 의성군,'10,5 - 9세,1998,3447,1914,1533
'47730, 의성군,'15,10 - 14세,1998,4423,2352,2071
'47730, 의성군,'20,15 - 19세,1998,6658,3336,3322
'47730, 의성군,'25,20 - 24세,1998,6937,4008,2929
'47730, 의성군,'30,25 - 29세,1998,4922,3067,1855
'47730, 의성군,'35,30 - 34세,1998,3831,2076,1755
'47730, 의성군,'40,35 - 39세,1998,4955,2483,2472
'47730, 의성군,'45,40 - 44세,1998,5173,2674,2499
'47730, 의성군,'50,45 - 49세,1998,4941,2392,2549
'47730, 의성군,'55,50 - 54세,1998,4578,2176,2402
'47730, 의성군,'60,55 - 59세,1998,7048,3192,3856
'47730, 의성군,'65,60 - 64세,1998,7003,3109,3894
'47730, 의성군,'70,65 - 69세,1998,5255,2255,3000
'47730, 의성군,'75,70 - 74세,1998,3808,1670,2138
'47730, 의성군,'80,75 - 79세,1998,2693,1134,1559
'47730, 의성군,'85,80 - 84세,1998,1398,535,863
'47730, 의성군,'90,85+ ,1998,805,238,567
'4773025000,  의성읍,'00,계,1998,18702,9285,9417
'4773025000,  의성읍,'05,0 - 4세,1998,921,487,434
'4773025000,  의성읍,'10,5 - 9세,1998,1112,640,472
'4773025000,  의성읍,'15,10 - 14세,1998,1312,680,632
'4773025000,  의성읍,'20,15 - 19세,1998,1805,931,874
'4773025000,  의성읍,'25,20 - 24세,1998,1691,897,794
'4773025000,  의성읍,'30,25 - 29세,1998,1430,769,661
'4773025000,  의성읍,'35,30 - 34세,1998,1251,645,606
'4773025000,  의성읍,'40,35 - 39세,1998,1517,713,804
'4773025000,  의성읍,'45,40 - 44세,1998,1434,717,717
'4773025000,  의성읍,'50,45 - 49세,1998,1183,583,600
'4773025000,  의성읍,'55,50 - 54세,1998,991,498,493
'4773025000,  의성읍,'60,55 - 59세,1998,1154,533,621
'4773025000,  의성읍,'65,60 - 64세,1998,999,453,546
'4773025000,  의성읍,'70,65 - 69세,1998,705,290,415
'4773025000,  의성읍,'75,70 - 74세,1998,546,214,332
'4773025000,  의성읍,'80,75 - 79세,1998,360,138,222
'4773025000,  의성읍,'85,80 - 84세,1998,175,65,110
'4773025000,  의성읍,'90,85+ ,1998,116,32,84
'4773031000,  단촌면,'00,계,1998,3408,1740,1668
'4773031000,  단촌면,'05,0 - 4세,1998,80,43,37
'4773031000,  단촌면,'10,5 - 9세,1998,95,58,37
'4773031000,  단촌면,'15,10 - 14세,1998,162,93,69
'4773031000,  단촌면,'20,15 - 19세,1998,298,163,135
'4773031000,  단촌면,'25,20 - 24세,1998,323,188,135
'4773031000,  단촌면,'30,25 - 29세,1998,232,166,66
'4773031000,  단촌면,'35,30 - 34세,1998,121,70,51
'4773031000,  단촌면,'40,35 - 39세,1998,184,94,90
'4773031000,  단촌면,'45,40 - 44세,1998,238,120,118
'4773031000,  단촌면,'50,45 - 49세,1998,196,101,95
'4773031000,  단촌면,'55,50 - 54세,1998,197,72,125
'4773031000,  단촌면,'60,55 - 59세,1998,345,158,187
'4773031000,  단촌면,'65,60 - 64세,1998,360,155,205
'4773031000,  단촌면,'70,65 - 69세,1998,217,103,114
'4773031000,  단촌면,'75,70 - 74세,1998,160,73,87
'4773031000,  단촌면,'80,75 - 79세,1998,110,50,60
'4773031000,  단촌면,'85,80 - 84세,1998,58,24,34
'4773031000,  단촌면,'90,85+ ,1998,32,9,23
'4773032000,  점곡면,'00,계,1998,2760,1381,1379
'4773032000,  점곡면,'05,0 - 4세,1998,91,47,44
'4773032000,  점곡면,'10,5 - 9세,1998,73,38,35
'4773032000,  점곡면,'15,10 - 14세,1998,97,55,42
'4773032000,  점곡면,'20,15 - 19세,1998,213,97,116
'4773032000,  점곡면,'25,20 - 24세,1998,259,150,109
'4773032000,  점곡면,'30,25 - 29세,1998,146,100,46
'4773032000,  점곡면,'35,30 - 34세,1998,111,67,44
'4773032000,  점곡면,'40,35 - 39세,1998,144,81,63
'4773032000,  점곡면,'45,40 - 44세,1998,150,76,74
'4773032000,  점곡면,'50,45 - 49세,1998,186,94,92
'4773032000,  점곡면,'55,50 - 54세,1998,178,93,85
'4773032000,  점곡면,'60,55 - 59세,1998,268,112,156
'4773032000,  점곡면,'65,60 - 64세,1998,268,123,145
'4773032000,  점곡면,'70,65 - 69세,1998,221,94,127
'4773032000,  점곡면,'75,70 - 74세,1998,157,66,91
'4773032000,  점곡면,'80,75 - 79세,1998,111,53,58
'4773032000,  점곡면,'85,80 - 84세,1998,58,23,35
'4773032000,  점곡면,'90,85+ ,1998,29,12,17
'4773033000,  옥산면,'00,계,1998,3020,1515,1505
'4773033000,  옥산면,'05,0 - 4세,1998,97,53,44
'4773033000,  옥산면,'10,5 - 9세,1998,103,55,48
'4773033000,  옥산면,'15,10 - 14세,1998,168,93,75
'4773033000,  옥산면,'20,15 - 19세,1998,235,122,113
'4773033000,  옥산면,'25,20 - 24세,1998,270,159,111
'4773033000,  옥산면,'30,25 - 29세,1998,172,114,58
'4773033000,  옥산면,'35,30 - 34세,1998,118,63,55
'4773033000,  옥산면,'40,35 - 39세,1998,157,78,79
'4773033000,  옥산면,'45,40 - 44세,1998,194,100,94
'4773033000,  옥산면,'50,45 - 49세,1998,171,78,93
'4773033000,  옥산면,'55,50 - 54세,1998,196,89,107
'4773033000,  옥산면,'60,55 - 59세,1998,289,126,163
'4773033000,  옥산면,'65,60 - 64세,1998,256,116,140
'4773033000,  옥산면,'70,65 - 69세,1998,220,99,121
'4773033000,  옥산면,'75,70 - 74세,1998,160,75,85
'4773033000,  옥산면,'80,75 - 79세,1998,106,50,56
'4773033000,  옥산면,'85,80 - 84세,1998,67,29,38
'4773033000,  옥산면,'90,85+ ,1998,41,16,25
'4773034000,  사곡면,'00,계,1998,2703,1338,1365
'4773034000,  사곡면,'05,0 - 4세,1998,53,27,26
'4773034000,  사곡면,'10,5 - 9세,1998,69,36,33
'4773034000,  사곡면,'15,10 - 14세,1998,109,56,53
'4773034000,  사곡면,'20,15 - 19세,1998,231,126,105
'4773034000,  사곡면,'25,20 - 24세,1998,213,123,90
'4773034000,  사곡면,'30,25 - 29세,1998,129,92,37
'4773034000,  사곡면,'35,30 - 34세,1998,94,58,36
'4773034000,  사곡면,'40,35 - 39세,1998,125,66,59
'4773034000,  사곡면,'45,40 - 44세,1998,166,78,88
'4773034000,  사곡면,'50,45 - 49세,1998,148,80,68
'4773034000,  사곡면,'55,50 - 54세,1998,144,67,77
'4773034000,  사곡면,'60,55 - 59세,1998,273,119,154
'4773034000,  사곡면,'65,60 - 64세,1998,289,121,168
'4773034000,  사곡면,'70,65 - 69세,1998,250,101,149
'4773034000,  사곡면,'75,70 - 74세,1998,164,77,87
'4773034000,  사곡면,'80,75 - 79세,1998,150,73,77
'4773034000,  사곡면,'85,80 - 84세,1998,60,21,39
'4773034000,  사곡면,'90,85+ ,1998,36,17,19
'4773035000,  춘산면,'00,계,1998,2436,1197,1239
'4773035000,  춘산면,'05,0 - 4세,1998,54,35,19
'4773035000,  춘산면,'10,5 - 9세,1998,110,58,52
'4773035000,  춘산면,'15,10 - 14세,1998,180,99,81
'4773035000,  춘산면,'20,15 - 19세,1998,206,96,110
'4773035000,  춘산면,'25,20 - 24세,1998,159,85,74
'4773035000,  춘산면,'30,25 - 29세,1998,115,74,41
'4773035000,  춘산면,'35,30 - 34세,1998,113,49,64
'4773035000,  춘산면,'40,35 - 39세,1998,164,88,76
'4773035000,  춘산면,'45,40 - 44세,1998,183,103,80
'4773035000,  춘산면,'50,45 - 49세,1998,131,70,61
'4773035000,  춘산면,'55,50 - 54세,1998,128,55,73
'4773035000,  춘산면,'60,55 - 59세,1998,183,81,102
'4773035000,  춘산면,'65,60 - 64세,1998,206,97,109
'4773035000,  춘산면,'70,65 - 69세,1998,185,77,108
'4773035000,  춘산면,'75,70 - 74세,1998,150,62,88
'4773035000,  춘산면,'80,75 - 79세,1998,96,39,57
'4773035000,  춘산면,'85,80 - 84세,1998,47,18,29
'4773035000,  춘산면,'90,85+ ,1998,26,11,15
'4773036000,  가음면,'00,계,1998,2340,1138,1202
'4773036000,  가음면,'05,0 - 4세,1998,40,25,15
'4773036000,  가음면,'10,5 - 9세,1998,87,48,39
'4773036000,  가음면,'15,10 - 14세,1998,131,56,75
'4773036000,  가음면,'20,15 - 19세,1998,180,93,87
'4773036000,  가음면,'25,20 - 24세,1998,171,97,74
'4773036000,  가음면,'30,25 - 29세,1998,107,73,34
'4773036000,  가음면,'35,30 - 34세,1998,86,44,42
'4773036000,  가음면,'40,35 - 39세,1998,143,78,65
'4773036000,  가음면,'45,40 - 44세,1998,140,77,63
'4773036000,  가음면,'50,45 - 49세,1998,140,65,75
'4773036000,  가음면,'55,50 - 54세,1998,128,68,60
'4773036000,  가음면,'60,55 - 59세,1998,210,92,118
'4773036000,  가음면,'65,60 - 64세,1998,249,95,154
'4773036000,  가음면,'70,65 - 69세,1998,201,77,124
'4773036000,  가음면,'75,70 - 74세,1998,165,78,87
'4773036000,  가음면,'80,75 - 79세,1998,98,45,53
'4773036000,  가음면,'85,80 - 84세,1998,47,20,27
'4773036000,  가음면,'90,85+ ,1998,17,7,10
'4773037000,  금성면,'00,계,1998,6940,3399,3541
'4773037000,  금성면,'05,0 - 4세,1998,191,107,84
'4773037000,  금성면,'10,5 - 9세,1998,271,143,128
'4773037000,  금성면,'15,10 - 14세,1998,363,192,171
'4773037000,  금성면,'20,15 - 19세,1998,578,259,319
'4773037000,  금성면,'25,20 - 24세,1998,636,363,273
'4773037000,  금성면,'30,25 - 29세,1998,435,293,142
'4773037000,  금성면,'35,30 - 34세,1998,294,156,138
'4773037000,  금성면,'40,35 - 39세,1998,387,193,194
'4773037000,  금성면,'45,40 - 44세,1998,423,228,195
'4773037000,  금성면,'50,45 - 49세,1998,423,189,234
'4773037000,  금성면,'55,50 - 54세,1998,437,220,217
'4773037000,  금성면,'60,55 - 59세,1998,607,276,331
'4773037000,  금성면,'65,60 - 64세,1998,639,292,347
'4773037000,  금성면,'70,65 - 69세,1998,459,185,274
'4773037000,  금성면,'75,70 - 74세,1998,381,142,239
'4773037000,  금성면,'80,75 - 79세,1998,233,100,133
'4773037000,  금성면,'85,80 - 84세,1998,124,44,80
'4773037000,  금성면,'90,85+ ,1998,59,17,42
'4773038000,  봉양면,'00,계,1998,5544,2785,2759
'4773038000,  봉양면,'05,0 - 4세,1998,204,109,95
'4773038000,  봉양면,'10,5 - 9세,1998,224,121,103
'4773038000,  봉양면,'15,10 - 14세,1998,249,129,120
'4773038000,  봉양면,'20,15 - 19세,1998,445,221,224
'4773038000,  봉양면,'25,20 - 24세,1998,513,317,196
'4773038000,  봉양면,'30,25 - 29세,1998,327,199,128
'4773038000,  봉양면,'35,30 - 34세,1998,272,158,114
'4773038000,  봉양면,'40,35 - 39세,1998,303,167,136
'4773038000,  봉양면,'45,40 - 44세,1998,354,182,172
'4773038000,  봉양면,'50,45 - 49세,1998,389,188,201
'4773038000,  봉양면,'55,50 - 54세,1998,340,169,171
'4773038000,  봉양면,'60,55 - 59세,1998,497,223,274
'4773038000,  봉양면,'65,60 - 64세,1998,468,207,261
'4773038000,  봉양면,'70,65 - 69세,1998,376,153,223
'4773038000,  봉양면,'75,70 - 74세,1998,250,120,130
'4773038000,  봉양면,'80,75 - 79세,1998,166,60,106
'4773038000,  봉양면,'85,80 - 84세,1998,109,42,67
'4773038000,  봉양면,'90,85+ ,1998,58,20,38
'4773039000,  비안면,'00,계,1998,3969,1954,2015
'4773039000,  비안면,'05,0 - 4세,1998,87,50,37
'4773039000,  비안면,'10,5 - 9세,1998,126,68,58
'4773039000,  비안면,'15,10 - 14세,1998,189,101,88
'4773039000,  비안면,'20,15 - 19세,1998,295,148,147
'4773039000,  비안면,'25,20 - 24세,1998,322,182,140
'4773039000,  비안면,'30,25 - 29세,1998,219,152,67
'4773039000,  비안면,'35,30 - 34세,1998,164,91,73
'4773039000,  비안면,'40,35 - 39세,1998,187,101,86
'4773039000,  비안면,'45,40 - 44세,1998,224,112,112
'4773039000,  비안면,'50,45 - 49세,1998,234,107,127
'4773039000,  비안면,'55,50 - 54세,1998,227,108,119
'4773039000,  비안면,'60,55 - 59세,1998,370,161,209
'4773039000,  비안면,'65,60 - 64세,1998,402,183,219
'4773039000,  비안면,'70,65 - 69세,1998,331,143,188
'4773039000,  비안면,'75,70 - 74세,1998,267,120,147
'4773039000,  비안면,'80,75 - 79세,1998,165,73,92
'4773039000,  비안면,'85,80 - 84세,1998,103,43,60
'4773039000,  비안면,'90,85+ ,1998,57,11,46
'4773040000,  구천면,'00,계,1998,2816,1403,1413
'4773040000,  구천면,'05,0 - 4세,1998,93,50,43
'4773040000,  구천면,'10,5 - 9세,1998,115,63,52
'4773040000,  구천면,'15,10 - 14세,1998,103,49,54
'4773040000,  구천면,'20,15 - 19세,1998,182,91,91
'4773040000,  구천면,'25,20 - 24세,1998,207,121,86
'4773040000,  구천면,'30,25 - 29세,1998,150,100,50
'4773040000,  구천면,'35,30 - 34세,1998,131,85,46
'4773040000,  구천면,'40,35 - 39세,1998,154,85,69
'4773040000,  구천면,'45,40 - 44세,1998,163,86,77
'4773040000,  구천면,'50,45 - 49세,1998,166,92,74
'4773040000,  구천면,'55,50 - 54세,1998,153,74,79
'4773040000,  구천면,'60,55 - 59세,1998,266,118,148
'4773040000,  구천면,'65,60 - 64세,1998,316,129,187
'4773040000,  구천면,'70,65 - 69세,1998,221,97,124
'4773040000,  구천면,'75,70 - 74세,1998,173,76,97
'4773040000,  구천면,'80,75 - 79세,1998,134,61,73
'4773040000,  구천면,'85,80 - 84세,1998,56,21,35
'4773040000,  구천면,'90,85+ ,1998,33,5,28
'4773041000,  단밀면,'00,계,1998,3034,1504,1530
'4773041000,  단밀면,'05,0 - 4세,1998,75,40,35
'4773041000,  단밀면,'10,5 - 9세,1998,136,80,56
'4773041000,  단밀면,'15,10 - 14세,1998,167,84,83
'4773041000,  단밀면,'20,15 - 19세,1998,221,123,98
'4773041000,  단밀면,'25,20 - 24세,1998,245,140,105
'4773041000,  단밀면,'30,25 - 29세,1998,163,100,63
'4773041000,  단밀면,'35,30 - 34세,1998,116,59,57
'4773041000,  단밀면,'40,35 - 39세,1998,190,102,88
'4773041000,  단밀면,'45,40 - 44세,1998,168,85,83
'4773041000,  단밀면,'50,45 - 49세,1998,183,81,102
'4773041000,  단밀면,'55,50 - 54세,1998,167,84,83
'4773041000,  단밀면,'60,55 - 59세,1998,280,125,155
'4773041000,  단밀면,'65,60 - 64세,1998,340,154,186
'4773041000,  단밀면,'70,65 - 69세,1998,233,97,136
'4773041000,  단밀면,'75,70 - 74세,1998,147,66,81
'4773041000,  단밀면,'80,75 - 79세,1998,106,48,58
'4773041000,  단밀면,'85,80 - 84세,1998,52,23,29
'4773041000,  단밀면,'90,85+ ,1998,45,13,32
'4773042000,  단북면,'00,계,1998,2984,1500,1484
'4773042000,  단북면,'05,0 - 4세,1998,77,42,35
'4773042000,  단북면,'10,5 - 9세,1998,70,39,31
'4773042000,  단북면,'15,10 - 14세,1998,156,84,72
'4773042000,  단북면,'20,15 - 19세,1998,222,117,105
'4773042000,  단북면,'25,20 - 24세,1998,252,157,95
'4773042000,  단북면,'30,25 - 29세,1998,167,120,47
'4773042000,  단북면,'35,30 - 34세,1998,98,68,30
'4773042000,  단북면,'40,35 - 39세,1998,157,77,80
'4773042000,  단북면,'45,40 - 44세,1998,185,102,83
'4773042000,  단북면,'50,45 - 49세,1998,198,94,104
'4773042000,  단북면,'55,50 - 54세,1998,175,72,103
'4773042000,  단북면,'60,55 - 59세,1998,331,144,187
'4773042000,  단북면,'65,60 - 64세,1998,317,130,187
'4773042000,  단북면,'70,65 - 69세,1998,227,124,103
'4773042000,  단북면,'75,70 - 74세,1998,144,64,80
'4773042000,  단북면,'80,75 - 79세,1998,104,38,66
'4773042000,  단북면,'85,80 - 84세,1998,63,15,48
'4773042000,  단북면,'90,85+ ,1998,41,13,28
'4773043000,  안계면,'00,계,1998,6846,3405,3441
'4773043000,  안계면,'05,0 - 4세,1998,317,162,155
'4773043000,  안계면,'10,5 - 9세,1998,439,239,200
'4773043000,  안계면,'15,10 - 14세,1998,397,217,180
'4773043000,  안계면,'20,15 - 19세,1998,523,256,267
'4773043000,  안계면,'25,20 - 24세,1998,529,314,215
'4773043000,  안계면,'30,25 - 29세,1998,485,269,216
'4773043000,  안계면,'35,30 - 34세,1998,422,215,207
'4773043000,  안계면,'40,35 - 39세,1998,480,239,241
'4773043000,  안계면,'45,40 - 44세,1998,454,237,217
'4773043000,  안계면,'50,45 - 49세,1998,384,185,199
'4773043000,  안계면,'55,50 - 54세,1998,374,181,193
'4773043000,  안계면,'60,55 - 59세,1998,558,255,303
'4773043000,  안계면,'65,60 - 64세,1998,509,229,280
'4773043000,  안계면,'70,65 - 69세,1998,372,171,201
'4773043000,  안계면,'75,70 - 74세,1998,232,112,120
'4773043000,  안계면,'80,75 - 79세,1998,209,71,138
'4773043000,  안계면,'85,80 - 84세,1998,102,37,65
'4773043000,  안계면,'90,85+ ,1998,60,16,44
'4773044000,  다인면,'00,계,1998,6750,3377,3373
'4773044000,  다인면,'05,0 - 4세,1998,195,114,81
'4773044000,  다인면,'10,5 - 9세,1998,264,144,120
'4773044000,  다인면,'15,10 - 14세,1998,383,227,156
'4773044000,  다인면,'20,15 - 19세,1998,582,275,307
'4773044000,  다인면,'25,20 - 24세,1998,593,357,236
'4773044000,  다인면,'30,25 - 29세,1998,358,228,130
'4773044000,  다인면,'35,30 - 34세,1998,269,150,119
'4773044000,  다인면,'40,35 - 39세,1998,372,186,186
'4773044000,  다인면,'45,40 - 44세,1998,384,200,184
'4773044000,  다인면,'50,45 - 49세,1998,442,210,232
'4773044000,  다인면,'55,50 - 54세,1998,376,173,203
'4773044000,  다인면,'60,55 - 59세,1998,667,322,345
'4773044000,  다인면,'65,60 - 64세,1998,641,293,348
'4773044000,  다인면,'70,65 - 69세,1998,497,207,290
'4773044000,  다인면,'75,70 - 74세,1998,290,127,163
'4773044000,  다인면,'80,75 - 79세,1998,259,117,142
'4773044000,  다인면,'85,80 - 84세,1998,111,36,75
'4773044000,  다인면,'90,85+ ,1998,67,11,56
'4773045000,  신평면,'00,계,1998,1359,676,683
'4773045000,  신평면,'05,0 - 4세,1998,16,8,8
'4773045000,  신평면,'10,5 - 9세,1998,29,18,11
'4773045000,  신평면,'15,10 - 14세,1998,50,27,23
'4773045000,  신평면,'20,15 - 19세,1998,96,42,54
'4773045000,  신평면,'25,20 - 24세,1998,128,80,48
'4773045000,  신평면,'30,25 - 29세,1998,49,35,14
'4773045000,  신평면,'35,30 - 34세,1998,29,18,11
'4773045000,  신평면,'40,35 - 39세,1998,61,29,32
'4773045000,  신평면,'45,40 - 44세,1998,65,32,33
'4773045000,  신평면,'50,45 - 49세,1998,80,38,42
'4773045000,  신평면,'55,50 - 54세,1998,91,32,59
'4773045000,  신평면,'60,55 - 59세,1998,193,90,103
'4773045000,  신평면,'65,60 - 64세,1998,177,81,96
'4773045000,  신평면,'70,65 - 69세,1998,110,58,52
'4773045000,  신평면,'75,70 - 74세,1998,84,41,43
'4773045000,  신평면,'80,75 - 79세,1998,60,29,31
'4773045000,  신평면,'85,80 - 84세,1998,23,11,12
'4773045000,  신평면,'90,85+ ,1998,18,7,11
'4773046000,  안평면,'00,계,1998,3527,1759,1768
'4773046000,  안평면,'05,0 - 4세,1998,73,35,38
'4773046000,  안평면,'10,5 - 9세,1998,91,49,42
'4773046000,  안평면,'15,10 - 14세,1998,168,90,78
'4773046000,  안평면,'20,15 - 19세,1998,253,128,125
'4773046000,  안평면,'25,20 - 24세,1998,302,198,104
'4773046000,  안평면,'30,25 - 29세,1998,178,136,42
'4773046000,  안평면,'35,30 - 34세,1998,101,56,45
'4773046000,  안평면,'40,35 - 39세,1998,183,82,101
'4773046000,  안평면,'45,40 - 44세,1998,179,103,76
'4773046000,  안평면,'50,45 - 49세,1998,202,95,107
'4773046000,  안평면,'55,50 - 54세,1998,207,89,118
'4773046000,  안평면,'60,55 - 59세,1998,380,180,200
'4773046000,  안평면,'65,60 - 64세,1998,368,159,209
'4773046000,  안평면,'70,65 - 69세,1998,304,126,178
'4773046000,  안평면,'75,70 - 74세,1998,232,107,125
'4773046000,  안평면,'80,75 - 79세,1998,160,64,96
'4773046000,  안평면,'85,80 - 84세,1998,97,46,51
'4773046000,  안평면,'90,85+ ,1998,49,16,33
'4773047000,  안사면,'00,계,1998,1421,697,724
'4773047000,  안사면,'05,0 - 4세,1998,20,8,12
'4773047000,  안사면,'10,5 - 9세,1998,33,17,16
'4773047000,  안사면,'15,10 - 14세,1998,39,20,19
'4773047000,  안사면,'20,15 - 19세,1998,93,48,45
'4773047000,  안사면,'25,20 - 24세,1998,124,80,44
'4773047000,  안사면,'30,25 - 29세,1998,60,47,13
'4773047000,  안사면,'35,30 - 34세,1998,41,24,17
'4773047000,  안사면,'40,35 - 39세,1998,47,24,23
'4773047000,  안사면,'45,40 - 44세,1998,69,36,33
'4773047000,  안사면,'50,45 - 49세,1998,85,42,43
'4773047000,  안사면,'55,50 - 54세,1998,69,32,37
'4773047000,  안사면,'60,55 - 59세,1998,177,77,100
'4773047000,  안사면,'65,60 - 64세,1998,199,92,107
'4773047000,  안사면,'70,65 - 69세,1998,126,53,73
'4773047000,  안사면,'75,70 - 74세,1998,106,50,56
'4773047000,  안사면,'80,75 - 79세,1998,66,25,41
'4773047000,  안사면,'85,80 - 84세,1998,46,17,29
'4773047000,  안사면,'90,85+ ,1998,21,5,16
'47750, 청송군,'00,계,1998,35760,17944,17816
'47750, 청송군,'05,0 - 4세,1998,1855,949,906
'47750, 청송군,'10,5 - 9세,1998,1853,1057,796
'47750, 청송군,'15,10 - 14세,1998,1883,971,912
'47750, 청송군,'20,15 - 19세,1998,2762,1340,1422
'47750, 청송군,'25,20 - 24세,1998,2811,1604,1207
'47750, 청송군,'30,25 - 29세,1998,2455,1400,1055
'47750, 청송군,'35,30 - 34세,1998,2310,1239,1071
'47750, 청송군,'40,35 - 39세,1998,2464,1348,1116
'47750, 청송군,'45,40 - 44세,1998,2177,1146,1031
'47750, 청송군,'50,45 - 49세,1998,2063,1071,992
'47750, 청송군,'55,50 - 54세,1998,2072,975,1097
'47750, 청송군,'60,55 - 59세,1998,2992,1312,1680
'47750, 청송군,'65,60 - 64세,1998,2751,1251,1500
'47750, 청송군,'70,65 - 69세,1998,2007,889,1118
'47750, 청송군,'75,70 - 74세,1998,1493,667,826
'47750, 청송군,'80,75 - 79세,1998,995,422,573
'47750, 청송군,'85,80 - 84세,1998,570,227,343
'47750, 청송군,'90,85+ ,1998,247,76,171
'4775025000,  청송읍,'00,계,1998,7004,3514,3490
'4775025000,  청송읍,'05,0 - 4세,1998,486,243,243
'4775025000,  청송읍,'10,5 - 9세,1998,505,304,201
'4775025000,  청송읍,'15,10 - 14세,1998,488,254,234
'4775025000,  청송읍,'20,15 - 19세,1998,548,250,298
'4775025000,  청송읍,'25,20 - 24세,1998,507,284,223
'4775025000,  청송읍,'30,25 - 29세,1998,503,269,234
'4775025000,  청송읍,'35,30 - 34세,1998,552,264,288
'4775025000,  청송읍,'40,35 - 39세,1998,597,320,277
'4775025000,  청송읍,'45,40 - 44세,1998,501,269,232
'4775025000,  청송읍,'50,45 - 49세,1998,361,192,169
'4775025000,  청송읍,'55,50 - 54세,1998,363,173,190
'4775025000,  청송읍,'60,55 - 59세,1998,429,193,236
'4775025000,  청송읍,'65,60 - 64세,1998,422,179,243
'4775025000,  청송읍,'70,65 - 69세,1998,260,120,140
'4775025000,  청송읍,'75,70 - 74세,1998,212,102,110
'4775025000,  청송읍,'80,75 - 79세,1998,158,57,101
'4775025000,  청송읍,'85,80 - 84세,1998,75,30,45
'4775025000,  청송읍,'90,85+ ,1998,37,11,26
'4775031000,  부동면,'00,계,1998,2537,1253,1284
'4775031000,  부동면,'05,0 - 4세,1998,83,47,36
'4775031000,  부동면,'10,5 - 9세,1998,82,37,45
'4775031000,  부동면,'15,10 - 14세,1998,113,52,61
'4775031000,  부동면,'20,15 - 19세,1998,245,120,125
'4775031000,  부동면,'25,20 - 24세,1998,216,128,88
'4775031000,  부동면,'30,25 - 29세,1998,125,79,46
'4775031000,  부동면,'35,30 - 34세,1998,101,62,39
'4775031000,  부동면,'40,35 - 39세,1998,182,100,82
'4775031000,  부동면,'45,40 - 44세,1998,155,71,84
'4775031000,  부동면,'50,45 - 49세,1998,144,74,70
'4775031000,  부동면,'55,50 - 54세,1998,165,78,87
'4775031000,  부동면,'60,55 - 59세,1998,267,115,152
'4775031000,  부동면,'65,60 - 64세,1998,241,114,127
'4775031000,  부동면,'70,65 - 69세,1998,160,73,87
'4775031000,  부동면,'75,70 - 74세,1998,118,47,71
'4775031000,  부동면,'80,75 - 79세,1998,74,28,46
'4775031000,  부동면,'85,80 - 84세,1998,48,23,25
'4775031000,  부동면,'90,85+ ,1998,18,5,13
'4775032000,  부남면,'00,계,1998,3321,1679,1642
'4775032000,  부남면,'05,0 - 4세,1998,106,57,49
'4775032000,  부남면,'10,5 - 9세,1998,132,73,59
'4775032000,  부남면,'15,10 - 14세,1998,152,88,64
'4775032000,  부남면,'20,15 - 19세,1998,260,134,126
'4775032000,  부남면,'25,20 - 24세,1998,217,127,90
'4775032000,  부남면,'30,25 - 29세,1998,169,101,68
'4775032000,  부남면,'35,30 - 34세,1998,165,92,73
'4775032000,  부남면,'40,35 - 39세,1998,200,109,91
'4775032000,  부남면,'45,40 - 44세,1998,217,114,103
'4775032000,  부남면,'50,45 - 49세,1998,210,119,91
'4775032000,  부남면,'55,50 - 54세,1998,226,96,130
'4775032000,  부남면,'60,55 - 59세,1998,367,160,207
'4775032000,  부남면,'65,60 - 64세,1998,290,134,156
'4775032000,  부남면,'70,65 - 69세,1998,248,111,137
'4775032000,  부남면,'75,70 - 74세,1998,172,82,90
'4775032000,  부남면,'80,75 - 79세,1998,92,44,48
'4775032000,  부남면,'85,80 - 84세,1998,70,31,39
'4775032000,  부남면,'90,85+ ,1998,28,7,21
'4775033000,  현동면,'00,계,1998,2360,1191,1169
'4775033000,  현동면,'05,0 - 4세,1998,93,46,47
'4775033000,  현동면,'10,5 - 9세,1998,94,50,44
'4775033000,  현동면,'15,10 - 14세,1998,101,54,47
'4775033000,  현동면,'20,15 - 19세,1998,150,73,77
'4775033000,  현동면,'25,20 - 24세,1998,182,121,61
'4775033000,  현동면,'30,25 - 29세,1998,139,88,51
'4775033000,  현동면,'35,30 - 34세,1998,130,73,57
'4775033000,  현동면,'40,35 - 39세,1998,107,59,48
'4775033000,  현동면,'45,40 - 44세,1998,116,63,53
'4775033000,  현동면,'50,45 - 49세,1998,147,76,71
'4775033000,  현동면,'55,50 - 54세,1998,140,47,93
'4775033000,  현동면,'60,55 - 59세,1998,247,112,135
'4775033000,  현동면,'65,60 - 64세,1998,263,123,140
'4775033000,  현동면,'70,65 - 69세,1998,164,74,90
'4775033000,  현동면,'75,70 - 74세,1998,141,64,77
'4775033000,  현동면,'80,75 - 79세,1998,94,46,48
'4775033000,  현동면,'85,80 - 84세,1998,43,19,24
'4775033000,  현동면,'90,85+ ,1998,9,3,6
'4775034000,  현서면,'00,계,1998,3412,1707,1705
'4775034000,  현서면,'05,0 - 4세,1998,78,36,42
'4775034000,  현서면,'10,5 - 9세,1998,143,81,62
'4775034000,  현서면,'15,10 - 14세,1998,195,102,93
'4775034000,  현서면,'20,15 - 19세,1998,286,127,159
'4775034000,  현서면,'25,20 - 24세,1998,249,146,103
'4775034000,  현서면,'30,25 - 29세,1998,156,107,49
'4775034000,  현서면,'35,30 - 34세,1998,136,71,65
'4775034000,  현서면,'40,35 - 39세,1998,211,98,113
'4775034000,  현서면,'45,40 - 44세,1998,236,135,101
'4775034000,  현서면,'50,45 - 49세,1998,209,105,104
'4775034000,  현서면,'55,50 - 54세,1998,235,120,115
'4775034000,  현서면,'60,55 - 59세,1998,322,144,178
'4775034000,  현서면,'65,60 - 64세,1998,312,155,157
'4775034000,  현서면,'70,65 - 69세,1998,251,119,132
'4775034000,  현서면,'75,70 - 74세,1998,172,73,99
'4775034000,  현서면,'80,75 - 79세,1998,108,44,64
'4775034000,  현서면,'85,80 - 84세,1998,76,30,46
'4775034000,  현서면,'90,85+ ,1998,37,14,23
'4775035000,  안덕면,'00,계,1998,3746,1861,1885
'4775035000,  안덕면,'05,0 - 4세,1998,91,48,43
'4775035000,  안덕면,'10,5 - 9세,1998,142,76,66
'4775035000,  안덕면,'15,10 - 14세,1998,180,102,78
'4775035000,  안덕면,'20,15 - 19세,1998,268,124,144
'4775035000,  안덕면,'25,20 - 24세,1998,306,174,132
'4775035000,  안덕면,'30,25 - 29세,1998,246,155,91
'4775035000,  안덕면,'35,30 - 34세,1998,192,99,93
'4775035000,  안덕면,'40,35 - 39세,1998,234,128,106
'4775035000,  안덕면,'45,40 - 44세,1998,209,110,99
'4775035000,  안덕면,'50,45 - 49세,1998,225,111,114
'4775035000,  안덕면,'55,50 - 54세,1998,257,125,132
'4775035000,  안덕면,'60,55 - 59세,1998,373,164,209
'4775035000,  안덕면,'65,60 - 64세,1998,326,152,174
'4775035000,  안덕면,'70,65 - 69세,1998,247,112,135
'4775035000,  안덕면,'75,70 - 74세,1998,188,78,110
'4775035000,  안덕면,'80,75 - 79세,1998,139,63,76
'4775035000,  안덕면,'85,80 - 84세,1998,90,30,60
'4775035000,  안덕면,'90,85+ ,1998,33,10,23
'4775036000,  파천면,'00,계,1998,2770,1405,1365
'4775036000,  파천면,'05,0 - 4세,1998,77,42,35
'4775036000,  파천면,'10,5 - 9세,1998,81,47,34
'4775036000,  파천면,'15,10 - 14세,1998,112,61,51
'4775036000,  파천면,'20,15 - 19세,1998,241,121,120
'4775036000,  파천면,'25,20 - 24세,1998,251,147,104
'4775036000,  파천면,'30,25 - 29세,1998,174,112,62
'4775036000,  파천면,'35,30 - 34세,1998,105,68,37
'4775036000,  파천면,'40,35 - 39세,1998,136,74,62
'4775036000,  파천면,'45,40 - 44세,1998,141,73,68
'4775036000,  파천면,'50,45 - 49세,1998,169,82,87
'4775036000,  파천면,'55,50 - 54세,1998,164,84,80
'4775036000,  파천면,'60,55 - 59세,1998,292,129,163
'4775036000,  파천면,'65,60 - 64세,1998,256,113,143
'4775036000,  파천면,'70,65 - 69세,1998,192,84,108
'4775036000,  파천면,'75,70 - 74세,1998,170,72,98
'4775036000,  파천면,'80,75 - 79세,1998,112,55,57
'4775036000,  파천면,'85,80 - 84세,1998,65,31,34
'4775036000,  파천면,'90,85+ ,1998,32,10,22
'4775037000,  진보면,'00,계,1998,10610,5334,5276
'4775037000,  진보면,'05,0 - 4세,1998,841,430,411
'4775037000,  진보면,'10,5 - 9세,1998,674,389,285
'4775037000,  진보면,'15,10 - 14세,1998,542,258,284
'4775037000,  진보면,'20,15 - 19세,1998,764,391,373
'4775037000,  진보면,'25,20 - 24세,1998,883,477,406
'4775037000,  진보면,'30,25 - 29세,1998,943,489,454
'4775037000,  진보면,'35,30 - 34세,1998,929,510,419
'4775037000,  진보면,'40,35 - 39세,1998,797,460,337
'4775037000,  진보면,'45,40 - 44세,1998,602,311,291
'4775037000,  진보면,'50,45 - 49세,1998,598,312,286
'4775037000,  진보면,'55,50 - 54세,1998,522,252,270
'4775037000,  진보면,'60,55 - 59세,1998,695,295,400
'4775037000,  진보면,'65,60 - 64세,1998,641,281,360
'4775037000,  진보면,'70,65 - 69세,1998,485,196,289
'4775037000,  진보면,'75,70 - 74세,1998,320,149,171
'4775037000,  진보면,'80,75 - 79세,1998,218,85,133
'4775037000,  진보면,'85,80 - 84세,1998,103,33,70
'4775037000,  진보면,'90,85+ ,1998,53,16,37
'47760, 영양군,'00,계,1998,23976,11964,12012
'47760, 영양군,'05,0 - 4세,1998,884,490,394
'47760, 영양군,'10,5 - 9세,1998,973,541,432
'47760, 영양군,'15,10 - 14세,1998,1325,680,645
'47760, 영양군,'20,15 - 19세,1998,2244,1096,1148
'47760, 영양군,'25,20 - 24세,1998,2240,1289,951
'47760, 영양군,'30,25 - 29세,1998,1533,954,579
'47760, 영양군,'35,30 - 34세,1998,1215,654,561
'47760, 영양군,'40,35 - 39세,1998,1481,762,719
'47760, 영양군,'45,40 - 44세,1998,1462,724,738
'47760, 영양군,'50,45 - 49세,1998,1368,684,684
'47760, 영양군,'55,50 - 54세,1998,1346,641,705
'47760, 영양군,'60,55 - 59세,1998,2146,987,1159
'47760, 영양군,'65,60 - 64세,1998,2001,900,1101
'47760, 영양군,'70,65 - 69세,1998,1414,566,848
'47760, 영양군,'75,70 - 74세,1998,1055,480,575
'47760, 영양군,'80,75 - 79세,1998,719,324,395
'47760, 영양군,'85,80 - 84세,1998,379,134,245
'47760, 영양군,'90,85+ ,1998,191,58,133
'4776025000,  영양읍,'00,계,1998,9648,4789,4859
'4776025000,  영양읍,'05,0 - 4세,1998,542,287,255
'4776025000,  영양읍,'10,5 - 9세,1998,523,305,218
'4776025000,  영양읍,'15,10 - 14세,1998,615,308,307
'4776025000,  영양읍,'20,15 - 19세,1998,941,442,499
'4776025000,  영양읍,'25,20 - 24세,1998,812,453,359
'4776025000,  영양읍,'30,25 - 29세,1998,749,416,333
'4776025000,  영양읍,'35,30 - 34세,1998,638,336,302
'4776025000,  영양읍,'40,35 - 39세,1998,728,359,369
'4776025000,  영양읍,'45,40 - 44세,1998,669,342,327
'4776025000,  영양읍,'50,45 - 49세,1998,534,264,270
'4776025000,  영양읍,'55,50 - 54세,1998,499,241,258
'4776025000,  영양읍,'60,55 - 59세,1998,676,321,355
'4776025000,  영양읍,'65,60 - 64세,1998,602,275,327
'4776025000,  영양읍,'70,65 - 69세,1998,430,163,267
'4776025000,  영양읍,'75,70 - 74세,1998,298,123,175
'4776025000,  영양읍,'80,75 - 79세,1998,231,103,128
'4776025000,  영양읍,'85,80 - 84세,1998,103,34,69
'4776025000,  영양읍,'90,85+ ,1998,58,17,41
'4776031000,  입암면,'00,계,1998,3464,1733,1731
'4776031000,  입암면,'05,0 - 4세,1998,71,44,27
'4776031000,  입암면,'10,5 - 9세,1998,119,64,55
'4776031000,  입암면,'15,10 - 14세,1998,183,84,99
'4776031000,  입암면,'20,15 - 19세,1998,342,168,174
'4776031000,  입암면,'25,20 - 24세,1998,359,219,140
'4776031000,  입암면,'30,25 - 29세,1998,192,136,56
'4776031000,  입암면,'35,30 - 34세,1998,156,85,71
'4776031000,  입암면,'40,35 - 39세,1998,178,93,85
'4776031000,  입암면,'45,40 - 44세,1998,186,87,99
'4776031000,  입암면,'50,45 - 49세,1998,223,110,113
'4776031000,  입암면,'55,50 - 54세,1998,215,110,105
'4776031000,  입암면,'60,55 - 59세,1998,322,146,176
'4776031000,  입암면,'65,60 - 64세,1998,306,137,169
'4776031000,  입암면,'70,65 - 69세,1998,233,87,146
'4776031000,  입암면,'75,70 - 74세,1998,165,81,84
'4776031000,  입암면,'80,75 - 79세,1998,119,47,72
'4776031000,  입암면,'85,80 - 84세,1998,67,21,46
'4776031000,  입암면,'90,85+ ,1998,28,14,14
'4776032000,  청기면,'00,계,1998,2727,1369,1358
'4776032000,  청기면,'05,0 - 4세,1998,46,26,20
'4776032000,  청기면,'10,5 - 9세,1998,69,44,25
'4776032000,  청기면,'15,10 - 14세,1998,121,63,58
'4776032000,  청기면,'20,15 - 19세,1998,250,129,121
'4776032000,  청기면,'25,20 - 24세,1998,289,165,124
'4776032000,  청기면,'30,25 - 29세,1998,145,105,40
'4776032000,  청기면,'35,30 - 34세,1998,73,41,32
'4776032000,  청기면,'40,35 - 39세,1998,120,62,58
'4776032000,  청기면,'45,40 - 44세,1998,159,68,91
'4776032000,  청기면,'50,45 - 49세,1998,163,89,74
'4776032000,  청기면,'55,50 - 54세,1998,174,79,95
'4776032000,  청기면,'60,55 - 59세,1998,294,143,151
'4776032000,  청기면,'65,60 - 64세,1998,274,115,159
'4776032000,  청기면,'70,65 - 69세,1998,191,78,113
'4776032000,  청기면,'75,70 - 74세,1998,146,68,78
'4776032000,  청기면,'80,75 - 79세,1998,104,51,53
'4776032000,  청기면,'85,80 - 84세,1998,79,35,44
'4776032000,  청기면,'90,85+ ,1998,30,8,22
'4776033000,  일월면,'00,계,1998,2559,1235,1324
'4776033000,  일월면,'05,0 - 4세,1998,75,40,35
'4776033000,  일월면,'10,5 - 9세,1998,79,33,46
'4776033000,  일월면,'15,10 - 14세,1998,125,63,62
'4776033000,  일월면,'20,15 - 19세,1998,218,111,107
'4776033000,  일월면,'25,20 - 24세,1998,247,129,118
'4776033000,  일월면,'30,25 - 29세,1998,143,96,47
'4776033000,  일월면,'35,30 - 34세,1998,87,43,44
'4776033000,  일월면,'40,35 - 39세,1998,137,78,59
'4776033000,  일월면,'45,40 - 44세,1998,125,59,66
'4776033000,  일월면,'50,45 - 49세,1998,129,62,67
'4776033000,  일월면,'55,50 - 54세,1998,146,63,83
'4776033000,  일월면,'60,55 - 59세,1998,298,138,160
'4776033000,  일월면,'65,60 - 64세,1998,277,130,147
'4776033000,  일월면,'70,65 - 69세,1998,180,70,110
'4776033000,  일월면,'75,70 - 74세,1998,141,61,80
'4776033000,  일월면,'80,75 - 79세,1998,79,39,40
'4776033000,  일월면,'85,80 - 84세,1998,45,12,33
'4776033000,  일월면,'90,85+ ,1998,28,8,20
'4776034000,  수비면,'00,계,1998,2451,1233,1218
'4776034000,  수비면,'05,0 - 4세,1998,76,41,35
'4776034000,  수비면,'10,5 - 9세,1998,78,36,42
'4776034000,  수비면,'15,10 - 14세,1998,137,79,58
'4776034000,  수비면,'20,15 - 19세,1998,232,111,121
'4776034000,  수비면,'25,20 - 24세,1998,242,147,95
'4776034000,  수비면,'30,25 - 29세,1998,139,92,47
'4776034000,  수비면,'35,30 - 34세,1998,114,67,47
'4776034000,  수비면,'40,35 - 39세,1998,130,68,62
'4776034000,  수비면,'45,40 - 44세,1998,136,61,75
'4776034000,  수비면,'50,45 - 49세,1998,124,61,63
'4776034000,  수비면,'55,50 - 54세,1998,133,62,71
'4776034000,  수비면,'60,55 - 59세,1998,232,101,131
'4776034000,  수비면,'65,60 - 64세,1998,232,110,122
'4776034000,  수비면,'70,65 - 69세,1998,165,74,91
'4776034000,  수비면,'75,70 - 74세,1998,133,61,72
'4776034000,  수비면,'80,75 - 79세,1998,92,43,49
'4776034000,  수비면,'85,80 - 84세,1998,42,15,27
'4776034000,  수비면,'90,85+ ,1998,14,4,10
'4776035000,  석보면,'00,계,1998,3127,1605,1522
'4776035000,  석보면,'05,0 - 4세,1998,74,52,22
'4776035000,  석보면,'10,5 - 9세,1998,105,59,46
'4776035000,  석보면,'15,10 - 14세,1998,144,83,61
'4776035000,  석보면,'20,15 - 19세,1998,261,135,126
'4776035000,  석보면,'25,20 - 24세,1998,291,176,115
'4776035000,  석보면,'30,25 - 29세,1998,165,109,56
'4776035000,  석보면,'35,30 - 34세,1998,147,82,65
'4776035000,  석보면,'40,35 - 39세,1998,188,102,86
'4776035000,  석보면,'45,40 - 44세,1998,187,107,80
'4776035000,  석보면,'50,45 - 49세,1998,195,98,97
'4776035000,  석보면,'55,50 - 54세,1998,179,86,93
'4776035000,  석보면,'60,55 - 59세,1998,324,138,186
'4776035000,  석보면,'65,60 - 64세,1998,310,133,177
'4776035000,  석보면,'70,65 - 69세,1998,215,94,121
'4776035000,  석보면,'75,70 - 74세,1998,172,86,86
'4776035000,  석보면,'80,75 - 79세,1998,94,41,53
'4776035000,  석보면,'85,80 - 84세,1998,43,17,26
'4776035000,  석보면,'90,85+ ,1998,33,7,26
'47770, 영덕군,'00,계,1998,53999,26102,27897
'47770, 영덕군,'05,0 - 4세,1998,2242,1235,1007
'47770, 영덕군,'10,5 - 9세,1998,2424,1323,1101
'47770, 영덕군,'15,10 - 14세,1998,2820,1469,1351
'47770, 영덕군,'20,15 - 19세,1998,4760,2411,2349
'47770, 영덕군,'25,20 - 24세,1998,4759,2673,2086
'47770, 영덕군,'30,25 - 29세,1998,3704,2188,1516
'47770, 영덕군,'35,30 - 34세,1998,2965,1582,1383
'47770, 영덕군,'40,35 - 39세,1998,3462,1758,1704
'47770, 영덕군,'45,40 - 44세,1998,3298,1622,1676
'47770, 영덕군,'50,45 - 49세,1998,3188,1530,1658
'47770, 영덕군,'55,50 - 54세,1998,3141,1398,1743
'47770, 영덕군,'60,55 - 59세,1998,4755,2115,2640
'47770, 영덕군,'65,60 - 64세,1998,4085,1804,2281
'47770, 영덕군,'70,65 - 69세,1998,3065,1249,1816
'47770, 영덕군,'75,70 - 74세,1998,2315,854,1461
'47770, 영덕군,'80,75 - 79세,1998,1548,544,1004
'47770, 영덕군,'85,80 - 84세,1998,911,238,673
'47770, 영덕군,'90,85+ ,1998,557,109,448
'4777025000,  영덕읍,'00,계,1998,13270,6427,6843
'4777025000,  영덕읍,'05,0 - 4세,1998,777,425,352
'4777025000,  영덕읍,'10,5 - 9세,1998,797,450,347
'4777025000,  영덕읍,'15,10 - 14세,1998,754,385,369
'4777025000,  영덕읍,'20,15 - 19세,1998,1085,530,555
'4777025000,  영덕읍,'25,20 - 24세,1998,1094,598,496
'4777025000,  영덕읍,'30,25 - 29세,1998,1062,561,501
'4777025000,  영덕읍,'35,30 - 34세,1998,942,485,457
'4777025000,  영덕읍,'40,35 - 39세,1998,1040,541,499
'4777025000,  영덕읍,'45,40 - 44세,1998,890,432,458
'4777025000,  영덕읍,'50,45 - 49세,1998,747,361,386
'4777025000,  영덕읍,'55,50 - 54세,1998,700,316,384
'4777025000,  영덕읍,'60,55 - 59세,1998,980,454,526
'4777025000,  영덕읍,'65,60 - 64세,1998,794,356,438
'4777025000,  영덕읍,'70,65 - 69세,1998,561,217,344
'4777025000,  영덕읍,'75,70 - 74세,1998,458,158,300
'4777025000,  영덕읍,'80,75 - 79세,1998,291,97,194
'4777025000,  영덕읍,'85,80 - 84세,1998,187,40,147
'4777025000,  영덕읍,'90,85+ ,1998,111,21,90
'4777031000,  강구면,'00,계,1998,9916,4840,5076
'4777031000,  강구면,'05,0 - 4세,1998,414,234,180
'4777031000,  강구면,'10,5 - 9세,1998,438,251,187
'4777031000,  강구면,'15,10 - 14세,1998,544,291,253
'4777031000,  강구면,'20,15 - 19세,1998,906,479,427
'4777031000,  강구면,'25,20 - 24세,1998,912,495,417
'4777031000,  강구면,'30,25 - 29세,1998,739,419,320
'4777031000,  강구면,'35,30 - 34세,1998,592,324,268
'4777031000,  강구면,'40,35 - 39세,1998,701,353,348
'4777031000,  강구면,'45,40 - 44세,1998,696,347,349
'4777031000,  강구면,'50,45 - 49세,1998,662,322,340
'4777031000,  강구면,'55,50 - 54세,1998,562,258,304
'4777031000,  강구면,'60,55 - 59세,1998,850,352,498
'4777031000,  강구면,'65,60 - 64세,1998,669,313,356
'4777031000,  강구면,'70,65 - 69세,1998,434,161,273
'4777031000,  강구면,'75,70 - 74세,1998,340,122,218
'4777031000,  강구면,'80,75 - 79세,1998,240,77,163
'4777031000,  강구면,'85,80 - 84세,1998,137,31,106
'4777031000,  강구면,'90,85+ ,1998,80,11,69
'4777032000,  남정면,'00,계,1998,4023,1910,2113
'4777032000,  남정면,'05,0 - 4세,1998,141,89,52
'4777032000,  남정면,'10,5 - 9세,1998,133,68,65
'4777032000,  남정면,'15,10 - 14세,1998,184,103,81
'4777032000,  남정면,'20,15 - 19세,1998,329,144,185
'4777032000,  남정면,'25,20 - 24세,1998,347,190,157
'4777032000,  남정면,'30,25 - 29세,1998,292,187,105
'4777032000,  남정면,'35,30 - 34세,1998,195,103,92
'4777032000,  남정면,'40,35 - 39세,1998,222,113,109
'4777032000,  남정면,'45,40 - 44세,1998,214,112,102
'4777032000,  남정면,'50,45 - 49세,1998,228,110,118
'4777032000,  남정면,'55,50 - 54세,1998,240,97,143
'4777032000,  남정면,'60,55 - 59세,1998,356,156,200
'4777032000,  남정면,'65,60 - 64세,1998,336,140,196
'4777032000,  남정면,'70,65 - 69세,1998,281,113,168
'4777032000,  남정면,'75,70 - 74세,1998,213,83,130
'4777032000,  남정면,'80,75 - 79세,1998,171,59,112
'4777032000,  남정면,'85,80 - 84세,1998,80,29,51
'4777032000,  남정면,'90,85+ ,1998,61,14,47
'4777033000,  달산면,'00,계,1998,1745,820,925
'4777033000,  달산면,'05,0 - 4세,1998,31,15,16
'4777033000,  달산면,'10,5 - 9세,1998,39,21,18
'4777033000,  달산면,'15,10 - 14세,1998,54,29,25
'4777033000,  달산면,'20,15 - 19세,1998,137,71,66
'4777033000,  달산면,'25,20 - 24세,1998,143,86,57
'4777033000,  달산면,'30,25 - 29세,1998,97,67,30
'4777033000,  달산면,'35,30 - 34세,1998,54,34,20
'4777033000,  달산면,'40,35 - 39세,1998,57,28,29
'4777033000,  달산면,'45,40 - 44세,1998,67,33,34
'4777033000,  달산면,'50,45 - 49세,1998,91,45,46
'4777033000,  달산면,'55,50 - 54세,1998,115,40,75
'4777033000,  달산면,'60,55 - 59세,1998,198,83,115
'4777033000,  달산면,'65,60 - 64세,1998,197,83,114
'4777033000,  달산면,'70,65 - 69세,1998,174,75,99
'4777033000,  달산면,'75,70 - 74세,1998,129,46,83
'4777033000,  달산면,'80,75 - 79세,1998,84,36,48
'4777033000,  달산면,'85,80 - 84세,1998,61,25,36
'4777033000,  달산면,'90,85+ ,1998,17,3,14
'4777034000,  지품면,'00,계,1998,3490,1687,1803
'4777034000,  지품면,'05,0 - 4세,1998,110,57,53
'4777034000,  지품면,'10,5 - 9세,1998,95,48,47
'4777034000,  지품면,'15,10 - 14세,1998,114,54,60
'4777034000,  지품면,'20,15 - 19세,1998,290,152,138
'4777034000,  지품면,'25,20 - 24세,1998,347,188,159
'4777034000,  지품면,'30,25 - 29세,1998,234,156,78
'4777034000,  지품면,'35,30 - 34세,1998,144,92,52
'4777034000,  지품면,'40,35 - 39세,1998,155,89,66
'4777034000,  지품면,'45,40 - 44세,1998,170,72,98
'4777034000,  지품면,'50,45 - 49세,1998,191,90,101
'4777034000,  지품면,'55,50 - 54세,1998,226,105,121
'4777034000,  지품면,'60,55 - 59세,1998,366,162,204
'4777034000,  지품면,'65,60 - 64세,1998,345,151,194
'4777034000,  지품면,'70,65 - 69세,1998,233,96,137
'4777034000,  지품면,'75,70 - 74세,1998,228,91,137
'4777034000,  지품면,'80,75 - 79세,1998,128,60,68
'4777034000,  지품면,'85,80 - 84세,1998,77,19,58
'4777034000,  지품면,'90,85+ ,1998,37,5,32
'4777035000,  축산면,'00,계,1998,4533,2225,2308
'4777035000,  축산면,'05,0 - 4세,1998,142,85,57
'4777035000,  축산면,'10,5 - 9세,1998,182,87,95
'4777035000,  축산면,'15,10 - 14세,1998,214,117,97
'4777035000,  축산면,'20,15 - 19세,1998,440,226,214
'4777035000,  축산면,'25,20 - 24세,1998,453,262,191
'4777035000,  축산면,'30,25 - 29세,1998,271,187,84
'4777035000,  축산면,'35,30 - 34세,1998,205,105,100
'4777035000,  축산면,'40,35 - 39세,1998,272,142,130
'4777035000,  축산면,'45,40 - 44세,1998,266,125,141
'4777035000,  축산면,'50,45 - 49세,1998,295,139,156
'4777035000,  축산면,'55,50 - 54세,1998,304,131,173
'4777035000,  축산면,'60,55 - 59세,1998,447,212,235
'4777035000,  축산면,'65,60 - 64세,1998,352,154,198
'4777035000,  축산면,'70,65 - 69세,1998,270,119,151
'4777035000,  축산면,'75,70 - 74세,1998,200,77,123
'4777035000,  축산면,'80,75 - 79세,1998,110,35,75
'4777035000,  축산면,'85,80 - 84세,1998,63,12,51
'4777035000,  축산면,'90,85+ ,1998,47,10,37
'4777036000,  영해면,'00,계,1998,9399,4497,4902
'4777036000,  영해면,'05,0 - 4세,1998,454,236,218
'4777036000,  영해면,'10,5 - 9세,1998,517,276,241
'4777036000,  영해면,'15,10 - 14세,1998,589,298,291
'4777036000,  영해면,'20,15 - 19세,1998,906,440,466
'4777036000,  영해면,'25,20 - 24세,1998,746,431,315
'4777036000,  영해면,'30,25 - 29세,1998,613,333,280
'4777036000,  영해면,'35,30 - 34세,1998,580,296,284
'4777036000,  영해면,'40,35 - 39세,1998,655,334,321
'4777036000,  영해면,'45,40 - 44세,1998,601,295,306
'4777036000,  영해면,'50,45 - 49세,1998,553,270,283
'4777036000,  영해면,'55,50 - 54세,1998,521,234,287
'4777036000,  영해면,'60,55 - 59세,1998,708,318,390
'4777036000,  영해면,'65,60 - 64세,1998,635,279,356
'4777036000,  영해면,'70,65 - 69세,1998,492,201,291
'4777036000,  영해면,'75,70 - 74세,1998,354,127,227
'4777036000,  영해면,'80,75 - 79세,1998,248,79,169
'4777036000,  영해면,'85,80 - 84세,1998,137,40,97
'4777036000,  영해면,'90,85+ ,1998,90,10,80
'4777037000,  병곡면,'00,계,1998,4801,2318,2483
'4777037000,  병곡면,'05,0 - 4세,1998,120,63,57
'4777037000,  병곡면,'10,5 - 9세,1998,162,93,69
'4777037000,  병곡면,'15,10 - 14세,1998,236,116,120
'4777037000,  병곡면,'20,15 - 19세,1998,427,239,188
'4777037000,  병곡면,'25,20 - 24세,1998,462,271,191
'4777037000,  병곡면,'30,25 - 29세,1998,253,182,71
'4777037000,  병곡면,'35,30 - 34세,1998,184,104,80
'4777037000,  병곡면,'40,35 - 39세,1998,256,115,141
'4777037000,  병곡면,'45,40 - 44세,1998,255,132,123
'4777037000,  병곡면,'50,45 - 49세,1998,276,129,147
'4777037000,  병곡면,'55,50 - 54세,1998,269,125,144
'4777037000,  병곡면,'60,55 - 59세,1998,481,206,275
'4777037000,  병곡면,'65,60 - 64세,1998,468,191,277
'4777037000,  병곡면,'70,65 - 69세,1998,371,153,218
'4777037000,  병곡면,'75,70 - 74세,1998,258,97,161
'4777037000,  병곡면,'80,75 - 79세,1998,157,58,99
'4777037000,  병곡면,'85,80 - 84세,1998,103,22,81
'4777037000,  병곡면,'90,85+ ,1998,63,22,41
'4777038000,  창수면,'00,계,1998,2822,1378,1444
'4777038000,  창수면,'05,0 - 4세,1998,53,31,22
'4777038000,  창수면,'10,5 - 9세,1998,61,29,32
'4777038000,  창수면,'15,10 - 14세,1998,131,76,55
'4777038000,  창수면,'20,15 - 19세,1998,240,130,110
'4777038000,  창수면,'25,20 - 24세,1998,255,152,103
'4777038000,  창수면,'30,25 - 29세,1998,143,96,47
'4777038000,  창수면,'35,30 - 34세,1998,69,39,30
'4777038000,  창수면,'40,35 - 39세,1998,104,43,61
'4777038000,  창수면,'45,40 - 44세,1998,139,74,65
'4777038000,  창수면,'50,45 - 49세,1998,145,64,81
'4777038000,  창수면,'55,50 - 54세,1998,204,92,112
'4777038000,  창수면,'60,55 - 59세,1998,369,172,197
'4777038000,  창수면,'65,60 - 64세,1998,289,137,152
'4777038000,  창수면,'70,65 - 69세,1998,249,114,135
'4777038000,  창수면,'75,70 - 74세,1998,135,53,82
'4777038000,  창수면,'80,75 - 79세,1998,119,43,76
'4777038000,  창수면,'85,80 - 84세,1998,66,20,46
'4777038000,  창수면,'90,85+ ,1998,51,13,38
'47820, 청도군,'00,계,1998,56658,27392,29266
'47820, 청도군,'05,0 - 4세,1998,2402,1292,1110
'47820, 청도군,'10,5 - 9세,1998,2479,1375,1104
'47820, 청도군,'15,10 - 14세,1998,3033,1623,1410
'47820, 청도군,'20,15 - 19세,1998,4928,2452,2476
'47820, 청도군,'25,20 - 24세,1998,5117,2833,2284
'47820, 청도군,'30,25 - 29세,1998,4091,2355,1736
'47820, 청도군,'35,30 - 34세,1998,3090,1655,1435
'47820, 청도군,'40,35 - 39세,1998,3500,1747,1753
'47820, 청도군,'45,40 - 44세,1998,3338,1664,1674
'47820, 청도군,'50,45 - 49세,1998,3610,1716,1894
'47820, 청도군,'55,50 - 54세,1998,2996,1413,1583
'47820, 청도군,'60,55 - 59세,1998,4277,1831,2446
'47820, 청도군,'65,60 - 64세,1998,4483,1886,2597
'47820, 청도군,'70,65 - 69세,1998,3480,1344,2136
'47820, 청도군,'75,70 - 74세,1998,2611,1075,1536
'47820, 청도군,'80,75 - 79세,1998,1759,686,1073
'47820, 청도군,'85,80 - 84세,1998,926,328,598
'47820, 청도군,'90,85+ ,1998,538,117,421
'4782025000,  화양읍,'00,계,1998,8300,4072,4228
'4782025000,  화양읍,'05,0 - 4세,1998,363,206,157
'4782025000,  화양읍,'10,5 - 9세,1998,429,242,187
'4782025000,  화양읍,'15,10 - 14세,1998,507,274,233
'4782025000,  화양읍,'20,15 - 19세,1998,753,371,382
'4782025000,  화양읍,'25,20 - 24세,1998,744,422,322
'4782025000,  화양읍,'30,25 - 29세,1998,559,327,232
'4782025000,  화양읍,'35,30 - 34세,1998,486,246,240
'4782025000,  화양읍,'40,35 - 39세,1998,585,296,289
'4782025000,  화양읍,'45,40 - 44세,1998,543,296,247
'4782025000,  화양읍,'50,45 - 49세,1998,532,257,275
'4782025000,  화양읍,'55,50 - 54세,1998,430,215,215
'4782025000,  화양읍,'60,55 - 59세,1998,566,233,333
'4782025000,  화양읍,'65,60 - 64세,1998,556,241,315
'4782025000,  화양읍,'70,65 - 69세,1998,427,158,269
'4782025000,  화양읍,'75,70 - 74세,1998,349,135,214
'4782025000,  화양읍,'80,75 - 79세,1998,250,88,162
'4782025000,  화양읍,'85,80 - 84세,1998,133,48,85
'4782025000,  화양읍,'90,85+ ,1998,88,17,71
'4782025300,  청도읍,'00,계,1998,17160,8298,8862
'4782025300,  청도읍,'05,0 - 4세,1998,926,480,446
'4782025300,  청도읍,'10,5 - 9세,1998,933,504,429
'4782025300,  청도읍,'15,10 - 14세,1998,1009,559,450
'4782025300,  청도읍,'20,15 - 19세,1998,1590,795,795
'4782025300,  청도읍,'25,20 - 24세,1998,1578,835,743
'4782025300,  청도읍,'30,25 - 29세,1998,1423,764,659
'4782025300,  청도읍,'35,30 - 34세,1998,1087,593,494
'4782025300,  청도읍,'40,35 - 39세,1998,1196,586,610
'4782025300,  청도읍,'45,40 - 44세,1998,1147,534,613
'4782025300,  청도읍,'50,45 - 49세,1998,1124,556,568
'4782025300,  청도읍,'55,50 - 54세,1998,856,407,449
'4782025300,  청도읍,'60,55 - 59세,1998,1085,469,616
'4782025300,  청도읍,'65,60 - 64세,1998,1026,441,585
'4782025300,  청도읍,'70,65 - 69세,1998,816,282,534
'4782025300,  청도읍,'75,70 - 74세,1998,642,264,378
'4782025300,  청도읍,'80,75 - 79세,1998,418,145,273
'4782025300,  청도읍,'85,80 - 84세,1998,194,61,133
'4782025300,  청도읍,'90,85+ ,1998,110,23,87
'4782031000,  각남면,'00,계,1998,3355,1589,1766
'4782031000,  각남면,'05,0 - 4세,1998,108,57,51
'4782031000,  각남면,'10,5 - 9세,1998,107,64,43
'4782031000,  각남면,'15,10 - 14세,1998,155,77,78
'4782031000,  각남면,'20,15 - 19세,1998,278,134,144
'4782031000,  각남면,'25,20 - 24세,1998,323,193,130
'4782031000,  각남면,'30,25 - 29세,1998,243,159,84
'4782031000,  각남면,'35,30 - 34세,1998,131,70,61
'4782031000,  각남면,'40,35 - 39세,1998,165,77,88
'4782031000,  각남면,'45,40 - 44세,1998,163,89,74
'4782031000,  각남면,'50,45 - 49세,1998,223,96,127
'4782031000,  각남면,'55,50 - 54세,1998,200,88,112
'4782031000,  각남면,'60,55 - 59세,1998,294,125,169
'4782031000,  각남면,'65,60 - 64세,1998,314,120,194
'4782031000,  각남면,'70,65 - 69세,1998,222,88,134
'4782031000,  각남면,'75,70 - 74세,1998,172,69,103
'4782031000,  각남면,'80,75 - 79세,1998,141,45,96
'4782031000,  각남면,'85,80 - 84세,1998,69,29,40
'4782031000,  각남면,'90,85+ ,1998,47,9,38
'4782032000,  풍각면,'00,계,1998,5870,2890,2980
'4782032000,  풍각면,'05,0 - 4세,1998,245,120,125
'4782032000,  풍각면,'10,5 - 9세,1998,238,138,100
'4782032000,  풍각면,'15,10 - 14세,1998,326,169,157
'4782032000,  풍각면,'20,15 - 19세,1998,561,311,250
'4782032000,  풍각면,'25,20 - 24세,1998,480,279,201
'4782032000,  풍각면,'30,25 - 29세,1998,361,214,147
'4782032000,  풍각면,'35,30 - 34세,1998,298,167,131
'4782032000,  풍각면,'40,35 - 39세,1998,372,179,193
'4782032000,  풍각면,'45,40 - 44세,1998,372,196,176
'4782032000,  풍각면,'50,45 - 49세,1998,344,170,174
'4782032000,  풍각면,'55,50 - 54세,1998,298,143,155
'4782032000,  풍각면,'60,55 - 59세,1998,444,182,262
'4782032000,  풍각면,'65,60 - 64세,1998,492,220,272
'4782032000,  풍각면,'70,65 - 69세,1998,418,158,260
'4782032000,  풍각면,'75,70 - 74세,1998,292,113,179
'4782032000,  풍각면,'80,75 - 79세,1998,174,80,94
'4782032000,  풍각면,'85,80 - 84세,1998,102,36,66
'4782032000,  풍각면,'90,85+ ,1998,53,15,38
'4782033000,  각북면,'00,계,1998,2615,1253,1362
'4782033000,  각북면,'05,0 - 4세,1998,70,48,22
'4782033000,  각북면,'10,5 - 9세,1998,80,44,36
'4782033000,  각북면,'15,10 - 14세,1998,124,69,55
'4782033000,  각북면,'20,15 - 19세,1998,193,81,112
'4782033000,  각북면,'25,20 - 24세,1998,214,110,104
'4782033000,  각북면,'30,25 - 29세,1998,168,113,55
'4782033000,  각북면,'35,30 - 34세,1998,116,66,50
'4782033000,  각북면,'40,35 - 39세,1998,129,68,61
'4782033000,  각북면,'45,40 - 44세,1998,145,79,66
'4782033000,  각북면,'50,45 - 49세,1998,176,82,94
'4782033000,  각북면,'55,50 - 54세,1998,161,74,87
'4782033000,  각북면,'60,55 - 59세,1998,244,96,148
'4782033000,  각북면,'65,60 - 64세,1998,281,120,161
'4782033000,  각북면,'70,65 - 69세,1998,191,81,110
'4782033000,  각북면,'75,70 - 74세,1998,151,63,88
'4782033000,  각북면,'80,75 - 79세,1998,91,34,57
'4782033000,  각북면,'85,80 - 84세,1998,48,19,29
'4782033000,  각북면,'90,85+ ,1998,33,6,27
'4782034000,  이서면,'00,계,1998,5726,2771,2955
'4782034000,  이서면,'05,0 - 4세,1998,203,104,99
'4782034000,  이서면,'10,5 - 9세,1998,206,118,88
'4782034000,  이서면,'15,10 - 14세,1998,300,161,139
'4782034000,  이서면,'20,15 - 19세,1998,526,272,254
'4782034000,  이서면,'25,20 - 24세,1998,547,308,239
'4782034000,  이서면,'30,25 - 29세,1998,351,206,145
'4782034000,  이서면,'35,30 - 34세,1998,243,140,103
'4782034000,  이서면,'40,35 - 39세,1998,332,162,170
'4782034000,  이서면,'45,40 - 44세,1998,313,148,165
'4782034000,  이서면,'50,45 - 49세,1998,384,178,206
'4782034000,  이서면,'55,50 - 54세,1998,318,156,162
'4782034000,  이서면,'60,55 - 59세,1998,435,203,232
'4782034000,  이서면,'65,60 - 64세,1998,482,193,289
'4782034000,  이서면,'70,65 - 69세,1998,384,157,227
'4782034000,  이서면,'75,70 - 74세,1998,311,118,193
'4782034000,  이서면,'80,75 - 79세,1998,215,88,127
'4782034000,  이서면,'85,80 - 84세,1998,119,44,75
'4782034000,  이서면,'90,85+ ,1998,57,15,42
'4782035000,  운문면,'00,계,1998,2905,1297,1608
'4782035000,  운문면,'05,0 - 4세,1998,89,54,35
'4782035000,  운문면,'10,5 - 9세,1998,96,50,46
'4782035000,  운문면,'15,10 - 14세,1998,99,48,51
'4782035000,  운문면,'20,15 - 19세,1998,147,64,83
'4782035000,  운문면,'25,20 - 24세,1998,279,147,132
'4782035000,  운문면,'30,25 - 29세,1998,280,111,169
'4782035000,  운문면,'35,30 - 34세,1998,214,84,130
'4782035000,  운문면,'40,35 - 39세,1998,178,89,89
'4782035000,  운문면,'45,40 - 44세,1998,138,67,71
'4782035000,  운문면,'50,45 - 49세,1998,141,59,82
'4782035000,  운문면,'55,50 - 54세,1998,144,57,87
'4782035000,  운문면,'60,55 - 59세,1998,292,116,176
'4782035000,  운문면,'65,60 - 64세,1998,286,117,169
'4782035000,  운문면,'70,65 - 69세,1998,211,90,121
'4782035000,  운문면,'75,70 - 74세,1998,136,66,70
'4782035000,  운문면,'80,75 - 79세,1998,94,52,42
'4782035000,  운문면,'85,80 - 84세,1998,45,15,30
'4782035000,  운문면,'90,85+ ,1998,36,11,25
'4782036000,  금천면,'00,계,1998,4973,2460,2513
'4782036000,  금천면,'05,0 - 4세,1998,216,130,86
'4782036000,  금천면,'10,5 - 9세,1998,187,104,83
'4782036000,  금천면,'15,10 - 14세,1998,232,111,121
'4782036000,  금천면,'20,15 - 19세,1998,385,205,180
'4782036000,  금천면,'25,20 - 24세,1998,447,254,193
'4782036000,  금천면,'30,25 - 29세,1998,353,229,124
'4782036000,  금천면,'35,30 - 34세,1998,262,142,120
'4782036000,  금천면,'40,35 - 39세,1998,269,147,122
'4782036000,  금천면,'45,40 - 44세,1998,250,127,123
'4782036000,  금천면,'50,45 - 49세,1998,313,146,167
'4782036000,  금천면,'55,50 - 54세,1998,272,119,153
'4782036000,  금천면,'60,55 - 59세,1998,424,198,226
'4782036000,  금천면,'65,60 - 64세,1998,474,197,277
'4782036000,  금천면,'70,65 - 69세,1998,337,129,208
'4782036000,  금천면,'75,70 - 74세,1998,245,109,136
'4782036000,  금천면,'80,75 - 79세,1998,157,72,85
'4782036000,  금천면,'85,80 - 84세,1998,97,33,64
'4782036000,  금천면,'90,85+ ,1998,53,8,45
'4782037000,  매전면,'00,계,1998,5754,2762,2992
'4782037000,  매전면,'05,0 - 4세,1998,182,93,89
'4782037000,  매전면,'10,5 - 9세,1998,203,111,92
'4782037000,  매전면,'15,10 - 14세,1998,281,155,126
'4782037000,  매전면,'20,15 - 19세,1998,495,219,276
'4782037000,  매전면,'25,20 - 24세,1998,505,285,220
'4782037000,  매전면,'30,25 - 29세,1998,353,232,121
'4782037000,  매전면,'35,30 - 34세,1998,253,147,106
'4782037000,  매전면,'40,35 - 39세,1998,274,143,131
'4782037000,  매전면,'45,40 - 44세,1998,267,128,139
'4782037000,  매전면,'50,45 - 49세,1998,373,172,201
'4782037000,  매전면,'55,50 - 54세,1998,317,154,163
'4782037000,  매전면,'60,55 - 59세,1998,493,209,284
'4782037000,  매전면,'65,60 - 64세,1998,572,237,335
'4782037000,  매전면,'70,65 - 69세,1998,474,201,273
'4782037000,  매전면,'75,70 - 74세,1998,313,138,175
'4782037000,  매전면,'80,75 - 79세,1998,219,82,137
'4782037000,  매전면,'85,80 - 84세,1998,119,43,76
'4782037000,  매전면,'90,85+ ,1998,61,13,48
'47830, 고령군,'00,계,1998,38447,19471,18976
'47830, 고령군,'05,0 - 4세,1998,2384,1245,1139
'47830, 고령군,'10,5 - 9세,1998,2183,1181,1002
'47830, 고령군,'15,10 - 14세,1998,1780,944,836
'47830, 고령군,'20,15 - 19세,1998,2554,1303,1251
'47830, 고령군,'25,20 - 24세,1998,2982,1635,1347
'47830, 고령군,'30,25 - 29세,1998,3286,1859,1427
'47830, 고령군,'35,30 - 34세,1998,3052,1703,1349
'47830, 고령군,'40,35 - 39세,1998,2926,1683,1243
'47830, 고령군,'45,40 - 44세,1998,2273,1297,976
'47830, 고령군,'50,45 - 49세,1998,2161,1115,1046
'47830, 고령군,'55,50 - 54세,1998,1959,945,1014
'47830, 고령군,'60,55 - 59세,1998,2697,1172,1525
'47830, 고령군,'65,60 - 64세,1998,2742,1206,1536
'47830, 고령군,'70,65 - 69세,1998,2118,910,1208
'47830, 고령군,'75,70 - 74세,1998,1512,605,907
'47830, 고령군,'80,75 - 79세,1998,1015,416,599
'47830, 고령군,'85,80 - 84세,1998,515,174,341
'47830, 고령군,'90,85+ ,1998,308,78,230
'4783025000,  고령읍,'00,계,1998,11449,5693,5756
'4783025000,  고령읍,'05,0 - 4세,1998,816,414,402
'4783025000,  고령읍,'10,5 - 9세,1998,846,451,395
'4783025000,  고령읍,'15,10 - 14세,1998,644,341,303
'4783025000,  고령읍,'20,15 - 19세,1998,833,407,426
'4783025000,  고령읍,'25,20 - 24세,1998,963,505,458
'4783025000,  고령읍,'30,25 - 29세,1998,1008,530,478
'4783025000,  고령읍,'35,30 - 34세,1998,934,482,452
'4783025000,  고령읍,'40,35 - 39세,1998,974,509,465
'4783025000,  고령읍,'45,40 - 44세,1998,756,408,348
'4783025000,  고령읍,'50,45 - 49세,1998,662,349,313
'4783025000,  고령읍,'55,50 - 54세,1998,532,258,274
'4783025000,  고령읍,'60,55 - 59세,1998,681,301,380
'4783025000,  고령읍,'65,60 - 64세,1998,619,269,350
'4783025000,  고령읍,'70,65 - 69세,1998,495,220,275
'4783025000,  고령읍,'75,70 - 74세,1998,304,123,181
'4783025000,  고령읍,'80,75 - 79세,1998,199,70,129
'4783025000,  고령읍,'85,80 - 84세,1998,118,40,78
'4783025000,  고령읍,'90,85+ ,1998,65,16,49
'4783031000,  덕곡면,'00,계,1998,1866,929,937
'4783031000,  덕곡면,'05,0 - 4세,1998,68,35,33
'4783031000,  덕곡면,'10,5 - 9세,1998,41,21,20
'4783031000,  덕곡면,'15,10 - 14세,1998,76,42,34
'4783031000,  덕곡면,'20,15 - 19세,1998,113,61,52
'4783031000,  덕곡면,'25,20 - 24세,1998,124,74,50
'4783031000,  덕곡면,'30,25 - 29세,1998,116,68,48
'4783031000,  덕곡면,'35,30 - 34세,1998,90,64,26
'4783031000,  덕곡면,'40,35 - 39세,1998,111,64,47
'4783031000,  덕곡면,'45,40 - 44세,1998,102,51,51
'4783031000,  덕곡면,'50,45 - 49세,1998,110,63,47
'4783031000,  덕곡면,'55,50 - 54세,1998,98,40,58
'4783031000,  덕곡면,'60,55 - 59세,1998,171,73,98
'4783031000,  덕곡면,'65,60 - 64세,1998,214,91,123
'4783031000,  덕곡면,'70,65 - 69세,1998,149,65,84
'4783031000,  덕곡면,'75,70 - 74세,1998,116,45,71
'4783031000,  덕곡면,'80,75 - 79세,1998,94,47,47
'4783031000,  덕곡면,'85,80 - 84세,1998,47,17,30
'4783031000,  덕곡면,'90,85+ ,1998,26,8,18
'4783032000,  운수면,'00,계,1998,2643,1333,1310
'4783032000,  운수면,'05,0 - 4세,1998,103,58,45
'4783032000,  운수면,'10,5 - 9세,1998,76,44,32
'4783032000,  운수면,'15,10 - 14세,1998,98,57,41
'4783032000,  운수면,'20,15 - 19세,1998,187,82,105
'4783032000,  운수면,'25,20 - 24세,1998,190,109,81
'4783032000,  운수면,'30,25 - 29세,1998,203,129,74
'4783032000,  운수면,'35,30 - 34세,1998,149,88,61
'4783032000,  운수면,'40,35 - 39세,1998,162,102,60
'4783032000,  운수면,'45,40 - 44세,1998,143,83,60
'4783032000,  운수면,'50,45 - 49세,1998,141,74,67
'4783032000,  운수면,'55,50 - 54세,1998,163,76,87
'4783032000,  운수면,'60,55 - 59세,1998,258,104,154
'4783032000,  운수면,'65,60 - 64세,1998,272,120,152
'4783032000,  운수면,'70,65 - 69세,1998,187,92,95
'4783032000,  운수면,'75,70 - 74세,1998,147,62,85
'4783032000,  운수면,'80,75 - 79세,1998,79,32,47
'4783032000,  운수면,'85,80 - 84세,1998,45,10,35
'4783032000,  운수면,'90,85+ ,1998,40,11,29
'4783033000,  성산면,'00,계,1998,3758,1918,1840
'4783033000,  성산면,'05,0 - 4세,1998,176,95,81
'4783033000,  성산면,'10,5 - 9세,1998,195,106,89
'4783033000,  성산면,'15,10 - 14세,1998,179,81,98
'4783033000,  성산면,'20,15 - 19세,1998,297,155,142
'4783033000,  성산면,'25,20 - 24세,1998,300,167,133
'4783033000,  성산면,'30,25 - 29세,1998,280,176,104
'4783033000,  성산면,'35,30 - 34세,1998,280,152,128
'4783033000,  성산면,'40,35 - 39세,1998,256,153,103
'4783033000,  성산면,'45,40 - 44세,1998,245,140,105
'4783033000,  성산면,'50,45 - 49세,1998,227,124,103
'4783033000,  성산면,'55,50 - 54세,1998,192,99,93
'4783033000,  성산면,'60,55 - 59세,1998,266,117,149
'4783033000,  성산면,'65,60 - 64세,1998,261,112,149
'4783033000,  성산면,'70,65 - 69세,1998,245,108,137
'4783033000,  성산면,'75,70 - 74세,1998,160,62,98
'4783033000,  성산면,'80,75 - 79세,1998,103,43,60
'4783033000,  성산면,'85,80 - 84세,1998,54,21,33
'4783033000,  성산면,'90,85+ ,1998,42,7,35
'4783034000,  다산면,'00,계,1998,7398,3847,3551
'4783034000,  다산면,'05,0 - 4세,1998,753,386,367
'4783034000,  다산면,'10,5 - 9세,1998,569,311,258
'4783034000,  다산면,'15,10 - 14세,1998,257,148,109
'4783034000,  다산면,'20,15 - 19세,1998,379,211,168
'4783034000,  다산면,'25,20 - 24세,1998,459,234,225
'4783034000,  다산면,'30,25 - 29세,1998,805,390,415
'4783034000,  다산면,'35,30 - 34세,1998,931,503,428
'4783034000,  다산면,'40,35 - 39세,1998,695,451,244
'4783034000,  다산면,'45,40 - 44세,1998,397,239,158
'4783034000,  다산면,'50,45 - 49세,1998,356,180,176
'4783034000,  다산면,'55,50 - 54세,1998,306,151,155
'4783034000,  다산면,'60,55 - 59세,1998,399,173,226
'4783034000,  다산면,'65,60 - 64세,1998,358,173,185
'4783034000,  다산면,'70,65 - 69세,1998,276,113,163
'4783034000,  다산면,'75,70 - 74세,1998,203,90,113
'4783034000,  다산면,'80,75 - 79세,1998,157,61,96
'4783034000,  다산면,'85,80 - 84세,1998,64,24,40
'4783034000,  다산면,'90,85+ ,1998,34,9,25
'4783035000,  개진면,'00,계,1998,2976,1535,1441
'4783035000,  개진면,'05,0 - 4세,1998,161,96,65
'4783035000,  개진면,'10,5 - 9세,1998,122,69,53
'4783035000,  개진면,'15,10 - 14세,1998,115,64,51
'4783035000,  개진면,'20,15 - 19세,1998,177,83,94
'4783035000,  개진면,'25,20 - 24세,1998,216,125,91
'4783035000,  개진면,'30,25 - 29세,1998,230,134,96
'4783035000,  개진면,'35,30 - 34세,1998,193,116,77
'4783035000,  개진면,'40,35 - 39세,1998,199,126,73
'4783035000,  개진면,'45,40 - 44세,1998,176,111,65
'4783035000,  개진면,'50,45 - 49세,1998,178,94,84
'4783035000,  개진면,'55,50 - 54세,1998,187,92,95
'4783035000,  개진면,'60,55 - 59세,1998,248,107,141
'4783035000,  개진면,'65,60 - 64세,1998,255,119,136
'4783035000,  개진면,'70,65 - 69세,1998,201,84,117
'4783035000,  개진면,'75,70 - 74세,1998,150,51,99
'4783035000,  개진면,'80,75 - 79세,1998,100,40,60
'4783035000,  개진면,'85,80 - 84세,1998,49,17,32
'4783035000,  개진면,'90,85+ ,1998,19,7,12
'4783036000,  우곡면,'00,계,1998,2724,1393,1331
'4783036000,  우곡면,'05,0 - 4세,1998,83,47,36
'4783036000,  우곡면,'10,5 - 9세,1998,93,50,43
'4783036000,  우곡면,'15,10 - 14세,1998,130,72,58
'4783036000,  우곡면,'20,15 - 19세,1998,160,88,72
'4783036000,  우곡면,'25,20 - 24세,1998,234,139,95
'4783036000,  우곡면,'30,25 - 29세,1998,209,152,57
'4783036000,  우곡면,'35,30 - 34세,1998,129,81,48
'4783036000,  우곡면,'40,35 - 39세,1998,154,90,64
'4783036000,  우곡면,'45,40 - 44세,1998,128,73,55
'4783036000,  우곡면,'50,45 - 49세,1998,167,81,86
'4783036000,  우곡면,'55,50 - 54세,1998,175,79,96
'4783036000,  우곡면,'60,55 - 59세,1998,254,121,133
'4783036000,  우곡면,'65,60 - 64세,1998,294,124,170
'4783036000,  우곡면,'70,65 - 69세,1998,222,90,132
'4783036000,  우곡면,'75,70 - 74세,1998,152,57,95
'4783036000,  우곡면,'80,75 - 79세,1998,82,36,46
'4783036000,  우곡면,'85,80 - 84세,1998,36,10,26
'4783036000,  우곡면,'90,85+ ,1998,22,3,19
'4783037000,  쌍림면,'00,계,1998,5633,2823,2810
'4783037000,  쌍림면,'05,0 - 4세,1998,224,114,110
'4783037000,  쌍림면,'10,5 - 9세,1998,241,129,112
'4783037000,  쌍림면,'15,10 - 14세,1998,281,139,142
'4783037000,  쌍림면,'20,15 - 19세,1998,408,216,192
'4783037000,  쌍림면,'25,20 - 24세,1998,496,282,214
'4783037000,  쌍림면,'30,25 - 29세,1998,435,280,155
'4783037000,  쌍림면,'35,30 - 34세,1998,346,217,129
'4783037000,  쌍림면,'40,35 - 39세,1998,375,188,187
'4783037000,  쌍림면,'45,40 - 44세,1998,326,192,134
'4783037000,  쌍림면,'50,45 - 49세,1998,320,150,170
'4783037000,  쌍림면,'55,50 - 54세,1998,306,150,156
'4783037000,  쌍림면,'60,55 - 59세,1998,420,176,244
'4783037000,  쌍림면,'65,60 - 64세,1998,469,198,271
'4783037000,  쌍림면,'70,65 - 69세,1998,343,138,205
'4783037000,  쌍림면,'75,70 - 74세,1998,280,115,165
'4783037000,  쌍림면,'80,75 - 79세,1998,201,87,114
'4783037000,  쌍림면,'85,80 - 84세,1998,102,35,67
'4783037000,  쌍림면,'90,85+ ,1998,60,17,43
'47840, 성주군,'00,계,1998,52820,26767,26053
'47840, 성주군,'05,0 - 4세,1998,2749,1523,1226
'47840, 성주군,'10,5 - 9세,1998,2962,1641,1321
'47840, 성주군,'15,10 - 14세,1998,2809,1488,1321
'47840, 성주군,'20,15 - 19세,1998,3736,1737,1999
'47840, 성주군,'25,20 - 24세,1998,4169,2294,1875
'47840, 성주군,'30,25 - 29세,1998,3875,2286,1589
'47840, 성주군,'35,30 - 34세,1998,3575,1937,1638
'47840, 성주군,'40,35 - 39세,1998,3981,2202,1779
'47840, 성주군,'45,40 - 44세,1998,3271,1864,1407
'47840, 성주군,'50,45 - 49세,1998,3334,1736,1598
'47840, 성주군,'55,50 - 54세,1998,2909,1434,1475
'47840, 성주군,'60,55 - 59세,1998,3719,1741,1978
'47840, 성주군,'65,60 - 64세,1998,3739,1641,2098
'47840, 성주군,'70,65 - 69세,1998,2933,1218,1715
'47840, 성주군,'75,70 - 74세,1998,2245,961,1284
'47840, 성주군,'80,75 - 79세,1998,1451,642,809
'47840, 성주군,'85,80 - 84세,1998,828,305,523
'47840, 성주군,'90,85+ ,1998,535,117,418
'4784025000,  성주읍,'00,계,1998,14172,7069,7103
'4784025000,  성주읍,'05,0 - 4세,1998,1013,568,445
'4784025000,  성주읍,'10,5 - 9세,1998,1124,607,517
'4784025000,  성주읍,'15,10 - 14세,1998,942,483,459
'4784025000,  성주읍,'20,15 - 19세,1998,1040,459,581
'4784025000,  성주읍,'25,20 - 24세,1998,1083,545,538
'4784025000,  성주읍,'30,25 - 29세,1998,1199,635,564
'4784025000,  성주읍,'35,30 - 34세,1998,1193,593,600
'4784025000,  성주읍,'40,35 - 39세,1998,1233,645,588
'4784025000,  성주읍,'45,40 - 44세,1998,939,536,403
'4784025000,  성주읍,'50,45 - 49세,1998,850,435,415
'4784025000,  성주읍,'55,50 - 54세,1998,715,353,362
'4784025000,  성주읍,'60,55 - 59세,1998,765,349,416
'4784025000,  성주읍,'65,60 - 64세,1998,717,328,389
'4784025000,  성주읍,'70,65 - 69세,1998,510,210,300
'4784025000,  성주읍,'75,70 - 74세,1998,410,180,230
'4784025000,  성주읍,'80,75 - 79세,1998,248,98,150
'4784025000,  성주읍,'85,80 - 84세,1998,112,30,82
'4784025000,  성주읍,'90,85+ ,1998,79,15,64
'4784031000,  선남면,'00,계,1998,7530,3935,3595
'4784031000,  선남면,'05,0 - 4세,1998,437,243,194
'4784031000,  선남면,'10,5 - 9세,1998,466,266,200
'4784031000,  선남면,'15,10 - 14세,1998,343,174,169
'4784031000,  선남면,'20,15 - 19세,1998,485,222,263
'4784031000,  선남면,'25,20 - 24세,1998,606,348,258
'4784031000,  선남면,'30,25 - 29세,1998,571,331,240
'4784031000,  선남면,'35,30 - 34세,1998,584,319,265
'4784031000,  선남면,'40,35 - 39세,1998,646,399,247
'4784031000,  선남면,'45,40 - 44세,1998,453,260,193
'4784031000,  선남면,'50,45 - 49세,1998,502,274,228
'4784031000,  선남면,'55,50 - 54세,1998,419,222,197
'4784031000,  선남면,'60,55 - 59세,1998,540,260,280
'4784031000,  선남면,'65,60 - 64세,1998,475,206,269
'4784031000,  선남면,'70,65 - 69세,1998,365,149,216
'4784031000,  선남면,'75,70 - 74세,1998,283,125,158
'4784031000,  선남면,'80,75 - 79세,1998,169,77,92
'4784031000,  선남면,'85,80 - 84세,1998,111,46,65
'4784031000,  선남면,'90,85+ ,1998,75,14,61
'4784032000,  용암면,'00,계,1998,4602,2383,2219
'4784032000,  용암면,'05,0 - 4세,1998,204,115,89
'4784032000,  용암면,'10,5 - 9세,1998,190,103,87
'4784032000,  용암면,'15,10 - 14세,1998,168,93,75
'4784032000,  용암면,'20,15 - 19세,1998,318,164,154
'4784032000,  용암면,'25,20 - 24세,1998,372,202,170
'4784032000,  용암면,'30,25 - 29세,1998,320,205,115
'4784032000,  용암면,'35,30 - 34세,1998,289,187,102
'4784032000,  용암면,'40,35 - 39세,1998,301,155,146
'4784032000,  용암면,'45,40 - 44세,1998,287,173,114
'4784032000,  용암면,'50,45 - 49세,1998,301,161,140
'4784032000,  용암면,'55,50 - 54세,1998,245,118,127
'4784032000,  용암면,'60,55 - 59세,1998,364,172,192
'4784032000,  용암면,'65,60 - 64세,1998,401,175,226
'4784032000,  용암면,'70,65 - 69세,1998,325,131,194
'4784032000,  용암면,'75,70 - 74세,1998,266,126,140
'4784032000,  용암면,'80,75 - 79세,1998,131,65,66
'4784032000,  용암면,'85,80 - 84세,1998,75,31,44
'4784032000,  용암면,'90,85+ ,1998,45,7,38
'4784033000,  수륜면,'00,계,1998,4238,2072,2166
'4784033000,  수륜면,'05,0 - 4세,1998,142,68,74
'4784033000,  수륜면,'10,5 - 9세,1998,173,95,78
'4784033000,  수륜면,'15,10 - 14세,1998,215,107,108
'4784033000,  수륜면,'20,15 - 19세,1998,322,157,165
'4784033000,  수륜면,'25,20 - 24세,1998,303,163,140
'4784033000,  수륜면,'30,25 - 29세,1998,271,174,97
'4784033000,  수륜면,'35,30 - 34세,1998,217,123,94
'4784033000,  수륜면,'40,35 - 39세,1998,235,133,102
'4784033000,  수륜면,'45,40 - 44세,1998,213,116,97
'4784033000,  수륜면,'50,45 - 49세,1998,247,127,120
'4784033000,  수륜면,'55,50 - 54세,1998,260,122,138
'4784033000,  수륜면,'60,55 - 59세,1998,330,142,188
'4784033000,  수륜면,'65,60 - 64세,1998,434,192,242
'4784033000,  수륜면,'70,65 - 69세,1998,300,131,169
'4784033000,  수륜면,'75,70 - 74세,1998,239,95,144
'4784033000,  수륜면,'80,75 - 79세,1998,164,73,91
'4784033000,  수륜면,'85,80 - 84세,1998,97,36,61
'4784033000,  수륜면,'90,85+ ,1998,76,18,58
'4784034000,  가천면,'00,계,1998,2639,1328,1311
'4784034000,  가천면,'05,0 - 4세,1998,106,63,43
'4784034000,  가천면,'10,5 - 9세,1998,125,68,57
'4784034000,  가천면,'15,10 - 14세,1998,141,78,63
'4784034000,  가천면,'20,15 - 19세,1998,188,102,86
'4784034000,  가천면,'25,20 - 24세,1998,195,113,82
'4784034000,  가천면,'30,25 - 29세,1998,168,104,64
'4784034000,  가천면,'35,30 - 34세,1998,156,81,75
'4784034000,  가천면,'40,35 - 39세,1998,181,99,82
'4784034000,  가천면,'45,40 - 44세,1998,149,74,75
'4784034000,  가천면,'50,45 - 49세,1998,146,74,72
'4784034000,  가천면,'55,50 - 54세,1998,149,66,83
'4784034000,  가천면,'60,55 - 59세,1998,217,99,118
'4784034000,  가천면,'65,60 - 64세,1998,207,98,109
'4784034000,  가천면,'70,65 - 69세,1998,170,69,101
'4784034000,  가천면,'75,70 - 74세,1998,130,51,79
'4784034000,  가천면,'80,75 - 79세,1998,119,49,70
'4784034000,  가천면,'85,80 - 84세,1998,64,30,34
'4784034000,  가천면,'90,85+ ,1998,28,10,18
'4784035000,  금수면,'00,계,1998,1363,687,676
'4784035000,  금수면,'05,0 - 4세,1998,40,22,18
'4784035000,  금수면,'10,5 - 9세,1998,39,26,13
'4784035000,  금수면,'15,10 - 14세,1998,61,39,22
'4784035000,  금수면,'20,15 - 19세,1998,83,31,52
'4784035000,  금수면,'25,20 - 24세,1998,85,47,38
'4784035000,  금수면,'30,25 - 29세,1998,85,60,25
'4784035000,  금수면,'35,30 - 34세,1998,84,49,35
'4784035000,  금수면,'40,35 - 39세,1998,96,60,36
'4784035000,  금수면,'45,40 - 44세,1998,72,46,26
'4784035000,  금수면,'50,45 - 49세,1998,79,47,32
'4784035000,  금수면,'55,50 - 54세,1998,69,32,37
'4784035000,  금수면,'60,55 - 59세,1998,97,47,50
'4784035000,  금수면,'65,60 - 64세,1998,138,49,89
'4784035000,  금수면,'70,65 - 69세,1998,117,47,70
'4784035000,  금수면,'75,70 - 74세,1998,93,38,55
'4784035000,  금수면,'80,75 - 79세,1998,69,29,40
'4784035000,  금수면,'85,80 - 84세,1998,36,12,24
'4784035000,  금수면,'90,85+ ,1998,20,6,14
'4784036000,  대가면,'00,계,1998,3345,1714,1631
'4784036000,  대가면,'05,0 - 4세,1998,153,83,70
'4784036000,  대가면,'10,5 - 9세,1998,134,73,61
'4784036000,  대가면,'15,10 - 14세,1998,147,77,70
'4784036000,  대가면,'20,15 - 19세,1998,219,113,106
'4784036000,  대가면,'25,20 - 24세,1998,278,149,129
'4784036000,  대가면,'30,25 - 29세,1998,260,166,94
'4784036000,  대가면,'35,30 - 34세,1998,181,107,74
'4784036000,  대가면,'40,35 - 39세,1998,214,132,82
'4784036000,  대가면,'45,40 - 44세,1998,181,101,80
'4784036000,  대가면,'50,45 - 49세,1998,198,102,96
'4784036000,  대가면,'55,50 - 54세,1998,220,103,117
'4784036000,  대가면,'60,55 - 59세,1998,273,123,150
'4784036000,  대가면,'65,60 - 64세,1998,268,118,150
'4784036000,  대가면,'70,65 - 69세,1998,232,109,123
'4784036000,  대가면,'75,70 - 74세,1998,163,66,97
'4784036000,  대가면,'80,75 - 79세,1998,110,54,56
'4784036000,  대가면,'85,80 - 84세,1998,68,26,42
'4784036000,  대가면,'90,85+ ,1998,46,12,34
'4784037000,  벽진면,'00,계,1998,4435,2219,2216
'4784037000,  벽진면,'05,0 - 4세,1998,188,109,79
'4784037000,  벽진면,'10,5 - 9세,1998,209,114,95
'4784037000,  벽진면,'15,10 - 14세,1998,213,105,108
'4784037000,  벽진면,'20,15 - 19세,1998,323,132,191
'4784037000,  벽진면,'25,20 - 24세,1998,363,204,159
'4784037000,  벽진면,'30,25 - 29세,1998,268,157,111
'4784037000,  벽진면,'35,30 - 34세,1998,260,131,129
'4784037000,  벽진면,'40,35 - 39세,1998,336,186,150
'4784037000,  벽진면,'45,40 - 44세,1998,307,182,125
'4784037000,  벽진면,'50,45 - 49세,1998,336,165,171
'4784037000,  벽진면,'55,50 - 54세,1998,245,134,111
'4784037000,  벽진면,'60,55 - 59세,1998,337,163,174
'4784037000,  벽진면,'65,60 - 64세,1998,311,133,178
'4784037000,  벽진면,'70,65 - 69세,1998,276,123,153
'4784037000,  벽진면,'75,70 - 74세,1998,199,79,120
'4784037000,  벽진면,'80,75 - 79세,1998,150,66,84
'4784037000,  벽진면,'85,80 - 84세,1998,75,29,46
'4784037000,  벽진면,'90,85+ ,1998,39,7,32
'4784038000,  초전면,'00,계,1998,6227,3181,3046
'4784038000,  초전면,'05,0 - 4세,1998,276,153,123
'4784038000,  초전면,'10,5 - 9세,1998,300,177,123
'4784038000,  초전면,'15,10 - 14세,1998,395,227,168
'4784038000,  초전면,'20,15 - 19세,1998,458,218,240
'4784038000,  초전면,'25,20 - 24세,1998,531,312,219
'4784038000,  초전면,'30,25 - 29세,1998,427,263,164
'4784038000,  초전면,'35,30 - 34세,1998,357,201,156
'4784038000,  초전면,'40,35 - 39세,1998,457,236,221
'4784038000,  초전면,'45,40 - 44세,1998,404,217,187
'4784038000,  초전면,'50,45 - 49세,1998,410,213,197
'4784038000,  초전면,'55,50 - 54세,1998,335,161,174
'4784038000,  초전면,'60,55 - 59세,1998,477,231,246
'4784038000,  초전면,'65,60 - 64세,1998,457,198,259
'4784038000,  초전면,'70,65 - 69세,1998,344,139,205
'4784038000,  초전면,'75,70 - 74세,1998,257,113,144
'4784038000,  초전면,'80,75 - 79세,1998,164,76,88
'4784038000,  초전면,'85,80 - 84세,1998,108,30,78
'4784038000,  초전면,'90,85+ ,1998,70,16,54
'4784039000,  월항면,'00,계,1998,4269,2179,2090
'4784039000,  월항면,'05,0 - 4세,1998,190,99,91
'4784039000,  월항면,'10,5 - 9세,1998,202,112,90
'4784039000,  월항면,'15,10 - 14세,1998,184,105,79
'4784039000,  월항면,'20,15 - 19세,1998,300,139,161
'4784039000,  월항면,'25,20 - 24세,1998,353,211,142
'4784039000,  월항면,'30,25 - 29세,1998,306,191,115
'4784039000,  월항면,'35,30 - 34세,1998,254,146,108
'4784039000,  월항면,'40,35 - 39세,1998,282,157,125
'4784039000,  월항면,'45,40 - 44세,1998,266,159,107
'4784039000,  월항면,'50,45 - 49세,1998,265,138,127
'4784039000,  월항면,'55,50 - 54세,1998,252,123,129
'4784039000,  월항면,'60,55 - 59세,1998,319,155,164
'4784039000,  월항면,'65,60 - 64세,1998,331,144,187
'4784039000,  월항면,'70,65 - 69세,1998,294,110,184
'4784039000,  월항면,'75,70 - 74세,1998,205,88,117
'4784039000,  월항면,'80,75 - 79세,1998,127,55,72
'4784039000,  월항면,'85,80 - 84세,1998,82,35,47
'4784039000,  월항면,'90,85+ ,1998,57,12,45
'47850, 칠곡군,'00,계,1998,92420,46947,45473
'47850, 칠곡군,'05,0 - 4세,1998,8213,4469,3744
'47850, 칠곡군,'10,5 - 9세,1998,6972,3746,3226
'47850, 칠곡군,'15,10 - 14세,1998,5018,2684,2334
'47850, 칠곡군,'20,15 - 19세,1998,6130,3118,3012
'47850, 칠곡군,'25,20 - 24세,1998,7010,3468,3542
'47850, 칠곡군,'30,25 - 29세,1998,10334,5179,5155
'47850, 칠곡군,'35,30 - 34세,1998,9938,5394,4544
'47850, 칠곡군,'40,35 - 39세,1998,8232,4753,3479
'47850, 칠곡군,'45,40 - 44세,1998,5544,3077,2467
'47850, 칠곡군,'50,45 - 49세,1998,4211,2176,2035
'47850, 칠곡군,'55,50 - 54세,1998,3628,1771,1857
'47850, 칠곡군,'60,55 - 59세,1998,4642,1985,2657
'47850, 칠곡군,'65,60 - 64세,1998,4397,1950,2447
'47850, 칠곡군,'70,65 - 69세,1998,3125,1333,1792
'47850, 칠곡군,'75,70 - 74세,1998,2233,947,1286
'47850, 칠곡군,'80,75 - 79세,1998,1524,530,994
'47850, 칠곡군,'85,80 - 84세,1998,800,259,541
'47850, 칠곡군,'90,85+ ,1998,469,108,361
'4785025000,  왜관읍,'00,계,1998,31310,15696,15614
'4785025000,  왜관읍,'05,0 - 4세,1998,2413,1332,1081
'4785025000,  왜관읍,'10,5 - 9세,1998,2451,1325,1126
'4785025000,  왜관읍,'15,10 - 14세,1998,2099,1146,953
'4785025000,  왜관읍,'20,15 - 19세,1998,2336,1225,1111
'4785025000,  왜관읍,'25,20 - 24세,1998,2360,1168,1192
'4785025000,  왜관읍,'30,25 - 29세,1998,3120,1525,1595
'4785025000,  왜관읍,'35,30 - 34세,1998,3068,1583,1485
'4785025000,  왜관읍,'40,35 - 39세,1998,3091,1610,1481
'4785025000,  왜관읍,'45,40 - 44세,1998,2146,1156,990
'4785025000,  왜관읍,'50,45 - 49세,1998,1515,778,737
'4785025000,  왜관읍,'55,50 - 54세,1998,1263,588,675
'4785025000,  왜관읍,'60,55 - 59세,1998,1585,660,925
'4785025000,  왜관읍,'65,60 - 64세,1998,1468,666,802
'4785025000,  왜관읍,'70,65 - 69세,1998,949,416,533
'4785025000,  왜관읍,'75,70 - 74세,1998,653,278,375
'4785025000,  왜관읍,'80,75 - 79세,1998,414,143,271
'4785025000,  왜관읍,'85,80 - 84세,1998,228,69,159
'4785025000,  왜관읍,'90,85+ ,1998,151,28,123
'4785031000,  지천면,'00,계,1998,6926,3548,3378
'4785031000,  지천면,'05,0 - 4세,1998,320,185,135
'4785031000,  지천면,'10,5 - 9세,1998,277,157,120
'4785031000,  지천면,'15,10 - 14세,1998,239,117,122
'4785031000,  지천면,'20,15 - 19세,1998,465,238,227
'4785031000,  지천면,'25,20 - 24세,1998,662,368,294
'4785031000,  지천면,'30,25 - 29세,1998,637,387,250
'4785031000,  지천면,'35,30 - 34세,1998,436,259,177
'4785031000,  지천면,'40,35 - 39세,1998,433,258,175
'4785031000,  지천면,'45,40 - 44세,1998,423,245,178
'4785031000,  지천면,'50,45 - 49세,1998,426,224,202
'4785031000,  지천면,'55,50 - 54세,1998,391,183,208
'4785031000,  지천면,'60,55 - 59세,1998,579,256,323
'4785031000,  지천면,'65,60 - 64세,1998,527,237,290
'4785031000,  지천면,'70,65 - 69세,1998,412,172,240
'4785031000,  지천면,'75,70 - 74세,1998,315,142,173
'4785031000,  지천면,'80,75 - 79세,1998,218,68,150
'4785031000,  지천면,'85,80 - 84세,1998,120,40,80
'4785031000,  지천면,'90,85+ ,1998,46,12,34
'4785032000,  동명면,'00,계,1998,7093,3631,3462
'4785032000,  동명면,'05,0 - 4세,1998,378,212,166
'4785032000,  동명면,'10,5 - 9세,1998,363,175,188
'4785032000,  동명면,'15,10 - 14세,1998,257,146,111
'4785032000,  동명면,'20,15 - 19세,1998,521,264,257
'4785032000,  동명면,'25,20 - 24세,1998,662,350,312
'4785032000,  동명면,'30,25 - 29세,1998,632,393,239
'4785032000,  동명면,'35,30 - 34세,1998,567,309,258
'4785032000,  동명면,'40,35 - 39세,1998,527,329,198
'4785032000,  동명면,'45,40 - 44세,1998,464,254,210
'4785032000,  동명면,'50,45 - 49세,1998,439,224,215
'4785032000,  동명면,'55,50 - 54세,1998,393,208,185
'4785032000,  동명면,'60,55 - 59세,1998,480,211,269
'4785032000,  동명면,'65,60 - 64세,1998,466,195,271
'4785032000,  동명면,'70,65 - 69세,1998,346,162,184
'4785032000,  동명면,'75,70 - 74세,1998,254,108,146
'4785032000,  동명면,'80,75 - 79세,1998,186,58,128
'4785032000,  동명면,'85,80 - 84세,1998,105,19,86
'4785032000,  동명면,'90,85+ ,1998,53,14,39
'4785033000,  가산면,'00,계,1998,4896,2537,2359
'4785033000,  가산면,'05,0 - 4세,1998,235,121,114
'4785033000,  가산면,'10,5 - 9세,1998,231,124,107
'4785033000,  가산면,'15,10 - 14세,1998,225,131,94
'4785033000,  가산면,'20,15 - 19세,1998,374,195,179
'4785033000,  가산면,'25,20 - 24세,1998,429,228,201
'4785033000,  가산면,'30,25 - 29세,1998,407,248,159
'4785033000,  가산면,'35,30 - 34세,1998,347,194,153
'4785033000,  가산면,'40,35 - 39세,1998,344,216,128
'4785033000,  가산면,'45,40 - 44세,1998,317,176,141
'4785033000,  가산면,'50,45 - 49세,1998,311,164,147
'4785033000,  가산면,'55,50 - 54세,1998,278,146,132
'4785033000,  가산면,'60,55 - 59세,1998,366,165,201
'4785033000,  가산면,'65,60 - 64세,1998,301,137,164
'4785033000,  가산면,'70,65 - 69세,1998,278,119,159
'4785033000,  가산면,'75,70 - 74세,1998,208,83,125
'4785033000,  가산면,'80,75 - 79세,1998,141,60,81
'4785033000,  가산면,'85,80 - 84세,1998,69,21,48
'4785033000,  가산면,'90,85+ ,1998,35,9,26
'4785034000,  석적면,'00,계,1998,4133,2216,1917
'4785034000,  석적면,'05,0 - 4세,1998,258,140,118
'4785034000,  석적면,'10,5 - 9세,1998,146,79,67
'4785034000,  석적면,'15,10 - 14세,1998,162,88,74
'4785034000,  석적면,'20,15 - 19세,1998,285,147,138
'4785034000,  석적면,'25,20 - 24세,1998,407,218,189
'4785034000,  석적면,'30,25 - 29세,1998,612,404,208
'4785034000,  석적면,'35,30 - 34세,1998,307,205,102
'4785034000,  석적면,'40,35 - 39세,1998,266,159,107
'4785034000,  석적면,'45,40 - 44세,1998,226,120,106
'4785034000,  석적면,'50,45 - 49세,1998,200,105,95
'4785034000,  석적면,'55,50 - 54세,1998,195,103,92
'4785034000,  석적면,'60,55 - 59세,1998,248,102,146
'4785034000,  석적면,'65,60 - 64세,1998,280,130,150
'4785034000,  석적면,'70,65 - 69세,1998,196,85,111
'4785034000,  석적면,'75,70 - 74세,1998,153,69,84
'4785034000,  석적면,'80,75 - 79세,1998,91,33,58
'4785034000,  석적면,'85,80 - 84세,1998,52,19,33
'4785034000,  석적면,'90,85+ ,1998,49,10,39
'4785035000,  북삼면,'00,계,1998,17344,8831,8513
'4785035000,  북삼면,'05,0 - 4세,1998,2456,1317,1139
'4785035000,  북삼면,'10,5 - 9세,1998,1785,957,828
'4785035000,  북삼면,'15,10 - 14세,1998,929,467,462
'4785035000,  북삼면,'20,15 - 19세,1998,862,434,428
'4785035000,  북삼면,'25,20 - 24세,1998,984,431,553
'4785035000,  북삼면,'30,25 - 29세,1998,2441,1028,1413
'4785035000,  북삼면,'35,30 - 34세,1998,2717,1491,1226
'4785035000,  북삼면,'40,35 - 39세,1998,1693,1053,640
'4785035000,  북삼면,'45,40 - 44세,1998,853,506,347
'4785035000,  북삼면,'50,45 - 49세,1998,508,266,242
'4785035000,  북삼면,'55,50 - 54세,1998,383,179,204
'4785035000,  북삼면,'60,55 - 59세,1998,483,203,280
'4785035000,  북삼면,'65,60 - 64세,1998,456,203,253
'4785035000,  북삼면,'70,65 - 69세,1998,295,108,187
'4785035000,  북삼면,'75,70 - 74세,1998,215,87,128
'4785035000,  북삼면,'80,75 - 79세,1998,167,55,112
'4785035000,  북삼면,'85,80 - 84세,1998,71,33,38
'4785035000,  북삼면,'90,85+ ,1998,46,13,33
'4785036000,  약목면,'00,계,1998,17317,8739,8578
'4785036000,  약목면,'05,0 - 4세,1998,2017,1096,921
'4785036000,  약목면,'10,5 - 9세,1998,1572,846,726
'4785036000,  약목면,'15,10 - 14세,1998,901,473,428
'4785036000,  약목면,'20,15 - 19세,1998,1032,490,542
'4785036000,  약목면,'25,20 - 24세,1998,1200,531,669
'4785036000,  약목면,'30,25 - 29세,1998,2190,1006,1184
'4785036000,  약목면,'35,30 - 34세,1998,2288,1237,1051
'4785036000,  약목면,'40,35 - 39세,1998,1649,1003,646
'4785036000,  약목면,'45,40 - 44세,1998,927,510,417
'4785036000,  약목면,'50,45 - 49세,1998,646,329,317
'4785036000,  약목면,'55,50 - 54세,1998,541,272,269
'4785036000,  약목면,'60,55 - 59세,1998,645,269,376
'4785036000,  약목면,'65,60 - 64세,1998,619,262,357
'4785036000,  약목면,'70,65 - 69세,1998,430,170,260
'4785036000,  약목면,'75,70 - 74세,1998,292,117,175
'4785036000,  약목면,'80,75 - 79세,1998,213,78,135
'4785036000,  약목면,'85,80 - 84세,1998,103,37,66
'4785036000,  약목면,'90,85+ ,1998,52,13,39
'4785037000,  기산면,'00,계,1998,3401,1749,1652
'4785037000,  기산면,'05,0 - 4세,1998,136,66,70
'4785037000,  기산면,'10,5 - 9세,1998,147,83,64
'4785037000,  기산면,'15,10 - 14세,1998,206,116,90
'4785037000,  기산면,'20,15 - 19세,1998,255,125,130
'4785037000,  기산면,'25,20 - 24세,1998,306,174,132
'4785037000,  기산면,'30,25 - 29세,1998,295,188,107
'4785037000,  기산면,'35,30 - 34세,1998,208,116,92
'4785037000,  기산면,'40,35 - 39세,1998,229,125,104
'4785037000,  기산면,'45,40 - 44세,1998,188,110,78
'4785037000,  기산면,'50,45 - 49세,1998,166,86,80
'4785037000,  기산면,'55,50 - 54세,1998,184,92,92
'4785037000,  기산면,'60,55 - 59세,1998,256,119,137
'4785037000,  기산면,'65,60 - 64세,1998,280,120,160
'4785037000,  기산면,'70,65 - 69세,1998,219,101,118
'4785037000,  기산면,'75,70 - 74세,1998,143,63,80
'4785037000,  기산면,'80,75 - 79세,1998,94,35,59
'4785037000,  기산면,'85,80 - 84세,1998,52,21,31
'4785037000,  기산면,'90,85+ ,1998,37,9,28
'47900, 예천군,'00,계,1998,63681,31458,32223
'47900, 예천군,'05,0 - 4세,1998,2343,1273,1070
'47900, 예천군,'10,5 - 9세,1998,2769,1496,1273
'47900, 예천군,'15,10 - 14세,1998,3708,1946,1762
'47900, 예천군,'20,15 - 19세,1998,6077,3046,3031
'47900, 예천군,'25,20 - 24세,1998,6044,3590,2454
'47900, 예천군,'30,25 - 29세,1998,3676,2156,1520
'47900, 예천군,'35,30 - 34세,1998,3100,1634,1466
'47900, 예천군,'40,35 - 39세,1998,3877,1982,1895
'47900, 예천군,'45,40 - 44세,1998,4035,2028,2007
'47900, 예천군,'50,45 - 49세,1998,3656,1778,1878
'47900, 예천군,'55,50 - 54세,1998,3385,1626,1759
'47900, 예천군,'60,55 - 59세,1998,5192,2383,2809
'47900, 예천군,'65,60 - 64세,1998,5244,2394,2850
'47900, 예천군,'70,65 - 69세,1998,3629,1531,2098
'47900, 예천군,'75,70 - 74세,1998,2737,1130,1607
'47900, 예천군,'80,75 - 79세,1998,2086,798,1288
'47900, 예천군,'85,80 - 84세,1998,1325,472,853
'47900, 예천군,'90,85+ ,1998,798,195,603
'4790025000,  예천읍,'00,계,1998,21495,10698,10797
'4790025000,  예천읍,'05,0 - 4세,1998,1207,687,520
'4790025000,  예천읍,'10,5 - 9세,1998,1467,800,667
'4790025000,  예천읍,'15,10 - 14세,1998,1561,838,723
'4790025000,  예천읍,'20,15 - 19세,1998,2174,1082,1092
'4790025000,  예천읍,'25,20 - 24세,1998,1931,1068,863
'4790025000,  예천읍,'30,25 - 29세,1998,1526,785,741
'4790025000,  예천읍,'35,30 - 34세,1998,1481,713,768
'4790025000,  예천읍,'40,35 - 39세,1998,1750,868,882
'4790025000,  예천읍,'45,40 - 44세,1998,1659,838,821
'4790025000,  예천읍,'50,45 - 49세,1998,1249,621,628
'4790025000,  예천읍,'55,50 - 54세,1998,1036,514,522
'4790025000,  예천읍,'60,55 - 59세,1998,1223,586,637
'4790025000,  예천읍,'65,60 - 64세,1998,1073,500,573
'4790025000,  예천읍,'70,65 - 69세,1998,734,286,448
'4790025000,  예천읍,'75,70 - 74세,1998,615,241,374
'4790025000,  예천읍,'80,75 - 79세,1998,406,148,258
'4790025000,  예천읍,'85,80 - 84세,1998,273,91,182
'4790025000,  예천읍,'90,85+ ,1998,130,32,98
'4790031000,  용문면,'00,계,1998,3857,1892,1965
'4790031000,  용문면,'05,0 - 4세,1998,99,51,48
'4790031000,  용문면,'10,5 - 9세,1998,104,60,44
'4790031000,  용문면,'15,10 - 14세,1998,150,75,75
'4790031000,  용문면,'20,15 - 19세,1998,330,164,166
'4790031000,  용문면,'25,20 - 24세,1998,414,244,170
'4790031000,  용문면,'30,25 - 29세,1998,190,130,60
'4790031000,  용문면,'35,30 - 34세,1998,137,83,54
'4790031000,  용문면,'40,35 - 39세,1998,186,106,80
'4790031000,  용문면,'45,40 - 44세,1998,171,83,88
'4790031000,  용문면,'50,45 - 49세,1998,223,103,120
'4790031000,  용문면,'55,50 - 54세,1998,221,108,113
'4790031000,  용문면,'60,55 - 59세,1998,374,153,221
'4790031000,  용문면,'65,60 - 64세,1998,416,199,217
'4790031000,  용문면,'70,65 - 69세,1998,280,118,162
'4790031000,  용문면,'75,70 - 74세,1998,206,88,118
'4790031000,  용문면,'80,75 - 79세,1998,178,70,108
'4790031000,  용문면,'85,80 - 84세,1998,103,43,60
'4790031000,  용문면,'90,85+ ,1998,75,14,61
'4790032000,  상리면,'00,계,1998,1742,846,896
'4790032000,  상리면,'05,0 - 4세,1998,38,22,16
'4790032000,  상리면,'10,5 - 9세,1998,52,27,25
'4790032000,  상리면,'15,10 - 14세,1998,127,50,77
'4790032000,  상리면,'20,15 - 19세,1998,169,80,89
'4790032000,  상리면,'25,20 - 24세,1998,154,94,60
'4790032000,  상리면,'30,25 - 29세,1998,80,53,27
'4790032000,  상리면,'35,30 - 34세,1998,60,37,23
'4790032000,  상리면,'40,35 - 39세,1998,110,54,56
'4790032000,  상리면,'45,40 - 44세,1998,114,63,51
'4790032000,  상리면,'50,45 - 49세,1998,83,44,39
'4790032000,  상리면,'55,50 - 54세,1998,100,47,53
'4790032000,  상리면,'60,55 - 59세,1998,137,66,71
'4790032000,  상리면,'65,60 - 64세,1998,159,61,98
'4790032000,  상리면,'70,65 - 69세,1998,115,44,71
'4790032000,  상리면,'75,70 - 74세,1998,107,52,55
'4790032000,  상리면,'80,75 - 79세,1998,67,27,40
'4790032000,  상리면,'85,80 - 84세,1998,48,16,32
'4790032000,  상리면,'90,85+ ,1998,22,9,13
'4790033000,  하리면,'00,계,1998,2205,1101,1104
'4790033000,  하리면,'05,0 - 4세,1998,63,28,35
'4790033000,  하리면,'10,5 - 9세,1998,45,28,17
'4790033000,  하리면,'15,10 - 14세,1998,119,62,57
'4790033000,  하리면,'20,15 - 19세,1998,203,99,104
'4790033000,  하리면,'25,20 - 24세,1998,223,134,89
'4790033000,  하리면,'30,25 - 29세,1998,124,83,41
'4790033000,  하리면,'35,30 - 34세,1998,79,57,22
'4790033000,  하리면,'40,35 - 39세,1998,101,43,58
'4790033000,  하리면,'45,40 - 44세,1998,110,63,47
'4790033000,  하리면,'50,45 - 49세,1998,117,51,66
'4790033000,  하리면,'55,50 - 54세,1998,128,55,73
'4790033000,  하리면,'60,55 - 59세,1998,206,96,110
'4790033000,  하리면,'65,60 - 64세,1998,230,111,119
'4790033000,  하리면,'70,65 - 69세,1998,158,73,85
'4790033000,  하리면,'75,70 - 74세,1998,112,46,66
'4790033000,  하리면,'80,75 - 79세,1998,94,35,59
'4790033000,  하리면,'85,80 - 84세,1998,56,23,33
'4790033000,  하리면,'90,85+ ,1998,37,14,23
'4790034000,  감천면,'00,계,1998,4533,2269,2264
'4790034000,  감천면,'05,0 - 4세,1998,119,66,53
'4790034000,  감천면,'10,5 - 9세,1998,129,71,58
'4790034000,  감천면,'15,10 - 14세,1998,240,123,117
'4790034000,  감천면,'20,15 - 19세,1998,418,203,215
'4790034000,  감천면,'25,20 - 24세,1998,461,287,174
'4790034000,  감천면,'30,25 - 29세,1998,232,157,75
'4790034000,  감천면,'35,30 - 34세,1998,145,84,61
'4790034000,  감천면,'40,35 - 39세,1998,213,114,99
'4790034000,  감천면,'45,40 - 44세,1998,264,143,121
'4790034000,  감천면,'50,45 - 49세,1998,268,127,141
'4790034000,  감천면,'55,50 - 54세,1998,222,111,111
'4790034000,  감천면,'60,55 - 59세,1998,409,174,235
'4790034000,  감천면,'65,60 - 64세,1998,471,211,260
'4790034000,  감천면,'70,65 - 69세,1998,329,147,182
'4790034000,  감천면,'75,70 - 74세,1998,243,107,136
'4790034000,  감천면,'80,75 - 79세,1998,183,83,100
'4790034000,  감천면,'85,80 - 84세,1998,110,41,69
'4790034000,  감천면,'90,85+ ,1998,77,20,57
'4790035000,  보문면,'00,계,1998,2952,1449,1503
'4790035000,  보문면,'05,0 - 4세,1998,67,31,36
'4790035000,  보문면,'10,5 - 9세,1998,46,19,27
'4790035000,  보문면,'15,10 - 14세,1998,96,46,50
'4790035000,  보문면,'20,15 - 19세,1998,288,143,145
'4790035000,  보문면,'25,20 - 24세,1998,298,184,114
'4790035000,  보문면,'30,25 - 29세,1998,165,115,50
'4790035000,  보문면,'35,30 - 34세,1998,107,72,35
'4790035000,  보문면,'40,35 - 39세,1998,98,60,38
'4790035000,  보문면,'45,40 - 44세,1998,157,79,78
'4790035000,  보문면,'50,45 - 49세,1998,163,83,80
'4790035000,  보문면,'55,50 - 54세,1998,162,72,90
'4790035000,  보문면,'60,55 - 59세,1998,320,157,163
'4790035000,  보문면,'65,60 - 64세,1998,305,122,183
'4790035000,  보문면,'70,65 - 69세,1998,226,101,125
'4790035000,  보문면,'75,70 - 74세,1998,177,63,114
'4790035000,  보문면,'80,75 - 79세,1998,140,59,81
'4790035000,  보문면,'85,80 - 84세,1998,91,33,58
'4790035000,  보문면,'90,85+ ,1998,46,10,36
'4790036000,  호명면,'00,계,1998,3779,1857,1922
'4790036000,  호명면,'05,0 - 4세,1998,86,37,49
'4790036000,  호명면,'10,5 - 9세,1998,89,48,41
'4790036000,  호명면,'15,10 - 14세,1998,141,75,66
'4790036000,  호명면,'20,15 - 19세,1998,336,172,164
'4790036000,  호명면,'25,20 - 24세,1998,365,231,134
'4790036000,  호명면,'30,25 - 29세,1998,168,107,61
'4790036000,  호명면,'35,30 - 34세,1998,149,79,70
'4790036000,  호명면,'40,35 - 39세,1998,181,100,81
'4790036000,  호명면,'45,40 - 44세,1998,195,100,95
'4790036000,  호명면,'50,45 - 49세,1998,195,97,98
'4790036000,  호명면,'55,50 - 54세,1998,243,112,131
'4790036000,  호명면,'60,55 - 59세,1998,414,190,224
'4790036000,  호명면,'65,60 - 64세,1998,393,178,215
'4790036000,  호명면,'70,65 - 69세,1998,276,116,160
'4790036000,  호명면,'75,70 - 74세,1998,204,93,111
'4790036000,  호명면,'80,75 - 79세,1998,160,68,92
'4790036000,  호명면,'85,80 - 84세,1998,115,36,79
'4790036000,  호명면,'90,85+ ,1998,69,18,51
'4790037000,  유천면,'00,계,1998,4404,2174,2230
'4790037000,  유천면,'05,0 - 4세,1998,145,84,61
'4790037000,  유천면,'10,5 - 9세,1998,159,82,77
'4790037000,  유천면,'15,10 - 14세,1998,238,123,115
'4790037000,  유천면,'20,15 - 19세,1998,405,198,207
'4790037000,  유천면,'25,20 - 24세,1998,467,286,181
'4790037000,  유천면,'30,25 - 29세,1998,234,141,93
'4790037000,  유천면,'35,30 - 34세,1998,211,120,91
'4790037000,  유천면,'40,35 - 39세,1998,243,124,119
'4790037000,  유천면,'45,40 - 44세,1998,251,124,127
'4790037000,  유천면,'50,45 - 49세,1998,249,115,134
'4790037000,  유천면,'55,50 - 54세,1998,238,118,120
'4790037000,  유천면,'60,55 - 59세,1998,366,168,198
'4790037000,  유천면,'65,60 - 64세,1998,378,175,203
'4790037000,  유천면,'70,65 - 69세,1998,291,121,170
'4790037000,  유천면,'75,70 - 74세,1998,213,95,118
'4790037000,  유천면,'80,75 - 79세,1998,160,62,98
'4790037000,  유천면,'85,80 - 84세,1998,97,29,68
'4790037000,  유천면,'90,85+ ,1998,59,9,50
'4790038000,  용궁면,'00,계,1998,4765,2332,2433
'4790038000,  용궁면,'05,0 - 4세,1998,122,56,66
'4790038000,  용궁면,'10,5 - 9세,1998,180,100,80
'4790038000,  용궁면,'15,10 - 14세,1998,302,156,146
'4790038000,  용궁면,'20,15 - 19세,1998,480,243,237
'4790038000,  용궁면,'25,20 - 24세,1998,440,265,175
'4790038000,  용궁면,'30,25 - 29세,1998,232,150,82
'4790038000,  용궁면,'35,30 - 34세,1998,191,96,95
'4790038000,  용궁면,'40,35 - 39세,1998,249,130,119
'4790038000,  용궁면,'45,40 - 44세,1998,335,156,179
'4790038000,  용궁면,'50,45 - 49세,1998,305,152,153
'4790038000,  용궁면,'55,50 - 54세,1998,277,132,145
'4790038000,  용궁면,'60,55 - 59세,1998,391,171,220
'4790038000,  용궁면,'65,60 - 64세,1998,428,207,221
'4790038000,  용궁면,'70,65 - 69세,1998,300,127,173
'4790038000,  용궁면,'75,70 - 74세,1998,188,83,105
'4790038000,  용궁면,'80,75 - 79세,1998,162,54,108
'4790038000,  용궁면,'85,80 - 84세,1998,106,36,70
'4790038000,  용궁면,'90,85+ ,1998,77,18,59
'4790039000,  개포면,'00,계,1998,2900,1392,1508
'4790039000,  개포면,'05,0 - 4세,1998,70,39,31
'4790039000,  개포면,'10,5 - 9세,1998,56,23,33
'4790039000,  개포면,'15,10 - 14세,1998,142,80,62
'4790039000,  개포면,'20,15 - 19세,1998,278,140,138
'4790039000,  개포면,'25,20 - 24세,1998,299,179,120
'4790039000,  개포면,'30,25 - 29세,1998,154,92,62
'4790039000,  개포면,'35,30 - 34세,1998,112,66,46
'4790039000,  개포면,'40,35 - 39세,1998,129,66,63
'4790039000,  개포면,'45,40 - 44세,1998,162,76,86
'4790039000,  개포면,'50,45 - 49세,1998,177,83,94
'4790039000,  개포면,'55,50 - 54세,1998,136,63,73
'4790039000,  개포면,'60,55 - 59세,1998,320,156,164
'4790039000,  개포면,'65,60 - 64세,1998,304,133,171
'4790039000,  개포면,'70,65 - 69세,1998,191,76,115
'4790039000,  개포면,'75,70 - 74세,1998,145,49,96
'4790039000,  개포면,'80,75 - 79세,1998,117,44,73
'4790039000,  개포면,'85,80 - 84세,1998,58,16,42
'4790039000,  개포면,'90,85+ ,1998,50,11,39
'4790040000,  지보면,'00,계,1998,5161,2558,2603
'4790040000,  지보면,'05,0 - 4세,1998,124,66,58
'4790040000,  지보면,'10,5 - 9세,1998,161,87,74
'4790040000,  지보면,'15,10 - 14세,1998,240,128,112
'4790040000,  지보면,'20,15 - 19세,1998,458,240,218
'4790040000,  지보면,'25,20 - 24세,1998,480,301,179
'4790040000,  지보면,'30,25 - 29세,1998,260,162,98
'4790040000,  지보면,'35,30 - 34세,1998,173,99,74
'4790040000,  지보면,'40,35 - 39세,1998,248,133,115
'4790040000,  지보면,'45,40 - 44세,1998,277,138,139
'4790040000,  지보면,'50,45 - 49세,1998,322,147,175
'4790040000,  지보면,'55,50 - 54세,1998,294,136,158
'4790040000,  지보면,'60,55 - 59세,1998,505,240,265
'4790040000,  지보면,'65,60 - 64세,1998,524,233,291
'4790040000,  지보면,'70,65 - 69세,1998,379,171,208
'4790040000,  지보면,'75,70 - 74세,1998,280,109,171
'4790040000,  지보면,'80,75 - 79세,1998,210,83,127
'4790040000,  지보면,'85,80 - 84세,1998,151,61,90
'4790040000,  지보면,'90,85+ ,1998,75,24,51
'4790041000,  풍양면,'00,계,1998,5888,2890,2998
'4790041000,  풍양면,'05,0 - 4세,1998,203,106,97
'4790041000,  풍양면,'10,5 - 9세,1998,281,151,130
'4790041000,  풍양면,'15,10 - 14세,1998,352,190,162
'4790041000,  풍양면,'20,15 - 19세,1998,538,282,256
'4790041000,  풍양면,'25,20 - 24세,1998,512,317,195
'4790041000,  풍양면,'30,25 - 29세,1998,311,181,130
'4790041000,  풍양면,'35,30 - 34세,1998,255,128,127
'4790041000,  풍양면,'40,35 - 39세,1998,369,184,185
'4790041000,  풍양면,'45,40 - 44세,1998,340,165,175
'4790041000,  풍양면,'50,45 - 49세,1998,305,155,150
'4790041000,  풍양면,'55,50 - 54세,1998,328,158,170
'4790041000,  풍양면,'60,55 - 59세,1998,527,226,301
'4790041000,  풍양면,'65,60 - 64세,1998,563,264,299
'4790041000,  풍양면,'70,65 - 69세,1998,350,151,199
'4790041000,  풍양면,'75,70 - 74세,1998,247,104,143
'4790041000,  풍양면,'80,75 - 79세,1998,209,65,144
'4790041000,  풍양면,'85,80 - 84세,1998,117,47,70
'4790041000,  풍양면,'90,85+ ,1998,81,16,65
'47920, 봉화군,'00,계,1998,45737,22927,22810
'47920, 봉화군,'05,0 - 4세,1998,1799,937,862
'47920, 봉화군,'10,5 - 9세,1998,1915,1024,891
'47920, 봉화군,'15,10 - 14세,1998,2674,1378,1296
'47920, 봉화군,'20,15 - 19세,1998,4469,2180,2289
'47920, 봉화군,'25,20 - 24세,1998,4546,2674,1872
'47920, 봉화군,'30,25 - 29세,1998,2897,1772,1125
'47920, 봉화군,'35,30 - 34세,1998,2427,1341,1086
'47920, 봉화군,'40,35 - 39세,1998,2930,1564,1366
'47920, 봉화군,'45,40 - 44세,1998,2860,1497,1363
'47920, 봉화군,'50,45 - 49세,1998,2509,1258,1251
'47920, 봉화군,'55,50 - 54세,1998,2473,1166,1307
'47920, 봉화군,'60,55 - 59세,1998,3569,1595,1974
'47920, 봉화군,'65,60 - 64세,1998,3624,1654,1970
'47920, 봉화군,'70,65 - 69세,1998,2589,1106,1483
'47920, 봉화군,'75,70 - 74세,1998,1989,835,1154
'47920, 봉화군,'80,75 - 79세,1998,1292,560,732
'47920, 봉화군,'85,80 - 84세,1998,764,269,495
'47920, 봉화군,'90,85+ ,1998,411,117,294
'4792025000,  봉화읍,'00,계,1998,12955,6489,6466
'4792025000,  봉화읍,'05,0 - 4세,1998,741,371,370
'4792025000,  봉화읍,'10,5 - 9세,1998,692,385,307
'4792025000,  봉화읍,'15,10 - 14세,1998,819,450,369
'4792025000,  봉화읍,'20,15 - 19세,1998,1214,591,623
'4792025000,  봉화읍,'25,20 - 24세,1998,1203,698,505
'4792025000,  봉화읍,'30,25 - 29세,1998,987,544,443
'4792025000,  봉화읍,'35,30 - 34세,1998,914,504,410
'4792025000,  봉화읍,'40,35 - 39세,1998,1013,523,490
'4792025000,  봉화읍,'45,40 - 44세,1998,840,445,395
'4792025000,  봉화읍,'50,45 - 49세,1998,717,351,366
'4792025000,  봉화읍,'55,50 - 54세,1998,619,295,324
'4792025000,  봉화읍,'60,55 - 59세,1998,784,357,427
'4792025000,  봉화읍,'65,60 - 64세,1998,783,353,430
'4792025000,  봉화읍,'70,65 - 69세,1998,564,221,343
'4792025000,  봉화읍,'75,70 - 74세,1998,464,181,283
'4792025000,  봉화읍,'80,75 - 79세,1998,292,125,167
'4792025000,  봉화읍,'85,80 - 84세,1998,201,67,134
'4792025000,  봉화읍,'90,85+ ,1998,108,28,80
'4792031000,  물야면,'00,계,1998,4676,2310,2366
'4792031000,  물야면,'05,0 - 4세,1998,134,65,69
'4792031000,  물야면,'10,5 - 9세,1998,131,70,61
'4792031000,  물야면,'15,10 - 14세,1998,284,137,147
'4792031000,  물야면,'20,15 - 19세,1998,438,233,205
'4792031000,  물야면,'25,20 - 24세,1998,484,274,210
'4792031000,  물야면,'30,25 - 29세,1998,259,165,94
'4792031000,  물야면,'35,30 - 34세,1998,192,107,85
'4792031000,  물야면,'40,35 - 39세,1998,243,128,115
'4792031000,  물야면,'45,40 - 44세,1998,293,154,139
'4792031000,  물야면,'50,45 - 49세,1998,257,117,140
'4792031000,  물야면,'55,50 - 54세,1998,279,129,150
'4792031000,  물야면,'60,55 - 59세,1998,389,177,212
'4792031000,  물야면,'65,60 - 64세,1998,432,196,236
'4792031000,  물야면,'70,65 - 69세,1998,293,129,164
'4792031000,  물야면,'75,70 - 74세,1998,241,103,138
'4792031000,  물야면,'80,75 - 79세,1998,152,68,84
'4792031000,  물야면,'85,80 - 84세,1998,109,37,72
'4792031000,  물야면,'90,85+ ,1998,66,21,45
'4792032000,  봉성면,'00,계,1998,3308,1615,1693
'4792032000,  봉성면,'05,0 - 4세,1998,86,45,41
'4792032000,  봉성면,'10,5 - 9세,1998,112,60,52
'4792032000,  봉성면,'15,10 - 14세,1998,189,91,98
'4792032000,  봉성면,'20,15 - 19세,1998,323,148,175
'4792032000,  봉성면,'25,20 - 24세,1998,337,208,129
'4792032000,  봉성면,'30,25 - 29세,1998,198,136,62
'4792032000,  봉성면,'35,30 - 34세,1998,128,69,59
'4792032000,  봉성면,'40,35 - 39세,1998,189,98,91
'4792032000,  봉성면,'45,40 - 44세,1998,190,95,95
'4792032000,  봉성면,'50,45 - 49세,1998,207,113,94
'4792032000,  봉성면,'55,50 - 54세,1998,174,81,93
'4792032000,  봉성면,'60,55 - 59세,1998,270,114,156
'4792032000,  봉성면,'65,60 - 64세,1998,291,120,171
'4792032000,  봉성면,'70,65 - 69세,1998,233,94,139
'4792032000,  봉성면,'75,70 - 74세,1998,160,63,97
'4792032000,  봉성면,'80,75 - 79세,1998,120,53,67
'4792032000,  봉성면,'85,80 - 84세,1998,68,18,50
'4792032000,  봉성면,'90,85+ ,1998,33,9,24
'4792033000,  법전면,'00,계,1998,3179,1559,1620
'4792033000,  법전면,'05,0 - 4세,1998,92,49,43
'4792033000,  법전면,'10,5 - 9세,1998,102,55,47
'4792033000,  법전면,'15,10 - 14세,1998,169,74,95
'4792033000,  법전면,'20,15 - 19세,1998,296,137,159
'4792033000,  법전면,'25,20 - 24세,1998,339,197,142
'4792033000,  법전면,'30,25 - 29세,1998,169,113,56
'4792033000,  법전면,'35,30 - 34세,1998,126,71,55
'4792033000,  법전면,'40,35 - 39세,1998,144,74,70
'4792033000,  법전면,'45,40 - 44세,1998,175,92,83
'4792033000,  법전면,'50,45 - 49세,1998,153,88,65
'4792033000,  법전면,'55,50 - 54세,1998,173,67,106
'4792033000,  법전면,'60,55 - 59세,1998,316,146,170
'4792033000,  법전면,'65,60 - 64세,1998,300,140,160
'4792033000,  법전면,'70,65 - 69세,1998,215,93,122
'4792033000,  법전면,'75,70 - 74세,1998,187,74,113
'4792033000,  법전면,'80,75 - 79세,1998,116,57,59
'4792033000,  법전면,'85,80 - 84세,1998,61,23,38
'4792033000,  법전면,'90,85+ ,1998,46,9,37
'4792034000,  춘양면,'00,계,1998,6901,3500,3401
'4792034000,  춘양면,'05,0 - 4세,1998,263,138,125
'4792034000,  춘양면,'10,5 - 9세,1998,323,158,165
'4792034000,  춘양면,'15,10 - 14세,1998,402,208,194
'4792034000,  춘양면,'20,15 - 19세,1998,693,363,330
'4792034000,  춘양면,'25,20 - 24세,1998,678,399,279
'4792034000,  춘양면,'30,25 - 29세,1998,407,238,169
'4792034000,  춘양면,'35,30 - 34세,1998,378,195,183
'4792034000,  춘양면,'40,35 - 39세,1998,462,264,198
'4792034000,  춘양면,'45,40 - 44세,1998,465,239,226
'4792034000,  춘양면,'50,45 - 49세,1998,368,184,184
'4792034000,  춘양면,'55,50 - 54세,1998,396,186,210
'4792034000,  춘양면,'60,55 - 59세,1998,522,237,285
'4792034000,  춘양면,'65,60 - 64세,1998,562,255,307
'4792034000,  춘양면,'70,65 - 69세,1998,365,160,205
'4792034000,  춘양면,'75,70 - 74세,1998,288,128,160
'4792034000,  춘양면,'80,75 - 79세,1998,200,89,111
'4792034000,  춘양면,'85,80 - 84세,1998,88,49,39
'4792034000,  춘양면,'90,85+ ,1998,41,10,31
'4792035000,  소천면,'00,계,1998,3348,1708,1640
'4792035000,  소천면,'05,0 - 4세,1998,109,66,43
'4792035000,  소천면,'10,5 - 9세,1998,124,69,55
'4792035000,  소천면,'15,10 - 14세,1998,173,89,84
'4792035000,  소천면,'20,15 - 19세,1998,338,152,186
'4792035000,  소천면,'25,20 - 24세,1998,347,232,115
'4792035000,  소천면,'30,25 - 29세,1998,179,123,56
'4792035000,  소천면,'35,30 - 34세,1998,142,71,71
'4792035000,  소천면,'40,35 - 39세,1998,205,109,96
'4792035000,  소천면,'45,40 - 44세,1998,191,115,76
'4792035000,  소천면,'50,45 - 49세,1998,177,76,101
'4792035000,  소천면,'55,50 - 54세,1998,200,104,96
'4792035000,  소천면,'60,55 - 59세,1998,286,119,167
'4792035000,  소천면,'65,60 - 64세,1998,317,137,180
'4792035000,  소천면,'70,65 - 69세,1998,221,102,119
'4792035000,  소천면,'75,70 - 74세,1998,159,75,84
'4792035000,  소천면,'80,75 - 79세,1998,96,41,55
'4792035000,  소천면,'85,80 - 84세,1998,59,19,40
'4792035000,  소천면,'90,85+ ,1998,25,9,16
'4792036000,  재산면,'00,계,1998,2294,1176,1118
'4792036000,  재산면,'05,0 - 4세,1998,54,23,31
'4792036000,  재산면,'10,5 - 9세,1998,57,31,26
'4792036000,  재산면,'15,10 - 14세,1998,130,76,54
'4792036000,  재산면,'20,15 - 19세,1998,249,126,123
'4792036000,  재산면,'25,20 - 24세,1998,240,143,97
'4792036000,  재산면,'30,25 - 29세,1998,128,96,32
'4792036000,  재산면,'35,30 - 34세,1998,97,57,40
'4792036000,  재산면,'40,35 - 39세,1998,146,73,73
'4792036000,  재산면,'45,40 - 44세,1998,147,81,66
'4792036000,  재산면,'50,45 - 49세,1998,118,58,60
'4792036000,  재산면,'55,50 - 54세,1998,124,56,68
'4792036000,  재산면,'60,55 - 59세,1998,204,102,102
'4792036000,  재산면,'65,60 - 64세,1998,184,85,99
'4792036000,  재산면,'70,65 - 69세,1998,173,70,103
'4792036000,  재산면,'75,70 - 74세,1998,112,48,64
'4792036000,  재산면,'80,75 - 79세,1998,73,32,41
'4792036000,  재산면,'85,80 - 84세,1998,41,13,28
'4792036000,  재산면,'90,85+ ,1998,17,6,11
'4792037000,  명호면,'00,계,1998,3272,1650,1622
'4792037000,  명호면,'05,0 - 4세,1998,101,55,46
'4792037000,  명호면,'10,5 - 9세,1998,125,75,50
'4792037000,  명호면,'15,10 - 14세,1998,172,83,89
'4792037000,  명호면,'20,15 - 19세,1998,358,160,198
'4792037000,  명호면,'25,20 - 24세,1998,347,205,142
'4792037000,  명호면,'30,25 - 29세,1998,178,121,57
'4792037000,  명호면,'35,30 - 34세,1998,138,86,52
'4792037000,  명호면,'40,35 - 39세,1998,165,96,69
'4792037000,  명호면,'45,40 - 44세,1998,185,84,101
'4792037000,  명호면,'50,45 - 49세,1998,168,91,77
'4792037000,  명호면,'55,50 - 54세,1998,180,80,100
'4792037000,  명호면,'60,55 - 59세,1998,321,140,181
'4792037000,  명호면,'65,60 - 64세,1998,306,158,148
'4792037000,  명호면,'70,65 - 69세,1998,192,91,101
'4792037000,  명호면,'75,70 - 74세,1998,151,65,86
'4792037000,  명호면,'80,75 - 79세,1998,96,34,62
'4792037000,  명호면,'85,80 - 84세,1998,59,19,40
'4792037000,  명호면,'90,85+ ,1998,30,7,23
'4792038000,  상운면,'00,계,1998,2864,1425,1439
'4792038000,  상운면,'05,0 - 4세,1998,78,44,34
'4792038000,  상운면,'10,5 - 9세,1998,88,42,46
'4792038000,  상운면,'15,10 - 14세,1998,125,58,67
'4792038000,  상운면,'20,15 - 19세,1998,277,138,139
'4792038000,  상운면,'25,20 - 24세,1998,293,175,118
'4792038000,  상운면,'30,25 - 29세,1998,170,111,59
'4792038000,  상운면,'35,30 - 34세,1998,103,56,47
'4792038000,  상운면,'40,35 - 39세,1998,142,80,62
'4792038000,  상운면,'45,40 - 44세,1998,171,85,86
'4792038000,  상운면,'50,45 - 49세,1998,171,81,90
'4792038000,  상운면,'55,50 - 54세,1998,167,83,84
'4792038000,  상운면,'60,55 - 59세,1998,271,121,150
'4792038000,  상운면,'65,60 - 64세,1998,277,131,146
'4792038000,  상운면,'70,65 - 69세,1998,206,87,119
'4792038000,  상운면,'75,70 - 74세,1998,151,64,87
'4792038000,  상운면,'80,75 - 79세,1998,90,41,49
'4792038000,  상운면,'85,80 - 84세,1998,50,15,35
'4792038000,  상운면,'90,85+ ,1998,34,13,21
'4792039000,  석포면,'00,계,1998,2940,1495,1445
'4792039000,  석포면,'05,0 - 4세,1998,141,81,60
'4792039000,  석포면,'10,5 - 9세,1998,161,79,82
'4792039000,  석포면,'15,10 - 14세,1998,211,112,99
'4792039000,  석포면,'20,15 - 19세,1998,283,132,151
'4792039000,  석포면,'25,20 - 24세,1998,278,143,135
'4792039000,  석포면,'30,25 - 29세,1998,222,125,97
'4792039000,  석포면,'35,30 - 34세,1998,209,125,84
'4792039000,  석포면,'40,35 - 39세,1998,221,119,102
'4792039000,  석포면,'45,40 - 44세,1998,203,107,96
'4792039000,  석포면,'50,45 - 49세,1998,173,99,74
'4792039000,  석포면,'55,50 - 54세,1998,161,85,76
'4792039000,  석포면,'60,55 - 59세,1998,206,82,124
'4792039000,  석포면,'65,60 - 64세,1998,172,79,93
'4792039000,  석포면,'70,65 - 69세,1998,127,59,68
'4792039000,  석포면,'75,70 - 74세,1998,76,34,42
'4792039000,  석포면,'80,75 - 79세,1998,57,20,37
'4792039000,  석포면,'85,80 - 84세,1998,28,9,19
'4792039000,  석포면,'90,85+ ,1998,11,5,6
'47930, 울진군,'00,계,1998,68342,34022,34320
'47930, 울진군,'05,0 - 4세,1998,4065,2207,1858
'47930, 울진군,'10,5 - 9세,1998,4039,2143,1896
'47930, 울진군,'15,10 - 14세,1998,3907,2031,1876
'47930, 울진군,'20,15 - 19세,1998,6027,3103,2924
'47930, 울진군,'25,20 - 24세,1998,5814,3332,2482
'47930, 울진군,'30,25 - 29세,1998,5372,3044,2328
'47930, 울진군,'35,30 - 34세,1998,4871,2617,2254
'47930, 울진군,'40,35 - 39세,1998,5268,2729,2539
'47930, 울진군,'45,40 - 44세,1998,4475,2328,2147
'47930, 울진군,'50,45 - 49세,1998,3421,1767,1654
'47930, 울진군,'55,50 - 54세,1998,3366,1638,1728
'47930, 울진군,'60,55 - 59세,1998,4389,1995,2394
'47930, 울진군,'65,60 - 64세,1998,4273,1882,2391
'47930, 울진군,'70,65 - 69세,1998,3391,1368,2023
'47930, 울진군,'75,70 - 74세,1998,2448,892,1556
'47930, 울진군,'80,75 - 79세,1998,1629,550,1079
'47930, 울진군,'85,80 - 84세,1998,1013,277,736
'47930, 울진군,'90,85+ ,1998,574,119,455
'4793025000,  울진읍,'00,계,1998,14423,7184,7239
'4793025000,  울진읍,'05,0 - 4세,1998,1104,589,515
'4793025000,  울진읍,'10,5 - 9세,1998,1120,605,515
'4793025000,  울진읍,'15,10 - 14세,1998,950,510,440
'4793025000,  울진읍,'20,15 - 19세,1998,1190,612,578
'4793025000,  울진읍,'25,20 - 24세,1998,1080,580,500
'4793025000,  울진읍,'30,25 - 29세,1998,1267,666,601
'4793025000,  울진읍,'35,30 - 34세,1998,1224,627,597
'4793025000,  울진읍,'40,35 - 39세,1998,1322,699,623
'4793025000,  울진읍,'45,40 - 44세,1998,957,475,482
'4793025000,  울진읍,'50,45 - 49세,1998,710,382,328
'4793025000,  울진읍,'55,50 - 54세,1998,616,303,313
'4793025000,  울진읍,'60,55 - 59세,1998,743,343,400
'4793025000,  울진읍,'65,60 - 64세,1998,707,311,396
'4793025000,  울진읍,'70,65 - 69세,1998,482,205,277
'4793025000,  울진읍,'75,70 - 74세,1998,435,134,301
'4793025000,  울진읍,'80,75 - 79세,1998,249,89,160
'4793025000,  울진읍,'85,80 - 84세,1998,163,36,127
'4793025000,  울진읍,'90,85+ ,1998,104,18,86
'4793025300,  평해읍,'00,계,1998,4922,2456,2466
'4793025300,  평해읍,'05,0 - 4세,1998,204,114,90
'4793025300,  평해읍,'10,5 - 9세,1998,219,108,111
'4793025300,  평해읍,'15,10 - 14세,1998,241,125,116
'4793025300,  평해읍,'20,15 - 19세,1998,461,252,209
'4793025300,  평해읍,'25,20 - 24세,1998,459,288,171
'4793025300,  평해읍,'30,25 - 29세,1998,303,174,129
'4793025300,  평해읍,'35,30 - 34세,1998,217,121,96
'4793025300,  평해읍,'40,35 - 39세,1998,314,175,139
'4793025300,  평해읍,'45,40 - 44세,1998,281,127,154
'4793025300,  평해읍,'50,45 - 49세,1998,262,123,139
'4793025300,  평해읍,'55,50 - 54세,1998,311,147,164
'4793025300,  평해읍,'60,55 - 59세,1998,381,175,206
'4793025300,  평해읍,'65,60 - 64세,1998,393,189,204
'4793025300,  평해읍,'70,65 - 69세,1998,327,136,191
'4793025300,  평해읍,'75,70 - 74세,1998,246,103,143
'4793025300,  평해읍,'80,75 - 79세,1998,154,61,93
'4793025300,  평해읍,'85,80 - 84세,1998,96,28,68
'4793025300,  평해읍,'90,85+ ,1998,53,10,43
'4793031000,  북면,'00,계,1998,8938,4620,4318
'4793031000,  북면,'05,0 - 4세,1998,757,418,339
'4793031000,  북면,'10,5 - 9세,1998,702,370,332
'4793031000,  북면,'15,10 - 14세,1998,498,255,243
'4793031000,  북면,'20,15 - 19세,1998,612,295,317
'4793031000,  북면,'25,20 - 24세,1998,705,399,306
'4793031000,  북면,'30,25 - 29세,1998,897,575,322
'4793031000,  북면,'35,30 - 34세,1998,899,479,420
'4793031000,  북면,'40,35 - 39세,1998,744,414,330
'4793031000,  북면,'45,40 - 44세,1998,562,316,246
'4793031000,  북면,'50,45 - 49세,1998,336,180,156
'4793031000,  북면,'55,50 - 54세,1998,372,191,181
'4793031000,  북면,'60,55 - 59세,1998,457,214,243
'4793031000,  북면,'65,60 - 64세,1998,457,186,271
'4793031000,  북면,'70,65 - 69세,1998,310,129,181
'4793031000,  북면,'75,70 - 74세,1998,247,82,165
'4793031000,  북면,'80,75 - 79세,1998,188,67,121
'4793031000,  북면,'85,80 - 84세,1998,126,34,92
'4793031000,  북면,'90,85+ ,1998,69,16,53
'4793032000,  서면,'00,계,1998,2706,1291,1415
'4793032000,  서면,'05,0 - 4세,1998,58,32,26
'4793032000,  서면,'10,5 - 9세,1998,67,28,39
'4793032000,  서면,'15,10 - 14세,1998,151,74,77
'4793032000,  서면,'20,15 - 19세,1998,233,128,105
'4793032000,  서면,'25,20 - 24세,1998,214,121,93
'4793032000,  서면,'30,25 - 29세,1998,213,100,113
'4793032000,  서면,'35,30 - 34세,1998,221,111,110
'4793032000,  서면,'40,35 - 39세,1998,257,124,133
'4793032000,  서면,'45,40 - 44세,1998,205,104,101
'4793032000,  서면,'50,45 - 49세,1998,145,72,73
'4793032000,  서면,'55,50 - 54세,1998,149,72,77
'4793032000,  서면,'60,55 - 59세,1998,188,77,111
'4793032000,  서면,'65,60 - 64세,1998,210,99,111
'4793032000,  서면,'70,65 - 69세,1998,168,69,99
'4793032000,  서면,'75,70 - 74세,1998,104,39,65
'4793032000,  서면,'80,75 - 79세,1998,70,25,45
'4793032000,  서면,'85,80 - 84세,1998,32,10,22
'4793032000,  서면,'90,85+ ,1998,21,6,15
'4793033000,  근남면,'00,계,1998,4361,2096,2265
'4793033000,  근남면,'05,0 - 4세,1998,228,119,109
'4793033000,  근남면,'10,5 - 9세,1998,194,114,80
'4793033000,  근남면,'15,10 - 14세,1998,224,108,116
'4793033000,  근남면,'20,15 - 19세,1998,325,166,159
'4793033000,  근남면,'25,20 - 24세,1998,362,205,157
'4793033000,  근남면,'30,25 - 29세,1998,301,177,124
'4793033000,  근남면,'35,30 - 34세,1998,247,146,101
'4793033000,  근남면,'40,35 - 39세,1998,275,146,129
'4793033000,  근남면,'45,40 - 44세,1998,258,150,108
'4793033000,  근남면,'50,45 - 49세,1998,176,88,88
'4793033000,  근남면,'55,50 - 54세,1998,213,94,119
'4793033000,  근남면,'60,55 - 59세,1998,335,133,202
'4793033000,  근남면,'65,60 - 64세,1998,373,173,200
'4793033000,  근남면,'70,65 - 69세,1998,314,120,194
'4793033000,  근남면,'75,70 - 74세,1998,239,84,155
'4793033000,  근남면,'80,75 - 79세,1998,139,43,96
'4793033000,  근남면,'85,80 - 84세,1998,101,23,78
'4793033000,  근남면,'90,85+ ,1998,57,7,50
'4793034000,  원남면,'00,계,1998,3754,1822,1932
'4793034000,  원남면,'05,0 - 4세,1998,115,62,53
'4793034000,  원남면,'10,5 - 9세,1998,123,74,49
'4793034000,  원남면,'15,10 - 14세,1998,154,84,70
'4793034000,  원남면,'20,15 - 19세,1998,347,185,162
'4793034000,  원남면,'25,20 - 24세,1998,350,213,137
'4793034000,  원남면,'30,25 - 29세,1998,223,141,82
'4793034000,  원남면,'35,30 - 34세,1998,160,98,62
'4793034000,  원남면,'40,35 - 39세,1998,184,101,83
'4793034000,  원남면,'45,40 - 44세,1998,195,101,94
'4793034000,  원남면,'50,45 - 49세,1998,166,83,83
'4793034000,  원남면,'55,50 - 54세,1998,199,93,106
'4793034000,  원남면,'60,55 - 59세,1998,331,134,197
'4793034000,  원남면,'65,60 - 64세,1998,358,160,198
'4793034000,  원남면,'70,65 - 69세,1998,313,118,195
'4793034000,  원남면,'75,70 - 74세,1998,225,84,141
'4793034000,  원남면,'80,75 - 79세,1998,172,58,114
'4793034000,  원남면,'85,80 - 84세,1998,91,25,66
'4793034000,  원남면,'90,85+ ,1998,48,8,40
'4793035000,  기성면,'00,계,1998,4492,2115,2377
'4793035000,  기성면,'05,0 - 4세,1998,127,78,49
'4793035000,  기성면,'10,5 - 9세,1998,155,72,83
'4793035000,  기성면,'15,10 - 14세,1998,201,103,98
'4793035000,  기성면,'20,15 - 19세,1998,465,230,235
'4793035000,  기성면,'25,20 - 24세,1998,368,227,141
'4793035000,  기성면,'30,25 - 29세,1998,233,147,86
'4793035000,  기성면,'35,30 - 34세,1998,161,89,72
'4793035000,  기성면,'40,35 - 39세,1998,257,120,137
'4793035000,  기성면,'45,40 - 44세,1998,248,124,124
'4793035000,  기성면,'50,45 - 49세,1998,245,137,108
'4793035000,  기성면,'55,50 - 54세,1998,203,91,112
'4793035000,  기성면,'60,55 - 59세,1998,382,171,211
'4793035000,  기성면,'65,60 - 64세,1998,422,185,237
'4793035000,  기성면,'70,65 - 69세,1998,379,143,236
'4793035000,  기성면,'75,70 - 74세,1998,248,88,160
'4793035000,  기성면,'80,75 - 79세,1998,185,53,132
'4793035000,  기성면,'85,80 - 84세,1998,118,32,86
'4793035000,  기성면,'90,85+ ,1998,95,25,70
'4793036000,  온정면,'00,계,1998,3425,1691,1734
'4793036000,  온정면,'05,0 - 4세,1998,148,83,65
'4793036000,  온정면,'10,5 - 9세,1998,122,63,59
'4793036000,  온정면,'15,10 - 14세,1998,170,89,81
'4793036000,  온정면,'20,15 - 19세,1998,308,168,140
'4793036000,  온정면,'25,20 - 24세,1998,335,192,143
'4793036000,  온정면,'30,25 - 29세,1998,202,114,88
'4793036000,  온정면,'35,30 - 34세,1998,174,105,69
'4793036000,  온정면,'40,35 - 39세,1998,184,88,96
'4793036000,  온정면,'45,40 - 44세,1998,185,94,91
'4793036000,  온정면,'50,45 - 49세,1998,170,98,72
'4793036000,  온정면,'55,50 - 54세,1998,191,87,104
'4793036000,  온정면,'60,55 - 59세,1998,269,121,148
'4793036000,  온정면,'65,60 - 64세,1998,272,110,162
'4793036000,  온정면,'70,65 - 69세,1998,270,120,150
'4793036000,  온정면,'75,70 - 74세,1998,176,73,103
'4793036000,  온정면,'80,75 - 79세,1998,132,51,81
'4793036000,  온정면,'85,80 - 84세,1998,81,26,55
'4793036000,  온정면,'90,85+ ,1998,36,9,27
'4793037000,  죽변면,'00,계,1998,9597,4840,4757
'4793037000,  죽변면,'05,0 - 4세,1998,743,393,350
'4793037000,  죽변면,'10,5 - 9세,1998,601,301,300
'4793037000,  죽변면,'15,10 - 14세,1998,530,265,265
'4793037000,  죽변면,'20,15 - 19세,1998,793,415,378
'4793037000,  죽변면,'25,20 - 24세,1998,853,460,393
'4793037000,  죽변면,'30,25 - 29세,1998,983,554,429
'4793037000,  죽변면,'35,30 - 34세,1998,796,429,367
'4793037000,  죽변면,'40,35 - 39세,1998,751,401,350
'4793037000,  죽변면,'45,40 - 44세,1998,632,343,289
'4793037000,  죽변면,'50,45 - 49세,1998,454,230,224
'4793037000,  죽변면,'55,50 - 54세,1998,457,226,231
'4793037000,  죽변면,'60,55 - 59세,1998,571,266,305
'4793037000,  죽변면,'65,60 - 64세,1998,513,217,296
'4793037000,  죽변면,'70,65 - 69세,1998,385,155,230
'4793037000,  죽변면,'75,70 - 74세,1998,230,89,141
'4793037000,  죽변면,'80,75 - 79세,1998,158,52,106
'4793037000,  죽변면,'85,80 - 84세,1998,94,32,62
'4793037000,  죽변면,'90,85+ ,1998,53,12,41
'4793038000,  후포면,'00,계,1998,11724,5907,5817
'4793038000,  후포면,'05,0 - 4세,1998,581,319,262
'4793038000,  후포면,'10,5 - 9세,1998,736,408,328
'4793038000,  후포면,'15,10 - 14세,1998,788,418,370
'4793038000,  후포면,'20,15 - 19세,1998,1293,652,641
'4793038000,  후포면,'25,20 - 24세,1998,1088,647,441
'4793038000,  후포면,'30,25 - 29세,1998,750,396,354
'4793038000,  후포면,'35,30 - 34세,1998,772,412,360
'4793038000,  후포면,'40,35 - 39세,1998,980,461,519
'4793038000,  후포면,'45,40 - 44세,1998,952,494,458
'4793038000,  후포면,'50,45 - 49세,1998,757,374,383
'4793038000,  후포면,'55,50 - 54세,1998,655,334,321
'4793038000,  후포면,'60,55 - 59세,1998,732,361,371
'4793038000,  후포면,'65,60 - 64세,1998,568,252,316
'4793038000,  후포면,'70,65 - 69세,1998,443,173,270
'4793038000,  후포면,'75,70 - 74세,1998,298,116,182
'4793038000,  후포면,'80,75 - 79세,1998,182,51,131
'4793038000,  후포면,'85,80 - 84세,1998,111,31,80
'4793038000,  후포면,'90,85+ ,1998,38,8,30
'47940, 울릉군,'00,계,1998,10724,5541,5183
'47940, 울릉군,'05,0 - 4세,1998,573,311,262
'47940, 울릉군,'10,5 - 9세,1998,715,383,332
'47940, 울릉군,'15,10 - 14세,1998,626,326,300
'47940, 울릉군,'20,15 - 19세,1998,792,412,380
'47940, 울릉군,'25,20 - 24세,1998,736,446,290
'47940, 울릉군,'30,25 - 29세,1998,800,459,341
'47940, 울릉군,'35,30 - 34세,1998,746,393,353
'47940, 울릉군,'40,35 - 39세,1998,899,449,450
'47940, 울릉군,'45,40 - 44세,1998,805,425,380
'47940, 울릉군,'50,45 - 49세,1998,699,366,333
'47940, 울릉군,'55,50 - 54세,1998,720,361,359
'47940, 울릉군,'60,55 - 59세,1998,735,370,365
'47940, 울릉군,'65,60 - 64세,1998,636,304,332
'47940, 울릉군,'70,65 - 69세,1998,526,238,288
'47940, 울릉군,'75,70 - 74세,1998,350,161,189
'47940, 울릉군,'80,75 - 79세,1998,203,85,118
'47940, 울릉군,'85,80 - 84세,1998,103,34,69
'47940, 울릉군,'90,85+ ,1998,60,18,42
'4794025000,  울릉읍,'00,계,1998,7604,3942,3662
'4794025000,  울릉읍,'05,0 - 4세,1998,442,236,206
'4794025000,  울릉읍,'10,5 - 9세,1998,563,313,250
'4794025000,  울릉읍,'15,10 - 14세,1998,446,229,217
'4794025000,  울릉읍,'20,15 - 19세,1998,588,299,289
'4794025000,  울릉읍,'25,20 - 24세,1998,526,308,218
'4794025000,  울릉읍,'30,25 - 29세,1998,608,340,268
'4794025000,  울릉읍,'35,30 - 34세,1998,569,303,266
'4794025000,  울릉읍,'40,35 - 39세,1998,673,333,340
'4794025000,  울릉읍,'45,40 - 44세,1998,618,318,300
'4794025000,  울릉읍,'50,45 - 49세,1998,514,274,240
'4794025000,  울릉읍,'55,50 - 54세,1998,498,256,242
'4794025000,  울릉읍,'60,55 - 59세,1998,472,251,221
'4794025000,  울릉읍,'65,60 - 64세,1998,377,178,199
'4794025000,  울릉읍,'70,65 - 69세,1998,301,135,166
'4794025000,  울릉읍,'75,70 - 74세,1998,204,93,111
'4794025000,  울릉읍,'80,75 - 79세,1998,123,51,72
'4794025000,  울릉읍,'85,80 - 84세,1998,55,17,38
'4794025000,  울릉읍,'90,85+ ,1998,27,8,19
'4794031000,  서면,'00,계,1998,1697,879,818
'4794031000,  서면,'05,0 - 4세,1998,76,39,37
'4794031000,  서면,'10,5 - 9세,1998,93,41,52
'4794031000,  서면,'15,10 - 14세,1998,99,52,47
'4794031000,  서면,'20,15 - 19세,1998,116,68,48
'4794031000,  서면,'25,20 - 24세,1998,117,85,32
'4794031000,  서면,'30,25 - 29세,1998,101,62,39
'4794031000,  서면,'35,30 - 34세,1998,107,57,50
'4794031000,  서면,'40,35 - 39세,1998,124,63,61
'4794031000,  서면,'45,40 - 44세,1998,100,52,48
'4794031000,  서면,'50,45 - 49세,1998,111,59,52
'4794031000,  서면,'55,50 - 54세,1998,123,56,67
'4794031000,  서면,'60,55 - 59세,1998,141,67,74
'4794031000,  서면,'65,60 - 64세,1998,128,63,65
'4794031000,  서면,'70,65 - 69세,1998,117,53,64
'4794031000,  서면,'75,70 - 74세,1998,68,36,32
'4794031000,  서면,'80,75 - 79세,1998,42,18,24
'4794031000,  서면,'85,80 - 84세,1998,17,6,11
'4794031000,  서면,'90,85+ ,1998,17,2,15
'4794032000,  북면,'00,계,1998,1423,720,703
'4794032000,  북면,'05,0 - 4세,1998,55,36,19
'4794032000,  북면,'10,5 - 9세,1998,59,29,30
'4794032000,  북면,'15,10 - 14세,1998,81,45,36
'4794032000,  북면,'20,15 - 19세,1998,88,45,43
'4794032000,  북면,'25,20 - 24세,1998,93,53,40
'4794032000,  북면,'30,25 - 29세,1998,91,57,34
'4794032000,  북면,'35,30 - 34세,1998,70,33,37
'4794032000,  북면,'40,35 - 39세,1998,102,53,49
'4794032000,  북면,'45,40 - 44세,1998,87,55,32
'4794032000,  북면,'50,45 - 49세,1998,74,33,41
'4794032000,  북면,'55,50 - 54세,1998,99,49,50
'4794032000,  북면,'60,55 - 59세,1998,122,52,70
'4794032000,  북면,'65,60 - 64세,1998,131,63,68
'4794032000,  북면,'70,65 - 69세,1998,108,50,58
'4794032000,  북면,'75,70 - 74세,1998,78,32,46
'4794032000,  북면,'80,75 - 79세,1998,38,16,22
'4794032000,  북면,'85,80 - 84세,1998,31,11,20
'4794032000,  북면,'90,85+ ,1998,16,8,8
'48,경상남도,'00,계,1998,3069755,1536028,1533727
'48,경상남도,'05,0 - 4세,1998,226273,121327,104946
'48,경상남도,'10,5 - 9세,1998,228528,123205,105323
'48,경상남도,'15,10 - 14세,1998,211025,110102,100923
'48,경상남도,'20,15 - 19세,1998,267885,136723,131162
'48,경상남도,'25,20 - 24세,1998,249076,130457,118619
'48,경상남도,'30,25 - 29세,1998,285556,147325,138231
'48,경상남도,'35,30 - 34세,1998,276652,140620,136032
'48,경상남도,'40,35 - 39세,1998,289479,150190,139289
'48,경상남도,'45,40 - 44세,1998,235064,123161,111903
'48,경상남도,'50,45 - 49세,1998,164024,84451,79573
'48,경상남도,'55,50 - 54세,1998,131276,65261,66015
'48,경상남도,'60,55 - 59세,1998,139936,63841,76095
'48,경상남도,'65,60 - 64세,1998,124390,53667,70723
'48,경상남도,'70,65 - 69세,1998,96959,37303,59656
'48,경상남도,'75,70 - 74세,1998,68052,25096,42956
'48,경상남도,'80,75 - 79세,1998,42946,14765,28181
'48,경상남도,'85,80 - 84세,1998,20434,5986,14448
'48,경상남도,'90,85+ ,1998,12200,2548,9652
'48110, 창원시,'00,계,1998,503938,257045,246893
'48110, 창원시,'05,0 - 4세,1998,50509,27013,23496
'48110, 창원시,'10,5 - 9세,1998,50912,27618,23294
'48110, 창원시,'15,10 - 14세,1998,40594,21434,19160
'48110, 창원시,'20,15 - 19세,1998,39507,20181,19326
'48110, 창원시,'25,20 - 24세,1998,31646,15518,16128
'48110, 창원시,'30,25 - 29세,1998,52869,25092,27777
'48110, 창원시,'35,30 - 34세,1998,60183,29557,30626
'48110, 창원시,'40,35 - 39세,1998,60266,31783,28483
'48110, 창원시,'45,40 - 44세,1998,42101,22863,19238
'48110, 창원시,'50,45 - 49세,1998,23592,13280,10312
'48110, 창원시,'55,50 - 54세,1998,14126,7884,6242
'48110, 창원시,'60,55 - 59세,1998,11295,5570,5725
'48110, 창원시,'65,60 - 64세,1998,9055,3846,5209
'48110, 창원시,'70,65 - 69세,1998,7000,2447,4553
'48110, 창원시,'75,70 - 74세,1998,4912,1531,3381
'48110, 창원시,'80,75 - 79세,1998,3142,921,2221
'48110, 창원시,'85,80 - 84세,1998,1405,352,1053
'48110, 창원시,'90,85+ ,1998,824,155,669
'4811025000,  동읍,'00,계,1998,23024,11682,11342
'4811025000,  동읍,'05,0 - 4세,1998,2338,1255,1083
'4811025000,  동읍,'10,5 - 9세,1998,2085,1111,974
'4811025000,  동읍,'15,10 - 14세,1998,1345,692,653
'4811025000,  동읍,'20,15 - 19세,1998,1515,764,751
'4811025000,  동읍,'25,20 - 24세,1998,1528,853,675
'4811025000,  동읍,'30,25 - 29세,1998,2291,1086,1205
'4811025000,  동읍,'35,30 - 34세,1998,2718,1394,1324
'4811025000,  동읍,'40,35 - 39세,1998,2226,1299,927
'4811025000,  동읍,'45,40 - 44세,1998,1612,920,692
'4811025000,  동읍,'50,45 - 49세,1998,1076,551,525
'4811025000,  동읍,'55,50 - 54세,1998,867,451,416
'4811025000,  동읍,'60,55 - 59세,1998,978,458,520
'4811025000,  동읍,'65,60 - 64세,1998,841,342,499
'4811025000,  동읍,'70,65 - 69세,1998,673,224,449
'4811025000,  동읍,'75,70 - 74세,1998,434,145,289
'4811025000,  동읍,'80,75 - 79세,1998,264,80,184
'4811025000,  동읍,'85,80 - 84세,1998,145,44,101
'4811025000,  동읍,'90,85+ ,1998,88,13,75
'4811032000,  북면,'00,계,1998,12754,6427,6327
'4811032000,  북면,'05,0 - 4세,1998,872,460,412
'4811032000,  북면,'10,5 - 9세,1998,844,438,406
'4811032000,  북면,'15,10 - 14세,1998,701,362,339
'4811032000,  북면,'20,15 - 19세,1998,1038,536,502
'4811032000,  북면,'25,20 - 24세,1998,1061,578,483
'4811032000,  북면,'30,25 - 29세,1998,1064,583,481
'4811032000,  북면,'35,30 - 34세,1998,1057,551,506
'4811032000,  북면,'40,35 - 39세,1998,1121,641,480
'4811032000,  북면,'45,40 - 44세,1998,946,498,448
'4811032000,  북면,'50,45 - 49세,1998,706,365,341
'4811032000,  북면,'55,50 - 54세,1998,589,307,282
'4811032000,  북면,'60,55 - 59세,1998,709,350,359
'4811032000,  북면,'65,60 - 64세,1998,692,290,402
'4811032000,  북면,'70,65 - 69세,1998,533,196,337
'4811032000,  북면,'75,70 - 74세,1998,381,150,231
'4811032000,  북면,'80,75 - 79세,1998,272,83,189
'4811032000,  북면,'85,80 - 84세,1998,102,24,78
'4811032000,  북면,'90,85+ ,1998,66,15,51
'4811033000,  대산면,'00,계,1998,10464,5189,5275
'4811033000,  대산면,'05,0 - 4세,1998,553,305,248
'4811033000,  대산면,'10,5 - 9세,1998,595,317,278
'4811033000,  대산면,'15,10 - 14세,1998,691,369,322
'4811033000,  대산면,'20,15 - 19세,1998,959,476,483
'4811033000,  대산면,'25,20 - 24세,1998,942,492,450
'4811033000,  대산면,'30,25 - 29세,1998,840,512,328
'4811033000,  대산면,'35,30 - 34세,1998,692,348,344
'4811033000,  대산면,'40,35 - 39세,1998,791,429,362
'4811033000,  대산면,'45,40 - 44세,1998,777,422,355
'4811033000,  대산면,'50,45 - 49세,1998,630,299,331
'4811033000,  대산면,'55,50 - 54세,1998,560,279,281
'4811033000,  대산면,'60,55 - 59세,1998,583,265,318
'4811033000,  대산면,'65,60 - 64세,1998,631,243,388
'4811033000,  대산면,'70,65 - 69세,1998,523,190,333
'4811033000,  대산면,'75,70 - 74세,1998,341,123,218
'4811033000,  대산면,'80,75 - 79세,1998,230,87,143
'4811033000,  대산면,'85,80 - 84세,1998,67,23,44
'4811033000,  대산면,'90,85+ ,1998,59,10,49
'4811052500,  의창동,'00,계,1998,40803,20685,20118
'4811052500,  의창동,'05,0 - 4세,1998,3207,1690,1517
'4811052500,  의창동,'10,5 - 9세,1998,3411,1883,1528
'4811052500,  의창동,'15,10 - 14세,1998,3081,1666,1415
'4811052500,  의창동,'20,15 - 19세,1998,4011,2063,1948
'4811052500,  의창동,'25,20 - 24세,1998,3246,1635,1611
'4811052500,  의창동,'30,25 - 29세,1998,3814,1865,1949
'4811052500,  의창동,'35,30 - 34세,1998,4170,2073,2097
'4811052500,  의창동,'40,35 - 39세,1998,4384,2252,2132
'4811052500,  의창동,'45,40 - 44세,1998,3578,1781,1797
'4811052500,  의창동,'50,45 - 49세,1998,2420,1327,1093
'4811052500,  의창동,'55,50 - 54세,1998,1592,845,747
'4811052500,  의창동,'60,55 - 59세,1998,1314,642,672
'4811052500,  의창동,'65,60 - 64세,1998,980,467,513
'4811052500,  의창동,'70,65 - 69세,1998,692,253,439
'4811052500,  의창동,'75,70 - 74세,1998,423,137,286
'4811052500,  의창동,'80,75 - 79세,1998,275,68,207
'4811052500,  의창동,'85,80 - 84세,1998,128,25,103
'4811052500,  의창동,'90,85+ ,1998,77,13,64
'4811054000,  팔룡동,'00,계,1998,32655,16822,15833
'4811054000,  팔룡동,'05,0 - 4세,1998,3412,1812,1600
'4811054000,  팔룡동,'10,5 - 9세,1998,3406,1869,1537
'4811054000,  팔룡동,'15,10 - 14세,1998,2660,1430,1230
'4811054000,  팔룡동,'20,15 - 19세,1998,2482,1288,1194
'4811054000,  팔룡동,'25,20 - 24세,1998,1877,946,931
'4811054000,  팔룡동,'30,25 - 29세,1998,3460,1589,1871
'4811054000,  팔룡동,'35,30 - 34세,1998,4144,2033,2111
'4811054000,  팔룡동,'40,35 - 39세,1998,4029,2148,1881
'4811054000,  팔룡동,'45,40 - 44세,1998,2728,1527,1201
'4811054000,  팔룡동,'50,45 - 49세,1998,1474,864,610
'4811054000,  팔룡동,'55,50 - 54세,1998,836,460,376
'4811054000,  팔룡동,'60,55 - 59세,1998,658,320,338
'4811054000,  팔룡동,'65,60 - 64세,1998,493,224,269
'4811054000,  팔룡동,'70,65 - 69세,1998,390,128,262
'4811054000,  팔룡동,'75,70 - 74세,1998,282,94,188
'4811054000,  팔룡동,'80,75 - 79세,1998,193,61,132
'4811054000,  팔룡동,'85,80 - 84세,1998,97,26,71
'4811054000,  팔룡동,'90,85+ ,1998,34,3,31
'4811054500,  명곡동,'00,계,1998,61885,31438,30447
'4811054500,  명곡동,'05,0 - 4세,1998,7288,3886,3402
'4811054500,  명곡동,'10,5 - 9세,1998,6270,3394,2876
'4811054500,  명곡동,'15,10 - 14세,1998,4414,2290,2124
'4811054500,  명곡동,'20,15 - 19세,1998,4457,2204,2253
'4811054500,  명곡동,'25,20 - 24세,1998,4047,1956,2091
'4811054500,  명곡동,'30,25 - 29세,1998,7624,3455,4169
'4811054500,  명곡동,'35,30 - 34세,1998,8155,4165,3990
'4811054500,  명곡동,'40,35 - 39세,1998,6962,3737,3225
'4811054500,  명곡동,'45,40 - 44세,1998,4616,2449,2167
'4811054500,  명곡동,'50,45 - 49세,1998,2685,1473,1212
'4811054500,  명곡동,'55,50 - 54세,1998,1682,912,770
'4811054500,  명곡동,'60,55 - 59세,1998,1278,627,651
'4811054500,  명곡동,'65,60 - 64세,1998,965,431,534
'4811054500,  명곡동,'70,65 - 69세,1998,585,235,350
'4811054500,  명곡동,'75,70 - 74세,1998,404,115,289
'4811054500,  명곡동,'80,75 - 79세,1998,252,70,182
'4811054500,  명곡동,'85,80 - 84세,1998,126,24,102
'4811054500,  명곡동,'90,85+ ,1998,75,15,60
'4811055700,  봉림동,'00,계,1998,34559,17681,16878
'4811055700,  봉림동,'05,0 - 4세,1998,3906,2040,1866
'4811055700,  봉림동,'10,5 - 9세,1998,3013,1685,1328
'4811055700,  봉림동,'15,10 - 14세,1998,2103,1083,1020
'4811055700,  봉림동,'20,15 - 19세,1998,2436,1233,1203
'4811055700,  봉림동,'25,20 - 24세,1998,2574,1218,1356
'4811055700,  봉림동,'30,25 - 29세,1998,4908,2344,2564
'4811055700,  봉림동,'35,30 - 34세,1998,4520,2469,2051
'4811055700,  봉림동,'40,35 - 39세,1998,3436,1868,1568
'4811055700,  봉림동,'45,40 - 44세,1998,2381,1262,1119
'4811055700,  봉림동,'50,45 - 49세,1998,1487,817,670
'4811055700,  봉림동,'55,50 - 54세,1998,1011,539,472
'4811055700,  봉림동,'60,55 - 59세,1998,836,400,436
'4811055700,  봉림동,'65,60 - 64세,1998,681,310,371
'4811055700,  봉림동,'70,65 - 69세,1998,528,199,329
'4811055700,  봉림동,'75,70 - 74세,1998,350,114,236
'4811055700,  봉림동,'80,75 - 79세,1998,220,63,157
'4811055700,  봉림동,'85,80 - 84세,1998,109,25,84
'4811055700,  봉림동,'90,85+ ,1998,60,12,48
'4811057500,  반송동,'00,계,1998,48988,24763,24225
'4811057500,  반송동,'05,0 - 4세,1998,4602,2494,2108
'4811057500,  반송동,'10,5 - 9세,1998,4642,2516,2126
'4811057500,  반송동,'15,10 - 14세,1998,4459,2396,2063
'4811057500,  반송동,'20,15 - 19세,1998,4267,2201,2066
'4811057500,  반송동,'25,20 - 24세,1998,3279,1532,1747
'4811057500,  반송동,'30,25 - 29세,1998,5172,2424,2748
'4811057500,  반송동,'35,30 - 34세,1998,5265,2558,2707
'4811057500,  반송동,'40,35 - 39세,1998,5883,2869,3014
'4811057500,  반송동,'45,40 - 44세,1998,4652,2459,2193
'4811057500,  반송동,'50,45 - 49세,1998,2535,1448,1087
'4811057500,  반송동,'55,50 - 54세,1998,1314,763,551
'4811057500,  반송동,'60,55 - 59세,1998,905,462,443
'4811057500,  반송동,'65,60 - 64세,1998,658,264,394
'4811057500,  반송동,'70,65 - 69세,1998,537,159,378
'4811057500,  반송동,'75,70 - 74세,1998,400,110,290
'4811057500,  반송동,'80,75 - 79세,1998,262,71,191
'4811057500,  반송동,'85,80 - 84세,1998,91,21,70
'4811057500,  반송동,'90,85+ ,1998,65,16,49
'4811060500,  용지동,'00,계,1998,40749,20608,20141
'4811060500,  용지동,'05,0 - 4세,1998,4200,2245,1955
'4811060500,  용지동,'10,5 - 9세,1998,3695,2004,1691
'4811060500,  용지동,'15,10 - 14세,1998,3179,1713,1466
'4811060500,  용지동,'20,15 - 19세,1998,3512,1808,1704
'4811060500,  용지동,'25,20 - 24세,1998,2626,1229,1397
'4811060500,  용지동,'30,25 - 29세,1998,4320,1947,2373
'4811060500,  용지동,'35,30 - 34세,1998,4814,2409,2405
'4811060500,  용지동,'40,35 - 39세,1998,4558,2326,2232
'4811060500,  용지동,'45,40 - 44세,1998,3639,1861,1778
'4811060500,  용지동,'50,45 - 49세,1998,2105,1184,921
'4811060500,  용지동,'55,50 - 54세,1998,1262,741,521
'4811060500,  용지동,'60,55 - 59세,1998,905,475,430
'4811060500,  용지동,'65,60 - 64세,1998,660,269,391
'4811060500,  용지동,'70,65 - 69세,1998,497,180,317
'4811060500,  용지동,'75,70 - 74세,1998,387,113,274
'4811060500,  용지동,'80,75 - 79세,1998,220,65,155
'4811060500,  용지동,'85,80 - 84세,1998,104,27,77
'4811060500,  용지동,'90,85+ ,1998,66,12,54
'4811061600,  사파동,'00,계,1998,56614,28686,27928
'4811061600,  사파동,'05,0 - 4세,1998,5549,2996,2553
'4811061600,  사파동,'10,5 - 9세,1998,6782,3717,3065
'4811061600,  사파동,'15,10 - 14세,1998,5870,3136,2734
'4811061600,  사파동,'20,15 - 19세,1998,4397,2263,2134
'4811061600,  사파동,'25,20 - 24세,1998,2751,1301,1450
'4811061600,  사파동,'30,25 - 29세,1998,4725,1944,2781
'4811061600,  사파동,'35,30 - 34세,1998,6877,3119,3758
'4811061600,  사파동,'40,35 - 39세,1998,8452,4311,4141
'4811061600,  사파동,'45,40 - 44세,1998,4984,2902,2082
'4811061600,  사파동,'50,45 - 49세,1998,2304,1331,973
'4811061600,  사파동,'55,50 - 54세,1998,1133,660,473
'4811061600,  사파동,'60,55 - 59세,1998,756,368,388
'4811061600,  사파동,'65,60 - 64세,1998,633,227,406
'4811061600,  사파동,'70,65 - 69세,1998,583,207,376
'4811061600,  사파동,'75,70 - 74세,1998,392,107,285
'4811061600,  사파동,'80,75 - 79세,1998,238,60,178
'4811061600,  사파동,'85,80 - 84세,1998,116,28,88
'4811061600,  사파동,'90,85+ ,1998,72,9,63
'4811061800,  상남동,'00,계,1998,36130,18176,17954
'4811061800,  상남동,'05,0 - 4세,1998,3190,1744,1446
'4811061800,  상남동,'10,5 - 9세,1998,5091,2728,2363
'4811061800,  상남동,'15,10 - 14세,1998,3775,1973,1802
'4811061800,  상남동,'20,15 - 19세,1998,2839,1465,1374
'4811061800,  상남동,'25,20 - 24세,1998,1317,637,680
'4811061800,  상남동,'30,25 - 29세,1998,2128,818,1310
'4811061800,  상남동,'35,30 - 34세,1998,4161,1559,2602
'4811061800,  상남동,'40,35 - 39세,1998,5935,3112,2823
'4811061800,  상남동,'45,40 - 44세,1998,3639,2028,1611
'4811061800,  상남동,'50,45 - 49세,1998,1635,1039,596
'4811061800,  상남동,'55,50 - 54세,1998,703,434,269
'4811061800,  상남동,'60,55 - 59세,1998,491,250,241
'4811061800,  상남동,'65,60 - 64세,1998,360,158,202
'4811061800,  상남동,'70,65 - 69세,1998,322,98,224
'4811061800,  상남동,'75,70 - 74세,1998,262,60,202
'4811061800,  상남동,'80,75 - 79세,1998,180,49,131
'4811061800,  상남동,'85,80 - 84세,1998,65,13,52
'4811061800,  상남동,'90,85+ ,1998,37,11,26
'4811062000,  중앙동,'00,계,1998,26028,13459,12569
'4811062000,  중앙동,'05,0 - 4세,1998,2815,1491,1324
'4811062000,  중앙동,'10,5 - 9세,1998,2418,1266,1152
'4811062000,  중앙동,'15,10 - 14세,1998,1743,919,824
'4811062000,  중앙동,'20,15 - 19세,1998,1917,999,918
'4811062000,  중앙동,'25,20 - 24세,1998,1742,904,838
'4811062000,  중앙동,'30,25 - 29세,1998,3370,1707,1663
'4811062000,  중앙동,'35,30 - 34세,1998,3353,1716,1637
'4811062000,  중앙동,'40,35 - 39세,1998,2879,1599,1280
'4811062000,  중앙동,'45,40 - 44세,1998,1948,1012,936
'4811062000,  중앙동,'50,45 - 49세,1998,1261,648,613
'4811062000,  중앙동,'55,50 - 54세,1998,805,447,358
'4811062000,  중앙동,'60,55 - 59세,1998,594,301,293
'4811062000,  중앙동,'65,60 - 64세,1998,411,192,219
'4811062000,  중앙동,'70,65 - 69세,1998,309,114,195
'4811062000,  중앙동,'75,70 - 74세,1998,228,75,153
'4811062000,  중앙동,'80,75 - 79세,1998,131,43,88
'4811062000,  중앙동,'85,80 - 84세,1998,69,21,48
'4811062000,  중앙동,'90,85+ ,1998,35,5,30
'4811063000,  가음정동,'00,계,1998,55237,28305,26932
'4811063000,  가음정동,'05,0 - 4세,1998,6082,3291,2791
'4811063000,  가음정동,'10,5 - 9세,1998,6709,3633,3076
'4811063000,  가음정동,'15,10 - 14세,1998,4924,2549,2375
'4811063000,  가음정동,'20,15 - 19세,1998,3971,1982,1989
'4811063000,  가음정동,'25,20 - 24세,1998,2963,1266,1697
'4811063000,  가음정동,'30,25 - 29세,1998,5488,2563,2925
'4811063000,  가음정동,'35,30 - 34세,1998,7358,3513,3845
'4811063000,  가음정동,'40,35 - 39세,1998,7275,3928,3347
'4811063000,  가음정동,'45,40 - 44세,1998,4738,2696,2042
'4811063000,  가음정동,'50,45 - 49세,1998,2215,1344,871
'4811063000,  가음정동,'55,50 - 54세,1998,1039,635,404
'4811063000,  가음정동,'60,55 - 59세,1998,702,361,341
'4811063000,  가음정동,'65,60 - 64세,1998,550,217,333
'4811063000,  가음정동,'70,65 - 69세,1998,460,124,336
'4811063000,  가음정동,'75,70 - 74세,1998,357,99,258
'4811063000,  가음정동,'80,75 - 79세,1998,241,66,175
'4811063000,  가음정동,'85,80 - 84세,1998,109,28,81
'4811063000,  가음정동,'90,85+ ,1998,56,10,46
'4811065000,  성주동,'00,계,1998,10782,5907,4875
'4811065000,  성주동,'05,0 - 4세,1998,1480,745,735
'4811065000,  성주동,'10,5 - 9세,1998,945,517,428
'4811065000,  성주동,'15,10 - 14세,1998,640,323,317
'4811065000,  성주동,'20,15 - 19세,1998,599,307,292
'4811065000,  성주동,'25,20 - 24세,1998,623,348,275
'4811065000,  성주동,'30,25 - 29세,1998,1884,1109,775
'4811065000,  성주동,'35,30 - 34세,1998,1611,939,672
'4811065000,  성주동,'40,35 - 39세,1998,1005,587,418
'4811065000,  성주동,'45,40 - 44세,1998,662,401,261
'4811065000,  성주동,'50,45 - 49세,1998,352,203,149
'4811065000,  성주동,'55,50 - 54세,1998,251,145,106
'4811065000,  성주동,'60,55 - 59세,1998,196,90,106
'4811065000,  성주동,'65,60 - 64세,1998,188,66,122
'4811065000,  성주동,'70,65 - 69세,1998,137,62,75
'4811065000,  성주동,'75,70 - 74세,1998,106,36,70
'4811065000,  성주동,'80,75 - 79세,1998,61,18,43
'4811065000,  성주동,'85,80 - 84세,1998,30,9,21
'4811065000,  성주동,'90,85+ ,1998,12,2,10
'4811067500,  웅남동,'00,계,1998,13266,7217,6049
'4811067500,  웅남동,'05,0 - 4세,1998,1015,559,456
'4811067500,  웅남동,'10,5 - 9세,1998,1006,540,466
'4811067500,  웅남동,'15,10 - 14세,1998,1009,533,476
'4811067500,  웅남동,'20,15 - 19세,1998,1107,592,515
'4811067500,  웅남동,'25,20 - 24세,1998,1070,623,447
'4811067500,  웅남동,'30,25 - 29세,1998,1781,1146,635
'4811067500,  웅남동,'35,30 - 34세,1998,1288,711,577
'4811067500,  웅남동,'40,35 - 39세,1998,1330,677,653
'4811067500,  웅남동,'45,40 - 44세,1998,1201,645,556
'4811067500,  웅남동,'50,45 - 49세,1998,707,387,320
'4811067500,  웅남동,'55,50 - 54세,1998,482,266,216
'4811067500,  웅남동,'60,55 - 59세,1998,390,201,189
'4811067500,  웅남동,'65,60 - 64세,1998,312,146,166
'4811067500,  웅남동,'70,65 - 69세,1998,231,78,153
'4811067500,  웅남동,'75,70 - 74세,1998,165,53,112
'4811067500,  웅남동,'80,75 - 79세,1998,103,37,66
'4811067500,  웅남동,'85,80 - 84세,1998,47,14,33
'4811067500,  웅남동,'90,85+ ,1998,22,9,13
'48151, 합포구,'00,계,1998,216135,107501,108634
'48151, 합포구,'05,0 - 4세,1998,12873,6884,5989
'48151, 합포구,'10,5 - 9세,1998,13268,7247,6021
'48151, 합포구,'15,10 - 14세,1998,14623,7784,6839
'48151, 합포구,'20,15 - 19세,1998,21510,11118,10392
'48151, 합포구,'25,20 - 24세,1998,19722,10171,9551
'48151, 합포구,'30,25 - 29세,1998,20045,10539,9506
'48151, 합포구,'35,30 - 34세,1998,16884,8555,8329
'48151, 합포구,'40,35 - 39세,1998,19037,9302,9735
'48151, 합포구,'45,40 - 44세,1998,19095,9403,9692
'48151, 합포구,'50,45 - 49세,1998,14559,7236,7323
'48151, 합포구,'55,50 - 54세,1998,11352,5659,5693
'48151, 합포구,'60,55 - 59세,1998,10477,4973,5504
'48151, 합포구,'65,60 - 64세,1998,8045,3675,4370
'48151, 합포구,'70,65 - 69세,1998,6056,2296,3760
'48151, 합포구,'75,70 - 74세,1998,4140,1421,2719
'48151, 합포구,'80,75 - 79세,1998,2594,818,1776
'48151, 합포구,'85,80 - 84세,1998,1176,278,898
'48151, 합포구,'90,85+ ,1998,679,142,537
'4815135000,  구산면,'00,계,1998,6553,3306,3247
'4815135000,  구산면,'05,0 - 4세,1998,253,124,129
'4815135000,  구산면,'10,5 - 9세,1998,304,158,146
'4815135000,  구산면,'15,10 - 14세,1998,368,175,193
'4815135000,  구산면,'20,15 - 19세,1998,676,355,321
'4815135000,  구산면,'25,20 - 24세,1998,626,362,264
'4815135000,  구산면,'30,25 - 29세,1998,497,316,181
'4815135000,  구산면,'35,30 - 34세,1998,369,209,160
'4815135000,  구산면,'40,35 - 39세,1998,473,238,235
'4815135000,  구산면,'45,40 - 44세,1998,528,287,241
'4815135000,  구산면,'50,45 - 49세,1998,425,225,200
'4815135000,  구산면,'55,50 - 54세,1998,392,209,183
'4815135000,  구산면,'60,55 - 59세,1998,390,164,226
'4815135000,  구산면,'65,60 - 64세,1998,394,183,211
'4815135000,  구산면,'70,65 - 69세,1998,332,124,208
'4815135000,  구산면,'75,70 - 74세,1998,235,97,138
'4815135000,  구산면,'80,75 - 79세,1998,175,56,119
'4815135000,  구산면,'85,80 - 84세,1998,69,17,52
'4815135000,  구산면,'90,85+ ,1998,47,7,40
'4815136000,  진동면,'00,계,1998,10482,5314,5168
'4815136000,  진동면,'05,0 - 4세,1998,704,379,325
'4815136000,  진동면,'10,5 - 9세,1998,693,412,281
'4815136000,  진동면,'15,10 - 14세,1998,659,343,316
'4815136000,  진동면,'20,15 - 19세,1998,951,457,494
'4815136000,  진동면,'25,20 - 24세,1998,942,486,456
'4815136000,  진동면,'30,25 - 29세,1998,954,539,415
'4815136000,  진동면,'35,30 - 34세,1998,882,476,406
'4815136000,  진동면,'40,35 - 39세,1998,944,519,425
'4815136000,  진동면,'45,40 - 44세,1998,767,406,361
'4815136000,  진동면,'50,45 - 49세,1998,625,309,316
'4815136000,  진동면,'55,50 - 54세,1998,504,272,232
'4815136000,  진동면,'60,55 - 59세,1998,491,211,280
'4815136000,  진동면,'65,60 - 64세,1998,449,200,249
'4815136000,  진동면,'70,65 - 69세,1998,385,154,231
'4815136000,  진동면,'75,70 - 74세,1998,250,80,170
'4815136000,  진동면,'80,75 - 79세,1998,137,45,92
'4815136000,  진동면,'85,80 - 84세,1998,98,18,80
'4815136000,  진동면,'90,85+ ,1998,47,8,39
'4815137000,  진북면,'00,계,1998,5060,2574,2486
'4815137000,  진북면,'05,0 - 4세,1998,287,152,135
'4815137000,  진북면,'10,5 - 9세,1998,266,133,133
'4815137000,  진북면,'15,10 - 14세,1998,242,134,108
'4815137000,  진북면,'20,15 - 19세,1998,380,191,189
'4815137000,  진북면,'25,20 - 24세,1998,447,229,218
'4815137000,  진북면,'30,25 - 29세,1998,455,255,200
'4815137000,  진북면,'35,30 - 34세,1998,376,206,170
'4815137000,  진북면,'40,35 - 39세,1998,363,214,149
'4815137000,  진북면,'45,40 - 44세,1998,363,210,153
'4815137000,  진북면,'50,45 - 49세,1998,319,181,138
'4815137000,  진북면,'55,50 - 54세,1998,217,104,113
'4815137000,  진북면,'60,55 - 59세,1998,320,139,181
'4815137000,  진북면,'65,60 - 64세,1998,346,144,202
'4815137000,  진북면,'70,65 - 69세,1998,261,114,147
'4815137000,  진북면,'75,70 - 74세,1998,195,79,116
'4815137000,  진북면,'80,75 - 79세,1998,144,60,84
'4815137000,  진북면,'85,80 - 84세,1998,44,18,26
'4815137000,  진북면,'90,85+ ,1998,35,11,24
'4815138000,  진전면,'00,계,1998,5222,2617,2605
'4815138000,  진전면,'05,0 - 4세,1998,250,139,111
'4815138000,  진전면,'10,5 - 9세,1998,208,121,87
'4815138000,  진전면,'15,10 - 14세,1998,235,127,108
'4815138000,  진전면,'20,15 - 19세,1998,417,222,195
'4815138000,  진전면,'25,20 - 24세,1998,461,255,206
'4815138000,  진전면,'30,25 - 29세,1998,483,290,193
'4815138000,  진전면,'35,30 - 34세,1998,346,212,134
'4815138000,  진전면,'40,35 - 39세,1998,329,188,141
'4815138000,  진전면,'45,40 - 44세,1998,316,171,145
'4815138000,  진전면,'50,45 - 49세,1998,282,141,141
'4815138000,  진전면,'55,50 - 54세,1998,280,126,154
'4815138000,  진전면,'60,55 - 59세,1998,359,148,211
'4815138000,  진전면,'65,60 - 64세,1998,389,172,217
'4815138000,  진전면,'70,65 - 69세,1998,346,134,212
'4815138000,  진전면,'75,70 - 74세,1998,247,81,166
'4815138000,  진전면,'80,75 - 79세,1998,156,63,93
'4815138000,  진전면,'85,80 - 84세,1998,67,16,51
'4815138000,  진전면,'90,85+ ,1998,51,11,40
'4815138500,  의산출장소,'00,계,1998,969,476,493
'4815138500,  의산출장소,'05,0 - 4세,1998,25,15,10
'4815138500,  의산출장소,'10,5 - 9세,1998,23,11,12
'4815138500,  의산출장소,'15,10 - 14세,1998,45,27,18
'4815138500,  의산출장소,'20,15 - 19세,1998,61,31,30
'4815138500,  의산출장소,'25,20 - 24세,1998,69,37,32
'4815138500,  의산출장소,'30,25 - 29세,1998,78,51,27
'4815138500,  의산출장소,'35,30 - 34세,1998,47,30,17
'4815138500,  의산출장소,'40,35 - 39세,1998,45,24,21
'4815138500,  의산출장소,'45,40 - 44세,1998,57,31,26
'4815138500,  의산출장소,'50,45 - 49세,1998,43,23,20
'4815138500,  의산출장소,'55,50 - 54세,1998,55,22,33
'4815138500,  의산출장소,'60,55 - 59세,1998,86,36,50
'4815138500,  의산출장소,'65,60 - 64세,1998,109,41,68
'4815138500,  의산출장소,'70,65 - 69세,1998,94,45,49
'4815138500,  의산출장소,'75,70 - 74세,1998,60,22,38
'4815138500,  의산출장소,'80,75 - 79세,1998,50,23,27
'4815138500,  의산출장소,'85,80 - 84세,1998,12,1,11
'4815138500,  의산출장소,'90,85+ ,1998,10,6,4
'4815151000,  현동,'00,계,1998,3490,1781,1709
'4815151000,  현동,'05,0 - 4세,1998,152,75,77
'4815151000,  현동,'10,5 - 9세,1998,144,70,74
'4815151000,  현동,'15,10 - 14세,1998,156,84,72
'4815151000,  현동,'20,15 - 19세,1998,373,200,173
'4815151000,  현동,'25,20 - 24세,1998,429,226,203
'4815151000,  현동,'30,25 - 29세,1998,325,193,132
'4815151000,  현동,'35,30 - 34세,1998,209,128,81
'4815151000,  현동,'40,35 - 39세,1998,223,124,99
'4815151000,  현동,'45,40 - 44세,1998,276,128,148
'4815151000,  현동,'50,45 - 49세,1998,244,140,104
'4815151000,  현동,'55,50 - 54세,1998,191,100,91
'4815151000,  현동,'60,55 - 59세,1998,211,90,121
'4815151000,  현동,'65,60 - 64세,1998,187,90,97
'4815151000,  현동,'70,65 - 69세,1998,139,51,88
'4815151000,  현동,'75,70 - 74세,1998,122,50,72
'4815151000,  현동,'80,75 - 79세,1998,67,19,48
'4815151000,  현동,'85,80 - 84세,1998,29,8,21
'4815151000,  현동,'90,85+ ,1998,13,5,8
'4815152000,  가포동,'00,계,1998,2383,1207,1176
'4815152000,  가포동,'05,0 - 4세,1998,134,69,65
'4815152000,  가포동,'10,5 - 9세,1998,119,63,56
'4815152000,  가포동,'15,10 - 14세,1998,160,80,80
'4815152000,  가포동,'20,15 - 19세,1998,252,124,128
'4815152000,  가포동,'25,20 - 24세,1998,207,111,96
'4815152000,  가포동,'30,25 - 29세,1998,205,114,91
'4815152000,  가포동,'35,30 - 34세,1998,192,98,94
'4815152000,  가포동,'40,35 - 39세,1998,190,101,89
'4815152000,  가포동,'45,40 - 44세,1998,230,126,104
'4815152000,  가포동,'50,45 - 49세,1998,159,74,85
'4815152000,  가포동,'55,50 - 54세,1998,134,69,65
'4815152000,  가포동,'60,55 - 59세,1998,120,58,62
'4815152000,  가포동,'65,60 - 64세,1998,100,45,55
'4815152000,  가포동,'70,65 - 69세,1998,78,35,43
'4815152000,  가포동,'75,70 - 74세,1998,53,22,31
'4815152000,  가포동,'80,75 - 79세,1998,30,14,16
'4815152000,  가포동,'85,80 - 84세,1998,12,3,9
'4815152000,  가포동,'90,85+ ,1998,8,1,7
'4815154500,  월영동,'00,계,1998,35823,17948,17875
'4815154500,  월영동,'05,0 - 4세,1998,3095,1649,1446
'4815154500,  월영동,'10,5 - 9세,1998,2931,1610,1321
'4815154500,  월영동,'15,10 - 14세,1998,2917,1536,1381
'4815154500,  월영동,'20,15 - 19세,1998,3241,1697,1544
'4815154500,  월영동,'25,20 - 24세,1998,2632,1371,1261
'4815154500,  월영동,'30,25 - 29세,1998,3224,1460,1764
'4815154500,  월영동,'35,30 - 34세,1998,3614,1743,1871
'4815154500,  월영동,'40,35 - 39세,1998,3885,1905,1980
'4815154500,  월영동,'45,40 - 44세,1998,3347,1734,1613
'4815154500,  월영동,'50,45 - 49세,1998,2178,1137,1041
'4815154500,  월영동,'55,50 - 54세,1998,1403,757,646
'4815154500,  월영동,'60,55 - 59세,1998,1161,570,591
'4815154500,  월영동,'65,60 - 64세,1998,766,363,403
'4815154500,  월영동,'70,65 - 69세,1998,584,204,380
'4815154500,  월영동,'75,70 - 74세,1998,386,105,281
'4815154500,  월영동,'80,75 - 79세,1998,266,69,197
'4815154500,  월영동,'85,80 - 84세,1998,138,31,107
'4815154500,  월영동,'90,85+ ,1998,55,7,48
'4815155500,  문화동,'00,계,1998,16220,7985,8235
'4815155500,  문화동,'05,0 - 4세,1998,797,401,396
'4815155500,  문화동,'10,5 - 9세,1998,851,450,401
'4815155500,  문화동,'15,10 - 14세,1998,1024,551,473
'4815155500,  문화동,'20,15 - 19세,1998,1772,900,872
'4815155500,  문화동,'25,20 - 24세,1998,1687,886,801
'4815155500,  문화동,'30,25 - 29세,1998,1465,798,667
'4815155500,  문화동,'35,30 - 34세,1998,1120,591,529
'4815155500,  문화동,'40,35 - 39세,1998,1190,546,644
'4815155500,  문화동,'45,40 - 44세,1998,1430,660,770
'4815155500,  문화동,'50,45 - 49세,1998,1285,614,671
'4815155500,  문화동,'55,50 - 54세,1998,986,512,474
'4815155500,  문화동,'60,55 - 59세,1998,817,391,426
'4815155500,  문화동,'65,60 - 64세,1998,628,289,339
'4815155500,  문화동,'70,65 - 69세,1998,467,175,292
'4815155500,  문화동,'75,70 - 74세,1998,327,113,214
'4815155500,  문화동,'80,75 - 79세,1998,216,70,146
'4815155500,  문화동,'85,80 - 84세,1998,100,24,76
'4815155500,  문화동,'90,85+ ,1998,58,14,44
'4815157000,  반월동,'00,계,1998,10439,5160,5279
'4815157000,  반월동,'05,0 - 4세,1998,649,357,292
'4815157000,  반월동,'10,5 - 9세,1998,649,358,291
'4815157000,  반월동,'15,10 - 14세,1998,739,382,357
'4815157000,  반월동,'20,15 - 19세,1998,1013,500,513
'4815157000,  반월동,'25,20 - 24세,1998,967,495,472
'4815157000,  반월동,'30,25 - 29세,1998,1032,561,471
'4815157000,  반월동,'35,30 - 34세,1998,804,413,391
'4815157000,  반월동,'40,35 - 39세,1998,937,436,501
'4815157000,  반월동,'45,40 - 44세,1998,913,454,459
'4815157000,  반월동,'50,45 - 49세,1998,662,310,352
'4815157000,  반월동,'55,50 - 54세,1998,557,279,278
'4815157000,  반월동,'60,55 - 59세,1998,482,237,245
'4815157000,  반월동,'65,60 - 64세,1998,353,162,191
'4815157000,  반월동,'70,65 - 69세,1998,277,87,190
'4815157000,  반월동,'75,70 - 74세,1998,187,69,118
'4815157000,  반월동,'80,75 - 79세,1998,138,41,97
'4815157000,  반월동,'85,80 - 84세,1998,46,12,34
'4815157000,  반월동,'90,85+ ,1998,34,7,27
'4815158000,  중앙동,'00,계,1998,9044,4410,4634
'4815158000,  중앙동,'05,0 - 4세,1998,508,272,236
'4815158000,  중앙동,'10,5 - 9세,1998,553,282,271
'4815158000,  중앙동,'15,10 - 14세,1998,577,312,265
'4815158000,  중앙동,'20,15 - 19세,1998,912,466,446
'4815158000,  중앙동,'25,20 - 24세,1998,845,440,405
'4815158000,  중앙동,'30,25 - 29세,1998,840,425,415
'4815158000,  중앙동,'35,30 - 34세,1998,684,334,350
'4815158000,  중앙동,'40,35 - 39세,1998,793,382,411
'4815158000,  중앙동,'45,40 - 44세,1998,784,375,409
'4815158000,  중앙동,'50,45 - 49세,1998,664,324,340
'4815158000,  중앙동,'55,50 - 54세,1998,504,232,272
'4815158000,  중앙동,'60,55 - 59세,1998,453,210,243
'4815158000,  중앙동,'65,60 - 64세,1998,348,164,184
'4815158000,  중앙동,'70,65 - 69세,1998,235,88,147
'4815158000,  중앙동,'75,70 - 74세,1998,185,60,125
'4815158000,  중앙동,'80,75 - 79세,1998,88,27,61
'4815158000,  중앙동,'85,80 - 84세,1998,46,14,32
'4815158000,  중앙동,'90,85+ ,1998,25,3,22
'4815159000,  완월동,'00,계,1998,14596,7294,7302
'4815159000,  완월동,'05,0 - 4세,1998,738,424,314
'4815159000,  완월동,'10,5 - 9세,1998,900,515,385
'4815159000,  완월동,'15,10 - 14세,1998,1177,625,552
'4815159000,  완월동,'20,15 - 19세,1998,1632,823,809
'4815159000,  완월동,'25,20 - 24세,1998,1231,649,582
'4815159000,  완월동,'30,25 - 29세,1998,1238,648,590
'4815159000,  완월동,'35,30 - 34세,1998,1043,507,536
'4815159000,  완월동,'40,35 - 39세,1998,1378,649,729
'4815159000,  완월동,'45,40 - 44세,1998,1431,714,717
'4815159000,  완월동,'50,45 - 49세,1998,1010,519,491
'4815159000,  완월동,'55,50 - 54세,1998,716,354,362
'4815159000,  완월동,'60,55 - 59세,1998,666,324,342
'4815159000,  완월동,'65,60 - 64세,1998,523,232,291
'4815159000,  완월동,'70,65 - 69세,1998,383,163,220
'4815159000,  완월동,'75,70 - 74세,1998,266,88,178
'4815159000,  완월동,'80,75 - 79세,1998,165,37,128
'4815159000,  완월동,'85,80 - 84세,1998,63,18,45
'4815159000,  완월동,'90,85+ ,1998,36,5,31
'4815160000,  자산동,'00,계,1998,17813,8798,9015
'4815160000,  자산동,'05,0 - 4세,1998,1018,536,482
'4815160000,  자산동,'10,5 - 9세,1998,1108,605,503
'4815160000,  자산동,'15,10 - 14세,1998,1435,774,661
'4815160000,  자산동,'20,15 - 19세,1998,1987,1003,984
'4815160000,  자산동,'25,20 - 24세,1998,1611,810,801
'4815160000,  자산동,'30,25 - 29세,1998,1531,788,743
'4815160000,  자산동,'35,30 - 34세,1998,1279,583,696
'4815160000,  자산동,'40,35 - 39세,1998,1604,721,883
'4815160000,  자산동,'45,40 - 44세,1998,1750,866,884
'4815160000,  자산동,'50,45 - 49세,1998,1306,659,647
'4815160000,  자산동,'55,50 - 54세,1998,969,508,461
'4815160000,  자산동,'60,55 - 59세,1998,755,390,365
'4815160000,  자산동,'65,60 - 64세,1998,505,236,269
'4815160000,  자산동,'70,65 - 69세,1998,409,141,268
'4815160000,  자산동,'75,70 - 74세,1998,253,93,160
'4815160000,  자산동,'80,75 - 79세,1998,170,52,118
'4815160000,  자산동,'85,80 - 84세,1998,79,21,58
'4815160000,  자산동,'90,85+ ,1998,44,12,32
'4815162500,  동서동,'00,계,1998,7774,3831,3943
'4815162500,  동서동,'05,0 - 4세,1998,341,183,158
'4815162500,  동서동,'10,5 - 9세,1998,324,163,161
'4815162500,  동서동,'15,10 - 14세,1998,459,268,191
'4815162500,  동서동,'20,15 - 19세,1998,779,421,358
'4815162500,  동서동,'25,20 - 24세,1998,766,379,387
'4815162500,  동서동,'30,25 - 29세,1998,727,405,322
'4815162500,  동서동,'35,30 - 34세,1998,494,250,244
'4815162500,  동서동,'40,35 - 39세,1998,561,271,290
'4815162500,  동서동,'45,40 - 44세,1998,704,316,388
'4815162500,  동서동,'50,45 - 49세,1998,631,292,339
'4815162500,  동서동,'55,50 - 54세,1998,541,245,296
'4815162500,  동서동,'60,55 - 59세,1998,512,238,274
'4815162500,  동서동,'65,60 - 64세,1998,369,188,181
'4815162500,  동서동,'70,65 - 69세,1998,227,92,135
'4815162500,  동서동,'75,70 - 74세,1998,173,63,110
'4815162500,  동서동,'80,75 - 79세,1998,101,39,62
'4815162500,  동서동,'85,80 - 84세,1998,36,12,24
'4815162500,  동서동,'90,85+ ,1998,29,6,23
'4815166000,  성호동,'00,계,1998,6912,3406,3506
'4815166000,  성호동,'05,0 - 4세,1998,323,163,160
'4815166000,  성호동,'10,5 - 9세,1998,368,206,162
'4815166000,  성호동,'15,10 - 14세,1998,381,203,178
'4815166000,  성호동,'20,15 - 19세,1998,664,353,311
'4815166000,  성호동,'25,20 - 24세,1998,668,337,331
'4815166000,  성호동,'30,25 - 29세,1998,731,397,334
'4815166000,  성호동,'35,30 - 34세,1998,482,246,236
'4815166000,  성호동,'40,35 - 39세,1998,538,277,261
'4815166000,  성호동,'45,40 - 44세,1998,587,281,306
'4815166000,  성호동,'50,45 - 49세,1998,464,224,240
'4815166000,  성호동,'55,50 - 54세,1998,426,200,226
'4815166000,  성호동,'60,55 - 59세,1998,429,204,225
'4815166000,  성호동,'65,60 - 64세,1998,303,144,159
'4815166000,  성호동,'70,65 - 69세,1998,220,68,152
'4815166000,  성호동,'75,70 - 74세,1998,166,60,106
'4815166000,  성호동,'80,75 - 79세,1998,83,27,56
'4815166000,  성호동,'85,80 - 84세,1998,51,11,40
'4815166000,  성호동,'90,85+ ,1998,28,5,23
'4815168000,  교방동,'00,계,1998,14743,7337,7406
'4815168000,  교방동,'05,0 - 4세,1998,948,501,447
'4815168000,  교방동,'10,5 - 9세,1998,1015,550,465
'4815168000,  교방동,'15,10 - 14세,1998,1107,615,492
'4815168000,  교방동,'20,15 - 19세,1998,1575,823,752
'4815168000,  교방동,'25,20 - 24세,1998,1335,653,682
'4815168000,  교방동,'30,25 - 29세,1998,1300,649,651
'4815168000,  교방동,'35,30 - 34세,1998,1220,624,596
'4815168000,  교방동,'40,35 - 39세,1998,1401,650,751
'4815168000,  교방동,'45,40 - 44세,1998,1387,694,693
'4815168000,  교방동,'50,45 - 49세,1998,943,502,441
'4815168000,  교방동,'55,50 - 54세,1998,686,355,331
'4815168000,  교방동,'60,55 - 59세,1998,582,287,295
'4815168000,  교방동,'65,60 - 64세,1998,424,168,256
'4815168000,  교방동,'70,65 - 69세,1998,363,130,233
'4815168000,  교방동,'75,70 - 74세,1998,208,69,139
'4815168000,  교방동,'80,75 - 79세,1998,145,45,100
'4815168000,  교방동,'85,80 - 84세,1998,65,13,52
'4815168000,  교방동,'90,85+ ,1998,39,9,30
'4815169500,  노산동,'00,계,1998,11130,5553,5577
'4815169500,  노산동,'05,0 - 4세,1998,539,281,258
'4815169500,  노산동,'10,5 - 9세,1998,553,287,266
'4815169500,  노산동,'15,10 - 14세,1998,647,356,291
'4815169500,  노산동,'20,15 - 19세,1998,1134,601,533
'4815169500,  노산동,'25,20 - 24세,1998,1179,636,543
'4815169500,  노산동,'30,25 - 29세,1998,1109,632,477
'4815169500,  노산동,'35,30 - 34세,1998,812,445,367
'4815169500,  노산동,'40,35 - 39세,1998,906,434,472
'4815169500,  노산동,'45,40 - 44세,1998,934,440,494
'4815169500,  노산동,'50,45 - 49세,1998,787,362,425
'4815169500,  노산동,'55,50 - 54세,1998,683,324,359
'4815169500,  노산동,'60,55 - 59세,1998,632,310,322
'4815169500,  노산동,'65,60 - 64세,1998,483,216,267
'4815169500,  노산동,'70,65 - 69세,1998,327,124,203
'4815169500,  노산동,'75,70 - 74세,1998,211,64,147
'4815169500,  노산동,'80,75 - 79세,1998,113,28,85
'4815169500,  노산동,'85,80 - 84세,1998,56,7,49
'4815169500,  노산동,'90,85+ ,1998,25,6,19
'4815171000,  오동동,'00,계,1998,6246,2970,3276
'4815171000,  오동동,'05,0 - 4세,1998,301,151,150
'4815171000,  오동동,'10,5 - 9세,1998,320,170,150
'4815171000,  오동동,'15,10 - 14세,1998,264,129,135
'4815171000,  오동동,'20,15 - 19세,1998,591,313,278
'4815171000,  오동동,'25,20 - 24세,1998,600,318,282
'4815171000,  오동동,'30,25 - 29세,1998,616,314,302
'4815171000,  오동동,'35,30 - 34세,1998,451,233,218
'4815171000,  오동동,'40,35 - 39세,1998,481,254,227
'4815171000,  오동동,'45,40 - 44세,1998,543,235,308
'4815171000,  오동동,'50,45 - 49세,1998,451,183,268
'4815171000,  오동동,'55,50 - 54세,1998,402,178,224
'4815171000,  오동동,'60,55 - 59세,1998,448,202,246
'4815171000,  오동동,'65,60 - 64세,1998,304,140,164
'4815171000,  오동동,'70,65 - 69세,1998,191,68,123
'4815171000,  오동동,'75,70 - 74세,1998,131,41,90
'4815171000,  오동동,'80,75 - 79세,1998,90,28,62
'4815171000,  오동동,'85,80 - 84세,1998,36,8,28
'4815171000,  오동동,'90,85+ ,1998,26,5,21
'4815172500,  합포동,'00,계,1998,11526,5733,5793
'4815172500,  합포동,'05,0 - 4세,1998,569,319,250
'4815172500,  합포동,'10,5 - 9세,1998,659,372,287
'4815172500,  합포동,'15,10 - 14세,1998,699,378,321
'4815172500,  합포동,'20,15 - 19세,1998,1104,610,494
'4815172500,  합포동,'25,20 - 24세,1998,1086,561,525
'4815172500,  합포동,'30,25 - 29세,1998,1174,636,538
'4815172500,  합포동,'35,30 - 34세,1998,860,436,424
'4815172500,  합포동,'40,35 - 39세,1998,1005,490,515
'4815172500,  합포동,'45,40 - 44세,1998,1000,465,535
'4815172500,  합포동,'50,45 - 49세,1998,765,370,395
'4815172500,  합포동,'55,50 - 54세,1998,657,303,354
'4815172500,  합포동,'60,55 - 59세,1998,678,304,374
'4815172500,  합포동,'65,60 - 64세,1998,498,229,269
'4815172500,  합포동,'70,65 - 69세,1998,349,138,211
'4815172500,  합포동,'75,70 - 74세,1998,210,71,139
'4815172500,  합포동,'80,75 - 79세,1998,119,31,88
'4815172500,  합포동,'85,80 - 84세,1998,60,13,47
'4815172500,  합포동,'90,85+ ,1998,34,7,27
'4815174000,  산호동,'00,계,1998,19710,9801,9909
'4815174000,  산호동,'05,0 - 4세,1998,1242,694,548
'4815174000,  산호동,'10,5 - 9세,1998,1280,711,569
'4815174000,  산호동,'15,10 - 14세,1998,1332,685,647
'4815174000,  산호동,'20,15 - 19세,1998,1996,1028,968
'4815174000,  산호동,'25,20 - 24세,1998,1934,930,1004
'4815174000,  산호동,'30,25 - 29세,1998,2061,1068,993
'4815174000,  산호동,'35,30 - 34세,1998,1600,791,809
'4815174000,  산호동,'40,35 - 39세,1998,1791,879,912
'4815174000,  산호동,'45,40 - 44세,1998,1748,810,938
'4815174000,  산호동,'50,45 - 49세,1998,1316,647,669
'4815174000,  산호동,'55,50 - 54세,1998,1049,510,539
'4815174000,  산호동,'60,55 - 59세,1998,885,460,425
'4815174000,  산호동,'65,60 - 64세,1998,567,269,298
'4815174000,  산호동,'70,65 - 69세,1998,389,161,228
'4815174000,  산호동,'75,70 - 74세,1998,275,94,181
'4815174000,  산호동,'80,75 - 79세,1998,141,44,97
'4815174000,  산호동,'85,80 - 84세,1998,69,13,56
'4815174000,  산호동,'90,85+ ,1998,35,7,28
'48153, 회원구,'00,계,1998,217949,109470,108479
'48153, 회원구,'05,0 - 4세,1998,14818,7943,6875
'48153, 회원구,'10,5 - 9세,1998,16211,8794,7417
'48153, 회원구,'15,10 - 14세,1998,15741,8327,7414
'48153, 회원구,'20,15 - 19세,1998,22249,11446,10803
'48153, 회원구,'25,20 - 24세,1998,20627,10307,10320
'48153, 회원구,'30,25 - 29세,1998,20811,10631,10180
'48153, 회원구,'35,30 - 34세,1998,19510,9736,9774
'48153, 회원구,'40,35 - 39세,1998,21406,10637,10769
'48153, 회원구,'45,40 - 44세,1998,19217,9397,9820
'48153, 회원구,'50,45 - 49세,1998,14237,7121,7116
'48153, 회원구,'55,50 - 54세,1998,10160,5315,4845
'48153, 회원구,'60,55 - 59세,1998,8342,4201,4141
'48153, 회원구,'65,60 - 64세,1998,5876,2728,3148
'48153, 회원구,'70,65 - 69세,1998,3735,1443,2292
'48153, 회원구,'75,70 - 74세,1998,2318,780,1538
'48153, 회원구,'80,75 - 79세,1998,1536,419,1117
'48153, 회원구,'85,80 - 84세,1998,752,175,577
'48153, 회원구,'90,85+ ,1998,403,70,333
'4815325000,  내서읍,'00,계,1998,43401,21938,21463
'4815325000,  내서읍,'05,0 - 4세,1998,4291,2279,2012
'4815325000,  내서읍,'10,5 - 9세,1998,4952,2630,2322
'4815325000,  내서읍,'15,10 - 14세,1998,3034,1613,1421
'4815325000,  내서읍,'20,15 - 19세,1998,3268,1645,1623
'4815325000,  내서읍,'25,20 - 24세,1998,2673,1346,1327
'4815325000,  내서읍,'30,25 - 29세,1998,3979,1741,2238
'4815325000,  내서읍,'35,30 - 34세,1998,5484,2578,2906
'4815325000,  내서읍,'40,35 - 39세,1998,5424,3048,2376
'4815325000,  내서읍,'45,40 - 44세,1998,3344,1864,1480
'4815325000,  내서읍,'50,45 - 49세,1998,1948,1029,919
'4815325000,  내서읍,'55,50 - 54세,1998,1307,699,608
'4815325000,  내서읍,'60,55 - 59세,1998,1136,543,593
'4815325000,  내서읍,'65,60 - 64세,1998,941,400,541
'4815325000,  내서읍,'70,65 - 69세,1998,668,234,434
'4815325000,  내서읍,'75,70 - 74세,1998,457,167,290
'4815325000,  내서읍,'80,75 - 79세,1998,288,77,211
'4815325000,  내서읍,'85,80 - 84세,1998,143,31,112
'4815325000,  내서읍,'90,85+ ,1998,64,14,50
'4815351000,  회원1동,'00,계,1998,16140,7978,8162
'4815351000,  회원1동,'05,0 - 4세,1998,825,438,387
'4815351000,  회원1동,'10,5 - 9세,1998,918,516,402
'4815351000,  회원1동,'15,10 - 14세,1998,1005,536,469
'4815351000,  회원1동,'20,15 - 19세,1998,1778,874,904
'4815351000,  회원1동,'25,20 - 24세,1998,1732,871,861
'4815351000,  회원1동,'30,25 - 29세,1998,1593,844,749
'4815351000,  회원1동,'35,30 - 34세,1998,1163,576,587
'4815351000,  회원1동,'40,35 - 39세,1998,1346,656,690
'4815351000,  회원1동,'45,40 - 44세,1998,1418,642,776
'4815351000,  회원1동,'50,45 - 49세,1998,1152,548,604
'4815351000,  회원1동,'55,50 - 54세,1998,947,462,485
'4815351000,  회원1동,'60,55 - 59세,1998,850,436,414
'4815351000,  회원1동,'65,60 - 64세,1998,622,291,331
'4815351000,  회원1동,'70,65 - 69세,1998,340,144,196
'4815351000,  회원1동,'75,70 - 74세,1998,217,83,134
'4815351000,  회원1동,'80,75 - 79세,1998,139,45,94
'4815351000,  회원1동,'85,80 - 84세,1998,52,13,39
'4815351000,  회원1동,'90,85+ ,1998,43,3,40
'4815352000,  회원2동,'00,계,1998,20504,10202,10302
'4815352000,  회원2동,'05,0 - 4세,1998,1062,563,499
'4815352000,  회원2동,'10,5 - 9세,1998,1320,705,615
'4815352000,  회원2동,'15,10 - 14세,1998,1516,802,714
'4815352000,  회원2동,'20,15 - 19세,1998,2224,1122,1102
'4815352000,  회원2동,'25,20 - 24세,1998,2110,1053,1057
'4815352000,  회원2동,'30,25 - 29세,1998,1839,987,852
'4815352000,  회원2동,'35,30 - 34세,1998,1487,754,733
'4815352000,  회원2동,'40,35 - 39세,1998,1827,863,964
'4815352000,  회원2동,'45,40 - 44세,1998,1872,927,945
'4815352000,  회원2동,'50,45 - 49세,1998,1504,748,756
'4815352000,  회원2동,'55,50 - 54세,1998,1036,561,475
'4815352000,  회원2동,'60,55 - 59세,1998,903,438,465
'4815352000,  회원2동,'65,60 - 64세,1998,698,305,393
'4815352000,  회원2동,'70,65 - 69세,1998,462,185,277
'4815352000,  회원2동,'75,70 - 74세,1998,304,103,201
'4815352000,  회원2동,'80,75 - 79세,1998,183,62,121
'4815352000,  회원2동,'85,80 - 84세,1998,96,14,82
'4815352000,  회원2동,'90,85+ ,1998,61,10,51
'4815353000,  석전1동,'00,계,1998,12136,6161,5975
'4815353000,  석전1동,'05,0 - 4세,1998,630,351,279
'4815353000,  석전1동,'10,5 - 9세,1998,734,442,292
'4815353000,  석전1동,'15,10 - 14세,1998,865,463,402
'4815353000,  석전1동,'20,15 - 19세,1998,1376,684,692
'4815353000,  석전1동,'25,20 - 24세,1998,1348,705,643
'4815353000,  석전1동,'30,25 - 29세,1998,1155,628,527
'4815353000,  석전1동,'35,30 - 34세,1998,879,464,415
'4815353000,  석전1동,'40,35 - 39세,1998,1138,549,589
'4815353000,  석전1동,'45,40 - 44세,1998,1069,510,559
'4815353000,  석전1동,'50,45 - 49세,1998,886,422,464
'4815353000,  석전1동,'55,50 - 54세,1998,618,320,298
'4815353000,  석전1동,'60,55 - 59세,1998,550,277,273
'4815353000,  석전1동,'65,60 - 64세,1998,372,174,198
'4815353000,  석전1동,'70,65 - 69세,1998,221,90,131
'4815353000,  석전1동,'75,70 - 74세,1998,133,43,90
'4815353000,  석전1동,'80,75 - 79세,1998,102,25,77
'4815353000,  석전1동,'85,80 - 84세,1998,38,12,26
'4815353000,  석전1동,'90,85+ ,1998,22,2,20
'4815354000,  석전2동,'00,계,1998,12273,6072,6201
'4815354000,  석전2동,'05,0 - 4세,1998,694,358,336
'4815354000,  석전2동,'10,5 - 9세,1998,833,451,382
'4815354000,  석전2동,'15,10 - 14세,1998,977,463,514
'4815354000,  석전2동,'20,15 - 19세,1998,1313,692,621
'4815354000,  석전2동,'25,20 - 24세,1998,1263,616,647
'4815354000,  석전2동,'30,25 - 29세,1998,1117,627,490
'4815354000,  석전2동,'35,30 - 34세,1998,972,480,492
'4815354000,  석전2동,'40,35 - 39세,1998,1194,555,639
'4815354000,  석전2동,'45,40 - 44세,1998,1058,502,556
'4815354000,  석전2동,'50,45 - 49세,1998,825,389,436
'4815354000,  석전2동,'55,50 - 54세,1998,717,366,351
'4815354000,  석전2동,'60,55 - 59세,1998,535,259,276
'4815354000,  석전2동,'65,60 - 64세,1998,317,167,150
'4815354000,  석전2동,'70,65 - 69세,1998,199,77,122
'4815354000,  석전2동,'75,70 - 74세,1998,113,38,75
'4815354000,  석전2동,'80,75 - 79세,1998,71,20,51
'4815354000,  석전2동,'85,80 - 84세,1998,42,6,36
'4815354000,  석전2동,'90,85+ ,1998,33,6,27
'4815355000,  회성동,'00,계,1998,12636,6338,6298
'4815355000,  회성동,'05,0 - 4세,1998,742,399,343
'4815355000,  회성동,'10,5 - 9세,1998,733,402,331
'4815355000,  회성동,'15,10 - 14세,1998,1047,526,521
'4815355000,  회성동,'20,15 - 19세,1998,1323,669,654
'4815355000,  회성동,'25,20 - 24세,1998,1192,619,573
'4815355000,  회성동,'30,25 - 29세,1998,1209,664,545
'4815355000,  회성동,'35,30 - 34세,1998,947,493,454
'4815355000,  회성동,'40,35 - 39세,1998,1179,534,645
'4815355000,  회성동,'45,40 - 44세,1998,1120,561,559
'4815355000,  회성동,'50,45 - 49세,1998,838,415,423
'4815355000,  회성동,'55,50 - 54세,1998,651,318,333
'4815355000,  회성동,'60,55 - 59세,1998,574,288,286
'4815355000,  회성동,'65,60 - 64세,1998,444,218,226
'4815355000,  회성동,'70,65 - 69세,1998,266,117,149
'4815355000,  회성동,'75,70 - 74세,1998,175,57,118
'4815355000,  회성동,'80,75 - 79세,1998,116,34,82
'4815355000,  회성동,'85,80 - 84세,1998,49,15,34
'4815355000,  회성동,'90,85+ ,1998,31,9,22
'4815356000,  양덕1동,'00,계,1998,15434,7706,7728
'4815356000,  양덕1동,'05,0 - 4세,1998,941,525,416
'4815356000,  양덕1동,'10,5 - 9세,1998,980,530,450
'4815356000,  양덕1동,'15,10 - 14세,1998,1145,616,529
'4815356000,  양덕1동,'20,15 - 19세,1998,1763,880,883
'4815356000,  양덕1동,'25,20 - 24세,1998,1548,765,783
'4815356000,  양덕1동,'30,25 - 29세,1998,1458,759,699
'4815356000,  양덕1동,'35,30 - 34세,1998,1200,622,578
'4815356000,  양덕1동,'40,35 - 39세,1998,1412,670,742
'4815356000,  양덕1동,'45,40 - 44세,1998,1529,670,859
'4815356000,  양덕1동,'50,45 - 49세,1998,1085,545,540
'4815356000,  양덕1동,'55,50 - 54세,1998,819,434,385
'4815356000,  양덕1동,'60,55 - 59세,1998,629,326,303
'4815356000,  양덕1동,'65,60 - 64세,1998,378,181,197
'4815356000,  양덕1동,'70,65 - 69세,1998,231,87,144
'4815356000,  양덕1동,'75,70 - 74세,1998,146,54,92
'4815356000,  양덕1동,'80,75 - 79세,1998,94,28,66
'4815356000,  양덕1동,'85,80 - 84세,1998,55,12,43
'4815356000,  양덕1동,'90,85+ ,1998,21,2,19
'4815357000,  양덕2동,'00,계,1998,19747,10031,9716
'4815357000,  양덕2동,'05,0 - 4세,1998,1447,767,680
'4815357000,  양덕2동,'10,5 - 9세,1998,1585,857,728
'4815357000,  양덕2동,'15,10 - 14세,1998,1423,779,644
'4815357000,  양덕2동,'20,15 - 19세,1998,1958,1069,889
'4815357000,  양덕2동,'25,20 - 24세,1998,1773,885,888
'4815357000,  양덕2동,'30,25 - 29세,1998,1811,930,881
'4815357000,  양덕2동,'35,30 - 34세,1998,1886,904,982
'4815357000,  양덕2동,'40,35 - 39세,1998,2020,1031,989
'4815357000,  양덕2동,'45,40 - 44세,1998,1848,897,951
'4815357000,  양덕2동,'50,45 - 49세,1998,1313,666,647
'4815357000,  양덕2동,'55,50 - 54세,1998,897,478,419
'4815357000,  양덕2동,'60,55 - 59세,1998,668,329,339
'4815357000,  양덕2동,'65,60 - 64세,1998,449,227,222
'4815357000,  양덕2동,'70,65 - 69세,1998,277,107,170
'4815357000,  양덕2동,'75,70 - 74세,1998,181,50,131
'4815357000,  양덕2동,'80,75 - 79세,1998,109,32,77
'4815357000,  양덕2동,'85,80 - 84세,1998,66,17,49
'4815357000,  양덕2동,'90,85+ ,1998,36,6,30
'4815359000,  합성1동,'00,계,1998,15634,7770,7864
'4815359000,  합성1동,'05,0 - 4세,1998,999,547,452
'4815359000,  합성1동,'10,5 - 9세,1998,1006,534,472
'4815359000,  합성1동,'15,10 - 14세,1998,1099,570,529
'4815359000,  합성1동,'20,15 - 19세,1998,1642,871,771
'4815359000,  합성1동,'25,20 - 24세,1998,1734,827,907
'4815359000,  합성1동,'30,25 - 29세,1998,1652,878,774
'4815359000,  합성1동,'35,30 - 34세,1998,1319,667,652
'4815359000,  합성1동,'40,35 - 39세,1998,1364,639,725
'4815359000,  합성1동,'45,40 - 44세,1998,1359,648,711
'4815359000,  합성1동,'50,45 - 49세,1998,1035,501,534
'4815359000,  합성1동,'55,50 - 54세,1998,785,396,389
'4815359000,  합성1동,'60,55 - 59세,1998,641,323,318
'4815359000,  합성1동,'65,60 - 64세,1998,428,196,232
'4815359000,  합성1동,'70,65 - 69세,1998,245,95,150
'4815359000,  합성1동,'75,70 - 74세,1998,145,43,102
'4815359000,  합성1동,'80,75 - 79세,1998,108,22,86
'4815359000,  합성1동,'85,80 - 84세,1998,49,12,37
'4815359000,  합성1동,'90,85+ ,1998,24,1,23
'4815360000,  합성2동,'00,계,1998,13620,6832,6788
'4815360000,  합성2동,'05,0 - 4세,1998,700,380,320
'4815360000,  합성2동,'10,5 - 9세,1998,696,383,313
'4815360000,  합성2동,'15,10 - 14세,1998,913,500,413
'4815360000,  합성2동,'20,15 - 19세,1998,1621,842,779
'4815360000,  합성2동,'25,20 - 24세,1998,1579,813,766
'4815360000,  합성2동,'30,25 - 29세,1998,1323,693,630
'4815360000,  합성2동,'35,30 - 34세,1998,946,498,448
'4815360000,  합성2동,'40,35 - 39세,1998,1138,503,635
'4815360000,  합성2동,'45,40 - 44세,1998,1237,559,678
'4815360000,  합성2동,'50,45 - 49세,1998,1132,545,587
'4815360000,  합성2동,'55,50 - 54세,1998,811,411,400
'4815360000,  합성2동,'60,55 - 59세,1998,618,328,290
'4815360000,  합성2동,'65,60 - 64세,1998,367,187,180
'4815360000,  합성2동,'70,65 - 69세,1998,250,103,147
'4815360000,  합성2동,'75,70 - 74세,1998,128,39,89
'4815360000,  합성2동,'80,75 - 79세,1998,88,27,61
'4815360000,  합성2동,'85,80 - 84세,1998,51,14,37
'4815360000,  합성2동,'90,85+ ,1998,22,7,15
'4815361000,  구암1동,'00,계,1998,17131,8646,8485
'4815361000,  구암1동,'05,0 - 4세,1998,1165,618,547
'4815361000,  구암1동,'10,5 - 9세,1998,1208,658,550
'4815361000,  구암1동,'15,10 - 14세,1998,1376,738,638
'4815361000,  구암1동,'20,15 - 19세,1998,2004,1045,959
'4815361000,  구암1동,'25,20 - 24세,1998,1556,767,789
'4815361000,  구암1동,'30,25 - 29세,1998,1551,789,762
'4815361000,  구암1동,'35,30 - 34세,1998,1500,781,719
'4815361000,  구암1동,'40,35 - 39세,1998,1659,764,895
'4815361000,  구암1동,'45,40 - 44세,1998,1692,806,886
'4815361000,  구암1동,'50,45 - 49세,1998,1210,642,568
'4815361000,  구암1동,'55,50 - 54세,1998,731,432,299
'4815361000,  구암1동,'60,55 - 59세,1998,510,265,245
'4815361000,  구암1동,'65,60 - 64세,1998,388,167,221
'4815361000,  구암1동,'70,65 - 69세,1998,274,96,178
'4815361000,  구암1동,'75,70 - 74세,1998,135,39,96
'4815361000,  구암1동,'80,75 - 79세,1998,112,26,86
'4815361000,  구암1동,'85,80 - 84세,1998,43,9,34
'4815361000,  구암1동,'90,85+ ,1998,17,4,13
'4815362000,  구암2동,'00,계,1998,13266,6703,6563
'4815362000,  구암2동,'05,0 - 4세,1998,929,503,426
'4815362000,  구암2동,'10,5 - 9세,1998,863,480,383
'4815362000,  구암2동,'15,10 - 14세,1998,932,499,433
'4815362000,  구암2동,'20,15 - 19세,1998,1407,741,666
'4815362000,  구암2동,'25,20 - 24세,1998,1391,717,674
'4815362000,  구암2동,'30,25 - 29세,1998,1384,689,695
'4815362000,  구암2동,'35,30 - 34세,1998,1169,615,554
'4815362000,  구암2동,'40,35 - 39세,1998,1180,556,624
'4815362000,  구암2동,'45,40 - 44세,1998,1153,552,601
'4815362000,  구암2동,'50,45 - 49세,1998,940,470,470
'4815362000,  구암2동,'55,50 - 54세,1998,600,304,296
'4815362000,  구암2동,'60,55 - 59세,1998,510,277,233
'4815362000,  구암2동,'65,60 - 64세,1998,317,148,169
'4815362000,  구암2동,'70,65 - 69세,1998,212,73,139
'4815362000,  구암2동,'75,70 - 74세,1998,128,44,84
'4815362000,  구암2동,'80,75 - 79세,1998,82,15,67
'4815362000,  구암2동,'85,80 - 84세,1998,48,14,34
'4815362000,  구암2동,'90,85+ ,1998,21,6,15
'4815363000,  봉암동,'00,계,1998,6027,3093,2934
'4815363000,  봉암동,'05,0 - 4세,1998,393,215,178
'4815363000,  봉암동,'10,5 - 9세,1998,383,206,177
'4815363000,  봉암동,'15,10 - 14세,1998,409,222,187
'4815363000,  봉암동,'20,15 - 19세,1998,572,312,260
'4815363000,  봉암동,'25,20 - 24세,1998,728,323,405
'4815363000,  봉암동,'30,25 - 29세,1998,740,402,338
'4815363000,  봉암동,'35,30 - 34세,1998,558,304,254
'4815363000,  봉암동,'40,35 - 39세,1998,525,269,256
'4815363000,  봉암동,'45,40 - 44세,1998,518,259,259
'4815363000,  봉암동,'50,45 - 49세,1998,369,201,168
'4815363000,  봉암동,'55,50 - 54세,1998,241,134,107
'4815363000,  봉암동,'60,55 - 59세,1998,218,112,106
'4815363000,  봉암동,'65,60 - 64세,1998,155,67,88
'4815363000,  봉암동,'70,65 - 69세,1998,90,35,55
'4815363000,  봉암동,'75,70 - 74세,1998,56,20,36
'4815363000,  봉암동,'80,75 - 79세,1998,44,6,38
'4815363000,  봉암동,'85,80 - 84세,1998,20,6,14
'4815363000,  봉암동,'90,85+ ,1998,8,0,8
'48160, 마산시,'00,계,1998,434084,216971,217113
'48160, 마산시,'05,0 - 4세,1998,27691,14827,12864
'48160, 마산시,'10,5 - 9세,1998,29479,16041,13438
'48160, 마산시,'15,10 - 14세,1998,30364,16111,14253
'48160, 마산시,'20,15 - 19세,1998,43759,22564,21195
'48160, 마산시,'25,20 - 24세,1998,40349,20478,19871
'48160, 마산시,'30,25 - 29세,1998,40856,21170,19686
'48160, 마산시,'35,30 - 34세,1998,36394,18291,18103
'48160, 마산시,'40,35 - 39세,1998,40443,19939,20504
'48160, 마산시,'45,40 - 44세,1998,38312,18800,19512
'48160, 마산시,'50,45 - 49세,1998,28796,14357,14439
'48160, 마산시,'55,50 - 54세,1998,21512,10974,10538
'48160, 마산시,'60,55 - 59세,1998,18819,9174,9645
'48160, 마산시,'65,60 - 64세,1998,13921,6403,7518
'48160, 마산시,'70,65 - 69세,1998,9791,3739,6052
'48160, 마산시,'75,70 - 74세,1998,6458,2201,4257
'48160, 마산시,'80,75 - 79세,1998,4130,1237,2893
'48160, 마산시,'85,80 - 84세,1998,1928,453,1475
'48160, 마산시,'90,85+ ,1998,1082,212,870
'48170, 진주시,'00,계,1998,341156,169071,172085
'48170, 진주시,'05,0 - 4세,1998,23659,12748,10911
'48170, 진주시,'10,5 - 9세,1998,23901,13216,10685
'48170, 진주시,'15,10 - 14세,1998,24653,12982,11671
'48170, 진주시,'20,15 - 19세,1998,33695,17496,16199
'48170, 진주시,'25,20 - 24세,1998,31143,16126,15017
'48170, 진주시,'30,25 - 29세,1998,31715,16151,15564
'48170, 진주시,'35,30 - 34세,1998,27845,13939,13906
'48170, 진주시,'40,35 - 39세,1998,30766,15131,15635
'48170, 진주시,'45,40 - 44세,1998,27220,13523,13697
'48170, 진주시,'50,45 - 49세,1998,19392,9561,9831
'48170, 진주시,'55,50 - 54세,1998,15695,7618,8077
'48170, 진주시,'60,55 - 59세,1998,15421,7175,8246
'48170, 진주시,'65,60 - 64세,1998,12706,5510,7196
'48170, 진주시,'70,65 - 69세,1998,9386,3448,5938
'48170, 진주시,'75,70 - 74세,1998,6613,2307,4306
'48170, 진주시,'80,75 - 79세,1998,4178,1348,2830
'48170, 진주시,'85,80 - 84세,1998,2023,571,1452
'48170, 진주시,'90,85+ ,1998,1145,221,924
'4817025000,  문산읍,'00,계,1998,9220,4551,4669
'4817025000,  문산읍,'05,0 - 4세,1998,576,305,271
'4817025000,  문산읍,'10,5 - 9세,1998,582,334,248
'4817025000,  문산읍,'15,10 - 14세,1998,508,266,242
'4817025000,  문산읍,'20,15 - 19세,1998,821,404,417
'4817025000,  문산읍,'25,20 - 24세,1998,859,460,399
'4817025000,  문산읍,'30,25 - 29세,1998,875,485,390
'4817025000,  문산읍,'35,30 - 34세,1998,728,399,329
'4817025000,  문산읍,'40,35 - 39세,1998,707,375,332
'4817025000,  문산읍,'45,40 - 44세,1998,608,323,285
'4817025000,  문산읍,'50,45 - 49세,1998,506,254,252
'4817025000,  문산읍,'55,50 - 54세,1998,467,212,255
'4817025000,  문산읍,'60,55 - 59세,1998,496,206,290
'4817025000,  문산읍,'65,60 - 64세,1998,513,192,321
'4817025000,  문산읍,'70,65 - 69세,1998,394,151,243
'4817025000,  문산읍,'75,70 - 74세,1998,297,97,200
'4817025000,  문산읍,'80,75 - 79세,1998,162,57,105
'4817025000,  문산읍,'85,80 - 84세,1998,70,22,48
'4817025000,  문산읍,'90,85+ ,1998,51,9,42
'4817031000,  내동면,'00,계,1998,2282,1168,1114
'4817031000,  내동면,'05,0 - 4세,1998,109,54,55
'4817031000,  내동면,'10,5 - 9세,1998,59,33,26
'4817031000,  내동면,'15,10 - 14세,1998,81,38,43
'4817031000,  내동면,'20,15 - 19세,1998,191,98,93
'4817031000,  내동면,'25,20 - 24세,1998,262,147,115
'4817031000,  내동면,'30,25 - 29세,1998,244,160,84
'4817031000,  내동면,'35,30 - 34세,1998,124,80,44
'4817031000,  내동면,'40,35 - 39세,1998,132,81,51
'4817031000,  내동면,'45,40 - 44세,1998,120,66,54
'4817031000,  내동면,'50,45 - 49세,1998,125,58,67
'4817031000,  내동면,'55,50 - 54세,1998,134,69,65
'4817031000,  내동면,'60,55 - 59세,1998,162,72,90
'4817031000,  내동면,'65,60 - 64세,1998,206,81,125
'4817031000,  내동면,'70,65 - 69세,1998,147,61,86
'4817031000,  내동면,'75,70 - 74세,1998,90,34,56
'4817031000,  내동면,'80,75 - 79세,1998,54,25,29
'4817031000,  내동면,'85,80 - 84세,1998,29,7,22
'4817031000,  내동면,'90,85+ ,1998,13,4,9
'4817032000,  정촌면,'00,계,1998,4457,2205,2252
'4817032000,  정촌면,'05,0 - 4세,1998,253,136,117
'4817032000,  정촌면,'10,5 - 9세,1998,192,115,77
'4817032000,  정촌면,'15,10 - 14세,1998,239,113,126
'4817032000,  정촌면,'20,15 - 19세,1998,431,218,213
'4817032000,  정촌면,'25,20 - 24세,1998,482,252,230
'4817032000,  정촌면,'30,25 - 29세,1998,412,224,188
'4817032000,  정촌면,'35,30 - 34세,1998,310,182,128
'4817032000,  정촌면,'40,35 - 39세,1998,277,153,124
'4817032000,  정촌면,'45,40 - 44세,1998,290,153,137
'4817032000,  정촌면,'50,45 - 49세,1998,250,121,129
'4817032000,  정촌면,'55,50 - 54세,1998,243,128,115
'4817032000,  정촌면,'60,55 - 59세,1998,278,111,167
'4817032000,  정촌면,'65,60 - 64세,1998,270,121,149
'4817032000,  정촌면,'70,65 - 69세,1998,217,77,140
'4817032000,  정촌면,'75,70 - 74세,1998,153,50,103
'4817032000,  정촌면,'80,75 - 79세,1998,89,33,56
'4817032000,  정촌면,'85,80 - 84세,1998,42,14,28
'4817032000,  정촌면,'90,85+ ,1998,29,4,25
'4817033000,  금곡면,'00,계,1998,3806,1862,1944
'4817033000,  금곡면,'05,0 - 4세,1998,151,91,60
'4817033000,  금곡면,'10,5 - 9세,1998,136,76,60
'4817033000,  금곡면,'15,10 - 14세,1998,185,76,109
'4817033000,  금곡면,'20,15 - 19세,1998,327,177,150
'4817033000,  금곡면,'25,20 - 24세,1998,390,224,166
'4817033000,  금곡면,'30,25 - 29세,1998,365,226,139
'4817033000,  금곡면,'35,30 - 34세,1998,198,118,80
'4817033000,  금곡면,'40,35 - 39세,1998,211,118,93
'4817033000,  금곡면,'45,40 - 44세,1998,198,92,106
'4817033000,  금곡면,'50,45 - 49세,1998,192,82,110
'4817033000,  금곡면,'55,50 - 54세,1998,219,116,103
'4817033000,  금곡면,'60,55 - 59세,1998,300,119,181
'4817033000,  금곡면,'65,60 - 64세,1998,304,127,177
'4817033000,  금곡면,'70,65 - 69세,1998,254,96,158
'4817033000,  금곡면,'75,70 - 74세,1998,194,65,129
'4817033000,  금곡면,'80,75 - 79세,1998,116,41,75
'4817033000,  금곡면,'85,80 - 84세,1998,46,14,32
'4817033000,  금곡면,'90,85+ ,1998,20,4,16
'4817035000,  진성면,'00,계,1998,3366,1642,1724
'4817035000,  진성면,'05,0 - 4세,1998,140,67,73
'4817035000,  진성면,'10,5 - 9세,1998,136,83,53
'4817035000,  진성면,'15,10 - 14세,1998,154,76,78
'4817035000,  진성면,'20,15 - 19세,1998,306,159,147
'4817035000,  진성면,'25,20 - 24세,1998,326,181,145
'4817035000,  진성면,'30,25 - 29세,1998,290,174,116
'4817035000,  진성면,'35,30 - 34세,1998,196,122,74
'4817035000,  진성면,'40,35 - 39세,1998,198,94,104
'4817035000,  진성면,'45,40 - 44세,1998,199,114,85
'4817035000,  진성면,'50,45 - 49세,1998,165,82,83
'4817035000,  진성면,'55,50 - 54세,1998,162,72,90
'4817035000,  진성면,'60,55 - 59세,1998,253,108,145
'4817035000,  진성면,'65,60 - 64세,1998,271,115,156
'4817035000,  진성면,'70,65 - 69세,1998,239,85,154
'4817035000,  진성면,'75,70 - 74세,1998,138,55,83
'4817035000,  진성면,'80,75 - 79세,1998,112,41,71
'4817035000,  진성면,'85,80 - 84세,1998,55,12,43
'4817035000,  진성면,'90,85+ ,1998,26,2,24
'4817036000,  일반성면,'00,계,1998,4259,2081,2178
'4817036000,  일반성면,'05,0 - 4세,1998,197,93,104
'4817036000,  일반성면,'10,5 - 9세,1998,232,127,105
'4817036000,  일반성면,'15,10 - 14세,1998,255,133,122
'4817036000,  일반성면,'20,15 - 19세,1998,382,192,190
'4817036000,  일반성면,'25,20 - 24세,1998,423,238,185
'4817036000,  일반성면,'30,25 - 29세,1998,342,209,133
'4817036000,  일반성면,'35,30 - 34세,1998,280,144,136
'4817036000,  일반성면,'40,35 - 39세,1998,287,148,139
'4817036000,  일반성면,'45,40 - 44세,1998,287,147,140
'4817036000,  일반성면,'50,45 - 49세,1998,219,112,107
'4817036000,  일반성면,'55,50 - 54세,1998,200,98,102
'4817036000,  일반성면,'60,55 - 59세,1998,279,114,165
'4817036000,  일반성면,'65,60 - 64세,1998,288,116,172
'4817036000,  일반성면,'70,65 - 69세,1998,242,83,159
'4817036000,  일반성면,'75,70 - 74세,1998,166,63,103
'4817036000,  일반성면,'80,75 - 79세,1998,115,39,76
'4817036000,  일반성면,'85,80 - 84세,1998,45,22,23
'4817036000,  일반성면,'90,85+ ,1998,20,3,17
'4817037000,  이반성면,'00,계,1998,2766,1324,1442
'4817037000,  이반성면,'05,0 - 4세,1998,72,36,36
'4817037000,  이반성면,'10,5 - 9세,1998,103,50,53
'4817037000,  이반성면,'15,10 - 14세,1998,107,54,53
'4817037000,  이반성면,'20,15 - 19세,1998,222,110,112
'4817037000,  이반성면,'25,20 - 24세,1998,239,136,103
'4817037000,  이반성면,'30,25 - 29세,1998,212,143,69
'4817037000,  이반성면,'35,30 - 34세,1998,125,73,52
'4817037000,  이반성면,'40,35 - 39세,1998,126,72,54
'4817037000,  이반성면,'45,40 - 44세,1998,155,82,73
'4817037000,  이반성면,'50,45 - 49세,1998,127,70,57
'4817037000,  이반성면,'55,50 - 54세,1998,139,55,84
'4817037000,  이반성면,'60,55 - 59세,1998,252,97,155
'4817037000,  이반성면,'65,60 - 64세,1998,270,111,159
'4817037000,  이반성면,'70,65 - 69세,1998,244,101,143
'4817037000,  이반성면,'75,70 - 74세,1998,174,73,101
'4817037000,  이반성면,'80,75 - 79세,1998,114,38,76
'4817037000,  이반성면,'85,80 - 84세,1998,50,17,33
'4817037000,  이반성면,'90,85+ ,1998,35,6,29
'4817038000,  사봉면,'00,계,1998,2727,1339,1388
'4817038000,  사봉면,'05,0 - 4세,1998,80,45,35
'4817038000,  사봉면,'10,5 - 9세,1998,83,46,37
'4817038000,  사봉면,'15,10 - 14세,1998,121,51,70
'4817038000,  사봉면,'20,15 - 19세,1998,239,128,111
'4817038000,  사봉면,'25,20 - 24세,1998,270,168,102
'4817038000,  사봉면,'30,25 - 29세,1998,205,136,69
'4817038000,  사봉면,'35,30 - 34세,1998,121,79,42
'4817038000,  사봉면,'40,35 - 39세,1998,156,88,68
'4817038000,  사봉면,'45,40 - 44세,1998,175,91,84
'4817038000,  사봉면,'50,45 - 49세,1998,147,79,68
'4817038000,  사봉면,'55,50 - 54세,1998,141,60,81
'4817038000,  사봉면,'60,55 - 59세,1998,221,99,122
'4817038000,  사봉면,'65,60 - 64세,1998,251,99,152
'4817038000,  사봉면,'70,65 - 69세,1998,217,70,147
'4817038000,  사봉면,'75,70 - 74세,1998,147,49,98
'4817038000,  사봉면,'80,75 - 79세,1998,101,34,67
'4817038000,  사봉면,'85,80 - 84세,1998,36,11,25
'4817038000,  사봉면,'90,85+ ,1998,16,6,10
'4817039000,  지수면,'00,계,1998,2581,1286,1295
'4817039000,  지수면,'05,0 - 4세,1998,109,59,50
'4817039000,  지수면,'10,5 - 9세,1998,88,47,41
'4817039000,  지수면,'15,10 - 14세,1998,108,54,54
'4817039000,  지수면,'20,15 - 19세,1998,192,91,101
'4817039000,  지수면,'25,20 - 24세,1998,264,152,112
'4817039000,  지수면,'30,25 - 29세,1998,214,148,66
'4817039000,  지수면,'35,30 - 34세,1998,120,79,41
'4817039000,  지수면,'40,35 - 39세,1998,159,89,70
'4817039000,  지수면,'45,40 - 44세,1998,135,67,68
'4817039000,  지수면,'50,45 - 49세,1998,121,61,60
'4817039000,  지수면,'55,50 - 54세,1998,130,62,68
'4817039000,  지수면,'60,55 - 59세,1998,213,106,107
'4817039000,  지수면,'65,60 - 64세,1998,223,75,148
'4817039000,  지수면,'70,65 - 69세,1998,167,61,106
'4817039000,  지수면,'75,70 - 74세,1998,147,51,96
'4817039000,  지수면,'80,75 - 79세,1998,101,54,47
'4817039000,  지수면,'85,80 - 84세,1998,52,18,34
'4817039000,  지수면,'90,85+ ,1998,38,12,26
'4817040000,  대곡면,'00,계,1998,5764,2888,2876
'4817040000,  대곡면,'05,0 - 4세,1998,256,144,112
'4817040000,  대곡면,'10,5 - 9세,1998,290,172,118
'4817040000,  대곡면,'15,10 - 14세,1998,282,136,146
'4817040000,  대곡면,'20,15 - 19세,1998,495,262,233
'4817040000,  대곡면,'25,20 - 24세,1998,575,321,254
'4817040000,  대곡면,'30,25 - 29세,1998,505,286,219
'4817040000,  대곡면,'35,30 - 34세,1998,347,202,145
'4817040000,  대곡면,'40,35 - 39세,1998,336,201,135
'4817040000,  대곡면,'45,40 - 44세,1998,334,173,161
'4817040000,  대곡면,'50,45 - 49세,1998,243,120,123
'4817040000,  대곡면,'55,50 - 54세,1998,313,141,172
'4817040000,  대곡면,'60,55 - 59세,1998,437,178,259
'4817040000,  대곡면,'65,60 - 64세,1998,473,208,265
'4817040000,  대곡면,'70,65 - 69세,1998,380,144,236
'4817040000,  대곡면,'75,70 - 74세,1998,250,116,134
'4817040000,  대곡면,'80,75 - 79세,1998,140,55,85
'4817040000,  대곡면,'85,80 - 84세,1998,73,20,53
'4817040000,  대곡면,'90,85+ ,1998,35,9,26
'4817041000,  금산면,'00,계,1998,7897,4046,3851
'4817041000,  금산면,'05,0 - 4세,1998,570,291,279
'4817041000,  금산면,'10,5 - 9세,1998,553,307,246
'4817041000,  금산면,'15,10 - 14세,1998,456,237,219
'4817041000,  금산면,'20,15 - 19세,1998,645,348,297
'4817041000,  금산면,'25,20 - 24세,1998,655,345,310
'4817041000,  금산면,'30,25 - 29세,1998,843,482,361
'4817041000,  금산면,'35,30 - 34세,1998,693,381,312
'4817041000,  금산면,'40,35 - 39세,1998,649,356,293
'4817041000,  금산면,'45,40 - 44세,1998,527,293,234
'4817041000,  금산면,'50,45 - 49세,1998,360,187,173
'4817041000,  금산면,'55,50 - 54세,1998,369,173,196
'4817041000,  금산면,'60,55 - 59세,1998,435,206,229
'4817041000,  금산면,'65,60 - 64세,1998,414,177,237
'4817041000,  금산면,'70,65 - 69세,1998,314,124,190
'4817041000,  금산면,'75,70 - 74세,1998,196,79,117
'4817041000,  금산면,'80,75 - 79세,1998,122,32,90
'4817041000,  금산면,'85,80 - 84세,1998,65,20,45
'4817041000,  금산면,'90,85+ ,1998,31,8,23
'4817042000,  집현면,'00,계,1998,5168,2629,2539
'4817042000,  집현면,'05,0 - 4세,1998,240,136,104
'4817042000,  집현면,'10,5 - 9세,1998,219,123,96
'4817042000,  집현면,'15,10 - 14세,1998,259,133,126
'4817042000,  집현면,'20,15 - 19세,1998,507,256,251
'4817042000,  집현면,'25,20 - 24세,1998,563,296,267
'4817042000,  집현면,'30,25 - 29세,1998,503,327,176
'4817042000,  집현면,'35,30 - 34세,1998,302,187,115
'4817042000,  집현면,'40,35 - 39세,1998,357,202,155
'4817042000,  집현면,'45,40 - 44세,1998,320,184,136
'4817042000,  집현면,'50,45 - 49세,1998,235,129,106
'4817042000,  집현면,'55,50 - 54세,1998,279,112,167
'4817042000,  집현면,'60,55 - 59세,1998,382,159,223
'4817042000,  집현면,'65,60 - 64세,1998,366,157,209
'4817042000,  집현면,'70,65 - 69세,1998,319,124,195
'4817042000,  집현면,'75,70 - 74세,1998,175,73,102
'4817042000,  집현면,'80,75 - 79세,1998,82,18,64
'4817042000,  집현면,'85,80 - 84세,1998,33,7,26
'4817042000,  집현면,'90,85+ ,1998,27,6,21
'4817043000,  미천면,'00,계,1998,2948,1464,1484
'4817043000,  미천면,'05,0 - 4세,1998,83,51,32
'4817043000,  미천면,'10,5 - 9세,1998,81,36,45
'4817043000,  미천면,'15,10 - 14세,1998,134,64,70
'4817043000,  미천면,'20,15 - 19세,1998,235,121,114
'4817043000,  미천면,'25,20 - 24세,1998,285,160,125
'4817043000,  미천면,'30,25 - 29세,1998,283,193,90
'4817043000,  미천면,'35,30 - 34세,1998,116,76,40
'4817043000,  미천면,'40,35 - 39세,1998,144,78,66
'4817043000,  미천면,'45,40 - 44세,1998,165,94,71
'4817043000,  미천면,'50,45 - 49세,1998,134,76,58
'4817043000,  미천면,'55,50 - 54세,1998,178,74,104
'4817043000,  미천면,'60,55 - 59세,1998,261,103,158
'4817043000,  미천면,'65,60 - 64세,1998,290,119,171
'4817043000,  미천면,'70,65 - 69세,1998,230,91,139
'4817043000,  미천면,'75,70 - 74세,1998,166,70,96
'4817043000,  미천면,'80,75 - 79세,1998,99,35,64
'4817043000,  미천면,'85,80 - 84세,1998,45,17,28
'4817043000,  미천면,'90,85+ ,1998,19,6,13
'4817044000,  명석면,'00,계,1998,6071,3089,2982
'4817044000,  명석면,'05,0 - 4세,1998,404,203,201
'4817044000,  명석면,'10,5 - 9세,1998,292,168,124
'4817044000,  명석면,'15,10 - 14세,1998,283,153,130
'4817044000,  명석면,'20,15 - 19세,1998,528,264,264
'4817044000,  명석면,'25,20 - 24세,1998,579,327,252
'4817044000,  명석면,'30,25 - 29세,1998,584,310,274
'4817044000,  명석면,'35,30 - 34세,1998,463,273,190
'4817044000,  명석면,'40,35 - 39세,1998,508,296,212
'4817044000,  명석면,'45,40 - 44세,1998,398,203,195
'4817044000,  명석면,'50,45 - 49세,1998,304,172,132
'4817044000,  명석면,'55,50 - 54세,1998,292,134,158
'4817044000,  명석면,'60,55 - 59세,1998,345,162,183
'4817044000,  명석면,'65,60 - 64세,1998,350,138,212
'4817044000,  명석면,'70,65 - 69세,1998,352,139,213
'4817044000,  명석면,'75,70 - 74세,1998,199,78,121
'4817044000,  명석면,'80,75 - 79세,1998,106,44,62
'4817044000,  명석면,'85,80 - 84세,1998,56,17,39
'4817044000,  명석면,'90,85+ ,1998,28,8,20
'4817045000,  대평면,'00,계,1998,1782,912,870
'4817045000,  대평면,'05,0 - 4세,1998,84,49,35
'4817045000,  대평면,'10,5 - 9세,1998,43,21,22
'4817045000,  대평면,'15,10 - 14세,1998,59,32,27
'4817045000,  대평면,'20,15 - 19세,1998,178,84,94
'4817045000,  대평면,'25,20 - 24세,1998,196,107,89
'4817045000,  대평면,'30,25 - 29세,1998,161,103,58
'4817045000,  대평면,'35,30 - 34세,1998,91,64,27
'4817045000,  대평면,'40,35 - 39세,1998,98,62,36
'4817045000,  대평면,'45,40 - 44세,1998,121,71,50
'4817045000,  대평면,'50,45 - 49세,1998,90,48,42
'4817045000,  대평면,'55,50 - 54세,1998,112,54,58
'4817045000,  대평면,'60,55 - 59세,1998,132,56,76
'4817045000,  대평면,'65,60 - 64세,1998,132,52,80
'4817045000,  대평면,'70,65 - 69세,1998,112,43,69
'4817045000,  대평면,'75,70 - 74세,1998,79,34,45
'4817045000,  대평면,'80,75 - 79세,1998,51,22,29
'4817045000,  대평면,'85,80 - 84세,1998,23,7,16
'4817045000,  대평면,'90,85+ ,1998,20,3,17
'4817046000,  수곡면,'00,계,1998,3230,1613,1617
'4817046000,  수곡면,'05,0 - 4세,1998,103,54,49
'4817046000,  수곡면,'10,5 - 9세,1998,107,63,44
'4817046000,  수곡면,'15,10 - 14세,1998,131,60,71
'4817046000,  수곡면,'20,15 - 19세,1998,261,134,127
'4817046000,  수곡면,'25,20 - 24세,1998,335,176,159
'4817046000,  수곡면,'30,25 - 29세,1998,251,167,84
'4817046000,  수곡면,'35,30 - 34세,1998,147,92,55
'4817046000,  수곡면,'40,35 - 39세,1998,170,99,71
'4817046000,  수곡면,'45,40 - 44세,1998,174,87,87
'4817046000,  수곡면,'50,45 - 49세,1998,156,86,70
'4817046000,  수곡면,'55,50 - 54세,1998,191,85,106
'4817046000,  수곡면,'60,55 - 59세,1998,305,125,180
'4817046000,  수곡면,'65,60 - 64세,1998,300,124,176
'4817046000,  수곡면,'70,65 - 69세,1998,260,120,140
'4817046000,  수곡면,'75,70 - 74세,1998,157,70,87
'4817046000,  수곡면,'80,75 - 79세,1998,95,42,53
'4817046000,  수곡면,'85,80 - 84세,1998,57,22,35
'4817046000,  수곡면,'90,85+ ,1998,30,7,23
'4817051000,  망경동,'00,계,1998,17246,8644,8602
'4817051000,  망경동,'05,0 - 4세,1998,1227,665,562
'4817051000,  망경동,'10,5 - 9세,1998,1133,638,495
'4817051000,  망경동,'15,10 - 14세,1998,1221,664,557
'4817051000,  망경동,'20,15 - 19세,1998,1753,916,837
'4817051000,  망경동,'25,20 - 24세,1998,1682,850,832
'4817051000,  망경동,'30,25 - 29세,1998,1635,833,802
'4817051000,  망경동,'35,30 - 34세,1998,1427,729,698
'4817051000,  망경동,'40,35 - 39세,1998,1502,739,763
'4817051000,  망경동,'45,40 - 44세,1998,1375,661,714
'4817051000,  망경동,'50,45 - 49세,1998,1094,531,563
'4817051000,  망경동,'55,50 - 54세,1998,853,409,444
'4817051000,  망경동,'60,55 - 59세,1998,763,380,383
'4817051000,  망경동,'65,60 - 64세,1998,625,276,349
'4817051000,  망경동,'70,65 - 69세,1998,400,169,231
'4817051000,  망경동,'75,70 - 74세,1998,246,91,155
'4817051000,  망경동,'80,75 - 79세,1998,174,58,116
'4817051000,  망경동,'85,80 - 84세,1998,84,25,59
'4817051000,  망경동,'90,85+ ,1998,52,10,42
'4817052000,  강남동,'00,계,1998,8787,4260,4527
'4817052000,  강남동,'05,0 - 4세,1998,556,281,275
'4817052000,  강남동,'10,5 - 9세,1998,585,325,260
'4817052000,  강남동,'15,10 - 14세,1998,545,295,250
'4817052000,  강남동,'20,15 - 19세,1998,855,414,441
'4817052000,  강남동,'25,20 - 24세,1998,880,451,429
'4817052000,  강남동,'30,25 - 29세,1998,884,446,438
'4817052000,  강남동,'35,30 - 34세,1998,669,335,334
'4817052000,  강남동,'40,35 - 39세,1998,711,331,380
'4817052000,  강남동,'45,40 - 44세,1998,684,330,354
'4817052000,  강남동,'50,45 - 49세,1998,516,231,285
'4817052000,  강남동,'55,50 - 54세,1998,505,235,270
'4817052000,  강남동,'60,55 - 59세,1998,480,230,250
'4817052000,  강남동,'65,60 - 64세,1998,342,154,188
'4817052000,  강남동,'70,65 - 69세,1998,230,81,149
'4817052000,  강남동,'75,70 - 74세,1998,160,65,95
'4817052000,  강남동,'80,75 - 79세,1998,110,40,70
'4817052000,  강남동,'85,80 - 84세,1998,49,13,36
'4817052000,  강남동,'90,85+ ,1998,26,3,23
'4817053000,  칠암동,'00,계,1998,9650,4809,4841
'4817053000,  칠암동,'05,0 - 4세,1998,585,338,247
'4817053000,  칠암동,'10,5 - 9세,1998,693,384,309
'4817053000,  칠암동,'15,10 - 14세,1998,664,350,314
'4817053000,  칠암동,'20,15 - 19세,1998,923,511,412
'4817053000,  칠암동,'25,20 - 24세,1998,940,477,463
'4817053000,  칠암동,'30,25 - 29세,1998,1004,550,454
'4817053000,  칠암동,'35,30 - 34세,1998,691,336,355
'4817053000,  칠암동,'40,35 - 39세,1998,788,367,421
'4817053000,  칠암동,'45,40 - 44세,1998,725,342,383
'4817053000,  칠암동,'50,45 - 49세,1998,595,252,343
'4817053000,  칠암동,'55,50 - 54세,1998,549,260,289
'4817053000,  칠암동,'60,55 - 59세,1998,526,261,265
'4817053000,  칠암동,'65,60 - 64세,1998,351,161,190
'4817053000,  칠암동,'70,65 - 69세,1998,233,86,147
'4817053000,  칠암동,'75,70 - 74세,1998,168,59,109
'4817053000,  칠암동,'80,75 - 79세,1998,112,47,65
'4817053000,  칠암동,'85,80 - 84세,1998,70,24,46
'4817053000,  칠암동,'90,85+ ,1998,33,4,29
'4817054500,  성지동,'00,계,1998,7663,3747,3916
'4817054500,  성지동,'05,0 - 4세,1998,363,187,176
'4817054500,  성지동,'10,5 - 9세,1998,385,213,172
'4817054500,  성지동,'15,10 - 14세,1998,516,279,237
'4817054500,  성지동,'20,15 - 19세,1998,847,455,392
'4817054500,  성지동,'25,20 - 24세,1998,849,430,419
'4817054500,  성지동,'30,25 - 29세,1998,682,385,297
'4817054500,  성지동,'35,30 - 34세,1998,495,262,233
'4817054500,  성지동,'40,35 - 39세,1998,603,260,343
'4817054500,  성지동,'45,40 - 44세,1998,615,293,322
'4817054500,  성지동,'50,45 - 49세,1998,547,245,302
'4817054500,  성지동,'55,50 - 54세,1998,470,220,250
'4817054500,  성지동,'60,55 - 59세,1998,423,192,231
'4817054500,  성지동,'65,60 - 64세,1998,319,151,168
'4817054500,  성지동,'70,65 - 69세,1998,216,80,136
'4817054500,  성지동,'75,70 - 74세,1998,164,49,115
'4817054500,  성지동,'80,75 - 79세,1998,95,29,66
'4817054500,  성지동,'85,80 - 84세,1998,53,12,41
'4817054500,  성지동,'90,85+ ,1998,21,5,16
'4817056500,  중앙동,'00,계,1998,6083,2950,3133
'4817056500,  중앙동,'05,0 - 4세,1998,272,148,124
'4817056500,  중앙동,'10,5 - 9세,1998,283,159,124
'4817056500,  중앙동,'15,10 - 14세,1998,347,180,167
'4817056500,  중앙동,'20,15 - 19세,1998,625,336,289
'4817056500,  중앙동,'25,20 - 24세,1998,672,366,306
'4817056500,  중앙동,'30,25 - 29세,1998,567,299,268
'4817056500,  중앙동,'35,30 - 34세,1998,387,189,198
'4817056500,  중앙동,'40,35 - 39세,1998,435,198,237
'4817056500,  중앙동,'45,40 - 44세,1998,499,206,293
'4817056500,  중앙동,'50,45 - 49세,1998,491,205,286
'4817056500,  중앙동,'55,50 - 54세,1998,412,199,213
'4817056500,  중앙동,'60,55 - 59세,1998,406,177,229
'4817056500,  중앙동,'65,60 - 64세,1998,309,150,159
'4817056500,  중앙동,'70,65 - 69세,1998,158,61,97
'4817056500,  중앙동,'75,70 - 74세,1998,99,40,59
'4817056500,  중앙동,'80,75 - 79세,1998,63,21,42
'4817056500,  중앙동,'85,80 - 84세,1998,33,10,23
'4817056500,  중앙동,'90,85+ ,1998,25,6,19
'4817057500,  봉안동,'00,계,1998,7929,3852,4077
'4817057500,  봉안동,'05,0 - 4세,1998,363,199,164
'4817057500,  봉안동,'10,5 - 9세,1998,472,267,205
'4817057500,  봉안동,'15,10 - 14세,1998,538,272,266
'4817057500,  봉안동,'20,15 - 19세,1998,819,428,391
'4817057500,  봉안동,'25,20 - 24세,1998,841,460,381
'4817057500,  봉안동,'30,25 - 29세,1998,764,406,358
'4817057500,  봉안동,'35,30 - 34세,1998,533,249,284
'4817057500,  봉안동,'40,35 - 39세,1998,673,300,373
'4817057500,  봉안동,'45,40 - 44세,1998,647,282,365
'4817057500,  봉안동,'50,45 - 49세,1998,547,248,299
'4817057500,  봉안동,'55,50 - 54세,1998,463,199,264
'4817057500,  봉안동,'60,55 - 59세,1998,418,199,219
'4817057500,  봉안동,'65,60 - 64세,1998,298,155,143
'4817057500,  봉안동,'70,65 - 69세,1998,206,74,132
'4817057500,  봉안동,'75,70 - 74세,1998,150,55,95
'4817057500,  봉안동,'80,75 - 79세,1998,115,35,80
'4817057500,  봉안동,'85,80 - 84세,1998,50,16,34
'4817057500,  봉안동,'90,85+ ,1998,32,8,24
'4817059000,  상봉동동,'00,계,1998,9538,4697,4841
'4817059000,  상봉동동,'05,0 - 4세,1998,554,299,255
'4817059000,  상봉동동,'10,5 - 9세,1998,534,292,242
'4817059000,  상봉동동,'15,10 - 14세,1998,634,356,278
'4817059000,  상봉동동,'20,15 - 19세,1998,1016,541,475
'4817059000,  상봉동동,'25,20 - 24세,1998,1023,527,496
'4817059000,  상봉동동,'30,25 - 29세,1998,943,474,469
'4817059000,  상봉동동,'35,30 - 34세,1998,668,346,322
'4817059000,  상봉동동,'40,35 - 39세,1998,768,377,391
'4817059000,  상봉동동,'45,40 - 44세,1998,765,363,402
'4817059000,  상봉동동,'50,45 - 49세,1998,604,279,325
'4817059000,  상봉동동,'55,50 - 54세,1998,511,245,266
'4817059000,  상봉동동,'60,55 - 59세,1998,480,228,252
'4817059000,  상봉동동,'65,60 - 64세,1998,387,165,222
'4817059000,  상봉동동,'70,65 - 69세,1998,273,91,182
'4817059000,  상봉동동,'75,70 - 74세,1998,168,53,115
'4817059000,  상봉동동,'80,75 - 79세,1998,121,42,79
'4817059000,  상봉동동,'85,80 - 84세,1998,60,14,46
'4817059000,  상봉동동,'90,85+ ,1998,29,5,24
'4817060000,  상봉서동,'00,계,1998,13928,6841,7087
'4817060000,  상봉서동,'05,0 - 4세,1998,877,466,411
'4817060000,  상봉서동,'10,5 - 9세,1998,934,530,404
'4817060000,  상봉서동,'15,10 - 14세,1998,1035,558,477
'4817060000,  상봉서동,'20,15 - 19세,1998,1585,831,754
'4817060000,  상봉서동,'25,20 - 24세,1998,1366,683,683
'4817060000,  상봉서동,'30,25 - 29세,1998,1287,653,634
'4817060000,  상봉서동,'35,30 - 34세,1998,1025,487,538
'4817060000,  상봉서동,'40,35 - 39세,1998,1231,553,678
'4817060000,  상봉서동,'45,40 - 44세,1998,1206,563,643
'4817060000,  상봉서동,'50,45 - 49세,1998,918,435,483
'4817060000,  상봉서동,'55,50 - 54세,1998,672,336,336
'4817060000,  상봉서동,'60,55 - 59세,1998,614,297,317
'4817060000,  상봉서동,'65,60 - 64세,1998,457,222,235
'4817060000,  상봉서동,'70,65 - 69세,1998,275,104,171
'4817060000,  상봉서동,'75,70 - 74세,1998,209,66,143
'4817060000,  상봉서동,'80,75 - 79세,1998,126,26,100
'4817060000,  상봉서동,'85,80 - 84세,1998,63,18,45
'4817060000,  상봉서동,'90,85+ ,1998,48,13,35
'4817061500,  봉수동,'00,계,1998,6791,3377,3414
'4817061500,  봉수동,'05,0 - 4세,1998,355,173,182
'4817061500,  봉수동,'10,5 - 9세,1998,420,243,177
'4817061500,  봉수동,'15,10 - 14세,1998,457,248,209
'4817061500,  봉수동,'20,15 - 19세,1998,706,405,301
'4817061500,  봉수동,'25,20 - 24세,1998,666,376,290
'4817061500,  봉수동,'30,25 - 29세,1998,658,365,293
'4817061500,  봉수동,'35,30 - 34세,1998,447,227,220
'4817061500,  봉수동,'40,35 - 39세,1998,573,268,305
'4817061500,  봉수동,'45,40 - 44세,1998,550,255,295
'4817061500,  봉수동,'50,45 - 49세,1998,402,193,209
'4817061500,  봉수동,'55,50 - 54세,1998,390,177,213
'4817061500,  봉수동,'60,55 - 59세,1998,422,189,233
'4817061500,  봉수동,'65,60 - 64세,1998,278,118,160
'4817061500,  봉수동,'70,65 - 69세,1998,182,66,116
'4817061500,  봉수동,'75,70 - 74세,1998,112,36,76
'4817061500,  봉수동,'80,75 - 79세,1998,95,19,76
'4817061500,  봉수동,'85,80 - 84세,1998,53,15,38
'4817061500,  봉수동,'90,85+ ,1998,25,4,21
'4817064500,  옥봉동,'00,계,1998,10490,5158,5332
'4817064500,  옥봉동,'05,0 - 4세,1998,599,334,265
'4817064500,  옥봉동,'10,5 - 9세,1998,577,311,266
'4817064500,  옥봉동,'15,10 - 14세,1998,644,361,283
'4817064500,  옥봉동,'20,15 - 19세,1998,1087,588,499
'4817064500,  옥봉동,'25,20 - 24세,1998,1096,563,533
'4817064500,  옥봉동,'30,25 - 29세,1998,1032,534,498
'4817064500,  옥봉동,'35,30 - 34세,1998,789,402,387
'4817064500,  옥봉동,'40,35 - 39세,1998,777,382,395
'4817064500,  옥봉동,'45,40 - 44세,1998,859,412,447
'4817064500,  옥봉동,'50,45 - 49세,1998,707,354,353
'4817064500,  옥봉동,'55,50 - 54세,1998,595,264,331
'4817064500,  옥봉동,'60,55 - 59세,1998,579,265,314
'4817064500,  옥봉동,'65,60 - 64세,1998,443,177,266
'4817064500,  옥봉동,'70,65 - 69세,1998,283,92,191
'4817064500,  옥봉동,'75,70 - 74세,1998,210,68,142
'4817064500,  옥봉동,'80,75 - 79세,1998,116,33,83
'4817064500,  옥봉동,'85,80 - 84세,1998,62,12,50
'4817064500,  옥봉동,'90,85+ ,1998,35,6,29
'4817066000,  상대1동,'00,계,1998,18190,9008,9182
'4817066000,  상대1동,'05,0 - 4세,1998,1208,661,547
'4817066000,  상대1동,'10,5 - 9세,1998,1320,714,606
'4817066000,  상대1동,'15,10 - 14세,1998,1430,801,629
'4817066000,  상대1동,'20,15 - 19세,1998,1878,944,934
'4817066000,  상대1동,'25,20 - 24세,1998,1845,918,927
'4817066000,  상대1동,'30,25 - 29세,1998,1772,914,858
'4817066000,  상대1동,'35,30 - 34세,1998,1381,663,718
'4817066000,  상대1동,'40,35 - 39세,1998,1630,774,856
'4817066000,  상대1동,'45,40 - 44세,1998,1512,725,787
'4817066000,  상대1동,'50,45 - 49세,1998,1182,564,618
'4817066000,  상대1동,'55,50 - 54세,1998,880,434,446
'4817066000,  상대1동,'60,55 - 59세,1998,753,384,369
'4817066000,  상대1동,'65,60 - 64세,1998,503,251,252
'4817066000,  상대1동,'70,65 - 69세,1998,331,128,203
'4817066000,  상대1동,'75,70 - 74세,1998,265,66,199
'4817066000,  상대1동,'80,75 - 79세,1998,162,40,122
'4817066000,  상대1동,'85,80 - 84세,1998,88,18,70
'4817066000,  상대1동,'90,85+ ,1998,50,9,41
'4817067000,  상대2동,'00,계,1998,13146,6542,6604
'4817067000,  상대2동,'05,0 - 4세,1998,1153,600,553
'4817067000,  상대2동,'10,5 - 9세,1998,920,514,406
'4817067000,  상대2동,'15,10 - 14세,1998,918,507,411
'4817067000,  상대2동,'20,15 - 19세,1998,1348,703,645
'4817067000,  상대2동,'25,20 - 24세,1998,1296,660,636
'4817067000,  상대2동,'30,25 - 29세,1998,1411,648,763
'4817067000,  상대2동,'35,30 - 34세,1998,1279,647,632
'4817067000,  상대2동,'40,35 - 39세,1998,1169,575,594
'4817067000,  상대2동,'45,40 - 44세,1998,1003,482,521
'4817067000,  상대2동,'50,45 - 49세,1998,795,363,432
'4817067000,  상대2동,'55,50 - 54세,1998,596,298,298
'4817067000,  상대2동,'60,55 - 59세,1998,460,251,209
'4817067000,  상대2동,'65,60 - 64세,1998,296,135,161
'4817067000,  상대2동,'70,65 - 69세,1998,204,74,130
'4817067000,  상대2동,'75,70 - 74세,1998,135,54,81
'4817067000,  상대2동,'80,75 - 79세,1998,90,22,68
'4817067000,  상대2동,'85,80 - 84세,1998,43,6,37
'4817067000,  상대2동,'90,85+ ,1998,30,3,27
'4817067600,  하대1동,'00,계,1998,17598,8763,8835
'4817067600,  하대1동,'05,0 - 4세,1998,1507,832,675
'4817067600,  하대1동,'10,5 - 9세,1998,1497,832,665
'4817067600,  하대1동,'15,10 - 14세,1998,1552,828,724
'4817067600,  하대1동,'20,15 - 19세,1998,2027,1026,1001
'4817067600,  하대1동,'25,20 - 24세,1998,1398,673,725
'4817067600,  하대1동,'30,25 - 29세,1998,1562,709,853
'4817067600,  하대1동,'35,30 - 34세,1998,1644,790,854
'4817067600,  하대1동,'40,35 - 39세,1998,1871,877,994
'4817067600,  하대1동,'45,40 - 44세,1998,1584,801,783
'4817067600,  하대1동,'50,45 - 49세,1998,980,518,462
'4817067600,  하대1동,'55,50 - 54세,1998,609,340,269
'4817067600,  하대1동,'60,55 - 59세,1998,467,234,233
'4817067600,  하대1동,'65,60 - 64세,1998,324,134,190
'4817067600,  하대1동,'70,65 - 69세,1998,221,80,141
'4817067600,  하대1동,'75,70 - 74세,1998,174,45,129
'4817067600,  하대1동,'80,75 - 79세,1998,87,22,65
'4817067600,  하대1동,'85,80 - 84세,1998,70,18,52
'4817067600,  하대1동,'90,85+ ,1998,24,4,20
'4817067700,  하대2동,'00,계,1998,16454,8215,8239
'4817067700,  하대2동,'05,0 - 4세,1998,1375,751,624
'4817067700,  하대2동,'10,5 - 9세,1998,1591,900,691
'4817067700,  하대2동,'15,10 - 14세,1998,1689,897,792
'4817067700,  하대2동,'20,15 - 19세,1998,1711,899,812
'4817067700,  하대2동,'25,20 - 24세,1998,1090,551,539
'4817067700,  하대2동,'30,25 - 29세,1998,1257,536,721
'4817067700,  하대2동,'35,30 - 34세,1998,1561,720,841
'4817067700,  하대2동,'40,35 - 39세,1998,1989,928,1061
'4817067700,  하대2동,'45,40 - 44세,1998,1632,851,781
'4817067700,  하대2동,'50,45 - 49세,1998,884,477,407
'4817067700,  하대2동,'55,50 - 54세,1998,493,270,223
'4817067700,  하대2동,'60,55 - 59세,1998,344,179,165
'4817067700,  하대2동,'65,60 - 64세,1998,243,117,126
'4817067700,  하대2동,'70,65 - 69세,1998,173,53,120
'4817067700,  하대2동,'75,70 - 74세,1998,154,28,126
'4817067700,  하대2동,'80,75 - 79세,1998,142,41,101
'4817067700,  하대2동,'85,80 - 84세,1998,75,15,60
'4817067700,  하대2동,'90,85+ ,1998,51,2,49
'4817068000,  상평동,'00,계,1998,16301,8077,8224
'4817068000,  상평동,'05,0 - 4세,1998,1251,670,581
'4817068000,  상평동,'10,5 - 9세,1998,1102,611,491
'4817068000,  상평동,'15,10 - 14세,1998,1231,632,599
'4817068000,  상평동,'20,15 - 19세,1998,1767,883,884
'4817068000,  상평동,'25,20 - 24세,1998,1625,808,817
'4817068000,  상평동,'30,25 - 29세,1998,1652,801,851
'4817068000,  상평동,'35,30 - 34세,1998,1391,713,678
'4817068000,  상평동,'40,35 - 39세,1998,1485,719,766
'4817068000,  상평동,'45,40 - 44세,1998,1368,642,726
'4817068000,  상평동,'50,45 - 49세,1998,996,497,499
'4817068000,  상평동,'55,50 - 54세,1998,792,411,381
'4817068000,  상평동,'60,55 - 59세,1998,562,287,275
'4817068000,  상평동,'65,60 - 64세,1998,378,189,189
'4817068000,  상평동,'70,65 - 69세,1998,265,90,175
'4817068000,  상평동,'75,70 - 74세,1998,220,70,150
'4817068000,  상평동,'80,75 - 79세,1998,124,32,92
'4817068000,  상평동,'85,80 - 84세,1998,54,14,40
'4817068000,  상평동,'90,85+ ,1998,38,8,30
'4817069500,  초장동,'00,계,1998,9884,5025,4859
'4817069500,  초장동,'05,0 - 4세,1998,955,507,448
'4817069500,  초장동,'10,5 - 9세,1998,1023,561,462
'4817069500,  초장동,'15,10 - 14세,1998,858,453,405
'4817069500,  초장동,'20,15 - 19세,1998,803,451,352
'4817069500,  초장동,'25,20 - 24세,1998,633,335,298
'4817069500,  초장동,'30,25 - 29세,1998,825,375,450
'4817069500,  초장동,'35,30 - 34세,1998,1126,518,608
'4817069500,  초장동,'40,35 - 39세,1998,1167,628,539
'4817069500,  초장동,'45,40 - 44세,1998,777,428,349
'4817069500,  초장동,'50,45 - 49세,1998,440,231,209
'4817069500,  초장동,'55,50 - 54세,1998,291,148,143
'4817069500,  초장동,'60,55 - 59세,1998,308,146,162
'4817069500,  초장동,'65,60 - 64세,1998,227,97,130
'4817069500,  초장동,'70,65 - 69세,1998,190,68,122
'4817069500,  초장동,'75,70 - 74세,1998,134,41,93
'4817069500,  초장동,'80,75 - 79세,1998,77,26,51
'4817069500,  초장동,'85,80 - 84세,1998,31,9,22
'4817069500,  초장동,'90,85+ ,1998,19,3,16
'4817071000,  평거동,'00,계,1998,26849,13162,13687
'4817071000,  평거동,'05,0 - 4세,1998,3161,1673,1488
'4817071000,  평거동,'10,5 - 9세,1998,2731,1436,1295
'4817071000,  평거동,'15,10 - 14세,1998,2076,1045,1031
'4817071000,  평거동,'20,15 - 19세,1998,1961,961,1000
'4817071000,  평거동,'25,20 - 24세,1998,1578,751,827
'4817071000,  평거동,'30,25 - 29세,1998,2802,1150,1652
'4817071000,  평거동,'35,30 - 34세,1998,3427,1704,1723
'4817071000,  평거동,'40,35 - 39세,1998,3053,1606,1447
'4817071000,  평거동,'45,40 - 44세,1998,2041,1100,941
'4817071000,  평거동,'50,45 - 49세,1998,1036,551,485
'4817071000,  평거동,'55,50 - 54세,1998,741,371,370
'4817071000,  평거동,'60,55 - 59세,1998,669,280,389
'4817071000,  평거동,'65,60 - 64세,1998,545,220,325
'4817071000,  평거동,'70,65 - 69세,1998,425,134,291
'4817071000,  평거동,'75,70 - 74세,1998,314,103,211
'4817071000,  평거동,'80,75 - 79세,1998,179,51,128
'4817071000,  평거동,'85,80 - 84세,1998,77,19,58
'4817071000,  평거동,'90,85+ ,1998,33,7,26
'4817071500,  신안동,'00,계,1998,17781,8667,9114
'4817071500,  신안동,'05,0 - 4세,1998,1245,680,565
'4817071500,  신안동,'10,5 - 9세,1998,1589,869,720
'4817071500,  신안동,'15,10 - 14세,1998,1712,874,838
'4817071500,  신안동,'20,15 - 19세,1998,1800,922,878
'4817071500,  신안동,'25,20 - 24세,1998,1332,669,663
'4817071500,  신안동,'30,25 - 29세,1998,1372,639,733
'4817071500,  신안동,'35,30 - 34세,1998,1437,620,817
'4817071500,  신안동,'40,35 - 39세,1998,1936,879,1057
'4817071500,  신안동,'45,40 - 44세,1998,1730,839,891
'4817071500,  신안동,'50,45 - 49세,1998,1100,573,527
'4817071500,  신안동,'55,50 - 54세,1998,736,389,347
'4817071500,  신안동,'60,55 - 59세,1998,570,298,272
'4817071500,  신안동,'65,60 - 64세,1998,421,185,236
'4817071500,  신안동,'70,65 - 69세,1998,277,91,186
'4817071500,  신안동,'75,70 - 74세,1998,247,73,174
'4817071500,  신안동,'80,75 - 79세,1998,161,48,113
'4817071500,  신안동,'85,80 - 84세,1998,63,13,50
'4817071500,  신안동,'90,85+ ,1998,53,6,47
'4817072000,  이현동,'00,계,1998,14989,7468,7521
'4817072000,  이현동,'05,0 - 4세,1998,1045,559,486
'4817072000,  이현동,'10,5 - 9세,1998,992,567,425
'4817072000,  이현동,'15,10 - 14세,1998,1194,646,548
'4817072000,  이현동,'20,15 - 19세,1998,1718,952,766
'4817072000,  이현동,'25,20 - 24세,1998,1472,754,718
'4817072000,  이현동,'30,25 - 29세,1998,1275,621,654
'4817072000,  이현동,'35,30 - 34세,1998,1151,556,595
'4817072000,  이현동,'40,35 - 39세,1998,1398,632,766
'4817072000,  이현동,'45,40 - 44세,1998,1377,643,734
'4817072000,  이현동,'50,45 - 49세,1998,922,465,457
'4817072000,  이현동,'55,50 - 54세,1998,672,361,311
'4817072000,  이현동,'60,55 - 59세,1998,567,279,288
'4817072000,  이현동,'65,60 - 64세,1998,400,179,221
'4817072000,  이현동,'70,65 - 69세,1998,289,88,201
'4817072000,  이현동,'75,70 - 74세,1998,237,82,155
'4817072000,  이현동,'80,75 - 79세,1998,161,50,111
'4817072000,  이현동,'85,80 - 84세,1998,78,23,55
'4817072000,  이현동,'90,85+ ,1998,41,11,30
'4817073000,  판문동,'00,계,1998,12029,5904,6125
'4817073000,  판문동,'05,0 - 4세,1998,886,506,380
'4817073000,  판문동,'10,5 - 9세,1998,971,545,426
'4817073000,  판문동,'15,10 - 14세,1998,989,490,499
'4817073000,  판문동,'20,15 - 19세,1998,1251,613,638
'4817073000,  판문동,'25,20 - 24세,1998,1057,528,529
'4817073000,  판문동,'30,25 - 29세,1998,1098,532,566
'4817073000,  판문동,'35,30 - 34세,1998,1007,502,505
'4817073000,  판문동,'40,35 - 39세,1998,1220,600,620
'4817073000,  판문동,'45,40 - 44세,1998,1063,544,519
'4817073000,  판문동,'50,45 - 49세,1998,623,299,324
'4817073000,  판문동,'55,50 - 54세,1998,470,207,263
'4817073000,  판문동,'60,55 - 59세,1998,430,201,229
'4817073000,  판문동,'65,60 - 64세,1998,345,141,204
'4817073000,  판문동,'70,65 - 69세,1998,262,91,171
'4817073000,  판문동,'75,70 - 74세,1998,165,50,115
'4817073000,  판문동,'80,75 - 79세,1998,114,31,83
'4817073000,  판문동,'85,80 - 84세,1998,54,19,35
'4817073000,  판문동,'90,85+ ,1998,24,5,19
'4817074000,  가호동,'00,계,1998,11506,5806,5700
'4817074000,  가호동,'05,0 - 4세,1998,695,405,290
'4817074000,  가호동,'10,5 - 9세,1998,953,504,449
'4817074000,  가호동,'15,10 - 14세,1998,1041,570,471
'4817074000,  가호동,'20,15 - 19세,1998,1255,671,584
'4817074000,  가호동,'25,20 - 24세,1998,1099,606,493
'4817074000,  가호동,'30,25 - 29세,1998,944,508,436
'4817074000,  가호동,'35,30 - 34세,1998,949,393,556
'4817074000,  가호동,'40,35 - 39세,1998,1272,626,646
'4817074000,  가호동,'45,40 - 44세,1998,1002,521,481
'4817074000,  가호동,'50,45 - 49세,1998,639,313,326
'4817074000,  가호동,'55,50 - 54세,1998,426,200,226
'4817074000,  가호동,'60,55 - 59세,1998,429,197,232
'4817074000,  가호동,'65,60 - 64세,1998,294,121,173
'4817074000,  가호동,'70,65 - 69세,1998,205,77,128
'4817074000,  가호동,'75,70 - 74세,1998,154,56,98
'4817074000,  가호동,'80,75 - 79세,1998,95,25,70
'4817074000,  가호동,'85,80 - 84세,1998,36,11,25
'4817074000,  가호동,'90,85+ ,1998,18,2,16
'48190, 진해시,'00,계,1998,133217,67020,66197
'48190, 진해시,'05,0 - 4세,1998,9872,5306,4566
'48190, 진해시,'10,5 - 9세,1998,9797,5217,4580
'48190, 진해시,'15,10 - 14세,1998,8651,4461,4190
'48190, 진해시,'20,15 - 19세,1998,11682,5925,5757
'48190, 진해시,'25,20 - 24세,1998,11033,5809,5224
'48190, 진해시,'30,25 - 29세,1998,13371,7004,6367
'48190, 진해시,'35,30 - 34세,1998,11830,6029,5801
'48190, 진해시,'40,35 - 39세,1998,12565,6355,6210
'48190, 진해시,'45,40 - 44세,1998,11035,5624,5411
'48190, 진해시,'50,45 - 49세,1998,7791,3994,3797
'48190, 진해시,'55,50 - 54세,1998,6227,3169,3058
'48190, 진해시,'60,55 - 59세,1998,5878,2765,3113
'48190, 진해시,'65,60 - 64세,1998,4918,2254,2664
'48190, 진해시,'70,65 - 69세,1998,3513,1460,2053
'48190, 진해시,'75,70 - 74세,1998,2440,940,1500
'48190, 진해시,'80,75 - 79세,1998,1445,436,1009
'48190, 진해시,'85,80 - 84세,1998,730,190,540
'48190, 진해시,'90,85+ ,1998,439,82,357
'4819051500,  중앙동,'00,계,1998,8030,4001,4029
'4819051500,  중앙동,'05,0 - 4세,1998,947,477,470
'4819051500,  중앙동,'10,5 - 9세,1998,777,389,388
'4819051500,  중앙동,'15,10 - 14세,1998,562,292,270
'4819051500,  중앙동,'20,15 - 19세,1998,541,282,259
'4819051500,  중앙동,'25,20 - 24세,1998,551,277,274
'4819051500,  중앙동,'30,25 - 29세,1998,1022,515,507
'4819051500,  중앙동,'35,30 - 34세,1998,838,418,420
'4819051500,  중앙동,'40,35 - 39세,1998,811,406,405
'4819051500,  중앙동,'45,40 - 44세,1998,659,348,311
'4819051500,  중앙동,'50,45 - 49세,1998,335,167,168
'4819051500,  중앙동,'55,50 - 54세,1998,241,134,107
'4819051500,  중앙동,'60,55 - 59세,1998,219,90,129
'4819051500,  중앙동,'65,60 - 64세,1998,187,89,98
'4819051500,  중앙동,'70,65 - 69세,1998,123,47,76
'4819051500,  중앙동,'75,70 - 74세,1998,105,40,65
'4819051500,  중앙동,'80,75 - 79세,1998,64,21,43
'4819051500,  중앙동,'85,80 - 84세,1998,33,6,27
'4819051500,  중앙동,'90,85+ ,1998,15,3,12
'4819052500,  태평동,'00,계,1998,8578,4351,4227
'4819052500,  태평동,'05,0 - 4세,1998,510,276,234
'4819052500,  태평동,'10,5 - 9세,1998,558,279,279
'4819052500,  태평동,'15,10 - 14세,1998,540,266,274
'4819052500,  태평동,'20,15 - 19세,1998,813,429,384
'4819052500,  태평동,'25,20 - 24세,1998,834,451,383
'4819052500,  태평동,'30,25 - 29세,1998,876,522,354
'4819052500,  태평동,'35,30 - 34세,1998,663,340,323
'4819052500,  태평동,'40,35 - 39세,1998,739,372,367
'4819052500,  태평동,'45,40 - 44세,1998,699,348,351
'4819052500,  태평동,'50,45 - 49세,1998,612,308,304
'4819052500,  태평동,'55,50 - 54세,1998,468,237,231
'4819052500,  태평동,'60,55 - 59세,1998,384,179,205
'4819052500,  태평동,'65,60 - 64세,1998,308,149,159
'4819052500,  태평동,'70,65 - 69세,1998,230,78,152
'4819052500,  태평동,'75,70 - 74세,1998,181,73,108
'4819052500,  태평동,'80,75 - 79세,1998,100,29,71
'4819052500,  태평동,'85,80 - 84세,1998,47,12,35
'4819052500,  태평동,'90,85+ ,1998,16,3,13
'4819055500,  충무동,'00,계,1998,6814,3379,3435
'4819055500,  충무동,'05,0 - 4세,1998,372,211,161
'4819055500,  충무동,'10,5 - 9세,1998,416,216,200
'4819055500,  충무동,'15,10 - 14세,1998,443,231,212
'4819055500,  충무동,'20,15 - 19세,1998,582,310,272
'4819055500,  충무동,'25,20 - 24세,1998,589,309,280
'4819055500,  충무동,'30,25 - 29세,1998,666,396,270
'4819055500,  충무동,'35,30 - 34세,1998,491,247,244
'4819055500,  충무동,'40,35 - 39세,1998,581,279,302
'4819055500,  충무동,'45,40 - 44세,1998,544,261,283
'4819055500,  충무동,'50,45 - 49세,1998,428,201,227
'4819055500,  충무동,'55,50 - 54세,1998,391,172,219
'4819055500,  충무동,'60,55 - 59세,1998,368,167,201
'4819055500,  충무동,'65,60 - 64세,1998,335,144,191
'4819055500,  충무동,'70,65 - 69세,1998,272,125,147
'4819055500,  충무동,'75,70 - 74세,1998,160,63,97
'4819055500,  충무동,'80,75 - 79세,1998,92,23,69
'4819055500,  충무동,'85,80 - 84세,1998,47,16,31
'4819055500,  충무동,'90,85+ ,1998,37,8,29
'4819057500,  여좌동,'00,계,1998,17582,8866,8716
'4819057500,  여좌동,'05,0 - 4세,1998,1160,617,543
'4819057500,  여좌동,'10,5 - 9세,1998,996,532,464
'4819057500,  여좌동,'15,10 - 14세,1998,947,468,479
'4819057500,  여좌동,'20,15 - 19세,1998,1539,800,739
'4819057500,  여좌동,'25,20 - 24세,1998,1773,964,809
'4819057500,  여좌동,'30,25 - 29세,1998,2017,1104,913
'4819057500,  여좌동,'35,30 - 34세,1998,1333,701,632
'4819057500,  여좌동,'40,35 - 39세,1998,1326,674,652
'4819057500,  여좌동,'45,40 - 44세,1998,1402,638,764
'4819057500,  여좌동,'50,45 - 49세,1998,1124,536,588
'4819057500,  여좌동,'55,50 - 54세,1998,992,478,514
'4819057500,  여좌동,'60,55 - 59세,1998,950,457,493
'4819057500,  여좌동,'65,60 - 64세,1998,827,402,425
'4819057500,  여좌동,'70,65 - 69세,1998,549,255,294
'4819057500,  여좌동,'75,70 - 74세,1998,319,153,166
'4819057500,  여좌동,'80,75 - 79세,1998,163,54,109
'4819057500,  여좌동,'85,80 - 84세,1998,107,23,84
'4819057500,  여좌동,'90,85+ ,1998,58,10,48
'4819060000,  태백동,'00,계,1998,10780,5490,5290
'4819060000,  태백동,'05,0 - 4세,1998,679,359,320
'4819060000,  태백동,'10,5 - 9세,1998,617,351,266
'4819060000,  태백동,'15,10 - 14세,1998,581,312,269
'4819060000,  태백동,'20,15 - 19세,1998,934,463,471
'4819060000,  태백동,'25,20 - 24세,1998,1144,633,511
'4819060000,  태백동,'30,25 - 29세,1998,1157,646,511
'4819060000,  태백동,'35,30 - 34세,1998,866,466,400
'4819060000,  태백동,'40,35 - 39세,1998,856,439,417
'4819060000,  태백동,'45,40 - 44세,1998,793,409,384
'4819060000,  태백동,'50,45 - 49세,1998,683,312,371
'4819060000,  태백동,'55,50 - 54세,1998,624,318,306
'4819060000,  태백동,'60,55 - 59세,1998,631,290,341
'4819060000,  태백동,'65,60 - 64세,1998,491,216,275
'4819060000,  태백동,'70,65 - 69세,1998,339,144,195
'4819060000,  태백동,'75,70 - 74세,1998,185,73,112
'4819060000,  태백동,'80,75 - 79세,1998,114,37,77
'4819060000,  태백동,'85,80 - 84세,1998,53,14,39
'4819060000,  태백동,'90,85+ ,1998,33,8,25
'4819061500,  경화동,'00,계,1998,10694,5392,5302
'4819061500,  경화동,'05,0 - 4세,1998,734,407,327
'4819061500,  경화동,'10,5 - 9세,1998,749,409,340
'4819061500,  경화동,'15,10 - 14세,1998,668,340,328
'4819061500,  경화동,'20,15 - 19세,1998,982,496,486
'4819061500,  경화동,'25,20 - 24세,1998,946,474,472
'4819061500,  경화동,'30,25 - 29세,1998,1063,592,471
'4819061500,  경화동,'35,30 - 34세,1998,881,444,437
'4819061500,  경화동,'40,35 - 39세,1998,939,470,469
'4819061500,  경화동,'45,40 - 44세,1998,820,404,416
'4819061500,  경화동,'50,45 - 49세,1998,676,345,331
'4819061500,  경화동,'55,50 - 54세,1998,577,284,293
'4819061500,  경화동,'60,55 - 59세,1998,509,255,254
'4819061500,  경화동,'65,60 - 64세,1998,458,207,251
'4819061500,  경화동,'70,65 - 69세,1998,307,145,162
'4819061500,  경화동,'75,70 - 74세,1998,172,67,105
'4819061500,  경화동,'80,75 - 79세,1998,121,30,91
'4819061500,  경화동,'85,80 - 84세,1998,61,18,43
'4819061500,  경화동,'90,85+ ,1998,31,5,26
'4819063500,  병암동,'00,계,1998,9194,4622,4572
'4819063500,  병암동,'05,0 - 4세,1998,708,377,331
'4819063500,  병암동,'10,5 - 9세,1998,737,402,335
'4819063500,  병암동,'15,10 - 14세,1998,609,322,287
'4819063500,  병암동,'20,15 - 19세,1998,822,414,408
'4819063500,  병암동,'25,20 - 24세,1998,692,374,318
'4819063500,  병암동,'30,25 - 29세,1998,865,428,437
'4819063500,  병암동,'35,30 - 34세,1998,897,451,446
'4819063500,  병암동,'40,35 - 39세,1998,937,464,473
'4819063500,  병암동,'45,40 - 44세,1998,775,377,398
'4819063500,  병암동,'50,45 - 49세,1998,516,269,247
'4819063500,  병암동,'55,50 - 54세,1998,391,202,189
'4819063500,  병암동,'60,55 - 59세,1998,417,216,201
'4819063500,  병암동,'65,60 - 64세,1998,290,133,157
'4819063500,  병암동,'70,65 - 69세,1998,212,83,129
'4819063500,  병암동,'75,70 - 74세,1998,175,68,107
'4819063500,  병암동,'80,75 - 79세,1998,93,30,63
'4819063500,  병암동,'85,80 - 84세,1998,36,7,29
'4819063500,  병암동,'90,85+ ,1998,22,5,17
'4819064000,  석동,'00,계,1998,3435,1738,1697
'4819064000,  석동,'05,0 - 4세,1998,340,188,152
'4819064000,  석동,'10,5 - 9세,1998,310,161,149
'4819064000,  석동,'15,10 - 14세,1998,219,121,98
'4819064000,  석동,'20,15 - 19세,1998,269,125,144
'4819064000,  석동,'25,20 - 24세,1998,233,117,116
'4819064000,  석동,'30,25 - 29세,1998,431,198,233
'4819064000,  석동,'35,30 - 34세,1998,389,210,179
'4819064000,  석동,'40,35 - 39세,1998,341,175,166
'4819064000,  석동,'45,40 - 44세,1998,270,136,134
'4819064000,  석동,'50,45 - 49세,1998,163,87,76
'4819064000,  석동,'55,50 - 54세,1998,122,72,50
'4819064000,  석동,'60,55 - 59세,1998,113,58,55
'4819064000,  석동,'65,60 - 64세,1998,77,37,40
'4819064000,  석동,'70,65 - 69세,1998,55,20,35
'4819064000,  석동,'75,70 - 74세,1998,46,18,28
'4819064000,  석동,'80,75 - 79세,1998,35,10,25
'4819064000,  석동,'85,80 - 84세,1998,14,5,9
'4819064000,  석동,'90,85+ ,1998,8,0,8
'4819065000,  이동,'00,계,1998,13367,6675,6692
'4819065000,  이동,'05,0 - 4세,1998,958,499,459
'4819065000,  이동,'10,5 - 9세,1998,847,485,362
'4819065000,  이동,'15,10 - 14세,1998,956,474,482
'4819065000,  이동,'20,15 - 19세,1998,1352,691,661
'4819065000,  이동,'25,20 - 24세,1998,1112,555,557
'4819065000,  이동,'30,25 - 29세,1998,1379,692,687
'4819065000,  이동,'35,30 - 34세,1998,1098,567,531
'4819065000,  이동,'40,35 - 39세,1998,1289,601,688
'4819065000,  이동,'45,40 - 44세,1998,1312,664,648
'4819065000,  이동,'50,45 - 49세,1998,835,445,390
'4819065000,  이동,'55,50 - 54세,1998,610,318,292
'4819065000,  이동,'60,55 - 59세,1998,506,252,254
'4819065000,  이동,'65,60 - 64세,1998,390,187,203
'4819065000,  이동,'70,65 - 69세,1998,262,103,159
'4819065000,  이동,'75,70 - 74세,1998,215,81,134
'4819065000,  이동,'80,75 - 79세,1998,146,38,108
'4819065000,  이동,'85,80 - 84세,1998,55,14,41
'4819065000,  이동,'90,85+ ,1998,45,9,36
'4819066000,  자은동,'00,계,1998,10243,5173,5070
'4819066000,  자은동,'05,0 - 4세,1998,1059,568,491
'4819066000,  자은동,'10,5 - 9세,1998,1008,537,471
'4819066000,  자은동,'15,10 - 14세,1998,630,337,293
'4819066000,  자은동,'20,15 - 19세,1998,852,439,413
'4819066000,  자은동,'25,20 - 24세,1998,610,317,293
'4819066000,  자은동,'30,25 - 29세,1998,1012,469,543
'4819066000,  자은동,'35,30 - 34세,1998,1315,655,660
'4819066000,  자은동,'40,35 - 39세,1998,1111,617,494
'4819066000,  자은동,'45,40 - 44세,1998,744,383,361
'4819066000,  자은동,'50,45 - 49세,1998,461,241,220
'4819066000,  자은동,'55,50 - 54세,1998,322,167,155
'4819066000,  자은동,'60,55 - 59세,1998,330,156,174
'4819066000,  자은동,'65,60 - 64세,1998,262,113,149
'4819066000,  자은동,'70,65 - 69세,1998,213,80,133
'4819066000,  자은동,'75,70 - 74세,1998,153,54,99
'4819066000,  자은동,'80,75 - 79세,1998,81,22,59
'4819066000,  자은동,'85,80 - 84세,1998,55,12,43
'4819066000,  자은동,'90,85+ ,1998,25,6,19
'4819067000,  덕산동,'00,계,1998,7595,3770,3825
'4819067000,  덕산동,'05,0 - 4세,1998,593,329,264
'4819067000,  덕산동,'10,5 - 9세,1998,616,310,306
'4819067000,  덕산동,'15,10 - 14세,1998,617,321,296
'4819067000,  덕산동,'20,15 - 19세,1998,683,323,360
'4819067000,  덕산동,'25,20 - 24세,1998,576,311,265
'4819067000,  덕산동,'30,25 - 29세,1998,678,308,370
'4819067000,  덕산동,'35,30 - 34세,1998,715,369,346
'4819067000,  덕산동,'40,35 - 39세,1998,790,377,413
'4819067000,  덕산동,'45,40 - 44세,1998,722,379,343
'4819067000,  덕산동,'50,45 - 49세,1998,439,244,195
'4819067000,  덕산동,'55,50 - 54세,1998,311,175,136
'4819067000,  덕산동,'60,55 - 59세,1998,253,112,141
'4819067000,  덕산동,'65,60 - 64세,1998,209,92,117
'4819067000,  덕산동,'70,65 - 69세,1998,156,53,103
'4819067000,  덕산동,'75,70 - 74세,1998,106,33,73
'4819067000,  덕산동,'80,75 - 79세,1998,81,25,56
'4819067000,  덕산동,'85,80 - 84세,1998,35,8,27
'4819067000,  덕산동,'90,85+ ,1998,15,1,14
'4819068000,  풍호동,'00,계,1998,11711,5851,5860
'4819068000,  풍호동,'05,0 - 4세,1998,906,499,407
'4819068000,  풍호동,'10,5 - 9세,1998,1113,590,523
'4819068000,  풍호동,'15,10 - 14세,1998,1021,526,495
'4819068000,  풍호동,'20,15 - 19세,1998,1006,487,519
'4819068000,  풍호동,'25,20 - 24세,1998,674,332,342
'4819068000,  풍호동,'30,25 - 29세,1998,928,425,503
'4819068000,  풍호동,'35,30 - 34세,1998,1115,512,603
'4819068000,  풍호동,'40,35 - 39세,1998,1483,735,748
'4819068000,  풍호동,'45,40 - 44세,1998,1109,620,489
'4819068000,  풍호동,'50,45 - 49세,1998,613,353,260
'4819068000,  풍호동,'55,50 - 54세,1998,417,213,204
'4819068000,  풍호동,'60,55 - 59세,1998,396,180,216
'4819068000,  풍호동,'65,60 - 64세,1998,334,161,173
'4819068000,  풍호동,'70,65 - 69세,1998,235,99,136
'4819068000,  풍호동,'75,70 - 74세,1998,194,64,130
'4819068000,  풍호동,'80,75 - 79세,1998,87,30,57
'4819068000,  풍호동,'85,80 - 84세,1998,57,19,38
'4819068000,  풍호동,'90,85+ ,1998,23,6,17
'4819071500,  웅천동,'00,계,1998,6674,3367,3307
'4819071500,  웅천동,'05,0 - 4세,1998,394,203,191
'4819071500,  웅천동,'10,5 - 9세,1998,429,234,195
'4819071500,  웅천동,'15,10 - 14세,1998,353,183,170
'4819071500,  웅천동,'20,15 - 19세,1998,583,290,293
'4819071500,  웅천동,'25,20 - 24세,1998,605,312,293
'4819071500,  웅천동,'30,25 - 29세,1998,627,369,258
'4819071500,  웅천동,'35,30 - 34세,1998,499,285,214
'4819071500,  웅천동,'40,35 - 39세,1998,570,310,260
'4819071500,  웅천동,'45,40 - 44세,1998,487,262,225
'4819071500,  웅천동,'50,45 - 49세,1998,371,193,178
'4819071500,  웅천동,'55,50 - 54세,1998,350,179,171
'4819071500,  웅천동,'60,55 - 59세,1998,363,149,214
'4819071500,  웅천동,'65,60 - 64세,1998,378,167,211
'4819071500,  웅천동,'70,65 - 69세,1998,256,111,145
'4819071500,  웅천동,'75,70 - 74세,1998,180,61,119
'4819071500,  웅천동,'80,75 - 79세,1998,114,36,78
'4819071500,  웅천동,'85,80 - 84세,1998,60,13,47
'4819071500,  웅천동,'90,85+ ,1998,55,10,45
'4819073000,  웅동1동,'00,계,1998,4119,2063,2056
'4819073000,  웅동1동,'05,0 - 4세,1998,271,140,131
'4819073000,  웅동1동,'10,5 - 9세,1998,315,166,149
'4819073000,  웅동1동,'15,10 - 14세,1998,240,132,108
'4819073000,  웅동1동,'20,15 - 19세,1998,305,165,140
'4819073000,  웅동1동,'25,20 - 24세,1998,298,149,149
'4819073000,  웅동1동,'30,25 - 29세,1998,328,174,154
'4819073000,  웅동1동,'35,30 - 34세,1998,384,196,188
'4819073000,  웅동1동,'40,35 - 39세,1998,399,220,179
'4819073000,  웅동1동,'45,40 - 44세,1998,291,158,133
'4819073000,  웅동1동,'50,45 - 49세,1998,243,136,107
'4819073000,  웅동1동,'55,50 - 54세,1998,181,100,81
'4819073000,  웅동1동,'60,55 - 59세,1998,204,88,116
'4819073000,  웅동1동,'65,60 - 64세,1998,202,76,126
'4819073000,  웅동1동,'70,65 - 69세,1998,163,65,98
'4819073000,  웅동1동,'75,70 - 74세,1998,132,50,82
'4819073000,  웅동1동,'80,75 - 79세,1998,92,29,63
'4819073000,  웅동1동,'85,80 - 84세,1998,36,13,23
'4819073000,  웅동1동,'90,85+ ,1998,35,6,29
'4819074000,  웅동2동,'00,계,1998,4401,2282,2119
'4819074000,  웅동2동,'05,0 - 4세,1998,241,156,85
'4819074000,  웅동2동,'10,5 - 9세,1998,309,156,153
'4819074000,  웅동2동,'15,10 - 14세,1998,265,136,129
'4819074000,  웅동2동,'20,15 - 19세,1998,419,211,208
'4819074000,  웅동2동,'25,20 - 24세,1998,396,234,162
'4819074000,  웅동2동,'30,25 - 29세,1998,322,166,156
'4819074000,  웅동2동,'35,30 - 34세,1998,346,168,178
'4819074000,  웅동2동,'40,35 - 39세,1998,393,216,177
'4819074000,  웅동2동,'45,40 - 44세,1998,408,237,171
'4819074000,  웅동2동,'50,45 - 49세,1998,292,157,135
'4819074000,  웅동2동,'55,50 - 54세,1998,230,120,110
'4819074000,  웅동2동,'60,55 - 59세,1998,235,116,119
'4819074000,  웅동2동,'65,60 - 64세,1998,170,81,89
'4819074000,  웅동2동,'70,65 - 69세,1998,141,52,89
'4819074000,  웅동2동,'75,70 - 74세,1998,117,42,75
'4819074000,  웅동2동,'80,75 - 79세,1998,62,22,40
'4819074000,  웅동2동,'85,80 - 84세,1998,34,10,24
'4819074000,  웅동2동,'90,85+ ,1998,21,2,19
'48220, 통영시,'00,계,1998,140397,70565,69832
'48220, 통영시,'05,0 - 4세,1998,8059,4236,3823
'48220, 통영시,'10,5 - 9세,1998,8789,4553,4236
'48220, 통영시,'15,10 - 14세,1998,10285,5359,4926
'48220, 통영시,'20,15 - 19세,1998,14918,7680,7238
'48220, 통영시,'25,20 - 24세,1998,13340,7217,6123
'48220, 통영시,'30,25 - 29세,1998,11940,6507,5433
'48220, 통영시,'35,30 - 34세,1998,10593,5477,5116
'48220, 통영시,'40,35 - 39세,1998,12796,6448,6348
'48220, 통영시,'45,40 - 44세,1998,11280,5771,5509
'48220, 통영시,'50,45 - 49세,1998,8418,4423,3995
'48220, 통영시,'55,50 - 54세,1998,6877,3508,3369
'48220, 통영시,'60,55 - 59세,1998,6876,3222,3654
'48220, 통영시,'65,60 - 64세,1998,5493,2470,3023
'48220, 통영시,'70,65 - 69세,1998,4318,1673,2645
'48220, 통영시,'75,70 - 74세,1998,3175,1121,2054
'48220, 통영시,'80,75 - 79세,1998,1840,568,1272
'48220, 통영시,'85,80 - 84세,1998,870,233,637
'48220, 통영시,'90,85+ ,1998,530,99,431
'4822025000,  산양읍,'00,계,1998,8290,4309,3981
'4822025000,  산양읍,'05,0 - 4세,1998,286,154,132
'4822025000,  산양읍,'10,5 - 9세,1998,263,136,127
'4822025000,  산양읍,'15,10 - 14세,1998,433,226,207
'4822025000,  산양읍,'20,15 - 19세,1998,901,453,448
'4822025000,  산양읍,'25,20 - 24세,1998,992,570,422
'4822025000,  산양읍,'30,25 - 29세,1998,723,480,243
'4822025000,  산양읍,'35,30 - 34세,1998,429,257,172
'4822025000,  산양읍,'40,35 - 39세,1998,567,322,245
'4822025000,  산양읍,'45,40 - 44세,1998,554,311,243
'4822025000,  산양읍,'50,45 - 49세,1998,506,284,222
'4822025000,  산양읍,'55,50 - 54세,1998,434,213,221
'4822025000,  산양읍,'60,55 - 59세,1998,589,263,326
'4822025000,  산양읍,'65,60 - 64세,1998,575,247,328
'4822025000,  산양읍,'70,65 - 69세,1998,450,191,259
'4822025000,  산양읍,'75,70 - 74세,1998,314,114,200
'4822025000,  산양읍,'80,75 - 79세,1998,159,61,98
'4822025000,  산양읍,'85,80 - 84세,1998,71,21,50
'4822025000,  산양읍,'90,85+ ,1998,44,6,38
'4822031000,  용남면,'00,계,1998,9601,4902,4699
'4822031000,  용남면,'05,0 - 4세,1998,609,296,313
'4822031000,  용남면,'10,5 - 9세,1998,560,286,274
'4822031000,  용남면,'15,10 - 14세,1998,712,370,342
'4822031000,  용남면,'20,15 - 19세,1998,897,459,438
'4822031000,  용남면,'25,20 - 24세,1998,900,496,404
'4822031000,  용남면,'30,25 - 29세,1998,895,497,398
'4822031000,  용남면,'35,30 - 34세,1998,768,411,357
'4822031000,  용남면,'40,35 - 39세,1998,869,497,372
'4822031000,  용남면,'45,40 - 44세,1998,634,344,290
'4822031000,  용남면,'50,45 - 49세,1998,510,271,239
'4822031000,  용남면,'55,50 - 54세,1998,458,244,214
'4822031000,  용남면,'60,55 - 59세,1998,493,208,285
'4822031000,  용남면,'65,60 - 64세,1998,411,192,219
'4822031000,  용남면,'70,65 - 69세,1998,332,144,188
'4822031000,  용남면,'75,70 - 74세,1998,283,103,180
'4822031000,  용남면,'80,75 - 79세,1998,155,55,100
'4822031000,  용남면,'85,80 - 84세,1998,76,22,54
'4822031000,  용남면,'90,85+ ,1998,39,7,32
'4822033000,  도산면,'00,계,1998,4894,2463,2431
'4822033000,  도산면,'05,0 - 4세,1998,184,106,78
'4822033000,  도산면,'10,5 - 9세,1998,164,85,79
'4822033000,  도산면,'15,10 - 14세,1998,258,133,125
'4822033000,  도산면,'20,15 - 19세,1998,521,249,272
'4822033000,  도산면,'25,20 - 24세,1998,562,319,243
'4822033000,  도산면,'30,25 - 29세,1998,381,245,136
'4822033000,  도산면,'35,30 - 34세,1998,238,147,91
'4822033000,  도산면,'40,35 - 39세,1998,294,158,136
'4822033000,  도산면,'45,40 - 44세,1998,340,175,165
'4822033000,  도산면,'50,45 - 49세,1998,306,158,148
'4822033000,  도산면,'55,50 - 54세,1998,276,149,127
'4822033000,  도산면,'60,55 - 59세,1998,334,150,184
'4822033000,  도산면,'65,60 - 64세,1998,368,164,204
'4822033000,  도산면,'70,65 - 69세,1998,280,109,171
'4822033000,  도산면,'75,70 - 74세,1998,191,66,125
'4822033000,  도산면,'80,75 - 79세,1998,108,33,75
'4822033000,  도산면,'85,80 - 84세,1998,57,11,46
'4822033000,  도산면,'90,85+ ,1998,32,6,26
'4822034000,  광도면,'00,계,1998,8100,4075,4025
'4822034000,  광도면,'05,0 - 4세,1998,385,204,181
'4822034000,  광도면,'10,5 - 9세,1998,394,215,179
'4822034000,  광도면,'15,10 - 14세,1998,555,291,264
'4822034000,  광도면,'20,15 - 19세,1998,871,440,431
'4822034000,  광도면,'25,20 - 24세,1998,813,446,367
'4822034000,  광도면,'30,25 - 29세,1998,665,404,261
'4822034000,  광도면,'35,30 - 34세,1998,533,293,240
'4822034000,  광도면,'40,35 - 39세,1998,627,327,300
'4822034000,  광도면,'45,40 - 44세,1998,546,267,279
'4822034000,  광도면,'50,45 - 49세,1998,453,249,204
'4822034000,  광도면,'55,50 - 54세,1998,392,196,196
'4822034000,  광도면,'60,55 - 59세,1998,479,225,254
'4822034000,  광도면,'65,60 - 64세,1998,453,184,269
'4822034000,  광도면,'70,65 - 69세,1998,383,135,248
'4822034000,  광도면,'75,70 - 74세,1998,289,112,177
'4822034000,  광도면,'80,75 - 79세,1998,133,52,81
'4822034000,  광도면,'85,80 - 84세,1998,77,21,56
'4822034000,  광도면,'90,85+ ,1998,52,14,38
'4822035000,  욕지면,'00,계,1998,3527,1865,1662
'4822035000,  욕지면,'05,0 - 4세,1998,126,77,49
'4822035000,  욕지면,'10,5 - 9세,1998,141,84,57
'4822035000,  욕지면,'15,10 - 14세,1998,206,107,99
'4822035000,  욕지면,'20,15 - 19세,1998,335,176,159
'4822035000,  욕지면,'25,20 - 24세,1998,360,206,154
'4822035000,  욕지면,'30,25 - 29세,1998,209,148,61
'4822035000,  욕지면,'35,30 - 34세,1998,214,139,75
'4822035000,  욕지면,'40,35 - 39세,1998,231,128,103
'4822035000,  욕지면,'45,40 - 44세,1998,218,125,93
'4822035000,  욕지면,'50,45 - 49세,1998,214,113,101
'4822035000,  욕지면,'55,50 - 54세,1998,188,108,80
'4822035000,  욕지면,'60,55 - 59세,1998,243,110,133
'4822035000,  욕지면,'65,60 - 64세,1998,259,119,140
'4822035000,  욕지면,'70,65 - 69세,1998,226,92,134
'4822035000,  욕지면,'75,70 - 74세,1998,189,78,111
'4822035000,  욕지면,'80,75 - 79세,1998,101,36,65
'4822035000,  욕지면,'85,80 - 84세,1998,36,14,22
'4822035000,  욕지면,'90,85+ ,1998,31,5,26
'4822036000,  한산면,'00,계,1998,3845,1933,1912
'4822036000,  한산면,'05,0 - 4세,1998,74,44,30
'4822036000,  한산면,'10,5 - 9세,1998,68,38,30
'4822036000,  한산면,'15,10 - 14세,1998,138,62,76
'4822036000,  한산면,'20,15 - 19세,1998,350,174,176
'4822036000,  한산면,'25,20 - 24세,1998,401,233,168
'4822036000,  한산면,'30,25 - 29세,1998,260,188,72
'4822036000,  한산면,'35,30 - 34세,1998,138,90,48
'4822036000,  한산면,'40,35 - 39세,1998,205,134,71
'4822036000,  한산면,'45,40 - 44세,1998,207,111,96
'4822036000,  한산면,'50,45 - 49세,1998,213,112,101
'4822036000,  한산면,'55,50 - 54세,1998,272,130,142
'4822036000,  한산면,'60,55 - 59세,1998,422,186,236
'4822036000,  한산면,'65,60 - 64세,1998,353,163,190
'4822036000,  한산면,'70,65 - 69세,1998,297,124,173
'4822036000,  한산면,'75,70 - 74세,1998,208,76,132
'4822036000,  한산면,'80,75 - 79세,1998,130,41,89
'4822036000,  한산면,'85,80 - 84세,1998,55,18,37
'4822036000,  한산면,'90,85+ ,1998,54,9,45
'4822037000,  사량면,'00,계,1998,2981,1516,1465
'4822037000,  사량면,'05,0 - 4세,1998,96,50,46
'4822037000,  사량면,'10,5 - 9세,1998,100,52,48
'4822037000,  사량면,'15,10 - 14세,1998,136,66,70
'4822037000,  사량면,'20,15 - 19세,1998,323,173,150
'4822037000,  사량면,'25,20 - 24세,1998,309,180,129
'4822037000,  사량면,'30,25 - 29세,1998,212,141,71
'4822037000,  사량면,'35,30 - 34세,1998,154,108,46
'4822037000,  사량면,'40,35 - 39세,1998,182,106,76
'4822037000,  사량면,'45,40 - 44세,1998,171,97,74
'4822037000,  사량면,'50,45 - 49세,1998,156,83,73
'4822037000,  사량면,'55,50 - 54세,1998,196,87,109
'4822037000,  사량면,'60,55 - 59세,1998,243,111,132
'4822037000,  사량면,'65,60 - 64세,1998,223,88,135
'4822037000,  사량면,'70,65 - 69세,1998,197,86,111
'4822037000,  사량면,'75,70 - 74세,1998,143,59,84
'4822037000,  사량면,'80,75 - 79세,1998,88,21,67
'4822037000,  사량면,'85,80 - 84세,1998,31,6,25
'4822037000,  사량면,'90,85+ ,1998,21,2,19
'4822051000,  도천동,'00,계,1998,9261,4572,4689
'4822051000,  도천동,'05,0 - 4세,1998,468,245,223
'4822051000,  도천동,'10,5 - 9세,1998,499,261,238
'4822051000,  도천동,'15,10 - 14세,1998,718,352,366
'4822051000,  도천동,'20,15 - 19세,1998,1115,576,539
'4822051000,  도천동,'25,20 - 24세,1998,1024,556,468
'4822051000,  도천동,'30,25 - 29세,1998,765,414,351
'4822051000,  도천동,'35,30 - 34세,1998,620,319,301
'4822051000,  도천동,'40,35 - 39세,1998,814,378,436
'4822051000,  도천동,'45,40 - 44세,1998,760,381,379
'4822051000,  도천동,'50,45 - 49세,1998,621,306,315
'4822051000,  도천동,'55,50 - 54세,1998,491,242,249
'4822051000,  도천동,'60,55 - 59세,1998,419,187,232
'4822051000,  도천동,'65,60 - 64세,1998,331,151,180
'4822051000,  도천동,'70,65 - 69세,1998,238,84,154
'4822051000,  도천동,'75,70 - 74세,1998,170,57,113
'4822051000,  도천동,'80,75 - 79세,1998,115,34,81
'4822051000,  도천동,'85,80 - 84세,1998,62,21,41
'4822051000,  도천동,'90,85+ ,1998,31,8,23
'4822053000,  명정동,'00,계,1998,7430,3705,3725
'4822053000,  명정동,'05,0 - 4세,1998,334,177,157
'4822053000,  명정동,'10,5 - 9세,1998,440,211,229
'4822053000,  명정동,'15,10 - 14세,1998,511,277,234
'4822053000,  명정동,'20,15 - 19세,1998,806,407,399
'4822053000,  명정동,'25,20 - 24세,1998,780,417,363
'4822053000,  명정동,'30,25 - 29세,1998,616,357,259
'4822053000,  명정동,'35,30 - 34세,1998,499,255,244
'4822053000,  명정동,'40,35 - 39세,1998,609,306,303
'4822053000,  명정동,'45,40 - 44세,1998,616,332,284
'4822053000,  명정동,'50,45 - 49세,1998,501,254,247
'4822053000,  명정동,'55,50 - 54세,1998,398,191,207
'4822053000,  명정동,'60,55 - 59세,1998,456,198,258
'4822053000,  명정동,'65,60 - 64세,1998,301,142,159
'4822053000,  명정동,'70,65 - 69세,1998,227,80,147
'4822053000,  명정동,'75,70 - 74세,1998,168,57,111
'4822053000,  명정동,'80,75 - 79세,1998,99,26,73
'4822053000,  명정동,'85,80 - 84세,1998,41,12,29
'4822053000,  명정동,'90,85+ ,1998,28,6,22
'4822055000,  중앙동,'00,계,1998,10222,5084,5138
'4822055000,  중앙동,'05,0 - 4세,1998,458,229,229
'4822055000,  중앙동,'10,5 - 9세,1998,583,314,269
'4822055000,  중앙동,'15,10 - 14세,1998,693,377,316
'4822055000,  중앙동,'20,15 - 19세,1998,1105,558,547
'4822055000,  중앙동,'25,20 - 24세,1998,1032,550,482
'4822055000,  중앙동,'30,25 - 29세,1998,894,485,409
'4822055000,  중앙동,'35,30 - 34세,1998,679,348,331
'4822055000,  중앙동,'40,35 - 39세,1998,858,414,444
'4822055000,  중앙동,'45,40 - 44세,1998,895,445,450
'4822055000,  중앙동,'50,45 - 49세,1998,694,334,360
'4822055000,  중앙동,'55,50 - 54세,1998,622,311,311
'4822055000,  중앙동,'60,55 - 59세,1998,566,265,301
'4822055000,  중앙동,'65,60 - 64세,1998,388,191,197
'4822055000,  중앙동,'70,65 - 69세,1998,298,107,191
'4822055000,  중앙동,'75,70 - 74세,1998,221,73,148
'4822055000,  중앙동,'80,75 - 79세,1998,141,51,90
'4822055000,  중앙동,'85,80 - 84세,1998,64,25,39
'4822055000,  중앙동,'90,85+ ,1998,31,7,24
'4822059000,  정량동,'00,계,1998,15129,7600,7529
'4822059000,  정량동,'05,0 - 4세,1998,878,463,415
'4822059000,  정량동,'10,5 - 9세,1998,1020,517,503
'4822059000,  정량동,'15,10 - 14세,1998,1212,649,563
'4822059000,  정량동,'20,15 - 19세,1998,1629,829,800
'4822059000,  정량동,'25,20 - 24세,1998,1413,758,655
'4822059000,  정량동,'30,25 - 29세,1998,1271,687,584
'4822059000,  정량동,'35,30 - 34세,1998,1201,605,596
'4822059000,  정량동,'40,35 - 39세,1998,1522,723,799
'4822059000,  정량동,'45,40 - 44세,1998,1325,665,660
'4822059000,  정량동,'50,45 - 49세,1998,969,499,470
'4822059000,  정량동,'55,50 - 54세,1998,772,403,369
'4822059000,  정량동,'60,55 - 59세,1998,647,324,323
'4822059000,  정량동,'65,60 - 64세,1998,448,200,248
'4822059000,  정량동,'70,65 - 69세,1998,314,127,187
'4822059000,  정량동,'75,70 - 74세,1998,253,79,174
'4822059000,  정량동,'80,75 - 79세,1998,156,51,105
'4822059000,  정량동,'85,80 - 84세,1998,64,15,49
'4822059000,  정량동,'90,85+ ,1998,35,6,29
'4822060000,  북신동,'00,계,1998,15363,7610,7753
'4822060000,  북신동,'05,0 - 4세,1998,922,495,427
'4822060000,  북신동,'10,5 - 9세,1998,1222,637,585
'4822060000,  북신동,'15,10 - 14세,1998,1233,636,597
'4822060000,  북신동,'20,15 - 19세,1998,1801,949,852
'4822060000,  북신동,'25,20 - 24세,1998,1428,768,660
'4822060000,  북신동,'30,25 - 29세,1998,1168,593,575
'4822060000,  북신동,'35,30 - 34세,1998,1181,492,689
'4822060000,  북신동,'40,35 - 39세,1998,1581,778,803
'4822060000,  북신동,'45,40 - 44세,1998,1380,642,738
'4822060000,  북신동,'50,45 - 49세,1998,1045,528,517
'4822060000,  북신동,'55,50 - 54세,1998,755,401,354
'4822060000,  북신동,'60,55 - 59세,1998,587,303,284
'4822060000,  북신동,'65,60 - 64세,1998,351,181,170
'4822060000,  북신동,'70,65 - 69세,1998,266,93,173
'4822060000,  북신동,'75,70 - 74세,1998,210,65,145
'4822060000,  북신동,'80,75 - 79세,1998,128,32,96
'4822060000,  북신동,'85,80 - 84세,1998,70,10,60
'4822060000,  북신동,'90,85+ ,1998,35,7,28
'4822063000,  인평동,'00,계,1998,6357,3167,3190
'4822063000,  인평동,'05,0 - 4세,1998,507,260,247
'4822063000,  인평동,'10,5 - 9세,1998,543,287,256
'4822063000,  인평동,'15,10 - 14세,1998,530,251,279
'4822063000,  인평동,'20,15 - 19세,1998,614,310,304
'4822063000,  인평동,'25,20 - 24세,1998,519,265,254
'4822063000,  인평동,'30,25 - 29세,1998,645,314,331
'4822063000,  인평동,'35,30 - 34세,1998,629,328,301
'4822063000,  인평동,'40,35 - 39세,1998,656,317,339
'4822063000,  인평동,'45,40 - 44세,1998,502,276,226
'4822063000,  인평동,'50,45 - 49세,1998,290,166,124
'4822063000,  인평동,'55,50 - 54세,1998,220,123,97
'4822063000,  인평동,'60,55 - 59세,1998,219,98,121
'4822063000,  인평동,'65,60 - 64세,1998,177,74,103
'4822063000,  인평동,'70,65 - 69세,1998,124,50,74
'4822063000,  인평동,'75,70 - 74세,1998,79,28,51
'4822063000,  인평동,'80,75 - 79세,1998,54,13,41
'4822063000,  인평동,'85,80 - 84세,1998,25,0,25
'4822063000,  인평동,'90,85+ ,1998,24,7,17
'4822065000,  미수1동,'00,계,1998,7508,3782,3726
'4822065000,  미수1동,'05,0 - 4세,1998,712,379,333
'4822065000,  미수1동,'10,5 - 9세,1998,626,321,305
'4822065000,  미수1동,'15,10 - 14세,1998,658,321,337
'4822065000,  미수1동,'20,15 - 19세,1998,708,372,336
'4822065000,  미수1동,'25,20 - 24세,1998,495,258,237
'4822065000,  미수1동,'30,25 - 29세,1998,723,319,404
'4822065000,  미수1동,'35,30 - 34세,1998,878,473,405
'4822065000,  미수1동,'40,35 - 39세,1998,876,423,453
'4822065000,  미수1동,'45,40 - 44세,1998,661,362,299
'4822065000,  미수1동,'50,45 - 49세,1998,328,191,137
'4822065000,  미수1동,'55,50 - 54세,1998,214,109,105
'4822065000,  미수1동,'60,55 - 59세,1998,206,104,102
'4822065000,  미수1동,'65,60 - 64세,1998,156,66,90
'4822065000,  미수1동,'70,65 - 69세,1998,130,49,81
'4822065000,  미수1동,'75,70 - 74세,1998,79,28,51
'4822065000,  미수1동,'80,75 - 79세,1998,36,5,31
'4822065000,  미수1동,'85,80 - 84세,1998,13,1,12
'4822065000,  미수1동,'90,85+ ,1998,9,1,8
'4822066000,  미수2동,'00,계,1998,6790,3362,3428
'4822066000,  미수2동,'05,0 - 4세,1998,570,297,273
'4822066000,  미수2동,'10,5 - 9세,1998,648,340,308
'4822066000,  미수2동,'15,10 - 14세,1998,633,339,294
'4822066000,  미수2동,'20,15 - 19세,1998,686,331,355
'4822066000,  미수2동,'25,20 - 24세,1998,419,210,209
'4822066000,  미수2동,'30,25 - 29세,1998,516,240,276
'4822066000,  미수2동,'35,30 - 34세,1998,692,311,381
'4822066000,  미수2동,'40,35 - 39세,1998,862,424,438
'4822066000,  미수2동,'45,40 - 44세,1998,629,341,288
'4822066000,  미수2동,'50,45 - 49세,1998,351,213,138
'4822066000,  미수2동,'55,50 - 54세,1998,225,111,114
'4822066000,  미수2동,'60,55 - 59세,1998,184,85,99
'4822066000,  미수2동,'65,60 - 64세,1998,101,36,65
'4822066000,  미수2동,'70,65 - 69세,1998,110,42,68
'4822066000,  미수2동,'75,70 - 74세,1998,71,21,50
'4822066000,  미수2동,'80,75 - 79세,1998,55,11,44
'4822066000,  미수2동,'85,80 - 84세,1998,25,7,18
'4822066000,  미수2동,'90,85+ ,1998,13,3,10
'4822067000,  봉평동,'00,계,1998,6857,3423,3434
'4822067000,  봉평동,'05,0 - 4세,1998,381,207,174
'4822067000,  봉평동,'10,5 - 9세,1998,442,225,217
'4822067000,  봉평동,'15,10 - 14세,1998,550,282,268
'4822067000,  봉평동,'20,15 - 19세,1998,791,435,356
'4822067000,  봉평동,'25,20 - 24세,1998,607,323,284
'4822067000,  봉평동,'30,25 - 29세,1998,633,316,317
'4822067000,  봉평동,'35,30 - 34세,1998,484,247,237
'4822067000,  봉평동,'40,35 - 39세,1998,646,293,353
'4822067000,  봉평동,'45,40 - 44세,1998,633,312,321
'4822067000,  봉평동,'50,45 - 49세,1998,461,236,225
'4822067000,  봉평동,'55,50 - 54세,1998,353,184,169
'4822067000,  봉평동,'60,55 - 59세,1998,278,140,138
'4822067000,  봉평동,'65,60 - 64세,1998,201,99,102
'4822067000,  봉평동,'70,65 - 69세,1998,177,59,118
'4822067000,  봉평동,'75,70 - 74세,1998,101,36,65
'4822067000,  봉평동,'80,75 - 79세,1998,69,18,51
'4822067000,  봉평동,'85,80 - 84세,1998,31,10,21
'4822067000,  봉평동,'90,85+ ,1998,19,1,18
'4822069500,  도남동,'00,계,1998,9214,4647,4567
'4822069500,  도남동,'05,0 - 4세,1998,742,390,352
'4822069500,  도남동,'10,5 - 9세,1998,790,395,395
'4822069500,  도남동,'15,10 - 14세,1998,756,420,336
'4822069500,  도남동,'20,15 - 19세,1998,848,468,380
'4822069500,  도남동,'25,20 - 24세,1998,751,373,378
'4822069500,  도남동,'30,25 - 29세,1998,901,437,464
'4822069500,  도남동,'35,30 - 34세,1998,897,460,437
'4822069500,  도남동,'40,35 - 39세,1998,954,512,442
'4822069500,  도남동,'45,40 - 44세,1998,717,360,357
'4822069500,  도남동,'50,45 - 49세,1998,450,243,207
'4822069500,  도남동,'55,50 - 54세,1998,355,170,185
'4822069500,  도남동,'60,55 - 59세,1998,332,165,167
'4822069500,  도남동,'65,60 - 64세,1998,253,109,144
'4822069500,  도남동,'70,65 - 69세,1998,181,65,116
'4822069500,  도남동,'75,70 - 74세,1998,138,47,91
'4822069500,  도남동,'80,75 - 79세,1998,79,18,61
'4822069500,  도남동,'85,80 - 84세,1998,50,12,38
'4822069500,  도남동,'90,85+ ,1998,20,3,17
'4822070000,  무전동,'00,계,1998,5028,2550,2478
'4822070000,  무전동,'05,0 - 4세,1998,327,163,164
'4822070000,  무전동,'10,5 - 9세,1998,286,149,137
'4822070000,  무전동,'15,10 - 14세,1998,353,200,153
'4822070000,  무전동,'20,15 - 19세,1998,617,321,296
'4822070000,  무전동,'25,20 - 24세,1998,535,289,246
'4822070000,  무전동,'30,25 - 29세,1998,463,242,221
'4822070000,  무전동,'35,30 - 34세,1998,359,194,165
'4822070000,  무전동,'40,35 - 39세,1998,443,208,235
'4822070000,  무전동,'45,40 - 44세,1998,492,225,267
'4822070000,  무전동,'50,45 - 49세,1998,350,183,167
'4822070000,  무전동,'55,50 - 54세,1998,256,136,120
'4822070000,  무전동,'60,55 - 59세,1998,179,100,79
'4822070000,  무전동,'65,60 - 64세,1998,144,64,80
'4822070000,  무전동,'70,65 - 69세,1998,88,36,52
'4822070000,  무전동,'75,70 - 74세,1998,68,22,46
'4822070000,  무전동,'80,75 - 79세,1998,34,10,24
'4822070000,  무전동,'85,80 - 84세,1998,22,7,15
'4822070000,  무전동,'90,85+ ,1998,12,1,11
'48240, 사천시,'00,계,1998,120145,59907,60238
'48240, 사천시,'05,0 - 4세,1998,7945,4315,3630
'48240, 사천시,'10,5 - 9세,1998,7375,3964,3411
'48240, 사천시,'15,10 - 14세,1998,7101,3644,3457
'48240, 사천시,'20,15 - 19세,1998,10887,5486,5401
'48240, 사천시,'25,20 - 24세,1998,11299,6091,5208
'48240, 사천시,'30,25 - 29세,1998,11775,6429,5346
'48240, 사천시,'35,30 - 34세,1998,9457,5134,4323
'48240, 사천시,'40,35 - 39세,1998,9327,4889,4438
'48240, 사천시,'45,40 - 44세,1998,8109,4170,3939
'48240, 사천시,'50,45 - 49세,1998,6425,3226,3199
'48240, 사천시,'55,50 - 54세,1998,5989,2828,3161
'48240, 사천시,'60,55 - 59세,1998,6614,3015,3599
'48240, 사천시,'65,60 - 64세,1998,6118,2644,3474
'48240, 사천시,'70,65 - 69세,1998,4744,1827,2917
'48240, 사천시,'75,70 - 74세,1998,3333,1151,2182
'48240, 사천시,'80,75 - 79세,1998,2110,712,1398
'48240, 사천시,'85,80 - 84세,1998,968,262,706
'48240, 사천시,'90,85+ ,1998,569,120,449
'4824025000,  사천읍,'00,계,1998,16125,8023,8102
'4824025000,  사천읍,'05,0 - 4세,1998,1321,733,588
'4824025000,  사천읍,'10,5 - 9세,1998,1302,704,598
'4824025000,  사천읍,'15,10 - 14세,1998,1044,523,521
'4824025000,  사천읍,'20,15 - 19세,1998,1193,584,609
'4824025000,  사천읍,'25,20 - 24세,1998,1321,716,605
'4824025000,  사천읍,'30,25 - 29세,1998,1698,857,841
'4824025000,  사천읍,'35,30 - 34세,1998,1590,817,773
'4824025000,  사천읍,'40,35 - 39세,1998,1410,757,653
'4824025000,  사천읍,'45,40 - 44세,1998,1063,560,503
'4824025000,  사천읍,'50,45 - 49세,1998,743,374,369
'4824025000,  사천읍,'55,50 - 54세,1998,654,309,345
'4824025000,  사천읍,'60,55 - 59세,1998,725,314,411
'4824025000,  사천읍,'65,60 - 64세,1998,704,296,408
'4824025000,  사천읍,'70,65 - 69세,1998,537,203,334
'4824025000,  사천읍,'75,70 - 74세,1998,401,139,262
'4824025000,  사천읍,'80,75 - 79세,1998,238,87,151
'4824025000,  사천읍,'85,80 - 84세,1998,110,33,77
'4824025000,  사천읍,'90,85+ ,1998,71,17,54
'4824031000,  정동면,'00,계,1998,8506,4287,4219
'4824031000,  정동면,'05,0 - 4세,1998,1024,566,458
'4824031000,  정동면,'10,5 - 9세,1998,590,305,285
'4824031000,  정동면,'15,10 - 14세,1998,382,211,171
'4824031000,  정동면,'20,15 - 19세,1998,466,240,226
'4824031000,  정동면,'25,20 - 24세,1998,636,320,316
'4824031000,  정동면,'30,25 - 29세,1998,1244,599,645
'4824031000,  정동면,'35,30 - 34세,1998,979,572,407
'4824031000,  정동면,'40,35 - 39세,1998,642,382,260
'4824031000,  정동면,'45,40 - 44세,1998,437,240,197
'4824031000,  정동면,'50,45 - 49세,1998,283,137,146
'4824031000,  정동면,'55,50 - 54세,1998,317,131,186
'4824031000,  정동면,'60,55 - 59세,1998,390,183,207
'4824031000,  정동면,'65,60 - 64세,1998,374,140,234
'4824031000,  정동면,'70,65 - 69세,1998,313,119,194
'4824031000,  정동면,'75,70 - 74세,1998,221,73,148
'4824031000,  정동면,'80,75 - 79세,1998,115,42,73
'4824031000,  정동면,'85,80 - 84세,1998,60,18,42
'4824031000,  정동면,'90,85+ ,1998,33,9,24
'4824032000,  사남면,'00,계,1998,5596,2823,2773
'4824032000,  사남면,'05,0 - 4세,1998,320,166,154
'4824032000,  사남면,'10,5 - 9세,1998,222,116,106
'4824032000,  사남면,'15,10 - 14세,1998,259,129,130
'4824032000,  사남면,'20,15 - 19세,1998,439,227,212
'4824032000,  사남면,'25,20 - 24세,1998,525,308,217
'4824032000,  사남면,'30,25 - 29세,1998,604,383,221
'4824032000,  사남면,'35,30 - 34세,1998,370,218,152
'4824032000,  사남면,'40,35 - 39세,1998,359,203,156
'4824032000,  사남면,'45,40 - 44세,1998,331,177,154
'4824032000,  사남면,'50,45 - 49세,1998,263,133,130
'4824032000,  사남면,'55,50 - 54세,1998,268,121,147
'4824032000,  사남면,'60,55 - 59세,1998,338,160,178
'4824032000,  사남면,'65,60 - 64세,1998,363,146,217
'4824032000,  사남면,'70,65 - 69세,1998,345,132,213
'4824032000,  사남면,'75,70 - 74세,1998,268,96,172
'4824032000,  사남면,'80,75 - 79세,1998,189,72,117
'4824032000,  사남면,'85,80 - 84세,1998,89,25,64
'4824032000,  사남면,'90,85+ ,1998,44,11,33
'4824033000,  용현면,'00,계,1998,5707,2813,2894
'4824033000,  용현면,'05,0 - 4세,1998,203,117,86
'4824033000,  용현면,'10,5 - 9세,1998,186,121,65
'4824033000,  용현면,'15,10 - 14세,1998,284,155,129
'4824033000,  용현면,'20,15 - 19세,1998,557,263,294
'4824033000,  용현면,'25,20 - 24세,1998,593,318,275
'4824033000,  용현면,'30,25 - 29세,1998,529,349,180
'4824033000,  용현면,'35,30 - 34세,1998,297,173,124
'4824033000,  용현면,'40,35 - 39세,1998,327,167,160
'4824033000,  용현면,'45,40 - 44세,1998,325,167,158
'4824033000,  용현면,'50,45 - 49세,1998,332,161,171
'4824033000,  용현면,'55,50 - 54세,1998,353,162,191
'4824033000,  용현면,'60,55 - 59세,1998,426,194,232
'4824033000,  용현면,'65,60 - 64세,1998,422,186,236
'4824033000,  용현면,'70,65 - 69세,1998,355,123,232
'4824033000,  용현면,'75,70 - 74세,1998,239,89,150
'4824033000,  용현면,'80,75 - 79세,1998,148,45,103
'4824033000,  용현면,'85,80 - 84세,1998,76,14,62
'4824033000,  용현면,'90,85+ ,1998,55,9,46
'4824034000,  축동면,'00,계,1998,3219,1634,1585
'4824034000,  축동면,'05,0 - 4세,1998,185,107,78
'4824034000,  축동면,'10,5 - 9세,1998,128,64,64
'4824034000,  축동면,'15,10 - 14세,1998,102,52,50
'4824034000,  축동면,'20,15 - 19세,1998,270,147,123
'4824034000,  축동면,'25,20 - 24세,1998,338,193,145
'4824034000,  축동면,'30,25 - 29세,1998,334,201,133
'4824034000,  축동면,'35,30 - 34세,1998,213,136,77
'4824034000,  축동면,'40,35 - 39세,1998,175,104,71
'4824034000,  축동면,'45,40 - 44세,1998,172,81,91
'4824034000,  축동면,'50,45 - 49세,1998,195,93,102
'4824034000,  축동면,'55,50 - 54세,1998,171,90,81
'4824034000,  축동면,'60,55 - 59세,1998,226,93,133
'4824034000,  축동면,'65,60 - 64세,1998,251,102,149
'4824034000,  축동면,'70,65 - 69세,1998,207,74,133
'4824034000,  축동면,'75,70 - 74세,1998,126,55,71
'4824034000,  축동면,'80,75 - 79세,1998,77,30,47
'4824034000,  축동면,'85,80 - 84세,1998,37,9,28
'4824034000,  축동면,'90,85+ ,1998,12,3,9
'4824035000,  곤양면,'00,계,1998,6300,3145,3155
'4824035000,  곤양면,'05,0 - 4세,1998,347,189,158
'4824035000,  곤양면,'10,5 - 9세,1998,351,189,162
'4824035000,  곤양면,'15,10 - 14세,1998,362,174,188
'4824035000,  곤양면,'20,15 - 19세,1998,488,237,251
'4824035000,  곤양면,'25,20 - 24세,1998,642,358,284
'4824035000,  곤양면,'30,25 - 29세,1998,560,342,218
'4824035000,  곤양면,'35,30 - 34세,1998,442,241,201
'4824035000,  곤양면,'40,35 - 39세,1998,424,231,193
'4824035000,  곤양면,'45,40 - 44세,1998,330,186,144
'4824035000,  곤양면,'50,45 - 49세,1998,304,148,156
'4824035000,  곤양면,'55,50 - 54세,1998,341,160,181
'4824035000,  곤양면,'60,55 - 59세,1998,398,173,225
'4824035000,  곤양면,'65,60 - 64세,1998,437,187,250
'4824035000,  곤양면,'70,65 - 69세,1998,372,133,239
'4824035000,  곤양면,'75,70 - 74세,1998,223,94,129
'4824035000,  곤양면,'80,75 - 79세,1998,161,58,103
'4824035000,  곤양면,'85,80 - 84세,1998,79,31,48
'4824035000,  곤양면,'90,85+ ,1998,39,14,25
'4824036000,  곤명면,'00,계,1998,4354,2177,2177
'4824036000,  곤명면,'05,0 - 4세,1998,169,89,80
'4824036000,  곤명면,'10,5 - 9세,1998,128,55,73
'4824036000,  곤명면,'15,10 - 14세,1998,143,73,70
'4824036000,  곤명면,'20,15 - 19세,1998,334,192,142
'4824036000,  곤명면,'25,20 - 24세,1998,471,253,218
'4824036000,  곤명면,'30,25 - 29세,1998,409,249,160
'4824036000,  곤명면,'35,30 - 34세,1998,247,160,87
'4824036000,  곤명면,'40,35 - 39세,1998,191,115,76
'4824036000,  곤명면,'45,40 - 44세,1998,212,121,91
'4824036000,  곤명면,'50,45 - 49세,1998,243,122,121
'4824036000,  곤명면,'55,50 - 54세,1998,264,120,144
'4824036000,  곤명면,'60,55 - 59세,1998,411,171,240
'4824036000,  곤명면,'65,60 - 64세,1998,407,186,221
'4824036000,  곤명면,'70,65 - 69세,1998,285,116,169
'4824036000,  곤명면,'75,70 - 74세,1998,187,68,119
'4824036000,  곤명면,'80,75 - 79세,1998,147,56,91
'4824036000,  곤명면,'85,80 - 84세,1998,66,24,42
'4824036000,  곤명면,'90,85+ ,1998,40,7,33
'4824037000,  서포면,'00,계,1998,6299,3159,3140
'4824037000,  서포면,'05,0 - 4세,1998,296,163,133
'4824037000,  서포면,'10,5 - 9세,1998,273,156,117
'4824037000,  서포면,'15,10 - 14세,1998,340,164,176
'4824037000,  서포면,'20,15 - 19세,1998,641,310,331
'4824037000,  서포면,'25,20 - 24세,1998,684,395,289
'4824037000,  서포면,'30,25 - 29세,1998,509,327,182
'4824037000,  서포면,'35,30 - 34세,1998,316,182,134
'4824037000,  서포면,'40,35 - 39세,1998,392,205,187
'4824037000,  서포면,'45,40 - 44세,1998,368,184,184
'4824037000,  서포면,'50,45 - 49세,1998,338,175,163
'4824037000,  서포면,'55,50 - 54세,1998,334,151,183
'4824037000,  서포면,'60,55 - 59세,1998,490,226,264
'4824037000,  서포면,'65,60 - 64세,1998,460,212,248
'4824037000,  서포면,'70,65 - 69세,1998,359,139,220
'4824037000,  서포면,'75,70 - 74세,1998,249,88,161
'4824037000,  서포면,'80,75 - 79세,1998,163,61,102
'4824037000,  서포면,'85,80 - 84세,1998,56,15,41
'4824037000,  서포면,'90,85+ ,1998,31,6,25
'4824051000,  동서동,'00,계,1998,13338,6679,6659
'4824051000,  동서동,'05,0 - 4세,1998,542,299,243
'4824051000,  동서동,'10,5 - 9세,1998,673,366,307
'4824051000,  동서동,'15,10 - 14세,1998,922,466,456
'4824051000,  동서동,'20,15 - 19세,1998,1585,832,753
'4824051000,  동서동,'25,20 - 24세,1998,1485,773,712
'4824051000,  동서동,'30,25 - 29세,1998,1108,668,440
'4824051000,  동서동,'35,30 - 34세,1998,779,413,366
'4824051000,  동서동,'40,35 - 39세,1998,1030,502,528
'4824051000,  동서동,'45,40 - 44세,1998,1023,528,495
'4824051000,  동서동,'50,45 - 49세,1998,891,455,436
'4824051000,  동서동,'55,50 - 54세,1998,800,374,426
'4824051000,  동서동,'60,55 - 59세,1998,770,380,390
'4824051000,  동서동,'65,60 - 64세,1998,637,279,358
'4824051000,  동서동,'70,65 - 69세,1998,437,173,264
'4824051000,  동서동,'75,70 - 74세,1998,340,95,245
'4824051000,  동서동,'80,75 - 79세,1998,176,46,130
'4824051000,  동서동,'85,80 - 84세,1998,91,25,66
'4824051000,  동서동,'90,85+ ,1998,49,5,44
'4824052000,  선구동,'00,계,1998,10221,5101,5120
'4824052000,  선구동,'05,0 - 4세,1998,665,342,323
'4824052000,  선구동,'10,5 - 9세,1998,708,378,330
'4824052000,  선구동,'15,10 - 14세,1998,670,345,325
'4824052000,  선구동,'20,15 - 19세,1998,974,522,452
'4824052000,  선구동,'25,20 - 24세,1998,958,532,426
'4824052000,  선구동,'30,25 - 29세,1998,1023,525,498
'4824052000,  선구동,'35,30 - 34세,1998,844,442,402
'4824052000,  선구동,'40,35 - 39세,1998,851,425,426
'4824052000,  선구동,'45,40 - 44세,1998,807,421,386
'4824052000,  선구동,'50,45 - 49세,1998,570,275,295
'4824052000,  선구동,'55,50 - 54세,1998,520,234,286
'4824052000,  선구동,'60,55 - 59세,1998,505,230,275
'4824052000,  선구동,'65,60 - 64세,1998,421,178,243
'4824052000,  선구동,'70,65 - 69세,1998,306,137,169
'4824052000,  선구동,'75,70 - 74세,1998,193,62,131
'4824052000,  선구동,'80,75 - 79세,1998,134,42,92
'4824052000,  선구동,'85,80 - 84세,1998,42,10,32
'4824052000,  선구동,'90,85+ ,1998,30,1,29
'4824053000,  동서금동,'00,계,1998,9495,4682,4813
'4824053000,  동서금동,'05,0 - 4세,1998,582,303,279
'4824053000,  동서금동,'10,5 - 9세,1998,680,363,317
'4824053000,  동서금동,'15,10 - 14세,1998,585,282,303
'4824053000,  동서금동,'20,15 - 19세,1998,943,457,486
'4824053000,  동서금동,'25,20 - 24세,1998,940,494,446
'4824053000,  동서금동,'30,25 - 29세,1998,846,452,394
'4824053000,  동서금동,'35,30 - 34세,1998,769,407,362
'4824053000,  동서금동,'40,35 - 39세,1998,811,394,417
'4824053000,  동서금동,'45,40 - 44세,1998,751,367,384
'4824053000,  동서금동,'50,45 - 49세,1998,566,273,293
'4824053000,  동서금동,'55,50 - 54세,1998,523,259,264
'4824053000,  동서금동,'60,55 - 59세,1998,513,245,268
'4824053000,  동서금동,'65,60 - 64세,1998,370,171,199
'4824053000,  동서금동,'70,65 - 69세,1998,242,104,138
'4824053000,  동서금동,'75,70 - 74세,1998,180,56,124
'4824053000,  동서금동,'80,75 - 79세,1998,120,43,77
'4824053000,  동서금동,'85,80 - 84세,1998,48,7,41
'4824053000,  동서금동,'90,85+ ,1998,26,5,21
'4824055000,  벌용동,'00,계,1998,17797,8773,9024
'4824055000,  벌용동,'05,0 - 4세,1998,1483,809,674
'4824055000,  벌용동,'10,5 - 9세,1998,1463,777,686
'4824055000,  벌용동,'15,10 - 14세,1998,1246,669,577
'4824055000,  벌용동,'20,15 - 19세,1998,1767,841,926
'4824055000,  벌용동,'25,20 - 24세,1998,1404,713,691
'4824055000,  벌용동,'30,25 - 29세,1998,1635,765,870
'4824055000,  벌용동,'35,30 - 34세,1998,1710,868,842
'4824055000,  벌용동,'40,35 - 39세,1998,1783,908,875
'4824055000,  벌용동,'45,40 - 44세,1998,1402,691,711
'4824055000,  벌용동,'50,45 - 49세,1998,970,517,453
'4824055000,  벌용동,'55,50 - 54세,1998,705,356,349
'4824055000,  벌용동,'60,55 - 59세,1998,667,302,365
'4824055000,  벌용동,'65,60 - 64세,1998,548,234,314
'4824055000,  벌용동,'70,65 - 69세,1998,392,142,250
'4824055000,  벌용동,'75,70 - 74세,1998,303,107,196
'4824055000,  벌용동,'80,75 - 79세,1998,181,40,141
'4824055000,  벌용동,'85,80 - 84세,1998,82,20,62
'4824055000,  벌용동,'90,85+ ,1998,56,14,42
'4824057000,  향촌동,'00,계,1998,6769,3419,3350
'4824057000,  향촌동,'05,0 - 4세,1998,397,219,178
'4824057000,  향촌동,'10,5 - 9세,1998,347,198,149
'4824057000,  향촌동,'15,10 - 14세,1998,388,210,178
'4824057000,  향촌동,'20,15 - 19세,1998,644,327,317
'4824057000,  향촌동,'25,20 - 24세,1998,656,350,306
'4824057000,  향촌동,'30,25 - 29세,1998,634,357,277
'4824057000,  향촌동,'35,30 - 34세,1998,473,269,204
'4824057000,  향촌동,'40,35 - 39세,1998,492,255,237
'4824057000,  향촌동,'45,40 - 44세,1998,451,235,216
'4824057000,  향촌동,'50,45 - 49세,1998,390,194,196
'4824057000,  향촌동,'55,50 - 54세,1998,400,203,197
'4824057000,  향촌동,'60,55 - 59세,1998,371,170,201
'4824057000,  향촌동,'65,60 - 64세,1998,375,165,210
'4824057000,  향촌동,'70,65 - 69세,1998,297,123,174
'4824057000,  향촌동,'75,70 - 74세,1998,203,68,135
'4824057000,  향촌동,'80,75 - 79세,1998,140,51,89
'4824057000,  향촌동,'85,80 - 84세,1998,71,15,56
'4824057000,  향촌동,'90,85+ ,1998,40,10,30
'4824059500,  남양동,'00,계,1998,6419,3192,3227
'4824059500,  남양동,'05,0 - 4세,1998,411,213,198
'4824059500,  남양동,'10,5 - 9세,1998,324,172,152
'4824059500,  남양동,'15,10 - 14세,1998,374,191,183
'4824059500,  남양동,'20,15 - 19세,1998,586,307,279
'4824059500,  남양동,'25,20 - 24세,1998,646,368,278
'4824059500,  남양동,'30,25 - 29세,1998,642,355,287
'4824059500,  남양동,'35,30 - 34세,1998,428,236,192
'4824059500,  남양동,'40,35 - 39세,1998,440,241,199
'4824059500,  남양동,'45,40 - 44세,1998,437,212,225
'4824059500,  남양동,'50,45 - 49세,1998,337,169,168
'4824059500,  남양동,'55,50 - 54세,1998,339,158,181
'4824059500,  남양동,'60,55 - 59세,1998,384,174,210
'4824059500,  남양동,'65,60 - 64세,1998,349,162,187
'4824059500,  남양동,'70,65 - 69세,1998,297,109,188
'4824059500,  남양동,'75,70 - 74세,1998,200,61,139
'4824059500,  남양동,'80,75 - 79세,1998,121,39,82
'4824059500,  남양동,'85,80 - 84세,1998,61,16,45
'4824059500,  남양동,'90,85+ ,1998,43,9,34
'48250, 김해시,'00,계,1998,320487,161092,159395
'48250, 김해시,'05,0 - 4세,1998,30767,16429,14338
'48250, 김해시,'10,5 - 9세,1998,30735,16413,14322
'48250, 김해시,'15,10 - 14세,1998,23361,12064,11297
'48250, 김해시,'20,15 - 19세,1998,23139,11802,11337
'48250, 김해시,'25,20 - 24세,1998,20685,10329,10356
'48250, 김해시,'30,25 - 29세,1998,31803,14557,17246
'48250, 김해시,'35,30 - 34세,1998,37774,18730,19044
'48250, 김해시,'40,35 - 39세,1998,36341,19791,16550
'48250, 김해시,'45,40 - 44세,1998,24188,13548,10640
'48250, 김해시,'50,45 - 49세,1998,14337,7600,6737
'48250, 김해시,'55,50 - 54세,1998,10888,5434,5454
'48250, 김해시,'60,55 - 59세,1998,10995,5082,5913
'48250, 김해시,'65,60 - 64세,1998,9120,3820,5300
'48250, 김해시,'70,65 - 69세,1998,6840,2520,4320
'48250, 김해시,'75,70 - 74세,1998,4599,1574,3025
'48250, 김해시,'80,75 - 79세,1998,2880,887,1993
'48250, 김해시,'85,80 - 84세,1998,1304,351,953
'48250, 김해시,'90,85+ ,1998,731,161,570
'4825025000,  진영읍,'00,계,1998,25472,12775,12697
'4825025000,  진영읍,'05,0 - 4세,1998,2205,1206,999
'4825025000,  진영읍,'10,5 - 9세,1998,2051,1062,989
'4825025000,  진영읍,'15,10 - 14세,1998,1642,848,794
'4825025000,  진영읍,'20,15 - 19세,1998,2038,1035,1003
'4825025000,  진영읍,'25,20 - 24세,1998,2007,1041,966
'4825025000,  진영읍,'30,25 - 29세,1998,2475,1202,1273
'4825025000,  진영읍,'35,30 - 34세,1998,2566,1350,1216
'4825025000,  진영읍,'40,35 - 39세,1998,2383,1333,1050
'4825025000,  진영읍,'45,40 - 44세,1998,1834,940,894
'4825025000,  진영읍,'50,45 - 49세,1998,1311,683,628
'4825025000,  진영읍,'55,50 - 54세,1998,1082,518,564
'4825025000,  진영읍,'60,55 - 59세,1998,1119,543,576
'4825025000,  진영읍,'65,60 - 64세,1998,998,405,593
'4825025000,  진영읍,'70,65 - 69세,1998,740,277,463
'4825025000,  진영읍,'75,70 - 74세,1998,508,183,325
'4825025000,  진영읍,'80,75 - 79세,1998,312,95,217
'4825025000,  진영읍,'85,80 - 84세,1998,134,38,96
'4825025000,  진영읍,'90,85+ ,1998,67,16,51
'4825031000,  장유면,'00,계,1998,11698,5950,5748
'4825031000,  장유면,'05,0 - 4세,1998,769,431,338
'4825031000,  장유면,'10,5 - 9세,1998,891,472,419
'4825031000,  장유면,'15,10 - 14세,1998,761,404,357
'4825031000,  장유면,'20,15 - 19세,1998,1004,501,503
'4825031000,  장유면,'25,20 - 24세,1998,962,500,462
'4825031000,  장유면,'30,25 - 29세,1998,968,506,462
'4825031000,  장유면,'35,30 - 34세,1998,1032,541,491
'4825031000,  장유면,'40,35 - 39세,1998,1101,589,512
'4825031000,  장유면,'45,40 - 44세,1998,922,532,390
'4825031000,  장유면,'50,45 - 49세,1998,656,359,297
'4825031000,  장유면,'55,50 - 54세,1998,537,247,290
'4825031000,  장유면,'60,55 - 59세,1998,584,286,298
'4825031000,  장유면,'65,60 - 64세,1998,513,244,269
'4825031000,  장유면,'70,65 - 69세,1998,412,149,263
'4825031000,  장유면,'75,70 - 74세,1998,279,97,182
'4825031000,  장유면,'80,75 - 79세,1998,186,67,119
'4825031000,  장유면,'85,80 - 84세,1998,76,17,59
'4825031000,  장유면,'90,85+ ,1998,45,8,37
'4825032000,  주촌면,'00,계,1998,5609,2898,2711
'4825032000,  주촌면,'05,0 - 4세,1998,328,175,153
'4825032000,  주촌면,'10,5 - 9세,1998,349,182,167
'4825032000,  주촌면,'15,10 - 14세,1998,373,190,183
'4825032000,  주촌면,'20,15 - 19세,1998,518,275,243
'4825032000,  주촌면,'25,20 - 24세,1998,450,242,208
'4825032000,  주촌면,'30,25 - 29세,1998,469,279,190
'4825032000,  주촌면,'35,30 - 34세,1998,487,275,212
'4825032000,  주촌면,'40,35 - 39세,1998,486,277,209
'4825032000,  주촌면,'45,40 - 44세,1998,462,267,195
'4825032000,  주촌면,'50,45 - 49세,1998,308,169,139
'4825032000,  주촌면,'55,50 - 54세,1998,257,126,131
'4825032000,  주촌면,'60,55 - 59세,1998,277,127,150
'4825032000,  주촌면,'65,60 - 64세,1998,291,127,164
'4825032000,  주촌면,'70,65 - 69세,1998,210,77,133
'4825032000,  주촌면,'75,70 - 74세,1998,136,54,82
'4825032000,  주촌면,'80,75 - 79세,1998,115,36,79
'4825032000,  주촌면,'85,80 - 84세,1998,54,13,41
'4825032000,  주촌면,'90,85+ ,1998,39,7,32
'4825033000,  진례면,'00,계,1998,9358,4756,4602
'4825033000,  진례면,'05,0 - 4세,1998,664,368,296
'4825033000,  진례면,'10,5 - 9세,1998,666,355,311
'4825033000,  진례면,'15,10 - 14세,1998,550,283,267
'4825033000,  진례면,'20,15 - 19세,1998,686,343,343
'4825033000,  진례면,'25,20 - 24세,1998,739,407,332
'4825033000,  진례면,'30,25 - 29세,1998,846,449,397
'4825033000,  진례면,'35,30 - 34세,1998,847,467,380
'4825033000,  진례면,'40,35 - 39세,1998,817,459,358
'4825033000,  진례면,'45,40 - 44세,1998,692,388,304
'4825033000,  진례면,'50,45 - 49세,1998,483,254,229
'4825033000,  진례면,'55,50 - 54세,1998,444,224,220
'4825033000,  진례면,'60,55 - 59세,1998,472,220,252
'4825033000,  진례면,'65,60 - 64세,1998,485,207,278
'4825033000,  진례면,'70,65 - 69세,1998,380,146,234
'4825033000,  진례면,'75,70 - 74세,1998,274,96,178
'4825033000,  진례면,'80,75 - 79세,1998,166,55,111
'4825033000,  진례면,'85,80 - 84세,1998,89,24,65
'4825033000,  진례면,'90,85+ ,1998,58,11,47
'4825034000,  한림면,'00,계,1998,12736,6450,6286
'4825034000,  한림면,'05,0 - 4세,1998,695,367,328
'4825034000,  한림면,'10,5 - 9세,1998,771,428,343
'4825034000,  한림면,'15,10 - 14세,1998,700,349,351
'4825034000,  한림면,'20,15 - 19세,1998,1149,605,544
'4825034000,  한림면,'25,20 - 24세,1998,1148,617,531
'4825034000,  한림면,'30,25 - 29세,1998,1080,616,464
'4825034000,  한림면,'35,30 - 34세,1998,933,525,408
'4825034000,  한림면,'40,35 - 39세,1998,991,553,438
'4825034000,  한림면,'45,40 - 44세,1998,919,505,414
'4825034000,  한림면,'50,45 - 49세,1998,790,407,383
'4825034000,  한림면,'55,50 - 54세,1998,649,346,303
'4825034000,  한림면,'60,55 - 59세,1998,751,328,423
'4825034000,  한림면,'65,60 - 64세,1998,709,279,430
'4825034000,  한림면,'70,65 - 69세,1998,621,247,374
'4825034000,  한림면,'75,70 - 74세,1998,409,145,264
'4825034000,  한림면,'80,75 - 79세,1998,258,88,170
'4825034000,  한림면,'85,80 - 84세,1998,109,37,72
'4825034000,  한림면,'90,85+ ,1998,54,8,46
'4825035000,  생림면,'00,계,1998,5671,2841,2830
'4825035000,  생림면,'05,0 - 4세,1998,275,142,133
'4825035000,  생림면,'10,5 - 9세,1998,269,147,122
'4825035000,  생림면,'15,10 - 14세,1998,349,180,169
'4825035000,  생림면,'20,15 - 19세,1998,528,270,258
'4825035000,  생림면,'25,20 - 24세,1998,525,278,247
'4825035000,  생림면,'30,25 - 29세,1998,400,230,170
'4825035000,  생림면,'35,30 - 34세,1998,374,206,168
'4825035000,  생림면,'40,35 - 39세,1998,426,247,179
'4825035000,  생림면,'45,40 - 44세,1998,413,226,187
'4825035000,  생림면,'50,45 - 49세,1998,357,172,185
'4825035000,  생림면,'55,50 - 54세,1998,343,173,170
'4825035000,  생림면,'60,55 - 59세,1998,410,192,218
'4825035000,  생림면,'65,60 - 64세,1998,341,148,193
'4825035000,  생림면,'70,65 - 69세,1998,250,99,151
'4825035000,  생림면,'75,70 - 74세,1998,204,70,134
'4825035000,  생림면,'80,75 - 79세,1998,115,35,80
'4825035000,  생림면,'85,80 - 84세,1998,57,15,42
'4825035000,  생림면,'90,85+ ,1998,35,11,24
'4825036000,  상동면,'00,계,1998,4319,2229,2090
'4825036000,  상동면,'05,0 - 4세,1998,255,151,104
'4825036000,  상동면,'10,5 - 9세,1998,280,144,136
'4825036000,  상동면,'15,10 - 14세,1998,261,150,111
'4825036000,  상동면,'20,15 - 19세,1998,358,175,183
'4825036000,  상동면,'25,20 - 24세,1998,381,211,170
'4825036000,  상동면,'30,25 - 29세,1998,344,191,153
'4825036000,  상동면,'35,30 - 34세,1998,328,180,148
'4825036000,  상동면,'40,35 - 39세,1998,394,236,158
'4825036000,  상동면,'45,40 - 44세,1998,313,165,148
'4825036000,  상동면,'50,45 - 49세,1998,284,150,134
'4825036000,  상동면,'55,50 - 54세,1998,215,106,109
'4825036000,  상동면,'60,55 - 59세,1998,278,127,151
'4825036000,  상동면,'65,60 - 64세,1998,208,84,124
'4825036000,  상동면,'70,65 - 69세,1998,182,83,99
'4825036000,  상동면,'75,70 - 74세,1998,106,34,72
'4825036000,  상동면,'80,75 - 79세,1998,73,27,46
'4825036000,  상동면,'85,80 - 84세,1998,38,8,30
'4825036000,  상동면,'90,85+ ,1998,21,7,14
'4825037000,  대동면,'00,계,1998,10690,5384,5306
'4825037000,  대동면,'05,0 - 4세,1998,501,285,216
'4825037000,  대동면,'10,5 - 9세,1998,544,298,246
'4825037000,  대동면,'15,10 - 14세,1998,617,332,285
'4825037000,  대동면,'20,15 - 19세,1998,1140,597,543
'4825037000,  대동면,'25,20 - 24세,1998,1050,532,518
'4825037000,  대동면,'30,25 - 29세,1998,869,480,389
'4825037000,  대동면,'35,30 - 34세,1998,653,378,275
'4825037000,  대동면,'40,35 - 39세,1998,805,422,383
'4825037000,  대동면,'45,40 - 44세,1998,876,452,424
'4825037000,  대동면,'50,45 - 49세,1998,756,387,369
'4825037000,  대동면,'55,50 - 54세,1998,624,334,290
'4825037000,  대동면,'60,55 - 59세,1998,648,309,339
'4825037000,  대동면,'65,60 - 64세,1998,577,244,333
'4825037000,  대동면,'70,65 - 69세,1998,381,135,246
'4825037000,  대동면,'75,70 - 74세,1998,323,122,201
'4825037000,  대동면,'80,75 - 79세,1998,177,44,133
'4825037000,  대동면,'85,80 - 84세,1998,94,19,75
'4825037000,  대동면,'90,85+ ,1998,55,14,41
'4825051000,  동상동,'00,계,1998,9590,4756,4834
'4825051000,  동상동,'05,0 - 4세,1998,564,302,262
'4825051000,  동상동,'10,5 - 9세,1998,777,450,327
'4825051000,  동상동,'15,10 - 14세,1998,719,374,345
'4825051000,  동상동,'20,15 - 19세,1998,901,469,432
'4825051000,  동상동,'25,20 - 24세,1998,780,413,367
'4825051000,  동상동,'30,25 - 29세,1998,834,396,438
'4825051000,  동상동,'35,30 - 34세,1998,822,410,412
'4825051000,  동상동,'40,35 - 39세,1998,933,483,450
'4825051000,  동상동,'45,40 - 44세,1998,852,435,417
'4825051000,  동상동,'50,45 - 49세,1998,563,289,274
'4825051000,  동상동,'55,50 - 54세,1998,440,208,232
'4825051000,  동상동,'60,55 - 59세,1998,423,190,233
'4825051000,  동상동,'65,60 - 64세,1998,343,149,194
'4825051000,  동상동,'70,65 - 69세,1998,258,86,172
'4825051000,  동상동,'75,70 - 74세,1998,183,55,128
'4825051000,  동상동,'80,75 - 79세,1998,109,28,81
'4825051000,  동상동,'85,80 - 84세,1998,54,11,43
'4825051000,  동상동,'90,85+ ,1998,35,8,27
'4825052000,  회현동,'00,계,1998,12725,6401,6324
'4825052000,  회현동,'05,0 - 4세,1998,758,404,354
'4825052000,  회현동,'10,5 - 9세,1998,923,534,389
'4825052000,  회현동,'15,10 - 14세,1998,1003,547,456
'4825052000,  회현동,'20,15 - 19세,1998,1142,590,552
'4825052000,  회현동,'25,20 - 24세,1998,1066,545,521
'4825052000,  회현동,'30,25 - 29세,1998,1154,591,563
'4825052000,  회현동,'35,30 - 34세,1998,1028,502,526
'4825052000,  회현동,'40,35 - 39세,1998,1270,633,637
'4825052000,  회현동,'45,40 - 44세,1998,1144,609,535
'4825052000,  회현동,'50,45 - 49세,1998,765,350,415
'4825052000,  회현동,'55,50 - 54세,1998,686,351,335
'4825052000,  회현동,'60,55 - 59세,1998,589,292,297
'4825052000,  회현동,'65,60 - 64세,1998,403,176,227
'4825052000,  회현동,'70,65 - 69세,1998,344,128,216
'4825052000,  회현동,'75,70 - 74세,1998,229,84,145
'4825052000,  회현동,'80,75 - 79세,1998,122,39,83
'4825052000,  회현동,'85,80 - 84세,1998,60,19,41
'4825052000,  회현동,'90,85+ ,1998,39,7,32
'4825053000,  부원동,'00,계,1998,7910,3951,3959
'4825053000,  부원동,'05,0 - 4세,1998,516,267,249
'4825053000,  부원동,'10,5 - 9세,1998,532,290,242
'4825053000,  부원동,'15,10 - 14세,1998,539,290,249
'4825053000,  부원동,'20,15 - 19세,1998,706,353,353
'4825053000,  부원동,'25,20 - 24세,1998,709,364,345
'4825053000,  부원동,'30,25 - 29세,1998,818,432,386
'4825053000,  부원동,'35,30 - 34세,1998,685,354,331
'4825053000,  부원동,'40,35 - 39세,1998,762,369,393
'4825053000,  부원동,'45,40 - 44세,1998,664,317,347
'4825053000,  부원동,'50,45 - 49세,1998,522,254,268
'4825053000,  부원동,'55,50 - 54세,1998,394,190,204
'4825053000,  부원동,'60,55 - 59세,1998,380,178,202
'4825053000,  부원동,'65,60 - 64세,1998,288,129,159
'4825053000,  부원동,'70,65 - 69세,1998,180,83,97
'4825053000,  부원동,'75,70 - 74세,1998,101,44,57
'4825053000,  부원동,'80,75 - 79세,1998,73,24,49
'4825053000,  부원동,'85,80 - 84세,1998,25,11,14
'4825053000,  부원동,'90,85+ ,1998,16,2,14
'4825054000,  내외동,'00,계,1998,79629,39898,39731
'4825054000,  내외동,'05,0 - 4세,1998,10659,5627,5032
'4825054000,  내외동,'10,5 - 9세,1998,10150,5461,4689
'4825054000,  내외동,'15,10 - 14세,1998,6112,3111,3001
'4825054000,  내외동,'20,15 - 19세,1998,4016,2022,1994
'4825054000,  내외동,'25,20 - 24세,1998,3097,1365,1732
'4825054000,  내외동,'30,25 - 29세,1998,8726,3432,5294
'4825054000,  내외동,'35,30 - 34세,1998,12626,6035,6591
'4825054000,  내외동,'40,35 - 39세,1998,10752,5966,4786
'4825054000,  내외동,'45,40 - 44세,1998,5490,3304,2186
'4825054000,  내외동,'50,45 - 49세,1998,2199,1266,933
'4825054000,  내외동,'55,50 - 54세,1998,1379,709,670
'4825054000,  내외동,'60,55 - 59세,1998,1295,564,731
'4825054000,  내외동,'65,60 - 64세,1998,1074,417,657
'4825054000,  내외동,'70,65 - 69세,1998,893,279,614
'4825054000,  내외동,'75,70 - 74세,1998,588,183,405
'4825054000,  내외동,'80,75 - 79세,1998,362,103,259
'4825054000,  내외동,'85,80 - 84세,1998,143,39,104
'4825054000,  내외동,'90,85+ ,1998,68,15,53
'4825055000,  북부동,'00,계,1998,23807,11823,11984
'4825055000,  북부동,'05,0 - 4세,1998,1801,985,816
'4825055000,  북부동,'10,5 - 9세,1998,2106,1088,1018
'4825055000,  북부동,'15,10 - 14세,1998,1930,979,951
'4825055000,  북부동,'20,15 - 19세,1998,2241,1163,1078
'4825055000,  북부동,'25,20 - 24세,1998,1869,932,937
'4825055000,  북부동,'30,25 - 29세,1998,2049,979,1070
'4825055000,  북부동,'35,30 - 34세,1998,2370,1107,1263
'4825055000,  북부동,'40,35 - 39세,1998,2767,1415,1352
'4825055000,  북부동,'45,40 - 44세,1998,2003,1071,932
'4825055000,  북부동,'50,45 - 49세,1998,1323,671,652
'4825055000,  북부동,'55,50 - 54세,1998,923,454,469
'4825055000,  북부동,'60,55 - 59세,1998,809,386,423
'4825055000,  북부동,'65,60 - 64세,1998,610,262,348
'4825055000,  북부동,'70,65 - 69세,1998,442,166,276
'4825055000,  북부동,'75,70 - 74세,1998,250,82,168
'4825055000,  북부동,'80,75 - 79세,1998,180,51,129
'4825055000,  북부동,'85,80 - 84세,1998,84,19,65
'4825055000,  북부동,'90,85+ ,1998,50,13,37
'4825056500,  칠산서부동,'00,계,1998,7767,3931,3836
'4825056500,  칠산서부동,'05,0 - 4세,1998,675,360,315
'4825056500,  칠산서부동,'10,5 - 9세,1998,471,237,234
'4825056500,  칠산서부동,'15,10 - 14세,1998,455,253,202
'4825056500,  칠산서부동,'20,15 - 19세,1998,609,295,314
'4825056500,  칠산서부동,'25,20 - 24세,1998,589,294,295
'4825056500,  칠산서부동,'30,25 - 29세,1998,830,415,415
'4825056500,  칠산서부동,'35,30 - 34세,1998,790,462,328
'4825056500,  칠산서부동,'40,35 - 39세,1998,644,380,264
'4825056500,  칠산서부동,'45,40 - 44세,1998,543,308,235
'4825056500,  칠산서부동,'50,45 - 49세,1998,397,215,182
'4825056500,  칠산서부동,'55,50 - 54세,1998,334,160,174
'4825056500,  칠산서부동,'60,55 - 59세,1998,396,174,222
'4825056500,  칠산서부동,'65,60 - 64세,1998,339,149,190
'4825056500,  칠산서부동,'70,65 - 69세,1998,294,92,202
'4825056500,  칠산서부동,'75,70 - 74세,1998,192,69,123
'4825056500,  칠산서부동,'80,75 - 79세,1998,130,46,84
'4825056500,  칠산서부동,'85,80 - 84세,1998,51,15,36
'4825056500,  칠산서부동,'90,85+ ,1998,28,7,21
'4825058000,  활천동,'00,계,1998,39723,19980,19743
'4825058000,  활천동,'05,0 - 4세,1998,4298,2257,2041
'4825058000,  활천동,'10,5 - 9세,1998,4260,2278,1982
'4825058000,  활천동,'15,10 - 14세,1998,3026,1557,1469
'4825058000,  활천동,'20,15 - 19세,1998,2627,1364,1263
'4825058000,  활천동,'25,20 - 24세,1998,2268,1123,1145
'4825058000,  활천동,'30,25 - 29세,1998,4102,1759,2343
'4825058000,  활천동,'35,30 - 34세,1998,5284,2551,2733
'4825058000,  활천동,'40,35 - 39세,1998,4954,2730,2224
'4825058000,  활천동,'45,40 - 44세,1998,3027,1679,1348
'4825058000,  활천동,'50,45 - 49세,1998,1597,850,747
'4825058000,  활천동,'55,50 - 54세,1998,1187,598,589
'4825058000,  활천동,'60,55 - 59세,1998,1077,508,569
'4825058000,  활천동,'65,60 - 64세,1998,806,341,465
'4825058000,  활천동,'70,65 - 69세,1998,511,192,319
'4825058000,  활천동,'75,70 - 74세,1998,346,105,241
'4825058000,  활천동,'80,75 - 79세,1998,204,54,150
'4825058000,  활천동,'85,80 - 84세,1998,105,24,81
'4825058000,  활천동,'90,85+ ,1998,44,10,34
'4825059000,  삼안동,'00,계,1998,48063,24178,23885
'4825059000,  삼안동,'05,0 - 4세,1998,5377,2876,2501
'4825059000,  삼안동,'10,5 - 9세,1998,5282,2775,2507
'4825059000,  삼안동,'15,10 - 14세,1998,3923,2017,1906
'4825059000,  삼안동,'20,15 - 19세,1998,2982,1517,1465
'4825059000,  삼안동,'25,20 - 24세,1998,2570,1221,1349
'4825059000,  삼안동,'30,25 - 29세,1998,5261,2280,2981
'4825059000,  삼안동,'35,30 - 34세,1998,6375,3072,3303
'4825059000,  삼안동,'40,35 - 39세,1998,6300,3409,2891
'4825059000,  삼안동,'45,40 - 44세,1998,3560,2092,1468
'4825059000,  삼안동,'50,45 - 49세,1998,1736,971,765
'4825059000,  삼안동,'55,50 - 54세,1998,1146,566,580
'4825059000,  삼안동,'60,55 - 59세,1998,1212,521,691
'4825059000,  삼안동,'65,60 - 64세,1998,925,379,546
'4825059000,  삼안동,'70,65 - 69세,1998,596,220,376
'4825059000,  삼안동,'75,70 - 74세,1998,404,135,269
'4825059000,  삼안동,'80,75 - 79세,1998,248,79,169
'4825059000,  삼안동,'85,80 - 84세,1998,111,35,76
'4825059000,  삼안동,'90,85+ ,1998,55,13,42
'4825060000,  불암동,'00,계,1998,5720,2891,2829
'4825060000,  불암동,'05,0 - 4세,1998,427,226,201
'4825060000,  불암동,'10,5 - 9세,1998,413,212,201
'4825060000,  불암동,'15,10 - 14세,1998,401,200,201
'4825060000,  불암동,'20,15 - 19세,1998,494,228,266
'4825060000,  불암동,'25,20 - 24세,1998,475,244,231
'4825060000,  불암동,'30,25 - 29세,1998,578,320,258
'4825060000,  불암동,'35,30 - 34세,1998,574,315,259
'4825060000,  불암동,'40,35 - 39세,1998,556,290,266
'4825060000,  불암동,'45,40 - 44세,1998,474,258,216
'4825060000,  불암동,'50,45 - 49세,1998,290,153,137
'4825060000,  불암동,'55,50 - 54세,1998,248,124,124
'4825060000,  불암동,'60,55 - 59세,1998,275,137,138
'4825060000,  불암동,'65,60 - 64세,1998,210,80,130
'4825060000,  불암동,'70,65 - 69세,1998,146,61,85
'4825060000,  불암동,'75,70 - 74세,1998,67,16,51
'4825060000,  불암동,'80,75 - 79세,1998,50,16,34
'4825060000,  불암동,'85,80 - 84세,1998,20,7,13
'4825060000,  불암동,'90,85+ ,1998,22,4,18
'48270, 밀양시,'00,계,1998,128073,63195,64878
'48270, 밀양시,'05,0 - 4세,1998,6777,3669,3108
'48270, 밀양시,'10,5 - 9세,1998,7435,4099,3336
'48270, 밀양시,'15,10 - 14세,1998,8056,4236,3820
'48270, 밀양시,'20,15 - 19세,1998,11949,6096,5853
'48270, 밀양시,'25,20 - 24세,1998,11360,6296,5064
'48270, 밀양시,'30,25 - 29세,1998,9997,5531,4466
'48270, 밀양시,'35,30 - 34세,1998,8673,4464,4209
'48270, 밀양시,'40,35 - 39세,1998,9689,4961,4728
'48270, 밀양시,'45,40 - 44세,1998,9503,4855,4648
'48270, 밀양시,'50,45 - 49세,1998,7656,3773,3883
'48270, 밀양시,'55,50 - 54세,1998,6544,3084,3460
'48270, 밀양시,'60,55 - 59세,1998,7853,3382,4471
'48270, 밀양시,'65,60 - 64세,1998,7750,3238,4512
'48270, 밀양시,'70,65 - 69세,1998,6069,2400,3669
'48270, 밀양시,'75,70 - 74세,1998,4251,1669,2582
'48270, 밀양시,'80,75 - 79세,1998,2591,926,1665
'48270, 밀양시,'85,80 - 84세,1998,1213,362,851
'48270, 밀양시,'90,85+ ,1998,707,154,553
'4827025000,  삼랑진읍,'00,계,1998,10798,5308,5490
'4827025000,  삼랑진읍,'05,0 - 4세,1998,364,195,169
'4827025000,  삼랑진읍,'10,5 - 9세,1998,463,265,198
'4827025000,  삼랑진읍,'15,10 - 14세,1998,609,304,305
'4827025000,  삼랑진읍,'20,15 - 19세,1998,1062,545,517
'4827025000,  삼랑진읍,'25,20 - 24세,1998,1085,608,477
'4827025000,  삼랑진읍,'30,25 - 29세,1998,797,487,310
'4827025000,  삼랑진읍,'35,30 - 34세,1998,595,314,281
'4827025000,  삼랑진읍,'40,35 - 39세,1998,665,358,307
'4827025000,  삼랑진읍,'45,40 - 44세,1998,764,381,383
'4827025000,  삼랑진읍,'50,45 - 49세,1998,718,368,350
'4827025000,  삼랑진읍,'55,50 - 54세,1998,640,294,346
'4827025000,  삼랑진읍,'60,55 - 59세,1998,790,344,446
'4827025000,  삼랑진읍,'65,60 - 64세,1998,741,307,434
'4827025000,  삼랑진읍,'70,65 - 69세,1998,607,224,383
'4827025000,  삼랑진읍,'75,70 - 74세,1998,456,180,276
'4827025000,  삼랑진읍,'80,75 - 79세,1998,253,92,161
'4827025000,  삼랑진읍,'85,80 - 84세,1998,122,32,90
'4827025000,  삼랑진읍,'90,85+ ,1998,67,10,57
'4827025300,  하남읍,'00,계,1998,11206,5507,5699
'4827025300,  하남읍,'05,0 - 4세,1998,556,289,267
'4827025300,  하남읍,'10,5 - 9세,1998,630,348,282
'4827025300,  하남읍,'15,10 - 14세,1998,742,408,334
'4827025300,  하남읍,'20,15 - 19세,1998,1093,524,569
'4827025300,  하남읍,'25,20 - 24세,1998,1053,587,466
'4827025300,  하남읍,'30,25 - 29세,1998,845,480,365
'4827025300,  하남읍,'35,30 - 34세,1998,712,370,342
'4827025300,  하남읍,'40,35 - 39세,1998,814,418,396
'4827025300,  하남읍,'45,40 - 44세,1998,842,438,404
'4827025300,  하남읍,'50,45 - 49세,1998,675,329,346
'4827025300,  하남읍,'55,50 - 54세,1998,558,263,295
'4827025300,  하남읍,'60,55 - 59세,1998,685,287,398
'4827025300,  하남읍,'65,60 - 64세,1998,728,287,441
'4827025300,  하남읍,'70,65 - 69세,1998,533,205,328
'4827025300,  하남읍,'75,70 - 74세,1998,379,155,224
'4827025300,  하남읍,'80,75 - 79세,1998,207,81,126
'4827025300,  하남읍,'85,80 - 84세,1998,99,23,76
'4827025300,  하남읍,'90,85+ ,1998,55,15,40
'4827031000,  부북면,'00,계,1998,7855,3890,3965
'4827031000,  부북면,'05,0 - 4세,1998,342,193,149
'4827031000,  부북면,'10,5 - 9세,1998,359,200,159
'4827031000,  부북면,'15,10 - 14세,1998,472,243,229
'4827031000,  부북면,'20,15 - 19세,1998,765,396,369
'4827031000,  부북면,'25,20 - 24세,1998,693,385,308
'4827031000,  부북면,'30,25 - 29세,1998,584,356,228
'4827031000,  부북면,'35,30 - 34세,1998,456,256,200
'4827031000,  부북면,'40,35 - 39세,1998,499,255,244
'4827031000,  부북면,'45,40 - 44세,1998,587,307,280
'4827031000,  부북면,'50,45 - 49세,1998,452,238,214
'4827031000,  부북면,'55,50 - 54세,1998,383,173,210
'4827031000,  부북면,'60,55 - 59세,1998,536,228,308
'4827031000,  부북면,'65,60 - 64세,1998,562,237,325
'4827031000,  부북면,'70,65 - 69세,1998,489,183,306
'4827031000,  부북면,'75,70 - 74세,1998,333,131,202
'4827031000,  부북면,'80,75 - 79세,1998,190,60,130
'4827031000,  부북면,'85,80 - 84세,1998,97,31,66
'4827031000,  부북면,'90,85+ ,1998,56,18,38
'4827032000,  상동면,'00,계,1998,4126,2020,2106
'4827032000,  상동면,'05,0 - 4세,1998,128,72,56
'4827032000,  상동면,'10,5 - 9세,1998,142,82,60
'4827032000,  상동면,'15,10 - 14세,1998,180,93,87
'4827032000,  상동면,'20,15 - 19세,1998,401,197,204
'4827032000,  상동면,'25,20 - 24세,1998,397,226,171
'4827032000,  상동면,'30,25 - 29세,1998,285,189,96
'4827032000,  상동면,'35,30 - 34세,1998,167,96,71
'4827032000,  상동면,'40,35 - 39세,1998,200,107,93
'4827032000,  상동면,'45,40 - 44세,1998,274,128,146
'4827032000,  상동면,'50,45 - 49세,1998,269,138,131
'4827032000,  상동면,'55,50 - 54세,1998,243,115,128
'4827032000,  상동면,'60,55 - 59세,1998,329,131,198
'4827032000,  상동면,'65,60 - 64세,1998,386,155,231
'4827032000,  상동면,'70,65 - 69세,1998,316,139,177
'4827032000,  상동면,'75,70 - 74세,1998,191,79,112
'4827032000,  상동면,'80,75 - 79세,1998,132,47,85
'4827032000,  상동면,'85,80 - 84세,1998,56,18,38
'4827032000,  상동면,'90,85+ ,1998,30,8,22
'4827033000,  산외면,'00,계,1998,3661,1778,1883
'4827033000,  산외면,'05,0 - 4세,1998,147,81,66
'4827033000,  산외면,'10,5 - 9세,1998,122,65,57
'4827033000,  산외면,'15,10 - 14세,1998,174,94,80
'4827033000,  산외면,'20,15 - 19세,1998,353,175,178
'4827033000,  산외면,'25,20 - 24세,1998,358,192,166
'4827033000,  산외면,'30,25 - 29세,1998,263,160,103
'4827033000,  산외면,'35,30 - 34세,1998,180,100,80
'4827033000,  산외면,'40,35 - 39세,1998,224,116,108
'4827033000,  산외면,'45,40 - 44세,1998,229,109,120
'4827033000,  산외면,'50,45 - 49세,1998,231,106,125
'4827033000,  산외면,'55,50 - 54세,1998,260,121,139
'4827033000,  산외면,'60,55 - 59세,1998,294,127,167
'4827033000,  산외면,'65,60 - 64세,1998,270,120,150
'4827033000,  산외면,'70,65 - 69세,1998,221,94,127
'4827033000,  산외면,'75,70 - 74세,1998,138,50,88
'4827033000,  산외면,'80,75 - 79세,1998,112,43,69
'4827033000,  산외면,'85,80 - 84세,1998,60,17,43
'4827033000,  산외면,'90,85+ ,1998,25,8,17
'4827034000,  산내면,'00,계,1998,4812,2370,2442
'4827034000,  산내면,'05,0 - 4세,1998,166,97,69
'4827034000,  산내면,'10,5 - 9세,1998,175,89,86
'4827034000,  산내면,'15,10 - 14세,1998,243,120,123
'4827034000,  산내면,'20,15 - 19세,1998,430,231,199
'4827034000,  산내면,'25,20 - 24세,1998,435,242,193
'4827034000,  산내면,'30,25 - 29세,1998,318,210,108
'4827034000,  산내면,'35,30 - 34세,1998,219,122,97
'4827034000,  산내면,'40,35 - 39세,1998,251,132,119
'4827034000,  산내면,'45,40 - 44세,1998,313,154,159
'4827034000,  산내면,'50,45 - 49세,1998,306,145,161
'4827034000,  산내면,'55,50 - 54세,1998,281,140,141
'4827034000,  산내면,'60,55 - 59세,1998,408,175,233
'4827034000,  산내면,'65,60 - 64세,1998,397,162,235
'4827034000,  산내면,'70,65 - 69세,1998,372,167,205
'4827034000,  산내면,'75,70 - 74세,1998,227,93,134
'4827034000,  산내면,'80,75 - 79세,1998,156,62,94
'4827034000,  산내면,'85,80 - 84세,1998,71,22,49
'4827034000,  산내면,'90,85+ ,1998,44,7,37
'4827035000,  단장면,'00,계,1998,5081,2494,2587
'4827035000,  단장면,'05,0 - 4세,1998,161,79,82
'4827035000,  단장면,'10,5 - 9세,1998,185,114,71
'4827035000,  단장면,'15,10 - 14세,1998,281,142,139
'4827035000,  단장면,'20,15 - 19세,1998,454,232,222
'4827035000,  단장면,'25,20 - 24세,1998,503,299,204
'4827035000,  단장면,'30,25 - 29세,1998,293,192,101
'4827035000,  단장면,'35,30 - 34세,1998,236,140,96
'4827035000,  단장면,'40,35 - 39세,1998,285,143,142
'4827035000,  단장면,'45,40 - 44세,1998,350,183,167
'4827035000,  단장면,'50,45 - 49세,1998,317,145,172
'4827035000,  단장면,'55,50 - 54세,1998,319,147,172
'4827035000,  단장면,'60,55 - 59세,1998,413,169,244
'4827035000,  단장면,'65,60 - 64세,1998,456,191,265
'4827035000,  단장면,'70,65 - 69세,1998,336,134,202
'4827035000,  단장면,'75,70 - 74세,1998,219,95,124
'4827035000,  단장면,'80,75 - 79세,1998,144,50,94
'4827035000,  단장면,'85,80 - 84세,1998,78,26,52
'4827035000,  단장면,'90,85+ ,1998,51,13,38
'4827036000,  상남면,'00,계,1998,12891,6433,6458
'4827036000,  상남면,'05,0 - 4세,1998,800,426,374
'4827036000,  상남면,'10,5 - 9세,1998,672,349,323
'4827036000,  상남면,'15,10 - 14세,1998,716,360,356
'4827036000,  상남면,'20,15 - 19세,1998,1227,646,581
'4827036000,  상남면,'25,20 - 24세,1998,1163,636,527
'4827036000,  상남면,'30,25 - 29세,1998,1197,669,528
'4827036000,  상남면,'35,30 - 34세,1998,915,519,396
'4827036000,  상남면,'40,35 - 39세,1998,894,496,398
'4827036000,  상남면,'45,40 - 44세,1998,864,467,397
'4827036000,  상남면,'50,45 - 49세,1998,745,373,372
'4827036000,  상남면,'55,50 - 54세,1998,642,289,353
'4827036000,  상남면,'60,55 - 59세,1998,759,317,442
'4827036000,  상남면,'65,60 - 64세,1998,771,323,448
'4827036000,  상남면,'70,65 - 69세,1998,621,244,377
'4827036000,  상남면,'75,70 - 74세,1998,431,155,276
'4827036000,  상남면,'80,75 - 79세,1998,265,98,167
'4827036000,  상남면,'85,80 - 84세,1998,136,47,89
'4827036000,  상남면,'90,85+ ,1998,73,19,54
'4827037000,  초동면,'00,계,1998,4901,2459,2442
'4827037000,  초동면,'05,0 - 4세,1998,154,87,67
'4827037000,  초동면,'10,5 - 9세,1998,137,82,55
'4827037000,  초동면,'15,10 - 14세,1998,205,115,90
'4827037000,  초동면,'20,15 - 19세,1998,452,226,226
'4827037000,  초동면,'25,20 - 24세,1998,522,322,200
'4827037000,  초동면,'30,25 - 29세,1998,369,239,130
'4827037000,  초동면,'35,30 - 34세,1998,227,136,91
'4827037000,  초동면,'40,35 - 39세,1998,223,119,104
'4827037000,  초동면,'45,40 - 44세,1998,288,147,141
'4827037000,  초동면,'50,45 - 49세,1998,340,166,174
'4827037000,  초동면,'55,50 - 54세,1998,291,133,158
'4827037000,  초동면,'60,55 - 59세,1998,452,194,258
'4827037000,  초동면,'65,60 - 64세,1998,447,199,248
'4827037000,  초동면,'70,65 - 69세,1998,351,139,212
'4827037000,  초동면,'75,70 - 74세,1998,212,89,123
'4827037000,  초동면,'80,75 - 79세,1998,139,40,99
'4827037000,  초동면,'85,80 - 84세,1998,50,16,34
'4827037000,  초동면,'90,85+ ,1998,42,10,32
'4827038000,  무안면,'00,계,1998,7743,3829,3914
'4827038000,  무안면,'05,0 - 4세,1998,297,167,130
'4827038000,  무안면,'10,5 - 9세,1998,295,161,134
'4827038000,  무안면,'15,10 - 14세,1998,378,206,172
'4827038000,  무안면,'20,15 - 19세,1998,669,347,322
'4827038000,  무안면,'25,20 - 24세,1998,724,424,300
'4827038000,  무안면,'30,25 - 29세,1998,521,321,200
'4827038000,  무안면,'35,30 - 34세,1998,442,251,191
'4827038000,  무안면,'40,35 - 39세,1998,398,206,192
'4827038000,  무안면,'45,40 - 44세,1998,502,263,239
'4827038000,  무안면,'50,45 - 49세,1998,428,205,223
'4827038000,  무안면,'55,50 - 54세,1998,404,182,222
'4827038000,  무안면,'60,55 - 59세,1998,643,276,367
'4827038000,  무안면,'65,60 - 64세,1998,708,296,412
'4827038000,  무안면,'70,65 - 69세,1998,527,211,316
'4827038000,  무안면,'75,70 - 74세,1998,400,174,226
'4827038000,  무안면,'80,75 - 79세,1998,253,101,152
'4827038000,  무안면,'85,80 - 84세,1998,97,28,69
'4827038000,  무안면,'90,85+ ,1998,57,10,47
'4827039000,  청도면,'00,계,1998,2710,1324,1386
'4827039000,  청도면,'05,0 - 4세,1998,86,41,45
'4827039000,  청도면,'10,5 - 9세,1998,79,40,39
'4827039000,  청도면,'15,10 - 14세,1998,113,58,55
'4827039000,  청도면,'20,15 - 19세,1998,224,122,102
'4827039000,  청도면,'25,20 - 24세,1998,254,155,99
'4827039000,  청도면,'30,25 - 29세,1998,184,119,65
'4827039000,  청도면,'35,30 - 34세,1998,107,67,40
'4827039000,  청도면,'40,35 - 39세,1998,132,69,63
'4827039000,  청도면,'45,40 - 44세,1998,150,76,74
'4827039000,  청도면,'50,45 - 49세,1998,165,78,87
'4827039000,  청도면,'55,50 - 54세,1998,160,69,91
'4827039000,  청도면,'60,55 - 59세,1998,226,99,127
'4827039000,  청도면,'65,60 - 64세,1998,256,107,149
'4827039000,  청도면,'70,65 - 69세,1998,217,89,128
'4827039000,  청도면,'75,70 - 74세,1998,156,61,95
'4827039000,  청도면,'80,75 - 79세,1998,115,48,67
'4827039000,  청도면,'85,80 - 84세,1998,45,20,25
'4827039000,  청도면,'90,85+ ,1998,41,6,35
'4827051000,  내일동,'00,계,1998,6152,3009,3143
'4827051000,  내일동,'05,0 - 4세,1998,311,161,150
'4827051000,  내일동,'10,5 - 9세,1998,342,188,154
'4827051000,  내일동,'15,10 - 14세,1998,391,208,183
'4827051000,  내일동,'20,15 - 19세,1998,572,287,285
'4827051000,  내일동,'25,20 - 24세,1998,593,323,270
'4827051000,  내일동,'30,25 - 29세,1998,512,290,222
'4827051000,  내일동,'35,30 - 34세,1998,433,212,221
'4827051000,  내일동,'40,35 - 39세,1998,487,241,246
'4827051000,  내일동,'45,40 - 44세,1998,475,228,247
'4827051000,  내일동,'50,45 - 49세,1998,423,204,219
'4827051000,  내일동,'55,50 - 54세,1998,377,186,191
'4827051000,  내일동,'60,55 - 59세,1998,346,166,180
'4827051000,  내일동,'65,60 - 64세,1998,308,129,179
'4827051000,  내일동,'70,65 - 69세,1998,221,74,147
'4827051000,  내일동,'75,70 - 74세,1998,175,60,115
'4827051000,  내일동,'80,75 - 79세,1998,109,34,75
'4827051000,  내일동,'85,80 - 84세,1998,47,13,34
'4827051000,  내일동,'90,85+ ,1998,30,5,25
'4827052000,  내이동,'00,계,1998,10728,5328,5400
'4827052000,  내이동,'05,0 - 4세,1998,660,360,300
'4827052000,  내이동,'10,5 - 9세,1998,774,406,368
'4827052000,  내이동,'15,10 - 14세,1998,766,411,355
'4827052000,  내이동,'20,15 - 19세,1998,996,520,476
'4827052000,  내이동,'25,20 - 24세,1998,957,505,452
'4827052000,  내이동,'30,25 - 29세,1998,899,484,415
'4827052000,  내이동,'35,30 - 34세,1998,881,444,437
'4827052000,  내이동,'40,35 - 39세,1998,937,469,468
'4827052000,  내이동,'45,40 - 44세,1998,898,435,463
'4827052000,  내이동,'50,45 - 49세,1998,665,320,345
'4827052000,  내이동,'55,50 - 54세,1998,518,239,279
'4827052000,  내이동,'60,55 - 59세,1998,545,247,298
'4827052000,  내이동,'65,60 - 64세,1998,446,195,251
'4827052000,  내이동,'70,65 - 69세,1998,314,125,189
'4827052000,  내이동,'75,70 - 74세,1998,247,102,145
'4827052000,  내이동,'80,75 - 79세,1998,128,37,91
'4827052000,  내이동,'85,80 - 84세,1998,62,22,40
'4827052000,  내이동,'90,85+ ,1998,35,7,28
'4827053000,  삼문동,'00,계,1998,15654,7745,7909
'4827053000,  삼문동,'05,0 - 4세,1998,1085,599,486
'4827053000,  삼문동,'10,5 - 9세,1998,1431,812,619
'4827053000,  삼문동,'15,10 - 14세,1998,1326,702,624
'4827053000,  삼문동,'20,15 - 19세,1998,1438,734,704
'4827053000,  삼문동,'25,20 - 24세,1998,1119,595,524
'4827053000,  삼문동,'30,25 - 29세,1998,1111,525,586
'4827053000,  삼문동,'35,30 - 34세,1998,1327,565,762
'4827053000,  삼문동,'40,35 - 39세,1998,1724,845,879
'4827053000,  삼문동,'45,40 - 44세,1998,1411,733,678
'4827053000,  삼문동,'50,45 - 49세,1998,881,447,434
'4827053000,  삼문동,'55,50 - 54세,1998,649,334,315
'4827053000,  삼문동,'60,55 - 59세,1998,611,259,352
'4827053000,  삼문동,'65,60 - 64세,1998,552,250,302
'4827053000,  삼문동,'70,65 - 69세,1998,409,155,254
'4827053000,  삼문동,'75,70 - 74세,1998,288,105,183
'4827053000,  삼문동,'80,75 - 79세,1998,172,58,114
'4827053000,  삼문동,'85,80 - 84세,1998,80,18,62
'4827053000,  삼문동,'90,85+ ,1998,40,9,31
'4827054000,  가곡동,'00,계,1998,11888,5794,6094
'4827054000,  가곡동,'05,0 - 4세,1998,805,429,376
'4827054000,  가곡동,'10,5 - 9세,1998,908,501,407
'4827054000,  가곡동,'15,10 - 14세,1998,809,422,387
'4827054000,  가곡동,'20,15 - 19세,1998,1158,585,573
'4827054000,  가곡동,'25,20 - 24세,1998,973,531,442
'4827054000,  가곡동,'30,25 - 29세,1998,1017,476,541
'4827054000,  가곡동,'35,30 - 34세,1998,947,459,488
'4827054000,  가곡동,'40,35 - 39세,1998,1129,561,568
'4827054000,  가곡동,'45,40 - 44세,1998,945,493,452
'4827054000,  가곡동,'50,45 - 49세,1998,662,315,347
'4827054000,  가곡동,'55,50 - 54세,1998,527,248,279
'4827054000,  가곡동,'60,55 - 59세,1998,558,253,305
'4827054000,  가곡동,'65,60 - 64세,1998,498,184,314
'4827054000,  가곡동,'70,65 - 69세,1998,379,158,221
'4827054000,  가곡동,'75,70 - 74세,1998,292,101,191
'4827054000,  가곡동,'80,75 - 79세,1998,162,54,108
'4827054000,  가곡동,'85,80 - 84세,1998,76,16,60
'4827054000,  가곡동,'90,85+ ,1998,43,8,35
'4827055000,  교동,'00,계,1998,7867,3907,3960
'4827055000,  교동,'05,0 - 4세,1998,715,393,322
'4827055000,  교동,'10,5 - 9세,1998,721,397,324
'4827055000,  교동,'15,10 - 14세,1998,651,350,301
'4827055000,  교동,'20,15 - 19세,1998,655,329,326
'4827055000,  교동,'25,20 - 24세,1998,531,266,265
'4827055000,  교동,'30,25 - 29세,1998,802,334,468
'4827055000,  교동,'35,30 - 34세,1998,829,413,416
'4827055000,  교동,'40,35 - 39세,1998,827,426,401
'4827055000,  교동,'45,40 - 44세,1998,611,313,298
'4827055000,  교동,'50,45 - 49세,1998,379,196,183
'4827055000,  교동,'55,50 - 54세,1998,292,151,141
'4827055000,  교동,'60,55 - 59세,1998,258,110,148
'4827055000,  교동,'65,60 - 64세,1998,224,96,128
'4827055000,  교동,'70,65 - 69세,1998,156,59,97
'4827055000,  교동,'75,70 - 74세,1998,107,39,68
'4827055000,  교동,'80,75 - 79세,1998,54,21,33
'4827055000,  교동,'85,80 - 84세,1998,37,13,24
'4827055000,  교동,'90,85+ ,1998,18,1,17
'48310, 거제시,'00,계,1998,170275,87266,83009
'48310, 거제시,'05,0 - 4세,1998,15210,7940,7270
'48310, 거제시,'10,5 - 9세,1998,13486,7171,6315
'48310, 거제시,'15,10 - 14세,1998,13349,6854,6495
'48310, 거제시,'20,15 - 19세,1998,14469,7314,7155
'48310, 거제시,'25,20 - 24세,1998,13047,6946,6101
'48310, 거제시,'30,25 - 29세,1998,18227,9869,8358
'48310, 거제시,'35,30 - 34세,1998,16733,8942,7791
'48310, 거제시,'40,35 - 39세,1998,16828,8431,8397
'48310, 거제시,'45,40 - 44세,1998,13806,7734,6072
'48310, 거제시,'50,45 - 49세,1998,8357,4604,3753
'48310, 거제시,'55,50 - 54세,1998,5631,3112,2519
'48310, 거제시,'60,55 - 59세,1998,5491,2630,2861
'48310, 거제시,'65,60 - 64세,1998,4769,2066,2703
'48310, 거제시,'70,65 - 69세,1998,4260,1545,2715
'48310, 거제시,'75,70 - 74세,1998,3201,1122,2079
'48310, 거제시,'80,75 - 79세,1998,2005,648,1357
'48310, 거제시,'85,80 - 84세,1998,877,241,636
'48310, 거제시,'90,85+ ,1998,529,97,432
'4831025000,  신현읍,'00,계,1998,53465,27606,25859
'4831025000,  신현읍,'05,0 - 4세,1998,6166,3218,2948
'4831025000,  신현읍,'10,5 - 9세,1998,5202,2731,2471
'4831025000,  신현읍,'15,10 - 14세,1998,4534,2353,2181
'4831025000,  신현읍,'20,15 - 19세,1998,3966,1969,1997
'4831025000,  신현읍,'25,20 - 24세,1998,3501,1747,1754
'4831025000,  신현읍,'30,25 - 29세,1998,7070,3729,3341
'4831025000,  신현읍,'35,30 - 34세,1998,6297,3241,3056
'4831025000,  신현읍,'40,35 - 39세,1998,5987,3008,2979
'4831025000,  신현읍,'45,40 - 44세,1998,4247,2424,1823
'4831025000,  신현읍,'50,45 - 49세,1998,2101,1207,894
'4831025000,  신현읍,'55,50 - 54세,1998,1203,705,498
'4831025000,  신현읍,'60,55 - 59세,1998,944,466,478
'4831025000,  신현읍,'65,60 - 64세,1998,663,294,369
'4831025000,  신현읍,'70,65 - 69세,1998,618,216,402
'4831025000,  신현읍,'75,70 - 74세,1998,450,151,299
'4831025000,  신현읍,'80,75 - 79세,1998,284,86,198
'4831025000,  신현읍,'85,80 - 84세,1998,142,43,99
'4831025000,  신현읍,'90,85+ ,1998,90,18,72
'4831031000,  일운면,'00,계,1998,5639,2808,2831
'4831031000,  일운면,'05,0 - 4세,1998,308,164,144
'4831031000,  일운면,'10,5 - 9세,1998,249,129,120
'4831031000,  일운면,'15,10 - 14세,1998,304,147,157
'4831031000,  일운면,'20,15 - 19세,1998,535,263,272
'4831031000,  일운면,'25,20 - 24세,1998,561,310,251
'4831031000,  일운면,'30,25 - 29세,1998,483,286,197
'4831031000,  일운면,'35,30 - 34세,1998,365,209,156
'4831031000,  일운면,'40,35 - 39세,1998,405,221,184
'4831031000,  일운면,'45,40 - 44세,1998,385,199,186
'4831031000,  일운면,'50,45 - 49세,1998,332,175,157
'4831031000,  일운면,'55,50 - 54세,1998,276,131,145
'4831031000,  일운면,'60,55 - 59세,1998,337,164,173
'4831031000,  일운면,'65,60 - 64세,1998,339,127,212
'4831031000,  일운면,'70,65 - 69세,1998,285,118,167
'4831031000,  일운면,'75,70 - 74세,1998,240,88,152
'4831031000,  일운면,'80,75 - 79세,1998,142,51,91
'4831031000,  일운면,'85,80 - 84세,1998,61,19,42
'4831031000,  일운면,'90,85+ ,1998,32,7,25
'4831032000,  동부면,'00,계,1998,4575,2284,2291
'4831032000,  동부면,'05,0 - 4세,1998,222,111,111
'4831032000,  동부면,'10,5 - 9세,1998,187,93,94
'4831032000,  동부면,'15,10 - 14세,1998,223,116,107
'4831032000,  동부면,'20,15 - 19세,1998,467,223,244
'4831032000,  동부면,'25,20 - 24세,1998,513,306,207
'4831032000,  동부면,'30,25 - 29세,1998,342,214,128
'4831032000,  동부면,'35,30 - 34세,1998,265,160,105
'4831032000,  동부면,'40,35 - 39세,1998,267,140,127
'4831032000,  동부면,'45,40 - 44세,1998,316,166,150
'4831032000,  동부면,'50,45 - 49세,1998,267,127,140
'4831032000,  동부면,'55,50 - 54세,1998,267,147,120
'4831032000,  동부면,'60,55 - 59세,1998,282,134,148
'4831032000,  동부면,'65,60 - 64세,1998,281,121,160
'4831032000,  동부면,'70,65 - 69세,1998,240,91,149
'4831032000,  동부면,'75,70 - 74세,1998,205,70,135
'4831032000,  동부면,'80,75 - 79세,1998,138,41,97
'4831032000,  동부면,'85,80 - 84세,1998,51,14,37
'4831032000,  동부면,'90,85+ ,1998,42,10,32
'4831033000,  남부면,'00,계,1998,2624,1326,1298
'4831033000,  남부면,'05,0 - 4세,1998,105,53,52
'4831033000,  남부면,'10,5 - 9세,1998,111,63,48
'4831033000,  남부면,'15,10 - 14세,1998,118,64,54
'4831033000,  남부면,'20,15 - 19세,1998,237,96,141
'4831033000,  남부면,'25,20 - 24세,1998,277,166,111
'4831033000,  남부면,'30,25 - 29세,1998,179,122,57
'4831033000,  남부면,'35,30 - 34세,1998,145,86,59
'4831033000,  남부면,'40,35 - 39세,1998,189,114,75
'4831033000,  남부면,'45,40 - 44세,1998,167,88,79
'4831033000,  남부면,'50,45 - 49세,1998,154,76,78
'4831033000,  남부면,'55,50 - 54세,1998,173,86,87
'4831033000,  남부면,'60,55 - 59세,1998,221,91,130
'4831033000,  남부면,'65,60 - 64세,1998,176,81,95
'4831033000,  남부면,'70,65 - 69세,1998,142,54,88
'4831033000,  남부면,'75,70 - 74세,1998,115,49,66
'4831033000,  남부면,'80,75 - 79세,1998,71,28,43
'4831033000,  남부면,'85,80 - 84세,1998,28,6,22
'4831033000,  남부면,'90,85+ ,1998,16,3,13
'4831034000,  거제면,'00,계,1998,8098,4082,4016
'4831034000,  거제면,'05,0 - 4세,1998,359,202,157
'4831034000,  거제면,'10,5 - 9세,1998,402,219,183
'4831034000,  거제면,'15,10 - 14세,1998,554,288,266
'4831034000,  거제면,'20,15 - 19세,1998,844,417,427
'4831034000,  거제면,'25,20 - 24세,1998,809,470,339
'4831034000,  거제면,'30,25 - 29세,1998,644,406,238
'4831034000,  거제면,'35,30 - 34세,1998,444,254,190
'4831034000,  거제면,'40,35 - 39세,1998,578,300,278
'4831034000,  거제면,'45,40 - 44세,1998,558,278,280
'4831034000,  거제면,'50,45 - 49세,1998,468,249,219
'4831034000,  거제면,'55,50 - 54세,1998,415,184,231
'4831034000,  거제면,'60,55 - 59세,1998,500,253,247
'4831034000,  거제면,'65,60 - 64세,1998,456,195,261
'4831034000,  거제면,'70,65 - 69세,1998,422,146,276
'4831034000,  거제면,'75,70 - 74세,1998,299,109,190
'4831034000,  거제면,'80,75 - 79세,1998,217,80,137
'4831034000,  거제면,'85,80 - 84세,1998,83,21,62
'4831034000,  거제면,'90,85+ ,1998,46,11,35
'4831035000,  둔덕면,'00,계,1998,4386,2175,2211
'4831035000,  둔덕면,'05,0 - 4세,1998,169,92,77
'4831035000,  둔덕면,'10,5 - 9세,1998,191,91,100
'4831035000,  둔덕면,'15,10 - 14세,1998,239,113,126
'4831035000,  둔덕면,'20,15 - 19세,1998,409,189,220
'4831035000,  둔덕면,'25,20 - 24세,1998,465,265,200
'4831035000,  둔덕면,'30,25 - 29세,1998,329,205,124
'4831035000,  둔덕면,'35,30 - 34세,1998,261,151,110
'4831035000,  둔덕면,'40,35 - 39세,1998,274,137,137
'4831035000,  둔덕면,'45,40 - 44세,1998,284,162,122
'4831035000,  둔덕면,'50,45 - 49세,1998,242,122,120
'4831035000,  둔덕면,'55,50 - 54세,1998,254,128,126
'4831035000,  둔덕면,'60,55 - 59세,1998,292,133,159
'4831035000,  둔덕면,'65,60 - 64세,1998,301,143,158
'4831035000,  둔덕면,'70,65 - 69세,1998,279,108,171
'4831035000,  둔덕면,'75,70 - 74세,1998,199,77,122
'4831035000,  둔덕면,'80,75 - 79세,1998,113,40,73
'4831035000,  둔덕면,'85,80 - 84세,1998,55,17,38
'4831035000,  둔덕면,'90,85+ ,1998,30,2,28
'4831036000,  사등면,'00,계,1998,7573,3810,3763
'4831036000,  사등면,'05,0 - 4세,1998,487,245,242
'4831036000,  사등면,'10,5 - 9세,1998,350,178,172
'4831036000,  사등면,'15,10 - 14세,1998,423,207,216
'4831036000,  사등면,'20,15 - 19세,1998,758,397,361
'4831036000,  사등면,'25,20 - 24세,1998,800,423,377
'4831036000,  사등면,'30,25 - 29세,1998,755,430,325
'4831036000,  사등면,'35,30 - 34세,1998,521,303,218
'4831036000,  사등면,'40,35 - 39세,1998,529,292,237
'4831036000,  사등면,'45,40 - 44세,1998,506,257,249
'4831036000,  사등면,'50,45 - 49세,1998,454,222,232
'4831036000,  사등면,'55,50 - 54세,1998,407,207,200
'4831036000,  사등면,'60,55 - 59세,1998,454,223,231
'4831036000,  사등면,'65,60 - 64세,1998,357,161,196
'4831036000,  사등면,'70,65 - 69세,1998,307,121,186
'4831036000,  사등면,'75,70 - 74세,1998,221,76,145
'4831036000,  사등면,'80,75 - 79세,1998,143,46,97
'4831036000,  사등면,'85,80 - 84세,1998,64,16,48
'4831036000,  사등면,'90,85+ ,1998,37,6,31
'4831036600,  가조출장소,'00,계,1998,1681,853,828
'4831036600,  가조출장소,'05,0 - 4세,1998,54,23,31
'4831036600,  가조출장소,'10,5 - 9세,1998,72,34,38
'4831036600,  가조출장소,'15,10 - 14세,1998,123,66,57
'4831036600,  가조출장소,'20,15 - 19세,1998,181,92,89
'4831036600,  가조출장소,'25,20 - 24세,1998,174,115,59
'4831036600,  가조출장소,'30,25 - 29세,1998,114,73,41
'4831036600,  가조출장소,'35,30 - 34세,1998,96,55,41
'4831036600,  가조출장소,'40,35 - 39세,1998,124,64,60
'4831036600,  가조출장소,'45,40 - 44세,1998,127,70,57
'4831036600,  가조출장소,'50,45 - 49세,1998,110,61,49
'4831036600,  가조출장소,'55,50 - 54세,1998,82,45,37
'4831036600,  가조출장소,'60,55 - 59세,1998,114,45,69
'4831036600,  가조출장소,'65,60 - 64세,1998,98,40,58
'4831036600,  가조출장소,'70,65 - 69세,1998,79,31,48
'4831036600,  가조출장소,'75,70 - 74세,1998,62,20,42
'4831036600,  가조출장소,'80,75 - 79세,1998,44,12,32
'4831036600,  가조출장소,'85,80 - 84세,1998,17,6,11
'4831036600,  가조출장소,'90,85+ ,1998,10,1,9
'4831037000,  연초면,'00,계,1998,7647,3913,3734
'4831037000,  연초면,'05,0 - 4세,1998,635,327,308
'4831037000,  연초면,'10,5 - 9세,1998,460,247,213
'4831037000,  연초면,'15,10 - 14세,1998,419,209,210
'4831037000,  연초면,'20,15 - 19세,1998,612,305,307
'4831037000,  연초면,'25,20 - 24세,1998,737,386,351
'4831037000,  연초면,'30,25 - 29세,1998,834,479,355
'4831037000,  연초면,'35,30 - 34세,1998,636,370,266
'4831037000,  연초면,'40,35 - 39세,1998,609,343,266
'4831037000,  연초면,'45,40 - 44세,1998,555,294,261
'4831037000,  연초면,'50,45 - 49세,1998,407,204,203
'4831037000,  연초면,'55,50 - 54세,1998,296,162,134
'4831037000,  연초면,'60,55 - 59세,1998,338,170,168
'4831037000,  연초면,'65,60 - 64세,1998,365,162,203
'4831037000,  연초면,'70,65 - 69세,1998,308,118,190
'4831037000,  연초면,'75,70 - 74세,1998,209,69,140
'4831037000,  연초면,'80,75 - 79세,1998,121,43,78
'4831037000,  연초면,'85,80 - 84세,1998,64,17,47
'4831037000,  연초면,'90,85+ ,1998,42,8,34
'4831038000,  하청면,'00,계,1998,3843,1880,1963
'4831038000,  하청면,'05,0 - 4세,1998,206,101,105
'4831038000,  하청면,'10,5 - 9세,1998,190,111,79
'4831038000,  하청면,'15,10 - 14세,1998,210,110,100
'4831038000,  하청면,'20,15 - 19세,1998,387,187,200
'4831038000,  하청면,'25,20 - 24세,1998,355,199,156
'4831038000,  하청면,'30,25 - 29세,1998,321,173,148
'4831038000,  하청면,'35,30 - 34세,1998,271,153,118
'4831038000,  하청면,'40,35 - 39세,1998,248,135,113
'4831038000,  하청면,'45,40 - 44세,1998,258,116,142
'4831038000,  하청면,'50,45 - 49세,1998,229,127,102
'4831038000,  하청면,'55,50 - 54세,1998,194,94,100
'4831038000,  하청면,'60,55 - 59세,1998,218,101,117
'4831038000,  하청면,'65,60 - 64세,1998,209,90,119
'4831038000,  하청면,'70,65 - 69세,1998,226,77,149
'4831038000,  하청면,'75,70 - 74세,1998,164,56,108
'4831038000,  하청면,'80,75 - 79세,1998,87,26,61
'4831038000,  하청면,'85,80 - 84세,1998,40,17,23
'4831038000,  하청면,'90,85+ ,1998,30,7,23
'4831038500,  칠천출장소,'00,계,1998,1497,750,747
'4831038500,  칠천출장소,'05,0 - 4세,1998,30,15,15
'4831038500,  칠천출장소,'10,5 - 9세,1998,46,25,21
'4831038500,  칠천출장소,'15,10 - 14세,1998,58,32,26
'4831038500,  칠천출장소,'20,15 - 19세,1998,146,71,75
'4831038500,  칠천출장소,'25,20 - 24세,1998,159,90,69
'4831038500,  칠천출장소,'30,25 - 29세,1998,114,85,29
'4831038500,  칠천출장소,'35,30 - 34세,1998,56,37,19
'4831038500,  칠천출장소,'40,35 - 39세,1998,65,40,25
'4831038500,  칠천출장소,'45,40 - 44세,1998,94,54,40
'4831038500,  칠천출장소,'50,45 - 49세,1998,100,49,51
'4831038500,  칠천출장소,'55,50 - 54세,1998,77,33,44
'4831038500,  칠천출장소,'60,55 - 59세,1998,116,56,60
'4831038500,  칠천출장소,'65,60 - 64세,1998,135,58,77
'4831038500,  칠천출장소,'70,65 - 69세,1998,139,47,92
'4831038500,  칠천출장소,'75,70 - 74세,1998,86,37,49
'4831038500,  칠천출장소,'80,75 - 79세,1998,45,15,30
'4831038500,  칠천출장소,'85,80 - 84세,1998,17,6,11
'4831038500,  칠천출장소,'90,85+ ,1998,14,0,14
'4831039000,  장목면,'00,계,1998,5029,2506,2523
'4831039000,  장목면,'05,0 - 4세,1998,216,106,110
'4831039000,  장목면,'10,5 - 9세,1998,194,107,87
'4831039000,  장목면,'15,10 - 14세,1998,256,140,116
'4831039000,  장목면,'20,15 - 19세,1998,433,205,228
'4831039000,  장목면,'25,20 - 24세,1998,518,309,209
'4831039000,  장목면,'30,25 - 29세,1998,400,256,144
'4831039000,  장목면,'35,30 - 34세,1998,272,162,110
'4831039000,  장목면,'40,35 - 39세,1998,299,173,126
'4831039000,  장목면,'45,40 - 44세,1998,281,149,132
'4831039000,  장목면,'50,45 - 49세,1998,315,153,162
'4831039000,  장목면,'55,50 - 54세,1998,273,142,131
'4831039000,  장목면,'60,55 - 59세,1998,339,135,204
'4831039000,  장목면,'65,60 - 64세,1998,371,164,207
'4831039000,  장목면,'70,65 - 69세,1998,322,117,205
'4831039000,  장목면,'75,70 - 74세,1998,260,99,161
'4831039000,  장목면,'80,75 - 79세,1998,175,65,110
'4831039000,  장목면,'85,80 - 84세,1998,66,14,52
'4831039000,  장목면,'90,85+ ,1998,39,10,29
'4831039500,  외포출장소,'00,계,1998,1801,908,893
'4831039500,  외포출장소,'05,0 - 4세,1998,56,32,24
'4831039500,  외포출장소,'10,5 - 9세,1998,49,25,24
'4831039500,  외포출장소,'15,10 - 14세,1998,83,46,37
'4831039500,  외포출장소,'20,15 - 19세,1998,157,81,76
'4831039500,  외포출장소,'25,20 - 24세,1998,205,124,81
'4831039500,  외포출장소,'30,25 - 29세,1998,153,94,59
'4831039500,  외포출장소,'35,30 - 34세,1998,81,56,25
'4831039500,  외포출장소,'40,35 - 39세,1998,91,49,42
'4831039500,  외포출장소,'45,40 - 44세,1998,109,65,44
'4831039500,  외포출장소,'50,45 - 49세,1998,115,51,64
'4831039500,  외포출장소,'55,50 - 54세,1998,102,49,53
'4831039500,  외포출장소,'60,55 - 59세,1998,155,73,82
'4831039500,  외포출장소,'65,60 - 64세,1998,138,65,73
'4831039500,  외포출장소,'70,65 - 69세,1998,112,44,68
'4831039500,  외포출장소,'75,70 - 74세,1998,90,33,57
'4831039500,  외포출장소,'80,75 - 79세,1998,63,13,50
'4831039500,  외포출장소,'85,80 - 84세,1998,28,7,21
'4831039500,  외포출장소,'90,85+ ,1998,14,1,13
'4831051000,  장승포동,'00,계,1998,3532,1756,1776
'4831051000,  장승포동,'05,0 - 4세,1998,179,74,105
'4831051000,  장승포동,'10,5 - 9세,1998,201,107,94
'4831051000,  장승포동,'15,10 - 14세,1998,265,133,132
'4831051000,  장승포동,'20,15 - 19세,1998,380,191,189
'4831051000,  장승포동,'25,20 - 24세,1998,341,194,147
'4831051000,  장승포동,'30,25 - 29세,1998,336,196,140
'4831051000,  장승포동,'35,30 - 34세,1998,231,128,103
'4831051000,  장승포동,'40,35 - 39세,1998,285,141,144
'4831051000,  장승포동,'45,40 - 44세,1998,312,169,143
'4831051000,  장승포동,'50,45 - 49세,1998,208,110,98
'4831051000,  장승포동,'55,50 - 54세,1998,175,97,78
'4831051000,  장승포동,'60,55 - 59세,1998,148,57,91
'4831051000,  장승포동,'65,60 - 64세,1998,147,59,88
'4831051000,  장승포동,'70,65 - 69세,1998,130,43,87
'4831051000,  장승포동,'75,70 - 74세,1998,95,29,66
'4831051000,  장승포동,'80,75 - 79세,1998,61,16,45
'4831051000,  장승포동,'85,80 - 84세,1998,23,7,16
'4831051000,  장승포동,'90,85+ ,1998,15,5,10
'4831052000,  마전동,'00,계,1998,6173,3369,2804
'4831052000,  마전동,'05,0 - 4세,1998,828,428,400
'4831052000,  마전동,'10,5 - 9세,1998,532,289,243
'4831052000,  마전동,'15,10 - 14세,1998,427,231,196
'4831052000,  마전동,'20,15 - 19세,1998,304,148,156
'4831052000,  마전동,'25,20 - 24세,1998,450,218,232
'4831052000,  마전동,'30,25 - 29세,1998,1199,695,504
'4831052000,  마전동,'35,30 - 34세,1998,815,498,317
'4831052000,  마전동,'40,35 - 39세,1998,621,320,301
'4831052000,  마전동,'45,40 - 44세,1998,405,250,155
'4831052000,  마전동,'50,45 - 49세,1998,205,125,80
'4831052000,  마전동,'55,50 - 54세,1998,96,60,36
'4831052000,  마전동,'60,55 - 59세,1998,98,44,54
'4831052000,  마전동,'65,60 - 64세,1998,71,24,47
'4831052000,  마전동,'70,65 - 69세,1998,52,14,38
'4831052000,  마전동,'75,70 - 74세,1998,40,15,25
'4831052000,  마전동,'80,75 - 79세,1998,19,7,12
'4831052000,  마전동,'85,80 - 84세,1998,8,2,6
'4831052000,  마전동,'90,85+ ,1998,3,1,2
'4831053000,  능포동,'00,계,1998,10734,5567,5167
'4831053000,  능포동,'05,0 - 4세,1998,953,497,456
'4831053000,  능포동,'10,5 - 9세,1998,878,480,398
'4831053000,  능포동,'15,10 - 14세,1998,891,480,411
'4831053000,  능포동,'20,15 - 19세,1998,906,485,421
'4831053000,  능포동,'25,20 - 24세,1998,861,433,428
'4831053000,  능포동,'30,25 - 29세,1998,1195,667,528
'4831053000,  능포동,'35,30 - 34세,1998,1061,552,509
'4831053000,  능포동,'40,35 - 39세,1998,1081,504,577
'4831053000,  능포동,'45,40 - 44세,1998,961,534,427
'4831053000,  능포동,'50,45 - 49세,1998,615,321,294
'4831053000,  능포동,'55,50 - 54세,1998,388,227,161
'4831053000,  능포동,'60,55 - 59세,1998,287,153,134
'4831053000,  능포동,'65,60 - 64세,1998,208,87,121
'4831053000,  능포동,'70,65 - 69세,1998,186,62,124
'4831053000,  능포동,'75,70 - 74세,1998,140,54,86
'4831053000,  능포동,'80,75 - 79세,1998,73,19,54
'4831053000,  능포동,'85,80 - 84세,1998,33,9,24
'4831053000,  능포동,'90,85+ ,1998,17,3,14
'4831054000,  아주동,'00,계,1998,3934,2235,1699
'4831054000,  아주동,'05,0 - 4세,1998,282,151,131
'4831054000,  아주동,'10,5 - 9세,1998,266,134,132
'4831054000,  아주동,'15,10 - 14세,1998,310,148,162
'4831054000,  아주동,'20,15 - 19세,1998,529,377,152
'4831054000,  아주동,'25,20 - 24세,1998,332,200,132
'4831054000,  아주동,'30,25 - 29세,1998,455,323,132
'4831054000,  아주동,'35,30 - 34세,1998,322,171,151
'4831054000,  아주동,'40,35 - 39세,1998,369,179,190
'4831054000,  아주동,'45,40 - 44세,1998,338,192,146
'4831054000,  아주동,'50,45 - 49세,1998,204,113,91
'4831054000,  아주동,'55,50 - 54세,1998,131,86,45
'4831054000,  아주동,'60,55 - 59세,1998,116,63,53
'4831054000,  아주동,'65,60 - 64세,1998,93,42,51
'4831054000,  아주동,'70,65 - 69세,1998,63,22,41
'4831054000,  아주동,'75,70 - 74세,1998,54,15,39
'4831054000,  아주동,'80,75 - 79세,1998,50,16,34
'4831054000,  아주동,'85,80 - 84세,1998,10,2,8
'4831054000,  아주동,'90,85+ ,1998,10,1,9
'4831055000,  옥포1동,'00,계,1998,8385,4360,4025
'4831055000,  옥포1동,'05,0 - 4세,1998,684,389,295
'4831055000,  옥포1동,'10,5 - 9세,1998,808,457,351
'4831055000,  옥포1동,'15,10 - 14세,1998,835,419,416
'4831055000,  옥포1동,'20,15 - 19세,1998,753,378,375
'4831055000,  옥포1동,'25,20 - 24세,1998,542,290,252
'4831055000,  옥포1동,'30,25 - 29세,1998,714,361,353
'4831055000,  옥포1동,'35,30 - 34세,1998,889,465,424
'4831055000,  옥포1동,'40,35 - 39세,1998,983,441,542
'4831055000,  옥포1동,'45,40 - 44세,1998,921,516,405
'4831055000,  옥포1동,'50,45 - 49세,1998,500,287,213
'4831055000,  옥포1동,'55,50 - 54세,1998,245,153,92
'4831055000,  옥포1동,'60,55 - 59세,1998,154,81,73
'4831055000,  옥포1동,'65,60 - 64세,1998,114,51,63
'4831055000,  옥포1동,'70,65 - 69세,1998,102,42,60
'4831055000,  옥포1동,'75,70 - 74세,1998,76,22,54
'4831055000,  옥포1동,'80,75 - 79세,1998,35,4,31
'4831055000,  옥포1동,'85,80 - 84세,1998,20,2,18
'4831055000,  옥포1동,'90,85+ ,1998,10,2,8
'4831056000,  옥포2동,'00,계,1998,29659,15078,14581
'4831056000,  옥포2동,'05,0 - 4세,1998,3271,1712,1559
'4831056000,  옥포2동,'10,5 - 9세,1998,3098,1651,1447
'4831056000,  옥포2동,'15,10 - 14세,1998,3077,1552,1525
'4831056000,  옥포2동,'20,15 - 19세,1998,2465,1240,1225
'4831056000,  옥포2동,'25,20 - 24세,1998,1447,701,746
'4831056000,  옥포2동,'30,25 - 29세,1998,2590,1075,1515
'4831056000,  옥포2동,'35,30 - 34세,1998,3705,1891,1814
'4831056000,  옥포2동,'40,35 - 39세,1998,3824,1830,1994
'4831056000,  옥포2동,'45,40 - 44세,1998,2982,1751,1231
'4831056000,  옥포2동,'50,45 - 49세,1998,1331,825,506
'4831056000,  옥포2동,'55,50 - 54세,1998,577,376,201
'4831056000,  옥포2동,'60,55 - 59세,1998,378,188,190
'4831056000,  옥포2동,'65,60 - 64세,1998,247,102,145
'4831056000,  옥포2동,'70,65 - 69세,1998,248,74,174
'4831056000,  옥포2동,'75,70 - 74세,1998,196,53,143
'4831056000,  옥포2동,'80,75 - 79세,1998,124,40,84
'4831056000,  옥포2동,'85,80 - 84세,1998,67,16,51
'4831056000,  옥포2동,'90,85+ ,1998,32,1,31
'48330, 양산시,'00,계,1998,177081,89465,87616
'48330, 양산시,'05,0 - 4세,1998,17168,9343,7825
'48330, 양산시,'10,5 - 9세,1998,17219,9153,8066
'48330, 양산시,'15,10 - 14세,1998,11812,5975,5837
'48330, 양산시,'20,15 - 19세,1998,11865,5935,5930
'48330, 양산시,'25,20 - 24세,1998,11381,5707,5674
'48330, 양산시,'30,25 - 29세,1998,17682,8140,9542
'48330, 양산시,'35,30 - 34세,1998,21482,10518,10964
'48330, 양산시,'40,35 - 39세,1998,20606,11518,9088
'48330, 양산시,'45,40 - 44세,1998,13061,7349,5712
'48330, 양산시,'50,45 - 49세,1998,7832,4228,3604
'48330, 양산시,'55,50 - 54세,1998,6062,2983,3079
'48330, 양산시,'60,55 - 59세,1998,6516,3023,3493
'48330, 양산시,'65,60 - 64세,1998,5265,2327,2938
'48330, 양산시,'70,65 - 69세,1998,3679,1493,2186
'48330, 양산시,'75,70 - 74세,1998,2603,953,1650
'48330, 양산시,'80,75 - 79세,1998,1607,520,1087
'48330, 양산시,'85,80 - 84세,1998,767,214,553
'48330, 양산시,'90,85+ ,1998,474,86,388
'4833025000,  웅상읍,'00,계,1998,53470,27142,26328
'4833025000,  웅상읍,'05,0 - 4세,1998,5386,2953,2433
'4833025000,  웅상읍,'10,5 - 9세,1998,5215,2735,2480
'4833025000,  웅상읍,'15,10 - 14세,1998,3013,1526,1487
'4833025000,  웅상읍,'20,15 - 19세,1998,3135,1611,1524
'4833025000,  웅상읍,'25,20 - 24세,1998,3441,1784,1657
'4833025000,  웅상읍,'30,25 - 29세,1998,5641,2605,3036
'4833025000,  웅상읍,'35,30 - 34세,1998,6796,3339,3457
'4833025000,  웅상읍,'40,35 - 39세,1998,6228,3552,2676
'4833025000,  웅상읍,'45,40 - 44세,1998,3723,2097,1626
'4833025000,  웅상읍,'50,45 - 49세,1998,2338,1195,1143
'4833025000,  웅상읍,'55,50 - 54세,1998,1982,914,1068
'4833025000,  웅상읍,'60,55 - 59세,1998,2212,1016,1196
'4833025000,  웅상읍,'65,60 - 64세,1998,1773,809,964
'4833025000,  웅상읍,'70,65 - 69세,1998,1099,469,630
'4833025000,  웅상읍,'75,70 - 74세,1998,722,284,438
'4833025000,  웅상읍,'80,75 - 79세,1998,428,165,263
'4833025000,  웅상읍,'85,80 - 84세,1998,217,64,153
'4833025000,  웅상읍,'90,85+ ,1998,121,24,97
'4833025300,  물금읍,'00,계,1998,32387,16129,16258
'4833025300,  물금읍,'05,0 - 4세,1998,3525,1859,1666
'4833025300,  물금읍,'10,5 - 9세,1998,3503,1851,1652
'4833025300,  물금읍,'15,10 - 14세,1998,2478,1206,1272
'4833025300,  물금읍,'20,15 - 19세,1998,2031,998,1033
'4833025300,  물금읍,'25,20 - 24세,1998,1721,806,915
'4833025300,  물금읍,'30,25 - 29세,1998,3178,1324,1854
'4833025300,  물금읍,'35,30 - 34세,1998,4364,2110,2254
'4833025300,  물금읍,'40,35 - 39세,1998,4082,2260,1822
'4833025300,  물금읍,'45,40 - 44세,1998,2394,1432,962
'4833025300,  물금읍,'50,45 - 49세,1998,1176,649,527
'4833025300,  물금읍,'55,50 - 54세,1998,844,425,419
'4833025300,  물금읍,'60,55 - 59세,1998,913,412,501
'4833025300,  물금읍,'65,60 - 64세,1998,753,312,441
'4833025300,  물금읍,'70,65 - 69세,1998,591,233,358
'4833025300,  물금읍,'75,70 - 74세,1998,446,159,287
'4833025300,  물금읍,'80,75 - 79세,1998,216,50,166
'4833025300,  물금읍,'85,80 - 84세,1998,94,27,67
'4833025300,  물금읍,'90,85+ ,1998,78,16,62
'4833031000,  동면,'00,계,1998,12261,6231,6030
'4833031000,  동면,'05,0 - 4세,1998,1212,661,551
'4833031000,  동면,'10,5 - 9세,1998,1068,565,503
'4833031000,  동면,'15,10 - 14세,1998,699,365,334
'4833031000,  동면,'20,15 - 19세,1998,849,438,411
'4833031000,  동면,'25,20 - 24세,1998,780,417,363
'4833031000,  동면,'30,25 - 29세,1998,1280,583,697
'4833031000,  동면,'35,30 - 34세,1998,1406,757,649
'4833031000,  동면,'40,35 - 39세,1998,1292,711,581
'4833031000,  동면,'45,40 - 44세,1998,867,472,395
'4833031000,  동면,'50,45 - 49세,1998,580,331,249
'4833031000,  동면,'55,50 - 54세,1998,460,215,245
'4833031000,  동면,'60,55 - 59세,1998,530,235,295
'4833031000,  동면,'65,60 - 64세,1998,436,193,243
'4833031000,  동면,'70,65 - 69세,1998,296,121,175
'4833031000,  동면,'75,70 - 74세,1998,236,94,142
'4833031000,  동면,'80,75 - 79세,1998,167,47,120
'4833031000,  동면,'85,80 - 84세,1998,65,18,47
'4833031000,  동면,'90,85+ ,1998,38,8,30
'4833032000,  원동면,'00,계,1998,4478,2204,2274
'4833032000,  원동면,'05,0 - 4세,1998,173,91,82
'4833032000,  원동면,'10,5 - 9세,1998,184,91,93
'4833032000,  원동면,'15,10 - 14세,1998,236,125,111
'4833032000,  원동면,'20,15 - 19세,1998,348,169,179
'4833032000,  원동면,'25,20 - 24세,1998,409,235,174
'4833032000,  원동면,'30,25 - 29세,1998,389,243,146
'4833032000,  원동면,'35,30 - 34세,1998,237,139,98
'4833032000,  원동면,'40,35 - 39세,1998,291,150,141
'4833032000,  원동면,'45,40 - 44세,1998,297,152,145
'4833032000,  원동면,'50,45 - 49세,1998,262,119,143
'4833032000,  원동면,'55,50 - 54세,1998,306,155,151
'4833032000,  원동면,'60,55 - 59세,1998,375,159,216
'4833032000,  원동면,'65,60 - 64세,1998,365,168,197
'4833032000,  원동면,'70,65 - 69세,1998,232,91,141
'4833032000,  원동면,'75,70 - 74세,1998,179,62,117
'4833032000,  원동면,'80,75 - 79세,1998,113,33,80
'4833032000,  원동면,'85,80 - 84세,1998,54,17,37
'4833032000,  원동면,'90,85+ ,1998,28,5,23
'4833033000,  상북면,'00,계,1998,18412,9356,9056
'4833033000,  상북면,'05,0 - 4세,1998,1747,957,790
'4833033000,  상북면,'10,5 - 9세,1998,1804,976,828
'4833033000,  상북면,'15,10 - 14세,1998,1243,634,609
'4833033000,  상북면,'20,15 - 19세,1998,1244,617,627
'4833033000,  상북면,'25,20 - 24세,1998,1202,626,576
'4833033000,  상북면,'30,25 - 29세,1998,1769,838,931
'4833033000,  상북면,'35,30 - 34세,1998,2134,991,1143
'4833033000,  상북면,'40,35 - 39세,1998,2133,1252,881
'4833033000,  상북면,'45,40 - 44세,1998,1271,734,537
'4833033000,  상북면,'50,45 - 49세,1998,794,413,381
'4833033000,  상북면,'55,50 - 54세,1998,665,319,346
'4833033000,  상북면,'60,55 - 59세,1998,724,345,379
'4833033000,  상북면,'65,60 - 64세,1998,592,255,337
'4833033000,  상북면,'70,65 - 69세,1998,458,182,276
'4833033000,  상북면,'75,70 - 74세,1998,282,117,165
'4833033000,  상북면,'80,75 - 79세,1998,177,61,116
'4833033000,  상북면,'85,80 - 84세,1998,109,29,80
'4833033000,  상북면,'90,85+ ,1998,64,10,54
'4833034000,  하북면,'00,계,1998,10584,5362,5222
'4833034000,  하북면,'05,0 - 4세,1998,692,368,324
'4833034000,  하북면,'10,5 - 9세,1998,894,492,402
'4833034000,  하북면,'15,10 - 14세,1998,685,351,334
'4833034000,  하북면,'20,15 - 19세,1998,830,421,409
'4833034000,  하북면,'25,20 - 24세,1998,801,399,402
'4833034000,  하북면,'30,25 - 29세,1998,928,480,448
'4833034000,  하북면,'35,30 - 34세,1998,1041,505,536
'4833034000,  하북면,'40,35 - 39세,1998,1058,584,474
'4833034000,  하북면,'45,40 - 44세,1998,840,452,388
'4833034000,  하북면,'50,45 - 49세,1998,566,314,252
'4833034000,  하북면,'55,50 - 54세,1998,450,237,213
'4833034000,  하북면,'60,55 - 59세,1998,498,254,244
'4833034000,  하북면,'65,60 - 64세,1998,396,175,221
'4833034000,  하북면,'70,65 - 69세,1998,324,129,195
'4833034000,  하북면,'75,70 - 74세,1998,260,91,169
'4833034000,  하북면,'80,75 - 79세,1998,184,76,108
'4833034000,  하북면,'85,80 - 84세,1998,86,27,59
'4833034000,  하북면,'90,85+ ,1998,51,7,44
'4833051000,  중앙동,'00,계,1998,17550,8832,8718
'4833051000,  중앙동,'05,0 - 4세,1998,1288,703,585
'4833051000,  중앙동,'10,5 - 9세,1998,1407,774,633
'4833051000,  중앙동,'15,10 - 14세,1998,1295,676,619
'4833051000,  중앙동,'20,15 - 19세,1998,1659,819,840
'4833051000,  중앙동,'25,20 - 24세,1998,1483,727,756
'4833051000,  중앙동,'30,25 - 29세,1998,1624,820,804
'4833051000,  중앙동,'35,30 - 34세,1998,1712,847,865
'4833051000,  중앙동,'40,35 - 39세,1998,1836,918,918
'4833051000,  중앙동,'45,40 - 44세,1998,1595,817,778
'4833051000,  중앙동,'50,45 - 49세,1998,1041,578,463
'4833051000,  중앙동,'55,50 - 54세,1998,688,364,324
'4833051000,  중앙동,'60,55 - 59세,1998,639,315,324
'4833051000,  중앙동,'65,60 - 64세,1998,445,191,254
'4833051000,  중앙동,'70,65 - 69세,1998,329,127,202
'4833051000,  중앙동,'75,70 - 74세,1998,229,80,149
'4833051000,  중앙동,'80,75 - 79세,1998,162,51,111
'4833051000,  중앙동,'85,80 - 84세,1998,73,14,59
'4833051000,  중앙동,'90,85+ ,1998,45,11,34
'4833052000,  삼성동,'00,계,1998,21119,10807,10312
'4833052000,  삼성동,'05,0 - 4세,1998,2454,1365,1089
'4833052000,  삼성동,'10,5 - 9세,1998,2498,1319,1179
'4833052000,  삼성동,'15,10 - 14세,1998,1669,863,806
'4833052000,  삼성동,'20,15 - 19세,1998,1207,623,584
'4833052000,  삼성동,'25,20 - 24세,1998,1089,517,572
'4833052000,  삼성동,'30,25 - 29세,1998,2212,933,1279
'4833052000,  삼성동,'35,30 - 34세,1998,2998,1427,1571
'4833052000,  삼성동,'40,35 - 39세,1998,2909,1680,1229
'4833052000,  삼성동,'45,40 - 44세,1998,1510,886,624
'4833052000,  삼성동,'50,45 - 49세,1998,736,416,320
'4833052000,  삼성동,'55,50 - 54세,1998,479,251,228
'4833052000,  삼성동,'60,55 - 59세,1998,438,201,237
'4833052000,  삼성동,'65,60 - 64세,1998,322,144,178
'4833052000,  삼성동,'70,65 - 69세,1998,236,95,141
'4833052000,  삼성동,'75,70 - 74세,1998,170,41,129
'4833052000,  삼성동,'80,75 - 79세,1998,108,25,83
'4833052000,  삼성동,'85,80 - 84세,1998,47,16,31
'4833052000,  삼성동,'90,85+ ,1998,37,5,32
'4833053000,  강서동,'00,계,1998,6820,3402,3418
'4833053000,  강서동,'05,0 - 4세,1998,691,386,305
'4833053000,  강서동,'10,5 - 9세,1998,646,350,296
'4833053000,  강서동,'15,10 - 14세,1998,494,229,265
'4833053000,  강서동,'20,15 - 19세,1998,562,239,323
'4833053000,  강서동,'25,20 - 24세,1998,455,196,259
'4833053000,  강서동,'30,25 - 29세,1998,661,314,347
'4833053000,  강서동,'35,30 - 34세,1998,794,403,391
'4833053000,  강서동,'40,35 - 39세,1998,777,411,366
'4833053000,  강서동,'45,40 - 44세,1998,564,307,257
'4833053000,  강서동,'50,45 - 49세,1998,339,213,126
'4833053000,  강서동,'55,50 - 54세,1998,188,103,85
'4833053000,  강서동,'60,55 - 59세,1998,187,86,101
'4833053000,  강서동,'65,60 - 64세,1998,183,80,103
'4833053000,  강서동,'70,65 - 69세,1998,114,46,68
'4833053000,  강서동,'75,70 - 74세,1998,79,25,54
'4833053000,  강서동,'80,75 - 79세,1998,52,12,40
'4833053000,  강서동,'85,80 - 84세,1998,22,2,20
'4833053000,  강서동,'90,85+ ,1998,12,0,12
'48720, 의령군,'00,계,1998,36265,17422,18843
'48720, 의령군,'05,0 - 4세,1998,1449,792,657
'48720, 의령군,'10,5 - 9세,1998,1505,800,705
'48720, 의령군,'15,10 - 14세,1998,1731,881,850
'48720, 의령군,'20,15 - 19세,1998,2715,1346,1369
'48720, 의령군,'25,20 - 24세,1998,3229,1763,1466
'48720, 의령군,'30,25 - 29세,1998,2778,1744,1034
'48720, 의령군,'35,30 - 34세,1998,1976,1120,856
'48720, 의령군,'40,35 - 39세,1998,2130,1147,983
'48720, 의령군,'45,40 - 44세,1998,1949,1051,898
'48720, 의령군,'50,45 - 49세,1998,1754,837,917
'48720, 의령군,'55,50 - 54세,1998,1854,841,1013
'48720, 의령군,'60,55 - 59세,1998,3051,1230,1821
'48720, 의령군,'65,60 - 64세,1998,3247,1331,1916
'48720, 의령군,'70,65 - 69세,1998,2809,1033,1776
'48720, 의령군,'75,70 - 74세,1998,1966,762,1204
'48720, 의령군,'80,75 - 79세,1998,1233,491,742
'48720, 의령군,'85,80 - 84세,1998,575,182,393
'48720, 의령군,'90,85+ ,1998,314,71,243
'4872025000,  의령읍,'00,계,1998,10117,4988,5129
'4872025000,  의령읍,'05,0 - 4세,1998,698,385,313
'4872025000,  의령읍,'10,5 - 9세,1998,656,351,305
'4872025000,  의령읍,'15,10 - 14세,1998,619,317,302
'4872025000,  의령읍,'20,15 - 19세,1998,827,424,403
'4872025000,  의령읍,'25,20 - 24세,1998,908,483,425
'4872025000,  의령읍,'30,25 - 29세,1998,941,505,436
'4872025000,  의령읍,'35,30 - 34세,1998,812,435,377
'4872025000,  의령읍,'40,35 - 39세,1998,795,405,390
'4872025000,  의령읍,'45,40 - 44세,1998,675,355,320
'4872025000,  의령읍,'50,45 - 49세,1998,512,252,260
'4872025000,  의령읍,'55,50 - 54세,1998,443,209,234
'4872025000,  의령읍,'60,55 - 59세,1998,583,255,328
'4872025000,  의령읍,'65,60 - 64세,1998,556,217,339
'4872025000,  의령읍,'70,65 - 69세,1998,459,180,279
'4872025000,  의령읍,'75,70 - 74세,1998,315,115,200
'4872025000,  의령읍,'80,75 - 79세,1998,182,65,117
'4872025000,  의령읍,'85,80 - 84세,1998,95,26,69
'4872025000,  의령읍,'90,85+ ,1998,41,9,32
'4872031000,  가례면,'00,계,1998,2253,1075,1178
'4872031000,  가례면,'05,0 - 4세,1998,48,25,23
'4872031000,  가례면,'10,5 - 9세,1998,62,36,26
'4872031000,  가례면,'15,10 - 14세,1998,128,62,66
'4872031000,  가례면,'20,15 - 19세,1998,165,74,91
'4872031000,  가례면,'25,20 - 24세,1998,212,119,93
'4872031000,  가례면,'30,25 - 29세,1998,155,107,48
'4872031000,  가례면,'35,30 - 34세,1998,105,69,36
'4872031000,  가례면,'40,35 - 39세,1998,121,62,59
'4872031000,  가례면,'45,40 - 44세,1998,123,73,50
'4872031000,  가례면,'50,45 - 49세,1998,115,51,64
'4872031000,  가례면,'55,50 - 54세,1998,124,59,65
'4872031000,  가례면,'60,55 - 59세,1998,190,64,126
'4872031000,  가례면,'65,60 - 64세,1998,227,95,132
'4872031000,  가례면,'70,65 - 69세,1998,207,85,122
'4872031000,  가례면,'75,70 - 74세,1998,136,54,82
'4872031000,  가례면,'80,75 - 79세,1998,65,24,41
'4872031000,  가례면,'85,80 - 84세,1998,36,9,27
'4872031000,  가례면,'90,85+ ,1998,34,7,27
'4872032000,  칠곡면,'00,계,1998,1477,682,795
'4872032000,  칠곡면,'05,0 - 4세,1998,37,17,20
'4872032000,  칠곡면,'10,5 - 9세,1998,44,21,23
'4872032000,  칠곡면,'15,10 - 14세,1998,60,33,27
'4872032000,  칠곡면,'20,15 - 19세,1998,108,55,53
'4872032000,  칠곡면,'25,20 - 24세,1998,120,62,58
'4872032000,  칠곡면,'30,25 - 29세,1998,110,74,36
'4872032000,  칠곡면,'35,30 - 34세,1998,52,30,22
'4872032000,  칠곡면,'40,35 - 39세,1998,79,39,40
'4872032000,  칠곡면,'45,40 - 44세,1998,79,43,36
'4872032000,  칠곡면,'50,45 - 49세,1998,68,34,34
'4872032000,  칠곡면,'55,50 - 54세,1998,79,30,49
'4872032000,  칠곡면,'60,55 - 59세,1998,140,50,90
'4872032000,  칠곡면,'65,60 - 64세,1998,169,66,103
'4872032000,  칠곡면,'70,65 - 69세,1998,145,58,87
'4872032000,  칠곡면,'75,70 - 74세,1998,93,42,51
'4872032000,  칠곡면,'80,75 - 79세,1998,47,20,27
'4872032000,  칠곡면,'85,80 - 84세,1998,32,6,26
'4872032000,  칠곡면,'90,85+ ,1998,15,2,13
'4872033000,  대의면,'00,계,1998,1504,715,789
'4872033000,  대의면,'05,0 - 4세,1998,49,26,23
'4872033000,  대의면,'10,5 - 9세,1998,37,22,15
'4872033000,  대의면,'15,10 - 14세,1998,62,32,30
'4872033000,  대의면,'20,15 - 19세,1998,122,60,62
'4872033000,  대의면,'25,20 - 24세,1998,112,59,53
'4872033000,  대의면,'30,25 - 29세,1998,97,63,34
'4872033000,  대의면,'35,30 - 34세,1998,68,44,24
'4872033000,  대의면,'40,35 - 39세,1998,73,33,40
'4872033000,  대의면,'45,40 - 44세,1998,76,37,39
'4872033000,  대의면,'50,45 - 49세,1998,68,38,30
'4872033000,  대의면,'55,50 - 54세,1998,72,28,44
'4872033000,  대의면,'60,55 - 59세,1998,163,74,89
'4872033000,  대의면,'65,60 - 64세,1998,152,66,86
'4872033000,  대의면,'70,65 - 69세,1998,152,48,104
'4872033000,  대의면,'75,70 - 74세,1998,88,36,52
'4872033000,  대의면,'80,75 - 79세,1998,66,36,30
'4872033000,  대의면,'85,80 - 84세,1998,35,11,24
'4872033000,  대의면,'90,85+ ,1998,12,2,10
'4872034000,  화정면,'00,계,1998,2270,1109,1161
'4872034000,  화정면,'05,0 - 4세,1998,78,44,34
'4872034000,  화정면,'10,5 - 9세,1998,77,42,35
'4872034000,  화정면,'15,10 - 14세,1998,91,33,58
'4872034000,  화정면,'20,15 - 19세,1998,158,89,69
'4872034000,  화정면,'25,20 - 24세,1998,254,146,108
'4872034000,  화정면,'30,25 - 29세,1998,178,122,56
'4872034000,  화정면,'35,30 - 34세,1998,94,62,32
'4872034000,  화정면,'40,35 - 39세,1998,102,58,44
'4872034000,  화정면,'45,40 - 44세,1998,102,51,51
'4872034000,  화정면,'50,45 - 49세,1998,110,54,56
'4872034000,  화정면,'55,50 - 54세,1998,122,43,79
'4872034000,  화정면,'60,55 - 59세,1998,206,79,127
'4872034000,  화정면,'65,60 - 64세,1998,232,102,130
'4872034000,  화정면,'70,65 - 69세,1998,194,70,124
'4872034000,  화정면,'75,70 - 74세,1998,132,57,75
'4872034000,  화정면,'80,75 - 79세,1998,77,37,40
'4872034000,  화정면,'85,80 - 84세,1998,41,16,25
'4872034000,  화정면,'90,85+ ,1998,22,4,18
'4872035000,  용덕면,'00,계,1998,2424,1151,1273
'4872035000,  용덕면,'05,0 - 4세,1998,70,31,39
'4872035000,  용덕면,'10,5 - 9세,1998,88,46,42
'4872035000,  용덕면,'15,10 - 14세,1998,126,70,56
'4872035000,  용덕면,'20,15 - 19세,1998,199,92,107
'4872035000,  용덕면,'25,20 - 24세,1998,209,109,100
'4872035000,  용덕면,'30,25 - 29세,1998,189,129,60
'4872035000,  용덕면,'35,30 - 34세,1998,120,72,48
'4872035000,  용덕면,'40,35 - 39세,1998,139,73,66
'4872035000,  용덕면,'45,40 - 44세,1998,133,75,58
'4872035000,  용덕면,'50,45 - 49세,1998,108,53,55
'4872035000,  용덕면,'55,50 - 54세,1998,114,45,69
'4872035000,  용덕면,'60,55 - 59세,1998,201,87,114
'4872035000,  용덕면,'65,60 - 64세,1998,207,87,120
'4872035000,  용덕면,'70,65 - 69세,1998,206,70,136
'4872035000,  용덕면,'75,70 - 74세,1998,156,61,95
'4872035000,  용덕면,'80,75 - 79세,1998,92,36,56
'4872035000,  용덕면,'85,80 - 84세,1998,39,11,28
'4872035000,  용덕면,'90,85+ ,1998,28,4,24
'4872036000,  정곡면,'00,계,1998,2161,1030,1131
'4872036000,  정곡면,'05,0 - 4세,1998,63,33,30
'4872036000,  정곡면,'10,5 - 9세,1998,50,29,21
'4872036000,  정곡면,'15,10 - 14세,1998,80,41,39
'4872036000,  정곡면,'20,15 - 19세,1998,170,85,85
'4872036000,  정곡면,'25,20 - 24세,1998,186,107,79
'4872036000,  정곡면,'30,25 - 29세,1998,151,101,50
'4872036000,  정곡면,'35,30 - 34세,1998,95,62,33
'4872036000,  정곡면,'40,35 - 39세,1998,98,58,40
'4872036000,  정곡면,'45,40 - 44세,1998,102,51,51
'4872036000,  정곡면,'50,45 - 49세,1998,104,47,57
'4872036000,  정곡면,'55,50 - 54세,1998,128,61,67
'4872036000,  정곡면,'60,55 - 59세,1998,199,75,124
'4872036000,  정곡면,'65,60 - 64세,1998,218,92,126
'4872036000,  정곡면,'70,65 - 69세,1998,222,83,139
'4872036000,  정곡면,'75,70 - 74세,1998,144,62,82
'4872036000,  정곡면,'80,75 - 79세,1998,91,29,62
'4872036000,  정곡면,'85,80 - 84세,1998,41,11,30
'4872036000,  정곡면,'90,85+ ,1998,19,3,16
'4872037000,  지정면,'00,계,1998,2843,1373,1470
'4872037000,  지정면,'05,0 - 4세,1998,94,55,39
'4872037000,  지정면,'10,5 - 9세,1998,109,59,50
'4872037000,  지정면,'15,10 - 14세,1998,133,67,66
'4872037000,  지정면,'20,15 - 19세,1998,211,87,124
'4872037000,  지정면,'25,20 - 24세,1998,253,130,123
'4872037000,  지정면,'30,25 - 29세,1998,186,130,56
'4872037000,  지정면,'35,30 - 34세,1998,144,78,66
'4872037000,  지정면,'40,35 - 39세,1998,169,99,70
'4872037000,  지정면,'45,40 - 44세,1998,146,84,62
'4872037000,  지정면,'50,45 - 49세,1998,136,66,70
'4872037000,  지정면,'55,50 - 54세,1998,147,79,68
'4872037000,  지정면,'60,55 - 59세,1998,279,117,162
'4872037000,  지정면,'65,60 - 64세,1998,267,114,153
'4872037000,  지정면,'70,65 - 69세,1998,224,68,156
'4872037000,  지정면,'75,70 - 74세,1998,160,68,92
'4872037000,  지정면,'80,75 - 79세,1998,105,44,61
'4872037000,  지정면,'85,80 - 84세,1998,46,15,31
'4872037000,  지정면,'90,85+ ,1998,34,13,21
'4872038000,  낙서면,'00,계,1998,1326,634,692
'4872038000,  낙서면,'05,0 - 4세,1998,20,15,5
'4872038000,  낙서면,'10,5 - 9세,1998,35,14,21
'4872038000,  낙서면,'15,10 - 14세,1998,56,27,29
'4872038000,  낙서면,'20,15 - 19세,1998,91,45,46
'4872038000,  낙서면,'25,20 - 24세,1998,117,69,48
'4872038000,  낙서면,'30,25 - 29세,1998,83,60,23
'4872038000,  낙서면,'35,30 - 34세,1998,47,25,22
'4872038000,  낙서면,'40,35 - 39세,1998,47,22,25
'4872038000,  낙서면,'45,40 - 44세,1998,76,41,35
'4872038000,  낙서면,'50,45 - 49세,1998,75,41,34
'4872038000,  낙서면,'55,50 - 54세,1998,79,33,46
'4872038000,  낙서면,'60,55 - 59세,1998,131,55,76
'4872038000,  낙서면,'65,60 - 64세,1998,169,76,93
'4872038000,  낙서면,'70,65 - 69세,1998,121,50,71
'4872038000,  낙서면,'75,70 - 74세,1998,96,37,59
'4872038000,  낙서면,'80,75 - 79세,1998,52,18,34
'4872038000,  낙서면,'85,80 - 84세,1998,25,6,19
'4872038000,  낙서면,'90,85+ ,1998,6,0,6
'4872039000,  부림면,'00,계,1998,4725,2261,2464
'4872039000,  부림면,'05,0 - 4세,1998,191,104,87
'4872039000,  부림면,'10,5 - 9세,1998,214,112,102
'4872039000,  부림면,'15,10 - 14세,1998,214,120,94
'4872039000,  부림면,'20,15 - 19세,1998,351,185,166
'4872039000,  부림면,'25,20 - 24세,1998,429,231,198
'4872039000,  부림면,'30,25 - 29세,1998,382,235,147
'4872039000,  부림면,'35,30 - 34세,1998,269,141,128
'4872039000,  부림면,'40,35 - 39세,1998,282,161,121
'4872039000,  부림면,'45,40 - 44세,1998,240,129,111
'4872039000,  부림면,'50,45 - 49세,1998,233,101,132
'4872039000,  부림면,'55,50 - 54세,1998,257,113,144
'4872039000,  부림면,'60,55 - 59세,1998,423,171,252
'4872039000,  부림면,'65,60 - 64세,1998,399,166,233
'4872039000,  부림면,'70,65 - 69세,1998,312,100,212
'4872039000,  부림면,'75,70 - 74세,1998,244,75,169
'4872039000,  부림면,'80,75 - 79세,1998,172,73,99
'4872039000,  부림면,'85,80 - 84세,1998,69,30,39
'4872039000,  부림면,'90,85+ ,1998,44,14,30
'4872040000,  봉수면,'00,계,1998,1648,788,860
'4872040000,  봉수면,'05,0 - 4세,1998,27,15,12
'4872040000,  봉수면,'10,5 - 9세,1998,38,19,19
'4872040000,  봉수면,'15,10 - 14세,1998,67,32,35
'4872040000,  봉수면,'20,15 - 19세,1998,107,54,53
'4872040000,  봉수면,'25,20 - 24세,1998,166,104,62
'4872040000,  봉수면,'30,25 - 29세,1998,102,69,33
'4872040000,  봉수면,'35,30 - 34세,1998,52,34,18
'4872040000,  봉수면,'40,35 - 39세,1998,71,40,31
'4872040000,  봉수면,'45,40 - 44세,1998,68,33,35
'4872040000,  봉수면,'50,45 - 49세,1998,88,40,48
'4872040000,  봉수면,'55,50 - 54세,1998,104,52,52
'4872040000,  봉수면,'60,55 - 59세,1998,168,68,100
'4872040000,  봉수면,'65,60 - 64세,1998,178,66,112
'4872040000,  봉수면,'70,65 - 69세,1998,161,66,95
'4872040000,  봉수면,'75,70 - 74세,1998,126,51,75
'4872040000,  봉수면,'80,75 - 79세,1998,79,30,49
'4872040000,  봉수면,'85,80 - 84세,1998,31,12,19
'4872040000,  봉수면,'90,85+ ,1998,15,3,12
'4872041500,  궁류면,'00,계,1998,1665,770,895
'4872041500,  궁류면,'05,0 - 4세,1998,38,19,19
'4872041500,  궁류면,'10,5 - 9세,1998,37,20,17
'4872041500,  궁류면,'15,10 - 14세,1998,63,33,30
'4872041500,  궁류면,'20,15 - 19세,1998,102,43,59
'4872041500,  궁류면,'25,20 - 24세,1998,110,56,54
'4872041500,  궁류면,'30,25 - 29세,1998,104,75,29
'4872041500,  궁류면,'35,30 - 34세,1998,58,36,22
'4872041500,  궁류면,'40,35 - 39세,1998,74,45,29
'4872041500,  궁류면,'45,40 - 44세,1998,64,39,25
'4872041500,  궁류면,'50,45 - 49세,1998,53,22,31
'4872041500,  궁류면,'55,50 - 54세,1998,89,44,45
'4872041500,  궁류면,'60,55 - 59세,1998,181,69,112
'4872041500,  궁류면,'65,60 - 64세,1998,215,87,128
'4872041500,  궁류면,'70,65 - 69세,1998,198,73,125
'4872041500,  궁류면,'75,70 - 74세,1998,126,56,70
'4872041500,  궁류면,'80,75 - 79세,1998,94,34,60
'4872041500,  궁류면,'85,80 - 84세,1998,34,16,18
'4872041500,  궁류면,'90,85+ ,1998,25,3,22
'4872042000,  유곡면,'00,계,1998,1852,846,1006
'4872042000,  유곡면,'05,0 - 4세,1998,36,23,13
'4872042000,  유곡면,'10,5 - 9세,1998,58,29,29
'4872042000,  유곡면,'15,10 - 14세,1998,32,14,18
'4872042000,  유곡면,'20,15 - 19세,1998,104,53,51
'4872042000,  유곡면,'25,20 - 24세,1998,153,88,65
'4872042000,  유곡면,'30,25 - 29세,1998,100,74,26
'4872042000,  유곡면,'35,30 - 34세,1998,60,32,28
'4872042000,  유곡면,'40,35 - 39세,1998,80,52,28
'4872042000,  유곡면,'45,40 - 44세,1998,65,40,25
'4872042000,  유곡면,'50,45 - 49세,1998,84,38,46
'4872042000,  유곡면,'55,50 - 54세,1998,96,45,51
'4872042000,  유곡면,'60,55 - 59세,1998,187,66,121
'4872042000,  유곡면,'65,60 - 64세,1998,258,97,161
'4872042000,  유곡면,'70,65 - 69세,1998,208,82,126
'4872042000,  유곡면,'75,70 - 74세,1998,150,48,102
'4872042000,  유곡면,'80,75 - 79세,1998,111,45,66
'4872042000,  유곡면,'85,80 - 84세,1998,51,13,38
'4872042000,  유곡면,'90,85+ ,1998,19,7,12
'48730, 함안군,'00,계,1998,66865,33251,33614
'48730, 함안군,'05,0 - 4세,1998,4084,2197,1887
'48730, 함안군,'10,5 - 9세,1998,4054,2140,1914
'48730, 함안군,'15,10 - 14세,1998,3609,1861,1748
'48730, 함안군,'20,15 - 19세,1998,5240,2578,2662
'48730, 함안군,'25,20 - 24세,1998,5568,3033,2535
'48730, 함안군,'30,25 - 29세,1998,5975,3440,2535
'48730, 함안군,'35,30 - 34세,1998,5127,2812,2315
'48730, 함안군,'40,35 - 39세,1998,5071,2838,2233
'48730, 함안군,'45,40 - 44세,1998,4421,2404,2017
'48730, 함안군,'50,45 - 49세,1998,3381,1680,1701
'48730, 함안군,'55,50 - 54세,1998,3200,1499,1701
'48730, 함안군,'60,55 - 59세,1998,4250,1794,2456
'48730, 함안군,'65,60 - 64세,1998,4417,1901,2516
'48730, 함안군,'70,65 - 69세,1998,3455,1343,2112
'48730, 함안군,'75,70 - 74세,1998,2372,872,1500
'48730, 함안군,'80,75 - 79세,1998,1614,572,1042
'48730, 함안군,'85,80 - 84세,1998,659,200,459
'48730, 함안군,'90,85+ ,1998,368,87,281
'4873025000,  가야읍,'00,계,1998,19091,9450,9641
'4873025000,  가야읍,'05,0 - 4세,1998,1538,825,713
'4873025000,  가야읍,'10,5 - 9세,1998,1583,879,704
'4873025000,  가야읍,'15,10 - 14세,1998,1366,721,645
'4873025000,  가야읍,'20,15 - 19세,1998,1496,730,766
'4873025000,  가야읍,'25,20 - 24세,1998,1403,709,694
'4873025000,  가야읍,'30,25 - 29세,1998,1792,910,882
'4873025000,  가야읍,'35,30 - 34세,1998,1793,907,886
'4873025000,  가야읍,'40,35 - 39세,1998,1761,939,822
'4873025000,  가야읍,'45,40 - 44세,1998,1373,755,618
'4873025000,  가야읍,'50,45 - 49세,1998,923,464,459
'4873025000,  가야읍,'55,50 - 54세,1998,749,359,390
'4873025000,  가야읍,'60,55 - 59세,1998,868,372,496
'4873025000,  가야읍,'65,60 - 64세,1998,856,349,507
'4873025000,  가야읍,'70,65 - 69세,1998,631,229,402
'4873025000,  가야읍,'75,70 - 74세,1998,444,144,300
'4873025000,  가야읍,'80,75 - 79세,1998,311,107,204
'4873025000,  가야읍,'85,80 - 84세,1998,139,37,102
'4873025000,  가야읍,'90,85+ ,1998,65,14,51
'4873031000,  함안면,'00,계,1998,3834,1922,1912
'4873031000,  함안면,'05,0 - 4세,1998,152,87,65
'4873031000,  함안면,'10,5 - 9세,1998,159,80,79
'4873031000,  함안면,'15,10 - 14세,1998,149,77,72
'4873031000,  함안면,'20,15 - 19세,1998,318,182,136
'4873031000,  함안면,'25,20 - 24세,1998,338,199,139
'4873031000,  함안면,'30,25 - 29세,1998,310,199,111
'4873031000,  함안면,'35,30 - 34세,1998,235,139,96
'4873031000,  함안면,'40,35 - 39세,1998,230,132,98
'4873031000,  함안면,'45,40 - 44세,1998,251,142,109
'4873031000,  함안면,'50,45 - 49세,1998,191,96,95
'4873031000,  함안면,'55,50 - 54세,1998,202,89,113
'4873031000,  함안면,'60,55 - 59세,1998,298,120,178
'4873031000,  함안면,'65,60 - 64세,1998,343,144,199
'4873031000,  함안면,'70,65 - 69세,1998,250,109,141
'4873031000,  함안면,'75,70 - 74세,1998,172,43,129
'4873031000,  함안면,'80,75 - 79세,1998,137,54,83
'4873031000,  함안면,'85,80 - 84세,1998,61,22,39
'4873031000,  함안면,'90,85+ ,1998,38,8,30
'4873032000,  군북면,'00,계,1998,9637,4759,4878
'4873032000,  군북면,'05,0 - 4세,1998,426,223,203
'4873032000,  군북면,'10,5 - 9세,1998,448,216,232
'4873032000,  군북면,'15,10 - 14세,1998,445,231,214
'4873032000,  군북면,'20,15 - 19세,1998,757,373,384
'4873032000,  군북면,'25,20 - 24세,1998,891,516,375
'4873032000,  군북면,'30,25 - 29세,1998,831,520,311
'4873032000,  군북면,'35,30 - 34세,1998,574,336,238
'4873032000,  군북면,'40,35 - 39세,1998,614,336,278
'4873032000,  군북면,'45,40 - 44세,1998,602,331,271
'4873032000,  군북면,'50,45 - 49세,1998,469,225,244
'4873032000,  군북면,'55,50 - 54세,1998,510,231,279
'4873032000,  군북면,'60,55 - 59세,1998,725,313,412
'4873032000,  군북면,'65,60 - 64세,1998,803,332,471
'4873032000,  군북면,'70,65 - 69세,1998,672,256,416
'4873032000,  군북면,'75,70 - 74세,1998,440,171,269
'4873032000,  군북면,'80,75 - 79세,1998,265,102,163
'4873032000,  군북면,'85,80 - 84세,1998,106,33,73
'4873032000,  군북면,'90,85+ ,1998,59,14,45
'4873033000,  법수면,'00,계,1998,4563,2263,2300
'4873033000,  법수면,'05,0 - 4세,1998,184,97,87
'4873033000,  법수면,'10,5 - 9세,1998,156,86,70
'4873033000,  법수면,'15,10 - 14세,1998,192,82,110
'4873033000,  법수면,'20,15 - 19세,1998,391,191,200
'4873033000,  법수면,'25,20 - 24세,1998,450,266,184
'4873033000,  법수면,'30,25 - 29세,1998,374,246,128
'4873033000,  법수면,'35,30 - 34세,1998,224,135,89
'4873033000,  법수면,'40,35 - 39세,1998,257,151,106
'4873033000,  법수면,'45,40 - 44세,1998,282,152,130
'4873033000,  법수면,'50,45 - 49세,1998,246,122,124
'4873033000,  법수면,'55,50 - 54세,1998,278,121,157
'4873033000,  법수면,'60,55 - 59세,1998,368,150,218
'4873033000,  법수면,'65,60 - 64세,1998,405,188,217
'4873033000,  법수면,'70,65 - 69세,1998,323,123,200
'4873033000,  법수면,'75,70 - 74세,1998,217,91,126
'4873033000,  법수면,'80,75 - 79세,1998,139,46,93
'4873033000,  법수면,'85,80 - 84세,1998,52,12,40
'4873033000,  법수면,'90,85+ ,1998,25,4,21
'4873034000,  대산면,'00,계,1998,6129,3074,3055
'4873034000,  대산면,'05,0 - 4세,1998,276,130,146
'4873034000,  대산면,'10,5 - 9세,1998,308,171,137
'4873034000,  대산면,'15,10 - 14세,1998,273,147,126
'4873034000,  대산면,'20,15 - 19세,1998,512,246,266
'4873034000,  대산면,'25,20 - 24세,1998,539,290,249
'4873034000,  대산면,'30,25 - 29세,1998,506,324,182
'4873034000,  대산면,'35,30 - 34세,1998,377,227,150
'4873034000,  대산면,'40,35 - 39세,1998,392,224,168
'4873034000,  대산면,'45,40 - 44세,1998,377,209,168
'4873034000,  대산면,'50,45 - 49세,1998,334,173,161
'4873034000,  대산면,'55,50 - 54세,1998,334,152,182
'4873034000,  대산면,'60,55 - 59세,1998,501,199,302
'4873034000,  대산면,'65,60 - 64세,1998,499,231,268
'4873034000,  대산면,'70,65 - 69세,1998,367,148,219
'4873034000,  대산면,'75,70 - 74세,1998,245,107,138
'4873034000,  대산면,'80,75 - 79세,1998,186,66,120
'4873034000,  대산면,'85,80 - 84세,1998,65,19,46
'4873034000,  대산면,'90,85+ ,1998,38,11,27
'4873035000,  칠서면,'00,계,1998,4948,2435,2513
'4873035000,  칠서면,'05,0 - 4세,1998,231,129,102
'4873035000,  칠서면,'10,5 - 9세,1998,232,126,106
'4873035000,  칠서면,'15,10 - 14세,1998,217,118,99
'4873035000,  칠서면,'20,15 - 19세,1998,380,172,208
'4873035000,  칠서면,'25,20 - 24세,1998,440,249,191
'4873035000,  칠서면,'30,25 - 29세,1998,446,279,167
'4873035000,  칠서면,'35,30 - 34세,1998,333,200,133
'4873035000,  칠서면,'40,35 - 39세,1998,316,185,131
'4873035000,  칠서면,'45,40 - 44세,1998,317,154,163
'4873035000,  칠서면,'50,45 - 49세,1998,265,127,138
'4873035000,  칠서면,'55,50 - 54세,1998,291,134,157
'4873035000,  칠서면,'60,55 - 59세,1998,388,161,227
'4873035000,  칠서면,'65,60 - 64세,1998,377,157,220
'4873035000,  칠서면,'70,65 - 69세,1998,277,97,180
'4873035000,  칠서면,'75,70 - 74세,1998,229,86,143
'4873035000,  칠서면,'80,75 - 79세,1998,115,34,81
'4873035000,  칠서면,'85,80 - 84세,1998,56,18,38
'4873035000,  칠서면,'90,85+ ,1998,38,9,29
'4873036000,  칠북면,'00,계,1998,3057,1551,1506
'4873036000,  칠북면,'05,0 - 4세,1998,89,58,31
'4873036000,  칠북면,'10,5 - 9세,1998,116,60,56
'4873036000,  칠북면,'15,10 - 14세,1998,117,56,61
'4873036000,  칠북면,'20,15 - 19세,1998,263,134,129
'4873036000,  칠북면,'25,20 - 24세,1998,289,176,113
'4873036000,  칠북면,'30,25 - 29세,1998,215,149,66
'4873036000,  칠북면,'35,30 - 34세,1998,134,82,52
'4873036000,  칠북면,'40,35 - 39세,1998,166,103,63
'4873036000,  칠북면,'45,40 - 44세,1998,213,114,99
'4873036000,  칠북면,'50,45 - 49세,1998,186,90,96
'4873036000,  칠북면,'55,50 - 54세,1998,170,80,90
'4873036000,  칠북면,'60,55 - 59세,1998,276,117,159
'4873036000,  칠북면,'65,60 - 64세,1998,298,128,170
'4873036000,  칠북면,'70,65 - 69세,1998,237,99,138
'4873036000,  칠북면,'75,70 - 74세,1998,122,52,70
'4873036000,  칠북면,'80,75 - 79세,1998,98,28,70
'4873036000,  칠북면,'85,80 - 84세,1998,41,15,26
'4873036000,  칠북면,'90,85+ ,1998,27,10,17
'4873037000,  칠원면,'00,계,1998,11075,5528,5547
'4873037000,  칠원면,'05,0 - 4세,1998,988,542,446
'4873037000,  칠원면,'10,5 - 9세,1998,881,424,457
'4873037000,  칠원면,'15,10 - 14세,1998,647,322,325
'4873037000,  칠원면,'20,15 - 19세,1998,752,367,385
'4873037000,  칠원면,'25,20 - 24세,1998,799,403,396
'4873037000,  칠원면,'30,25 - 29세,1998,1125,571,554
'4873037000,  칠원면,'35,30 - 34세,1998,1192,629,563
'4873037000,  칠원면,'40,35 - 39세,1998,1039,587,452
'4873037000,  칠원면,'45,40 - 44세,1998,752,422,330
'4873037000,  칠원면,'50,45 - 49세,1998,519,269,250
'4873037000,  칠원면,'55,50 - 54세,1998,425,211,214
'4873037000,  칠원면,'60,55 - 59세,1998,516,229,287
'4873037000,  칠원면,'65,60 - 64세,1998,468,215,253
'4873037000,  칠원면,'70,65 - 69세,1998,396,150,246
'4873037000,  칠원면,'75,70 - 74세,1998,274,93,181
'4873037000,  칠원면,'80,75 - 79세,1998,200,69,131
'4873037000,  칠원면,'85,80 - 84세,1998,65,20,45
'4873037000,  칠원면,'90,85+ ,1998,37,5,32
'4873038000,  산인면,'00,계,1998,3483,1756,1727
'4873038000,  산인면,'05,0 - 4세,1998,164,87,77
'4873038000,  산인면,'10,5 - 9세,1998,148,89,59
'4873038000,  산인면,'15,10 - 14세,1998,160,84,76
'4873038000,  산인면,'20,15 - 19세,1998,277,139,138
'4873038000,  산인면,'25,20 - 24세,1998,323,177,146
'4873038000,  산인면,'30,25 - 29세,1998,292,184,108
'4873038000,  산인면,'35,30 - 34세,1998,220,131,89
'4873038000,  산인면,'40,35 - 39세,1998,229,141,88
'4873038000,  산인면,'45,40 - 44세,1998,193,96,97
'4873038000,  산인면,'50,45 - 49세,1998,197,87,110
'4873038000,  산인면,'55,50 - 54세,1998,184,98,86
'4873038000,  산인면,'60,55 - 59세,1998,232,101,131
'4873038000,  산인면,'65,60 - 64세,1998,279,119,160
'4873038000,  산인면,'70,65 - 69세,1998,202,89,113
'4873038000,  산인면,'75,70 - 74세,1998,167,58,109
'4873038000,  산인면,'80,75 - 79세,1998,133,53,80
'4873038000,  산인면,'85,80 - 84세,1998,53,16,37
'4873038000,  산인면,'90,85+ ,1998,30,7,23
'4873039000,  여항면,'00,계,1998,1048,513,535
'4873039000,  여항면,'05,0 - 4세,1998,36,19,17
'4873039000,  여항면,'10,5 - 9세,1998,23,9,14
'4873039000,  여항면,'15,10 - 14세,1998,43,23,20
'4873039000,  여항면,'20,15 - 19세,1998,94,44,50
'4873039000,  여항면,'25,20 - 24세,1998,96,48,48
'4873039000,  여항면,'30,25 - 29세,1998,84,58,26
'4873039000,  여항면,'35,30 - 34세,1998,45,26,19
'4873039000,  여항면,'40,35 - 39세,1998,67,40,27
'4873039000,  여항면,'45,40 - 44세,1998,61,29,32
'4873039000,  여항면,'50,45 - 49세,1998,51,27,24
'4873039000,  여항면,'55,50 - 54세,1998,57,24,33
'4873039000,  여항면,'60,55 - 59세,1998,78,32,46
'4873039000,  여항면,'65,60 - 64세,1998,89,38,51
'4873039000,  여항면,'70,65 - 69세,1998,100,43,57
'4873039000,  여항면,'75,70 - 74세,1998,62,27,35
'4873039000,  여항면,'80,75 - 79세,1998,30,13,17
'4873039000,  여항면,'85,80 - 84세,1998,21,8,13
'4873039000,  여항면,'90,85+ ,1998,11,5,6
'48740, 창녕군,'00,계,1998,76207,37415,38792
'48740, 창녕군,'05,0 - 4세,1998,3670,1979,1691
'48740, 창녕군,'10,5 - 9세,1998,3967,2141,1826
'48740, 창녕군,'15,10 - 14세,1998,4226,2213,2013
'48740, 창녕군,'20,15 - 19세,1998,6402,3239,3163
'48740, 창녕군,'25,20 - 24세,1998,6415,3555,2860
'48740, 창녕군,'30,25 - 29세,1998,5706,3374,2332
'48740, 창녕군,'35,30 - 34세,1998,4847,2574,2273
'48740, 창녕군,'40,35 - 39세,1998,5369,2786,2583
'48740, 창녕군,'45,40 - 44세,1998,5101,2638,2463
'48740, 창녕군,'50,45 - 49세,1998,4156,2047,2109
'48740, 창녕군,'55,50 - 54세,1998,4075,1917,2158
'48740, 창녕군,'60,55 - 59세,1998,5513,2342,3171
'48740, 창녕군,'65,60 - 64세,1998,5749,2399,3350
'48740, 창녕군,'70,65 - 69세,1998,4596,1788,2808
'48740, 창녕군,'75,70 - 74세,1998,3117,1233,1884
'48740, 창녕군,'80,75 - 79세,1998,1914,765,1149
'48740, 창녕군,'85,80 - 84세,1998,910,319,591
'48740, 창녕군,'90,85+ ,1998,474,106,368
'4874025000,  창녕읍,'00,계,1998,19106,9391,9715
'4874025000,  창녕읍,'05,0 - 4세,1998,1255,694,561
'4874025000,  창녕읍,'10,5 - 9세,1998,1444,763,681
'4874025000,  창녕읍,'15,10 - 14세,1998,1319,679,640
'4874025000,  창녕읍,'20,15 - 19세,1998,1647,822,825
'4874025000,  창녕읍,'25,20 - 24세,1998,1398,774,624
'4874025000,  창녕읍,'30,25 - 29세,1998,1525,809,716
'4874025000,  창녕읍,'35,30 - 34세,1998,1545,765,780
'4874025000,  창녕읍,'40,35 - 39세,1998,1740,875,865
'4874025000,  창녕읍,'45,40 - 44세,1998,1437,742,695
'4874025000,  창녕읍,'50,45 - 49세,1998,985,499,486
'4874025000,  창녕읍,'55,50 - 54세,1998,913,438,475
'4874025000,  창녕읍,'60,55 - 59세,1998,986,448,538
'4874025000,  창녕읍,'65,60 - 64세,1998,1020,404,616
'4874025000,  창녕읍,'70,65 - 69세,1998,802,309,493
'4874025000,  창녕읍,'75,70 - 74세,1998,546,198,348
'4874025000,  창녕읍,'80,75 - 79세,1998,301,109,192
'4874025000,  창녕읍,'85,80 - 84세,1998,152,46,106
'4874025000,  창녕읍,'90,85+ ,1998,91,17,74
'4874025300,  남지읍,'00,계,1998,12744,6193,6551
'4874025300,  남지읍,'05,0 - 4세,1998,675,362,313
'4874025300,  남지읍,'10,5 - 9세,1998,752,401,351
'4874025300,  남지읍,'15,10 - 14세,1998,769,374,395
'4874025300,  남지읍,'20,15 - 19세,1998,1113,555,558
'4874025300,  남지읍,'25,20 - 24세,1998,1116,572,544
'4874025300,  남지읍,'30,25 - 29세,1998,985,578,407
'4874025300,  남지읍,'35,30 - 34세,1998,911,458,453
'4874025300,  남지읍,'40,35 - 39세,1998,924,456,468
'4874025300,  남지읍,'45,40 - 44세,1998,947,500,447
'4874025300,  남지읍,'50,45 - 49세,1998,675,319,356
'4874025300,  남지읍,'55,50 - 54세,1998,639,296,343
'4874025300,  남지읍,'60,55 - 59세,1998,851,364,487
'4874025300,  남지읍,'65,60 - 64세,1998,818,342,476
'4874025300,  남지읍,'70,65 - 69세,1998,640,278,362
'4874025300,  남지읍,'75,70 - 74세,1998,427,146,281
'4874025300,  남지읍,'80,75 - 79세,1998,311,127,184
'4874025300,  남지읍,'85,80 - 84세,1998,131,50,81
'4874025300,  남지읍,'90,85+ ,1998,60,15,45
'4874031000,  고암면,'00,계,1998,2490,1190,1300
'4874031000,  고암면,'05,0 - 4세,1998,74,35,39
'4874031000,  고암면,'10,5 - 9세,1998,60,33,27
'4874031000,  고암면,'15,10 - 14세,1998,88,51,37
'4874031000,  고암면,'20,15 - 19세,1998,162,79,83
'4874031000,  고암면,'25,20 - 24세,1998,212,123,89
'4874031000,  고암면,'30,25 - 29세,1998,162,101,61
'4874031000,  고암면,'35,30 - 34세,1998,101,62,39
'4874031000,  고암면,'40,35 - 39세,1998,117,72,45
'4874031000,  고암면,'45,40 - 44세,1998,135,77,58
'4874031000,  고암면,'50,45 - 49세,1998,126,62,64
'4874031000,  고암면,'55,50 - 54세,1998,149,72,77
'4874031000,  고암면,'60,55 - 59세,1998,239,88,151
'4874031000,  고암면,'65,60 - 64세,1998,237,91,146
'4874031000,  고암면,'70,65 - 69세,1998,270,103,167
'4874031000,  고암면,'75,70 - 74세,1998,174,75,99
'4874031000,  고암면,'80,75 - 79세,1998,94,33,61
'4874031000,  고암면,'85,80 - 84세,1998,58,24,34
'4874031000,  고암면,'90,85+ ,1998,32,9,23
'4874032000,  성산면,'00,계,1998,2004,945,1059
'4874032000,  성산면,'05,0 - 4세,1998,58,29,29
'4874032000,  성산면,'10,5 - 9세,1998,64,32,32
'4874032000,  성산면,'15,10 - 14세,1998,83,40,43
'4874032000,  성산면,'20,15 - 19세,1998,126,57,69
'4874032000,  성산면,'25,20 - 24세,1998,154,90,64
'4874032000,  성산면,'30,25 - 29세,1998,128,75,53
'4874032000,  성산면,'35,30 - 34세,1998,106,54,52
'4874032000,  성산면,'40,35 - 39세,1998,129,73,56
'4874032000,  성산면,'45,40 - 44세,1998,110,59,51
'4874032000,  성산면,'50,45 - 49세,1998,118,63,55
'4874032000,  성산면,'55,50 - 54세,1998,102,50,52
'4874032000,  성산면,'60,55 - 59세,1998,178,67,111
'4874032000,  성산면,'65,60 - 64세,1998,186,81,105
'4874032000,  성산면,'70,65 - 69세,1998,189,58,131
'4874032000,  성산면,'75,70 - 74세,1998,132,51,81
'4874032000,  성산면,'80,75 - 79세,1998,89,43,46
'4874032000,  성산면,'85,80 - 84세,1998,35,18,17
'4874032000,  성산면,'90,85+ ,1998,17,5,12
'4874033000,  대합면,'00,계,1998,5538,2737,2801
'4874033000,  대합면,'05,0 - 4세,1998,206,104,102
'4874033000,  대합면,'10,5 - 9세,1998,169,98,71
'4874033000,  대합면,'15,10 - 14세,1998,233,114,119
'4874033000,  대합면,'20,15 - 19세,1998,425,222,203
'4874033000,  대합면,'25,20 - 24세,1998,520,310,210
'4874033000,  대합면,'30,25 - 29세,1998,392,261,131
'4874033000,  대합면,'35,30 - 34세,1998,257,149,108
'4874033000,  대합면,'40,35 - 39세,1998,280,161,119
'4874033000,  대합면,'45,40 - 44세,1998,314,160,154
'4874033000,  대합면,'50,45 - 49세,1998,322,163,159
'4874033000,  대합면,'55,50 - 54세,1998,306,141,165
'4874033000,  대합면,'60,55 - 59세,1998,532,210,322
'4874033000,  대합면,'65,60 - 64세,1998,544,228,316
'4874033000,  대합면,'70,65 - 69세,1998,447,170,277
'4874033000,  대합면,'75,70 - 74세,1998,295,135,160
'4874033000,  대합면,'80,75 - 79세,1998,174,69,105
'4874033000,  대합면,'85,80 - 84세,1998,75,28,47
'4874033000,  대합면,'90,85+ ,1998,47,14,33
'4874034000,  이방면,'00,계,1998,3960,1969,1991
'4874034000,  이방면,'05,0 - 4세,1998,121,62,59
'4874034000,  이방면,'10,5 - 9세,1998,133,79,54
'4874034000,  이방면,'15,10 - 14세,1998,219,131,88
'4874034000,  이방면,'20,15 - 19세,1998,366,185,181
'4874034000,  이방면,'25,20 - 24세,1998,371,213,158
'4874034000,  이방면,'30,25 - 29세,1998,207,138,69
'4874034000,  이방면,'35,30 - 34세,1998,176,97,79
'4874034000,  이방면,'40,35 - 39세,1998,223,109,114
'4874034000,  이방면,'45,40 - 44세,1998,266,125,141
'4874034000,  이방면,'50,45 - 49세,1998,237,128,109
'4874034000,  이방면,'55,50 - 54세,1998,248,120,128
'4874034000,  이방면,'60,55 - 59세,1998,339,146,193
'4874034000,  이방면,'65,60 - 64세,1998,378,163,215
'4874034000,  이방면,'70,65 - 69세,1998,276,110,166
'4874034000,  이방면,'75,70 - 74세,1998,192,86,106
'4874034000,  이방면,'80,75 - 79세,1998,127,52,75
'4874034000,  이방면,'85,80 - 84세,1998,60,23,37
'4874034000,  이방면,'90,85+ ,1998,21,2,19
'4874035000,  유어면,'00,계,1998,2962,1459,1503
'4874035000,  유어면,'05,0 - 4세,1998,88,44,44
'4874035000,  유어면,'10,5 - 9세,1998,65,36,29
'4874035000,  유어면,'15,10 - 14세,1998,112,62,50
'4874035000,  유어면,'20,15 - 19세,1998,257,134,123
'4874035000,  유어면,'25,20 - 24세,1998,284,160,124
'4874035000,  유어면,'30,25 - 29세,1998,229,152,77
'4874035000,  유어면,'35,30 - 34세,1998,130,84,46
'4874035000,  유어면,'40,35 - 39세,1998,134,83,51
'4874035000,  유어면,'45,40 - 44세,1998,169,82,87
'4874035000,  유어면,'50,45 - 49세,1998,177,81,96
'4874035000,  유어면,'55,50 - 54세,1998,203,97,106
'4874035000,  유어면,'60,55 - 59세,1998,295,120,175
'4874035000,  유어면,'65,60 - 64세,1998,291,129,162
'4874035000,  유어면,'70,65 - 69세,1998,201,79,122
'4874035000,  유어면,'75,70 - 74세,1998,161,68,93
'4874035000,  유어면,'80,75 - 79세,1998,105,37,68
'4874035000,  유어면,'85,80 - 84세,1998,37,7,30
'4874035000,  유어면,'90,85+ ,1998,24,4,20
'4874036000,  대지면,'00,계,1998,2872,1430,1442
'4874036000,  대지면,'05,0 - 4세,1998,98,46,52
'4874036000,  대지면,'10,5 - 9세,1998,91,53,38
'4874036000,  대지면,'15,10 - 14세,1998,114,65,49
'4874036000,  대지면,'20,15 - 19세,1998,256,131,125
'4874036000,  대지면,'25,20 - 24세,1998,256,145,111
'4874036000,  대지면,'30,25 - 29세,1998,221,133,88
'4874036000,  대지면,'35,30 - 34세,1998,144,91,53
'4874036000,  대지면,'40,35 - 39세,1998,155,96,59
'4874036000,  대지면,'45,40 - 44세,1998,163,85,78
'4874036000,  대지면,'50,45 - 49세,1998,161,69,92
'4874036000,  대지면,'55,50 - 54세,1998,193,91,102
'4874036000,  대지면,'60,55 - 59세,1998,240,101,139
'4874036000,  대지면,'65,60 - 64세,1998,265,123,142
'4874036000,  대지면,'70,65 - 69세,1998,224,84,140
'4874036000,  대지면,'75,70 - 74세,1998,143,66,77
'4874036000,  대지면,'80,75 - 79세,1998,75,32,43
'4874036000,  대지면,'85,80 - 84세,1998,48,15,33
'4874036000,  대지면,'90,85+ ,1998,25,4,21
'4874037000,  계성면,'00,계,1998,3460,1697,1763
'4874037000,  계성면,'05,0 - 4세,1998,158,93,65
'4874037000,  계성면,'10,5 - 9세,1998,116,60,56
'4874037000,  계성면,'15,10 - 14세,1998,164,85,79
'4874037000,  계성면,'20,15 - 19세,1998,271,136,135
'4874037000,  계성면,'25,20 - 24세,1998,287,162,125
'4874037000,  계성면,'30,25 - 29세,1998,272,173,99
'4874037000,  계성면,'35,30 - 34세,1998,190,111,79
'4874037000,  계성면,'40,35 - 39세,1998,200,109,91
'4874037000,  계성면,'45,40 - 44세,1998,188,97,91
'4874037000,  계성면,'50,45 - 49세,1998,188,88,100
'4874037000,  계성면,'55,50 - 54세,1998,228,101,127
'4874037000,  계성면,'60,55 - 59세,1998,283,120,163
'4874037000,  계성면,'65,60 - 64세,1998,332,132,200
'4874037000,  계성면,'70,65 - 69세,1998,247,104,143
'4874037000,  계성면,'75,70 - 74세,1998,170,64,106
'4874037000,  계성면,'80,75 - 79세,1998,88,41,47
'4874037000,  계성면,'85,80 - 84세,1998,48,14,34
'4874037000,  계성면,'90,85+ ,1998,30,7,23
'4874038000,  영산면,'00,계,1998,7670,3759,3911
'4874038000,  영산면,'05,0 - 4세,1998,420,225,195
'4874038000,  영산면,'10,5 - 9세,1998,503,271,232
'4874038000,  영산면,'15,10 - 14세,1998,474,253,221
'4874038000,  영산면,'20,15 - 19세,1998,663,328,335
'4874038000,  영산면,'25,20 - 24세,1998,643,342,301
'4874038000,  영산면,'30,25 - 29세,1998,587,326,261
'4874038000,  영산면,'35,30 - 34세,1998,543,290,253
'4874038000,  영산면,'40,35 - 39세,1998,633,302,331
'4874038000,  영산면,'45,40 - 44세,1998,553,307,246
'4874038000,  영산면,'50,45 - 49세,1998,412,198,214
'4874038000,  영산면,'55,50 - 54세,1998,382,185,197
'4874038000,  영산면,'60,55 - 59세,1998,464,204,260
'4874038000,  영산면,'65,60 - 64세,1998,484,193,291
'4874038000,  영산면,'70,65 - 69세,1998,355,130,225
'4874038000,  영산면,'75,70 - 74세,1998,257,102,155
'4874038000,  영산면,'80,75 - 79세,1998,177,64,113
'4874038000,  영산면,'85,80 - 84세,1998,89,31,58
'4874038000,  영산면,'90,85+ ,1998,31,8,23
'4874039000,  장마면,'00,계,1998,2580,1281,1299
'4874039000,  장마면,'05,0 - 4세,1998,53,35,18
'4874039000,  장마면,'10,5 - 9세,1998,63,30,33
'4874039000,  장마면,'15,10 - 14세,1998,83,57,26
'4874039000,  장마면,'20,15 - 19세,1998,166,94,72
'4874039000,  장마면,'25,20 - 24세,1998,223,140,83
'4874039000,  장마면,'30,25 - 29세,1998,169,120,49
'4874039000,  장마면,'35,30 - 34세,1998,104,72,32
'4874039000,  장마면,'40,35 - 39세,1998,114,64,50
'4874039000,  장마면,'45,40 - 44세,1998,115,59,56
'4874039000,  장마면,'50,45 - 49세,1998,132,66,66
'4874039000,  장마면,'55,50 - 54세,1998,154,57,97
'4874039000,  장마면,'60,55 - 59세,1998,284,115,169
'4874039000,  장마면,'65,60 - 64세,1998,332,143,189
'4874039000,  장마면,'70,65 - 69세,1998,239,98,141
'4874039000,  장마면,'75,70 - 74세,1998,161,57,104
'4874039000,  장마면,'80,75 - 79세,1998,98,47,51
'4874039000,  장마면,'85,80 - 84세,1998,65,24,41
'4874039000,  장마면,'90,85+ ,1998,25,3,22
'4874040000,  도천면,'00,계,1998,3244,1585,1659
'4874040000,  도천면,'05,0 - 4세,1998,138,68,70
'4874040000,  도천면,'10,5 - 9세,1998,126,63,63
'4874040000,  도천면,'15,10 - 14세,1998,118,66,52
'4874040000,  도천면,'20,15 - 19세,1998,257,134,123
'4874040000,  도천면,'25,20 - 24세,1998,282,160,122
'4874040000,  도천면,'30,25 - 29세,1998,257,160,97
'4874040000,  도천면,'35,30 - 34세,1998,179,106,73
'4874040000,  도천면,'40,35 - 39세,1998,180,109,71
'4874040000,  도천면,'45,40 - 44세,1998,177,90,87
'4874040000,  도천면,'50,45 - 49세,1998,164,70,94
'4874040000,  도천면,'55,50 - 54세,1998,167,74,93
'4874040000,  도천면,'60,55 - 59세,1998,284,125,159
'4874040000,  도천면,'65,60 - 64세,1998,320,130,190
'4874040000,  도천면,'70,65 - 69세,1998,264,97,167
'4874040000,  도천면,'75,70 - 74세,1998,184,80,104
'4874040000,  도천면,'80,75 - 79세,1998,85,33,52
'4874040000,  도천면,'85,80 - 84세,1998,43,14,29
'4874040000,  도천면,'90,85+ ,1998,19,6,13
'4874041000,  길곡면,'00,계,1998,1959,988,971
'4874041000,  길곡면,'05,0 - 4세,1998,57,33,24
'4874041000,  길곡면,'10,5 - 9세,1998,65,42,23
'4874041000,  길곡면,'15,10 - 14세,1998,102,55,47
'4874041000,  길곡면,'20,15 - 19세,1998,165,87,78
'4874041000,  길곡면,'25,20 - 24세,1998,188,116,72
'4874041000,  길곡면,'30,25 - 29세,1998,124,89,35
'4874041000,  길곡면,'35,30 - 34세,1998,81,47,34
'4874041000,  길곡면,'40,35 - 39세,1998,98,48,50
'4874041000,  길곡면,'45,40 - 44세,1998,128,59,69
'4874041000,  길곡면,'50,45 - 49세,1998,115,58,57
'4874041000,  길곡면,'55,50 - 54세,1998,122,67,55
'4874041000,  길곡면,'60,55 - 59세,1998,162,75,87
'4874041000,  길곡면,'65,60 - 64세,1998,179,73,106
'4874041000,  길곡면,'70,65 - 69세,1998,150,60,90
'4874041000,  길곡면,'75,70 - 74세,1998,96,37,59
'4874041000,  길곡면,'80,75 - 79세,1998,74,26,48
'4874041000,  길곡면,'85,80 - 84세,1998,33,12,21
'4874041000,  길곡면,'90,85+ ,1998,20,4,16
'4874042000,  부곡면,'00,계,1998,5618,2791,2827
'4874042000,  부곡면,'05,0 - 4세,1998,269,149,120
'4874042000,  부곡면,'10,5 - 9세,1998,316,180,136
'4874042000,  부곡면,'15,10 - 14세,1998,348,181,167
'4874042000,  부곡면,'20,15 - 19세,1998,528,275,253
'4874042000,  부곡면,'25,20 - 24세,1998,481,248,233
'4874042000,  부곡면,'30,25 - 29세,1998,448,259,189
'4874042000,  부곡면,'35,30 - 34세,1998,380,188,192
'4874042000,  부곡면,'40,35 - 39세,1998,442,229,213
'4874042000,  부곡면,'45,40 - 44세,1998,399,196,203
'4874042000,  부곡면,'50,45 - 49세,1998,344,183,161
'4874042000,  부곡면,'55,50 - 54세,1998,269,128,141
'4874042000,  부곡면,'60,55 - 59세,1998,376,159,217
'4874042000,  부곡면,'65,60 - 64세,1998,363,167,196
'4874042000,  부곡면,'70,65 - 69세,1998,292,108,184
'4874042000,  부곡면,'75,70 - 74세,1998,179,68,111
'4874042000,  부곡면,'80,75 - 79세,1998,116,52,64
'4874042000,  부곡면,'85,80 - 84세,1998,36,13,23
'4874042000,  부곡면,'90,85+ ,1998,32,8,24
'48820, 고성군,'00,계,1998,66612,32899,33713
'48820, 고성군,'05,0 - 4세,1998,3159,1724,1435
'48820, 고성군,'10,5 - 9세,1998,3274,1763,1511
'48820, 고성군,'15,10 - 14세,1998,3662,1845,1817
'48820, 고성군,'20,15 - 19세,1998,6124,3159,2965
'48820, 고성군,'25,20 - 24세,1998,6362,3493,2869
'48820, 고성군,'30,25 - 29세,1998,5456,3204,2252
'48820, 고성군,'35,30 - 34세,1998,3971,2209,1762
'48820, 고성군,'40,35 - 39세,1998,4488,2330,2158
'48820, 고성군,'45,40 - 44세,1998,4161,2121,2040
'48820, 고성군,'50,45 - 49세,1998,3704,1835,1869
'48820, 고성군,'55,50 - 54세,1998,3593,1744,1849
'48820, 고성군,'60,55 - 59세,1998,4433,1942,2491
'48820, 고성군,'65,60 - 64세,1998,4505,1965,2540
'48820, 고성군,'70,65 - 69세,1998,3945,1510,2435
'48820, 고성군,'75,70 - 74세,1998,2789,1049,1740
'48820, 고성군,'80,75 - 79세,1998,1680,625,1055
'48820, 고성군,'85,80 - 84세,1998,812,268,544
'48820, 고성군,'90,85+ ,1998,494,113,381
'4882025000,  고성읍,'00,계,1998,26624,13185,13439
'4882025000,  고성읍,'05,0 - 4세,1998,1804,992,812
'4882025000,  고성읍,'10,5 - 9세,1998,1781,963,818
'4882025000,  고성읍,'15,10 - 14세,1998,1792,922,870
'4882025000,  고성읍,'20,15 - 19세,1998,2604,1342,1262
'4882025000,  고성읍,'25,20 - 24세,1998,2428,1235,1193
'4882025000,  고성읍,'30,25 - 29세,1998,2411,1269,1142
'4882025000,  고성읍,'35,30 - 34세,1998,2043,1045,998
'4882025000,  고성읍,'40,35 - 39세,1998,2284,1150,1134
'4882025000,  고성읍,'45,40 - 44세,1998,1891,935,956
'4882025000,  고성읍,'50,45 - 49세,1998,1509,778,731
'4882025000,  고성읍,'55,50 - 54세,1998,1232,598,634
'4882025000,  고성읍,'60,55 - 59세,1998,1342,605,737
'4882025000,  고성읍,'65,60 - 64세,1998,1189,521,668
'4882025000,  고성읍,'70,65 - 69세,1998,989,366,623
'4882025000,  고성읍,'75,70 - 74세,1998,666,261,405
'4882025000,  고성읍,'80,75 - 79세,1998,392,143,249
'4882025000,  고성읍,'85,80 - 84세,1998,168,45,123
'4882025000,  고성읍,'90,85+ ,1998,99,15,84
'4882031000,  삼산면,'00,계,1998,2495,1273,1222
'4882031000,  삼산면,'05,0 - 4세,1998,70,42,28
'4882031000,  삼산면,'10,5 - 9세,1998,77,40,37
'4882031000,  삼산면,'15,10 - 14세,1998,99,49,50
'4882031000,  삼산면,'20,15 - 19세,1998,235,126,109
'4882031000,  삼산면,'25,20 - 24세,1998,263,149,114
'4882031000,  삼산면,'30,25 - 29세,1998,167,125,42
'4882031000,  삼산면,'35,30 - 34세,1998,102,64,38
'4882031000,  삼산면,'40,35 - 39세,1998,137,70,67
'4882031000,  삼산면,'45,40 - 44세,1998,145,82,63
'4882031000,  삼산면,'50,45 - 49세,1998,161,81,80
'4882031000,  삼산면,'55,50 - 54세,1998,170,93,77
'4882031000,  삼산면,'60,55 - 59세,1998,211,85,126
'4882031000,  삼산면,'65,60 - 64세,1998,221,105,116
'4882031000,  삼산면,'70,65 - 69세,1998,173,69,104
'4882031000,  삼산면,'75,70 - 74세,1998,122,46,76
'4882031000,  삼산면,'80,75 - 79세,1998,86,33,53
'4882031000,  삼산면,'85,80 - 84세,1998,31,8,23
'4882031000,  삼산면,'90,85+ ,1998,25,6,19
'4882032000,  하일면,'00,계,1998,3064,1497,1567
'4882032000,  하일면,'05,0 - 4세,1998,100,47,53
'4882032000,  하일면,'10,5 - 9세,1998,99,49,50
'4882032000,  하일면,'15,10 - 14세,1998,129,72,57
'4882032000,  하일면,'20,15 - 19세,1998,305,144,161
'4882032000,  하일면,'25,20 - 24세,1998,312,172,140
'4882032000,  하일면,'30,25 - 29세,1998,219,155,64
'4882032000,  하일면,'35,30 - 34세,1998,116,73,43
'4882032000,  하일면,'40,35 - 39세,1998,148,74,74
'4882032000,  하일면,'45,40 - 44세,1998,162,83,79
'4882032000,  하일면,'50,45 - 49세,1998,182,81,101
'4882032000,  하일면,'55,50 - 54세,1998,226,109,117
'4882032000,  하일면,'60,55 - 59세,1998,241,108,133
'4882032000,  하일면,'65,60 - 64세,1998,277,123,154
'4882032000,  하일면,'70,65 - 69세,1998,217,86,131
'4882032000,  하일면,'75,70 - 74세,1998,165,60,105
'4882032000,  하일면,'80,75 - 79세,1998,98,39,59
'4882032000,  하일면,'85,80 - 84세,1998,42,13,29
'4882032000,  하일면,'90,85+ ,1998,26,9,17
'4882033000,  하이면,'00,계,1998,3942,1985,1957
'4882033000,  하이면,'05,0 - 4세,1998,176,107,69
'4882033000,  하이면,'10,5 - 9세,1998,196,106,90
'4882033000,  하이면,'15,10 - 14세,1998,234,115,119
'4882033000,  하이면,'20,15 - 19세,1998,388,214,174
'4882033000,  하이면,'25,20 - 24세,1998,389,216,173
'4882033000,  하이면,'30,25 - 29세,1998,306,169,137
'4882033000,  하이면,'35,30 - 34세,1998,221,128,93
'4882033000,  하이면,'40,35 - 39세,1998,238,118,120
'4882033000,  하이면,'45,40 - 44세,1998,254,143,111
'4882033000,  하이면,'50,45 - 49세,1998,224,107,117
'4882033000,  하이면,'55,50 - 54세,1998,217,115,102
'4882033000,  하이면,'60,55 - 59세,1998,255,125,130
'4882033000,  하이면,'65,60 - 64세,1998,249,107,142
'4882033000,  하이면,'70,65 - 69세,1998,242,77,165
'4882033000,  하이면,'75,70 - 74세,1998,173,72,101
'4882033000,  하이면,'80,75 - 79세,1998,110,44,66
'4882033000,  하이면,'85,80 - 84세,1998,38,13,25
'4882033000,  하이면,'90,85+ ,1998,32,9,23
'4882034000,  상리면,'00,계,1998,2283,1116,1167
'4882034000,  상리면,'05,0 - 4세,1998,49,31,18
'4882034000,  상리면,'10,5 - 9세,1998,75,39,36
'4882034000,  상리면,'15,10 - 14세,1998,101,53,48
'4882034000,  상리면,'20,15 - 19세,1998,147,82,65
'4882034000,  상리면,'25,20 - 24세,1998,200,119,81
'4882034000,  상리면,'30,25 - 29세,1998,173,103,70
'4882034000,  상리면,'35,30 - 34세,1998,114,61,53
'4882034000,  상리면,'40,35 - 39세,1998,106,54,52
'4882034000,  상리면,'45,40 - 44세,1998,101,57,44
'4882034000,  상리면,'50,45 - 49세,1998,120,57,63
'4882034000,  상리면,'55,50 - 54세,1998,145,53,92
'4882034000,  상리면,'60,55 - 59세,1998,204,91,113
'4882034000,  상리면,'65,60 - 64세,1998,223,107,116
'4882034000,  상리면,'70,65 - 69세,1998,223,80,143
'4882034000,  상리면,'75,70 - 74세,1998,135,60,75
'4882034000,  상리면,'80,75 - 79세,1998,96,36,60
'4882034000,  상리면,'85,80 - 84세,1998,52,25,27
'4882034000,  상리면,'90,85+ ,1998,19,8,11
'4882035000,  대가면,'00,계,1998,2366,1149,1217
'4882035000,  대가면,'05,0 - 4세,1998,63,41,22
'4882035000,  대가면,'10,5 - 9세,1998,49,26,23
'4882035000,  대가면,'15,10 - 14세,1998,78,36,42
'4882035000,  대가면,'20,15 - 19세,1998,192,90,102
'4882035000,  대가면,'25,20 - 24세,1998,236,146,90
'4882035000,  대가면,'30,25 - 29세,1998,159,104,55
'4882035000,  대가면,'35,30 - 34세,1998,101,64,37
'4882035000,  대가면,'40,35 - 39세,1998,105,61,44
'4882035000,  대가면,'45,40 - 44세,1998,113,54,59
'4882035000,  대가면,'50,45 - 49세,1998,119,64,55
'4882035000,  대가면,'55,50 - 54세,1998,140,61,79
'4882035000,  대가면,'60,55 - 59세,1998,190,85,105
'4882035000,  대가면,'65,60 - 64세,1998,213,91,122
'4882035000,  대가면,'70,65 - 69세,1998,254,86,168
'4882035000,  대가면,'75,70 - 74세,1998,148,60,88
'4882035000,  대가면,'80,75 - 79세,1998,109,48,61
'4882035000,  대가면,'85,80 - 84세,1998,60,24,36
'4882035000,  대가면,'90,85+ ,1998,37,8,29
'4882036000,  영현면,'00,계,1998,1512,731,781
'4882036000,  영현면,'05,0 - 4세,1998,33,20,13
'4882036000,  영현면,'10,5 - 9세,1998,32,11,21
'4882036000,  영현면,'15,10 - 14세,1998,53,30,23
'4882036000,  영현면,'20,15 - 19세,1998,124,69,55
'4882036000,  영현면,'25,20 - 24세,1998,154,93,61
'4882036000,  영현면,'30,25 - 29세,1998,94,64,30
'4882036000,  영현면,'35,30 - 34세,1998,45,28,17
'4882036000,  영현면,'40,35 - 39세,1998,66,38,28
'4882036000,  영현면,'45,40 - 44세,1998,75,35,40
'4882036000,  영현면,'50,45 - 49세,1998,75,32,43
'4882036000,  영현면,'55,50 - 54세,1998,105,57,48
'4882036000,  영현면,'60,55 - 59세,1998,131,46,85
'4882036000,  영현면,'65,60 - 64세,1998,165,72,93
'4882036000,  영현면,'70,65 - 69세,1998,118,48,70
'4882036000,  영현면,'75,70 - 74세,1998,102,34,68
'4882036000,  영현면,'80,75 - 79세,1998,80,31,49
'4882036000,  영현면,'85,80 - 84세,1998,35,14,21
'4882036000,  영현면,'90,85+ ,1998,25,9,16
'4882037000,  영오면,'00,계,1998,2390,1160,1230
'4882037000,  영오면,'05,0 - 4세,1998,92,51,41
'4882037000,  영오면,'10,5 - 9세,1998,76,44,32
'4882037000,  영오면,'15,10 - 14세,1998,104,53,51
'4882037000,  영오면,'20,15 - 19세,1998,210,105,105
'4882037000,  영오면,'25,20 - 24세,1998,244,131,113
'4882037000,  영오면,'30,25 - 29세,1998,196,123,73
'4882037000,  영오면,'35,30 - 34세,1998,116,70,46
'4882037000,  영오면,'40,35 - 39세,1998,129,71,58
'4882037000,  영오면,'45,40 - 44세,1998,132,74,58
'4882037000,  영오면,'50,45 - 49세,1998,118,52,66
'4882037000,  영오면,'55,50 - 54세,1998,121,65,56
'4882037000,  영오면,'60,55 - 59세,1998,188,75,113
'4882037000,  영오면,'65,60 - 64세,1998,184,69,115
'4882037000,  영오면,'70,65 - 69세,1998,178,72,106
'4882037000,  영오면,'75,70 - 74세,1998,148,54,94
'4882037000,  영오면,'80,75 - 79세,1998,79,29,50
'4882037000,  영오면,'85,80 - 84세,1998,49,14,35
'4882037000,  영오면,'90,85+ ,1998,26,8,18
'4882038000,  개천면,'00,계,1998,1801,882,919
'4882038000,  개천면,'05,0 - 4세,1998,67,37,30
'4882038000,  개천면,'10,5 - 9세,1998,65,38,27
'4882038000,  개천면,'15,10 - 14세,1998,91,45,46
'4882038000,  개천면,'20,15 - 19세,1998,131,67,64
'4882038000,  개천면,'25,20 - 24세,1998,162,95,67
'4882038000,  개천면,'30,25 - 29세,1998,121,87,34
'4882038000,  개천면,'35,30 - 34세,1998,76,51,25
'4882038000,  개천면,'40,35 - 39세,1998,91,39,52
'4882038000,  개천면,'45,40 - 44세,1998,91,53,38
'4882038000,  개천면,'50,45 - 49세,1998,99,44,55
'4882038000,  개천면,'55,50 - 54세,1998,82,40,42
'4882038000,  개천면,'60,55 - 59세,1998,139,51,88
'4882038000,  개천면,'65,60 - 64세,1998,181,85,96
'4882038000,  개천면,'70,65 - 69세,1998,154,54,100
'4882038000,  개천면,'75,70 - 74세,1998,129,54,75
'4882038000,  개천면,'80,75 - 79세,1998,70,28,42
'4882038000,  개천면,'85,80 - 84세,1998,37,11,26
'4882038000,  개천면,'90,85+ ,1998,15,3,12
'4882039000,  구만면,'00,계,1998,1606,733,873
'4882039000,  구만면,'05,0 - 4세,1998,51,23,28
'4882039000,  구만면,'10,5 - 9세,1998,38,19,19
'4882039000,  구만면,'15,10 - 14세,1998,75,33,42
'4882039000,  구만면,'20,15 - 19세,1998,102,49,53
'4882039000,  구만면,'25,20 - 24세,1998,140,72,68
'4882039000,  구만면,'30,25 - 29세,1998,129,79,50
'4882039000,  구만면,'35,30 - 34세,1998,62,44,18
'4882039000,  구만면,'40,35 - 39세,1998,87,49,38
'4882039000,  구만면,'45,40 - 44세,1998,75,40,35
'4882039000,  구만면,'50,45 - 49세,1998,81,36,45
'4882039000,  구만면,'55,50 - 54세,1998,88,43,45
'4882039000,  구만면,'60,55 - 59세,1998,124,49,75
'4882039000,  구만면,'65,60 - 64세,1998,141,57,84
'4882039000,  구만면,'70,65 - 69세,1998,156,61,95
'4882039000,  구만면,'75,70 - 74세,1998,117,38,79
'4882039000,  구만면,'80,75 - 79세,1998,74,24,50
'4882039000,  구만면,'85,80 - 84세,1998,44,14,30
'4882039000,  구만면,'90,85+ ,1998,22,3,19
'4882040000,  회화면,'00,계,1998,5063,2485,2578
'4882040000,  회화면,'05,0 - 4세,1998,220,113,107
'4882040000,  회화면,'10,5 - 9세,1998,285,146,139
'4882040000,  회화면,'15,10 - 14세,1998,295,139,156
'4882040000,  회화면,'20,15 - 19세,1998,469,247,222
'4882040000,  회화면,'25,20 - 24세,1998,418,253,165
'4882040000,  회화면,'30,25 - 29세,1998,410,229,181
'4882040000,  회화면,'35,30 - 34세,1998,312,169,143
'4882040000,  회화면,'40,35 - 39세,1998,329,174,155
'4882040000,  회화면,'45,40 - 44세,1998,381,189,192
'4882040000,  회화면,'50,45 - 49세,1998,299,160,139
'4882040000,  회화면,'55,50 - 54세,1998,262,128,134
'4882040000,  회화면,'60,55 - 59세,1998,329,154,175
'4882040000,  회화면,'65,60 - 64세,1998,335,136,199
'4882040000,  회화면,'70,65 - 69세,1998,291,121,170
'4882040000,  회화면,'75,70 - 74세,1998,218,62,156
'4882040000,  회화면,'80,75 - 79세,1998,103,37,66
'4882040000,  회화면,'85,80 - 84세,1998,64,18,46
'4882040000,  회화면,'90,85+ ,1998,43,10,33
'4882041000,  마암면,'00,계,1998,2710,1306,1404
'4882041000,  마암면,'05,0 - 4세,1998,74,36,38
'4882041000,  마암면,'10,5 - 9세,1998,78,40,38
'4882041000,  마암면,'15,10 - 14세,1998,84,40,44
'4882041000,  마암면,'20,15 - 19세,1998,245,126,119
'4882041000,  마암면,'25,20 - 24세,1998,262,158,104
'4882041000,  마암면,'30,25 - 29세,1998,223,134,89
'4882041000,  마암면,'35,30 - 34세,1998,128,83,45
'4882041000,  마암면,'40,35 - 39세,1998,135,79,56
'4882041000,  마암면,'45,40 - 44세,1998,134,60,74
'4882041000,  마암면,'50,45 - 49세,1998,153,74,79
'4882041000,  마암면,'55,50 - 54세,1998,188,84,104
'4882041000,  마암면,'60,55 - 59세,1998,211,96,115
'4882041000,  마암면,'65,60 - 64세,1998,240,107,133
'4882041000,  마암면,'70,65 - 69세,1998,209,82,127
'4882041000,  마암면,'75,70 - 74세,1998,165,53,112
'4882041000,  마암면,'80,75 - 79세,1998,101,28,73
'4882041000,  마암면,'85,80 - 84세,1998,52,19,33
'4882041000,  마암면,'90,85+ ,1998,28,7,21
'4882042000,  동해면,'00,계,1998,5086,2557,2529
'4882042000,  동해면,'05,0 - 4세,1998,165,81,84
'4882042000,  동해면,'10,5 - 9세,1998,203,127,76
'4882042000,  동해면,'15,10 - 14세,1998,244,119,125
'4882042000,  동해면,'20,15 - 19세,1998,475,243,232
'4882042000,  동해면,'25,20 - 24세,1998,523,295,228
'4882042000,  동해면,'30,25 - 29세,1998,389,256,133
'4882042000,  동해면,'35,30 - 34세,1998,242,145,97
'4882042000,  동해면,'40,35 - 39세,1998,299,170,129
'4882042000,  동해면,'45,40 - 44세,1998,295,155,140
'4882042000,  동해면,'50,45 - 49세,1998,288,145,143
'4882042000,  동해면,'55,50 - 54세,1998,282,136,146
'4882042000,  동해면,'60,55 - 59세,1998,425,180,245
'4882042000,  동해면,'65,60 - 64세,1998,428,186,242
'4882042000,  동해면,'70,65 - 69세,1998,366,154,212
'4882042000,  동해면,'75,70 - 74세,1998,234,99,135
'4882042000,  동해면,'80,75 - 79세,1998,119,39,80
'4882042000,  동해면,'85,80 - 84세,1998,65,22,43
'4882042000,  동해면,'90,85+ ,1998,44,5,39
'4882043000,  거류면,'00,계,1998,5670,2840,2830
'4882043000,  거류면,'05,0 - 4세,1998,195,103,92
'4882043000,  거류면,'10,5 - 9세,1998,220,115,105
'4882043000,  거류면,'15,10 - 14세,1998,283,139,144
'4882043000,  거류면,'20,15 - 19세,1998,497,255,242
'4882043000,  거류면,'25,20 - 24세,1998,631,359,272
'4882043000,  거류면,'30,25 - 29세,1998,459,307,152
'4882043000,  거류면,'35,30 - 34세,1998,293,184,109
'4882043000,  거류면,'40,35 - 39세,1998,334,183,151
'4882043000,  거류면,'45,40 - 44세,1998,312,161,151
'4882043000,  거류면,'50,45 - 49세,1998,276,124,152
'4882043000,  거류면,'55,50 - 54세,1998,335,162,173
'4882043000,  거류면,'60,55 - 59세,1998,443,192,251
'4882043000,  거류면,'65,60 - 64세,1998,459,199,260
'4882043000,  거류면,'70,65 - 69세,1998,375,154,221
'4882043000,  거류면,'75,70 - 74세,1998,267,96,171
'4882043000,  거류면,'80,75 - 79세,1998,163,66,97
'4882043000,  거류면,'85,80 - 84세,1998,75,28,47
'4882043000,  거류면,'90,85+ ,1998,53,13,40
'48840, 남해군,'00,계,1998,63662,30784,32878
'48840, 남해군,'05,0 - 4세,1998,2631,1447,1184
'48840, 남해군,'10,5 - 9세,1998,2884,1526,1358
'48840, 남해군,'15,10 - 14세,1998,3458,1757,1701
'48840, 남해군,'20,15 - 19세,1998,5729,2842,2887
'48840, 남해군,'25,20 - 24세,1998,5617,3170,2447
'48840, 남해군,'30,25 - 29세,1998,4296,2654,1642
'48840, 남해군,'35,30 - 34세,1998,3330,1812,1518
'48840, 남해군,'40,35 - 39세,1998,3949,2079,1870
'48840, 남해군,'45,40 - 44세,1998,3656,1850,1806
'48840, 남해군,'50,45 - 49세,1998,3355,1654,1701
'48840, 남해군,'55,50 - 54세,1998,3387,1614,1773
'48840, 남해군,'60,55 - 59세,1998,4619,2004,2615
'48840, 남해군,'65,60 - 64세,1998,4827,2030,2797
'48840, 남해군,'70,65 - 69세,1998,4497,1786,2711
'48840, 남해군,'75,70 - 74세,1998,3407,1269,2138
'48840, 남해군,'80,75 - 79세,1998,2178,808,1370
'48840, 남해군,'85,80 - 84세,1998,1100,342,758
'48840, 남해군,'90,85+ ,1998,742,140,602
'4884025000,  남해읍,'00,계,1998,15054,7311,7743
'4884025000,  남해읍,'05,0 - 4세,1998,913,506,407
'4884025000,  남해읍,'10,5 - 9세,1998,1098,581,517
'4884025000,  남해읍,'15,10 - 14세,1998,1077,552,525
'4884025000,  남해읍,'20,15 - 19세,1998,1390,688,702
'4884025000,  남해읍,'25,20 - 24세,1998,1187,636,551
'4884025000,  남해읍,'30,25 - 29세,1998,1211,644,567
'4884025000,  남해읍,'35,30 - 34세,1998,1105,535,570
'4884025000,  남해읍,'40,35 - 39세,1998,1298,633,665
'4884025000,  남해읍,'45,40 - 44세,1998,1053,562,491
'4884025000,  남해읍,'50,45 - 49세,1998,796,381,415
'4884025000,  남해읍,'55,50 - 54세,1998,715,372,343
'4884025000,  남해읍,'60,55 - 59세,1998,781,323,458
'4884025000,  남해읍,'65,60 - 64세,1998,709,310,399
'4884025000,  남해읍,'70,65 - 69세,1998,640,252,388
'4884025000,  남해읍,'75,70 - 74세,1998,473,156,317
'4884025000,  남해읍,'80,75 - 79세,1998,338,115,223
'4884025000,  남해읍,'85,80 - 84세,1998,156,48,108
'4884025000,  남해읍,'90,85+ ,1998,114,17,97
'4884031000,  이동면,'00,계,1998,6146,2965,3181
'4884031000,  이동면,'05,0 - 4세,1998,242,145,97
'4884031000,  이동면,'10,5 - 9세,1998,221,120,101
'4884031000,  이동면,'15,10 - 14세,1998,300,157,143
'4884031000,  이동면,'20,15 - 19세,1998,508,248,260
'4884031000,  이동면,'25,20 - 24세,1998,530,298,232
'4884031000,  이동면,'30,25 - 29세,1998,379,247,132
'4884031000,  이동면,'35,30 - 34세,1998,312,166,146
'4884031000,  이동면,'40,35 - 39세,1998,332,181,151
'4884031000,  이동면,'45,40 - 44세,1998,320,163,157
'4884031000,  이동면,'50,45 - 49세,1998,321,149,172
'4884031000,  이동면,'55,50 - 54세,1998,339,151,188
'4884031000,  이동면,'60,55 - 59세,1998,472,209,263
'4884031000,  이동면,'65,60 - 64세,1998,531,221,310
'4884031000,  이동면,'70,65 - 69세,1998,496,207,289
'4884031000,  이동면,'75,70 - 74세,1998,361,146,215
'4884031000,  이동면,'80,75 - 79세,1998,248,95,153
'4884031000,  이동면,'85,80 - 84세,1998,138,41,97
'4884031000,  이동면,'90,85+ ,1998,96,21,75
'4884032000,  상주면,'00,계,1998,2734,1311,1423
'4884032000,  상주면,'05,0 - 4세,1998,130,68,62
'4884032000,  상주면,'10,5 - 9세,1998,107,51,56
'4884032000,  상주면,'15,10 - 14세,1998,128,63,65
'4884032000,  상주면,'20,15 - 19세,1998,200,96,104
'4884032000,  상주면,'25,20 - 24세,1998,220,118,102
'4884032000,  상주면,'30,25 - 29세,1998,178,115,63
'4884032000,  상주면,'35,30 - 34세,1998,174,101,73
'4884032000,  상주면,'40,35 - 39세,1998,186,113,73
'4884032000,  상주면,'45,40 - 44세,1998,143,74,69
'4884032000,  상주면,'50,45 - 49세,1998,141,68,73
'4884032000,  상주면,'55,50 - 54세,1998,121,53,68
'4884032000,  상주면,'60,55 - 59세,1998,223,89,134
'4884032000,  상주면,'65,60 - 64세,1998,246,108,138
'4884032000,  상주면,'70,65 - 69세,1998,223,89,134
'4884032000,  상주면,'75,70 - 74세,1998,141,59,82
'4884032000,  상주면,'80,75 - 79세,1998,93,30,63
'4884032000,  상주면,'85,80 - 84세,1998,44,14,30
'4884032000,  상주면,'90,85+ ,1998,36,2,34
'4884033000,  삼동면,'00,계,1998,6001,2963,3038
'4884033000,  삼동면,'05,0 - 4세,1998,215,113,102
'4884033000,  삼동면,'10,5 - 9세,1998,235,122,113
'4884033000,  삼동면,'15,10 - 14세,1998,285,155,130
'4884033000,  삼동면,'20,15 - 19세,1998,469,241,228
'4884033000,  삼동면,'25,20 - 24세,1998,499,289,210
'4884033000,  삼동면,'30,25 - 29세,1998,435,286,149
'4884033000,  삼동면,'35,30 - 34세,1998,306,186,120
'4884033000,  삼동면,'40,35 - 39세,1998,330,175,155
'4884033000,  삼동면,'45,40 - 44세,1998,346,178,168
'4884033000,  삼동면,'50,45 - 49세,1998,317,171,146
'4884033000,  삼동면,'55,50 - 54세,1998,306,145,161
'4884033000,  삼동면,'60,55 - 59세,1998,445,202,243
'4884033000,  삼동면,'65,60 - 64세,1998,503,215,288
'4884033000,  삼동면,'70,65 - 69세,1998,479,180,299
'4884033000,  삼동면,'75,70 - 74세,1998,393,147,246
'4884033000,  삼동면,'80,75 - 79세,1998,247,103,144
'4884033000,  삼동면,'85,80 - 84세,1998,125,42,83
'4884033000,  삼동면,'90,85+ ,1998,66,13,53
'4884034000,  미조면,'00,계,1998,3802,1911,1891
'4884034000,  미조면,'05,0 - 4세,1998,217,127,90
'4884034000,  미조면,'10,5 - 9세,1998,210,107,103
'4884034000,  미조면,'15,10 - 14세,1998,246,132,114
'4884034000,  미조면,'20,15 - 19세,1998,356,183,173
'4884034000,  미조면,'25,20 - 24세,1998,289,157,132
'4884034000,  미조면,'30,25 - 29세,1998,281,166,115
'4884034000,  미조면,'35,30 - 34세,1998,270,156,114
'4884034000,  미조면,'40,35 - 39세,1998,312,182,130
'4884034000,  미조면,'45,40 - 44세,1998,299,151,148
'4884034000,  미조면,'50,45 - 49세,1998,211,115,96
'4884034000,  미조면,'55,50 - 54세,1998,196,109,87
'4884034000,  미조면,'60,55 - 59세,1998,204,87,117
'4884034000,  미조면,'65,60 - 64세,1998,199,82,117
'4884034000,  미조면,'70,65 - 69세,1998,186,69,117
'4884034000,  미조면,'75,70 - 74세,1998,155,45,110
'4884034000,  미조면,'80,75 - 79세,1998,105,31,74
'4884034000,  미조면,'85,80 - 84세,1998,45,11,34
'4884034000,  미조면,'90,85+ ,1998,21,1,20
'4884035000,  남면,'00,계,1998,5823,2722,3101
'4884035000,  남면,'05,0 - 4세,1998,154,78,76
'4884035000,  남면,'10,5 - 9세,1998,178,92,86
'4884035000,  남면,'15,10 - 14세,1998,261,115,146
'4884035000,  남면,'20,15 - 19세,1998,524,267,257
'4884035000,  남면,'25,20 - 24세,1998,517,299,218
'4884035000,  남면,'30,25 - 29세,1998,332,218,114
'4884035000,  남면,'35,30 - 34세,1998,200,119,81
'4884035000,  남면,'40,35 - 39세,1998,265,147,118
'4884035000,  남면,'45,40 - 44세,1998,278,124,154
'4884035000,  남면,'50,45 - 49세,1998,317,154,163
'4884035000,  남면,'55,50 - 54세,1998,334,155,179
'4884035000,  남면,'60,55 - 59세,1998,531,230,301
'4884035000,  남면,'65,60 - 64세,1998,541,219,322
'4884035000,  남면,'70,65 - 69세,1998,522,203,319
'4884035000,  남면,'75,70 - 74세,1998,416,159,257
'4884035000,  남면,'80,75 - 79세,1998,226,80,146
'4884035000,  남면,'85,80 - 84세,1998,148,48,100
'4884035000,  남면,'90,85+ ,1998,79,15,64
'4884036000,  서면,'00,계,1998,4880,2309,2571
'4884036000,  서면,'05,0 - 4세,1998,129,76,53
'4884036000,  서면,'10,5 - 9세,1998,118,65,53
'4884036000,  서면,'15,10 - 14세,1998,215,108,107
'4884036000,  서면,'20,15 - 19세,1998,457,218,239
'4884036000,  서면,'25,20 - 24세,1998,482,258,224
'4884036000,  서면,'30,25 - 29세,1998,315,212,103
'4884036000,  서면,'35,30 - 34세,1998,171,101,70
'4884036000,  서면,'40,35 - 39세,1998,214,113,101
'4884036000,  서면,'45,40 - 44세,1998,218,91,127
'4884036000,  서면,'50,45 - 49세,1998,248,119,129
'4884036000,  서면,'55,50 - 54세,1998,246,123,123
'4884036000,  서면,'60,55 - 59세,1998,408,178,230
'4884036000,  서면,'65,60 - 64세,1998,490,202,288
'4884036000,  서면,'70,65 - 69세,1998,440,181,259
'4884036000,  서면,'75,70 - 74세,1998,330,123,207
'4884036000,  서면,'80,75 - 79세,1998,209,80,129
'4884036000,  서면,'85,80 - 84세,1998,112,42,70
'4884036000,  서면,'90,85+ ,1998,78,19,59
'4884037000,  고현면,'00,계,1998,5978,2888,3090
'4884037000,  고현면,'05,0 - 4세,1998,237,124,113
'4884037000,  고현면,'10,5 - 9세,1998,219,118,101
'4884037000,  고현면,'15,10 - 14세,1998,292,145,147
'4884037000,  고현면,'20,15 - 19세,1998,542,288,254
'4884037000,  고현면,'25,20 - 24세,1998,559,312,247
'4884037000,  고현면,'30,25 - 29세,1998,401,258,143
'4884037000,  고현면,'35,30 - 34세,1998,280,157,123
'4884037000,  고현면,'40,35 - 39세,1998,327,176,151
'4884037000,  고현면,'45,40 - 44세,1998,311,158,153
'4884037000,  고현면,'50,45 - 49세,1998,294,141,153
'4884037000,  고현면,'55,50 - 54세,1998,338,163,175
'4884037000,  고현면,'60,55 - 59세,1998,450,208,242
'4884037000,  고현면,'65,60 - 64세,1998,486,207,279
'4884037000,  고현면,'70,65 - 69세,1998,461,169,292
'4884037000,  고현면,'75,70 - 74세,1998,358,137,221
'4884037000,  고현면,'80,75 - 79세,1998,233,82,151
'4884037000,  고현면,'85,80 - 84세,1998,101,27,74
'4884037000,  고현면,'90,85+ ,1998,89,18,71
'4884038000,  설천면,'00,계,1998,4633,2210,2423
'4884038000,  설천면,'05,0 - 4세,1998,154,83,71
'4884038000,  설천면,'10,5 - 9세,1998,177,93,84
'4884038000,  설천면,'15,10 - 14세,1998,221,113,108
'4884038000,  설천면,'20,15 - 19세,1998,408,183,225
'4884038000,  설천면,'25,20 - 24세,1998,418,253,165
'4884038000,  설천면,'30,25 - 29세,1998,283,186,97
'4884038000,  설천면,'35,30 - 34세,1998,188,99,89
'4884038000,  설천면,'40,35 - 39세,1998,245,136,109
'4884038000,  설천면,'45,40 - 44세,1998,219,108,111
'4884038000,  설천면,'50,45 - 49세,1998,252,131,121
'4884038000,  설천면,'55,50 - 54세,1998,233,107,126
'4884038000,  설천면,'60,55 - 59세,1998,376,149,227
'4884038000,  설천면,'65,60 - 64세,1998,428,172,256
'4884038000,  설천면,'70,65 - 69세,1998,398,172,226
'4884038000,  설천면,'75,70 - 74세,1998,312,116,196
'4884038000,  설천면,'80,75 - 79세,1998,177,68,109
'4884038000,  설천면,'85,80 - 84세,1998,84,28,56
'4884038000,  설천면,'90,85+ ,1998,60,13,47
'4884039000,  창선면,'00,계,1998,8611,4194,4417
'4884039000,  창선면,'05,0 - 4세,1998,240,127,113
'4884039000,  창선면,'10,5 - 9세,1998,321,177,144
'4884039000,  창선면,'15,10 - 14세,1998,433,217,216
'4884039000,  창선면,'20,15 - 19세,1998,875,430,445
'4884039000,  창선면,'25,20 - 24세,1998,916,550,366
'4884039000,  창선면,'30,25 - 29세,1998,481,322,159
'4884039000,  창선면,'35,30 - 34세,1998,324,192,132
'4884039000,  창선면,'40,35 - 39세,1998,440,223,217
'4884039000,  창선면,'45,40 - 44세,1998,469,241,228
'4884039000,  창선면,'50,45 - 49세,1998,458,225,233
'4884039000,  창선면,'55,50 - 54세,1998,559,236,323
'4884039000,  창선면,'60,55 - 59세,1998,729,329,400
'4884039000,  창선면,'65,60 - 64세,1998,694,294,400
'4884039000,  창선면,'70,65 - 69세,1998,652,264,388
'4884039000,  창선면,'75,70 - 74세,1998,468,181,287
'4884039000,  창선면,'80,75 - 79세,1998,302,124,178
'4884039000,  창선면,'85,80 - 84세,1998,147,41,106
'4884039000,  창선면,'90,85+ ,1998,103,21,82
'48850, 하동군,'00,계,1998,62007,30445,31562
'48850, 하동군,'05,0 - 4세,1998,2978,1626,1352
'48850, 하동군,'10,5 - 9세,1998,3041,1614,1427
'48850, 하동군,'15,10 - 14세,1998,3500,1789,1711
'48850, 하동군,'20,15 - 19세,1998,5565,2781,2784
'48850, 하동군,'25,20 - 24세,1998,5972,3261,2711
'48850, 하동군,'30,25 - 29세,1998,4868,2889,1979
'48850, 하동군,'35,30 - 34세,1998,3633,2005,1628
'48850, 하동군,'40,35 - 39세,1998,4078,2165,1913
'48850, 하동군,'45,40 - 44세,1998,3626,1913,1713
'48850, 하동군,'50,45 - 49세,1998,3096,1547,1549
'48850, 하동군,'55,50 - 54세,1998,3204,1476,1728
'48850, 하동군,'60,55 - 59세,1998,4353,1873,2480
'48850, 하동군,'65,60 - 64세,1998,4442,1833,2609
'48850, 하동군,'70,65 - 69세,1998,3745,1501,2244
'48850, 하동군,'75,70 - 74세,1998,2784,1143,1641
'48850, 하동군,'80,75 - 79세,1998,1668,622,1046
'48850, 하동군,'85,80 - 84세,1998,862,268,594
'48850, 하동군,'90,85+ ,1998,592,139,453
'4885025000,  하동읍,'00,계,1998,13851,6721,7130
'4885025000,  하동읍,'05,0 - 4세,1998,913,495,418
'4885025000,  하동읍,'10,5 - 9세,1998,994,531,463
'4885025000,  하동읍,'15,10 - 14세,1998,996,512,484
'4885025000,  하동읍,'20,15 - 19세,1998,1261,588,673
'4885025000,  하동읍,'25,20 - 24세,1998,1158,577,581
'4885025000,  하동읍,'30,25 - 29세,1998,1145,615,530
'4885025000,  하동읍,'35,30 - 34세,1998,1086,528,558
'4885025000,  하동읍,'40,35 - 39세,1998,1170,577,593
'4885025000,  하동읍,'45,40 - 44세,1998,911,497,414
'4885025000,  하동읍,'50,45 - 49세,1998,693,361,332
'4885025000,  하동읍,'55,50 - 54세,1998,658,315,343
'4885025000,  하동읍,'60,55 - 59세,1998,760,307,453
'4885025000,  하동읍,'65,60 - 64세,1998,700,292,408
'4885025000,  하동읍,'70,65 - 69세,1998,565,224,341
'4885025000,  하동읍,'75,70 - 74세,1998,448,178,270
'4885025000,  하동읍,'80,75 - 79세,1998,196,68,128
'4885025000,  하동읍,'85,80 - 84세,1998,129,42,87
'4885025000,  하동읍,'90,85+ ,1998,68,14,54
'4885031000,  화개면,'00,계,1998,3938,1923,2015
'4885031000,  화개면,'05,0 - 4세,1998,205,96,109
'4885031000,  화개면,'10,5 - 9세,1998,188,89,99
'4885031000,  화개면,'15,10 - 14세,1998,223,114,109
'4885031000,  화개면,'20,15 - 19세,1998,331,155,176
'4885031000,  화개면,'25,20 - 24세,1998,375,208,167
'4885031000,  화개면,'30,25 - 29세,1998,306,175,131
'4885031000,  화개면,'35,30 - 34세,1998,262,150,112
'4885031000,  화개면,'40,35 - 39세,1998,279,148,131
'4885031000,  화개면,'45,40 - 44세,1998,238,120,118
'4885031000,  화개면,'50,45 - 49세,1998,178,90,88
'4885031000,  화개면,'55,50 - 54세,1998,229,97,132
'4885031000,  화개면,'60,55 - 59세,1998,303,150,153
'4885031000,  화개면,'65,60 - 64세,1998,263,115,148
'4885031000,  화개면,'70,65 - 69세,1998,212,88,124
'4885031000,  화개면,'75,70 - 74세,1998,126,57,69
'4885031000,  화개면,'80,75 - 79세,1998,110,45,65
'4885031000,  화개면,'85,80 - 84세,1998,54,12,42
'4885031000,  화개면,'90,85+ ,1998,56,14,42
'4885032000,  악양면,'00,계,1998,4665,2253,2412
'4885032000,  악양면,'05,0 - 4세,1998,138,76,62
'4885032000,  악양면,'10,5 - 9세,1998,156,77,79
'4885032000,  악양면,'15,10 - 14세,1998,236,121,115
'4885032000,  악양면,'20,15 - 19세,1998,442,218,224
'4885032000,  악양면,'25,20 - 24세,1998,453,259,194
'4885032000,  악양면,'30,25 - 29세,1998,313,203,110
'4885032000,  악양면,'35,30 - 34세,1998,219,122,97
'4885032000,  악양면,'40,35 - 39세,1998,237,129,108
'4885032000,  악양면,'45,40 - 44세,1998,244,138,106
'4885032000,  악양면,'50,45 - 49세,1998,184,91,93
'4885032000,  악양면,'55,50 - 54세,1998,282,102,180
'4885032000,  악양면,'60,55 - 59세,1998,399,187,212
'4885032000,  악양면,'65,60 - 64세,1998,401,159,242
'4885032000,  악양면,'70,65 - 69세,1998,335,140,195
'4885032000,  악양면,'75,70 - 74세,1998,263,107,156
'4885032000,  악양면,'80,75 - 79세,1998,183,73,110
'4885032000,  악양면,'85,80 - 84세,1998,97,30,67
'4885032000,  악양면,'90,85+ ,1998,83,21,62
'4885033000,  적량면,'00,계,1998,2910,1437,1473
'4885033000,  적량면,'05,0 - 4세,1998,110,61,49
'4885033000,  적량면,'10,5 - 9세,1998,84,47,37
'4885033000,  적량면,'15,10 - 14세,1998,122,64,58
'4885033000,  적량면,'20,15 - 19세,1998,249,124,125
'4885033000,  적량면,'25,20 - 24세,1998,303,172,131
'4885033000,  적량면,'30,25 - 29세,1998,233,147,86
'4885033000,  적량면,'35,30 - 34세,1998,127,80,47
'4885033000,  적량면,'40,35 - 39세,1998,151,87,64
'4885033000,  적량면,'45,40 - 44세,1998,124,74,50
'4885033000,  적량면,'50,45 - 49세,1998,146,61,85
'4885033000,  적량면,'55,50 - 54세,1998,164,79,85
'4885033000,  적량면,'60,55 - 59세,1998,256,96,160
'4885033000,  적량면,'65,60 - 64세,1998,286,125,161
'4885033000,  적량면,'70,65 - 69세,1998,226,100,126
'4885033000,  적량면,'75,70 - 74세,1998,163,76,87
'4885033000,  적량면,'80,75 - 79세,1998,96,26,70
'4885033000,  적량면,'85,80 - 84세,1998,34,10,24
'4885033000,  적량면,'90,85+ ,1998,36,8,28
'4885034000,  횡천면,'00,계,1998,2760,1365,1395
'4885034000,  횡천면,'05,0 - 4세,1998,90,50,40
'4885034000,  횡천면,'10,5 - 9세,1998,111,64,47
'4885034000,  횡천면,'15,10 - 14세,1998,145,74,71
'4885034000,  횡천면,'20,15 - 19세,1998,238,122,116
'4885034000,  횡천면,'25,20 - 24세,1998,283,169,114
'4885034000,  횡천면,'30,25 - 29세,1998,188,121,67
'4885034000,  횡천면,'35,30 - 34세,1998,117,67,50
'4885034000,  횡천면,'40,35 - 39세,1998,171,84,87
'4885034000,  횡천면,'45,40 - 44세,1998,148,84,64
'4885034000,  횡천면,'50,45 - 49세,1998,143,73,70
'4885034000,  횡천면,'55,50 - 54세,1998,134,75,59
'4885034000,  횡천면,'60,55 - 59세,1998,205,76,129
'4885034000,  횡천면,'65,60 - 64세,1998,261,108,153
'4885034000,  횡천면,'70,65 - 69세,1998,217,81,136
'4885034000,  횡천면,'75,70 - 74세,1998,145,62,83
'4885034000,  횡천면,'80,75 - 79세,1998,86,32,54
'4885034000,  횡천면,'85,80 - 84세,1998,44,15,29
'4885034000,  횡천면,'90,85+ ,1998,34,8,26
'4885035000,  고전면,'00,계,1998,3545,1733,1812
'4885035000,  고전면,'05,0 - 4세,1998,145,75,70
'4885035000,  고전면,'10,5 - 9세,1998,134,69,65
'4885035000,  고전면,'15,10 - 14세,1998,187,97,90
'4885035000,  고전면,'20,15 - 19세,1998,321,166,155
'4885035000,  고전면,'25,20 - 24세,1998,361,200,161
'4885035000,  고전면,'30,25 - 29세,1998,262,169,93
'4885035000,  고전면,'35,30 - 34세,1998,145,85,60
'4885035000,  고전면,'40,35 - 39세,1998,195,103,92
'4885035000,  고전면,'45,40 - 44세,1998,220,112,108
'4885035000,  고전면,'50,45 - 49세,1998,179,93,86
'4885035000,  고전면,'55,50 - 54세,1998,166,78,88
'4885035000,  고전면,'60,55 - 59세,1998,243,106,137
'4885035000,  고전면,'65,60 - 64세,1998,288,125,163
'4885035000,  고전면,'70,65 - 69세,1998,269,99,170
'4885035000,  고전면,'75,70 - 74세,1998,198,77,121
'4885035000,  고전면,'80,75 - 79세,1998,130,49,81
'4885035000,  고전면,'85,80 - 84세,1998,65,17,48
'4885035000,  고전면,'90,85+ ,1998,37,13,24
'4885036000,  금남면,'00,계,1998,5673,2799,2874
'4885036000,  금남면,'05,0 - 4세,1998,276,156,120
'4885036000,  금남면,'10,5 - 9세,1998,266,143,123
'4885036000,  금남면,'15,10 - 14세,1998,296,153,143
'4885036000,  금남면,'20,15 - 19세,1998,510,260,250
'4885036000,  금남면,'25,20 - 24세,1998,577,323,254
'4885036000,  금남면,'30,25 - 29세,1998,432,256,176
'4885036000,  금남면,'35,30 - 34세,1998,320,171,149
'4885036000,  금남면,'40,35 - 39세,1998,392,216,176
'4885036000,  금남면,'45,40 - 44세,1998,339,181,158
'4885036000,  금남면,'50,45 - 49세,1998,292,137,155
'4885036000,  금남면,'55,50 - 54세,1998,317,153,164
'4885036000,  금남면,'60,55 - 59세,1998,389,164,225
'4885036000,  금남면,'65,60 - 64세,1998,370,166,204
'4885036000,  금남면,'70,65 - 69세,1998,350,139,211
'4885036000,  금남면,'75,70 - 74세,1998,277,102,175
'4885036000,  금남면,'80,75 - 79세,1998,150,51,99
'4885036000,  금남면,'85,80 - 84세,1998,69,22,47
'4885036000,  금남면,'90,85+ ,1998,51,6,45
'4885037000,  진교면,'00,계,1998,7683,3815,3868
'4885037000,  진교면,'05,0 - 4세,1998,431,250,181
'4885037000,  진교면,'10,5 - 9세,1998,449,230,219
'4885037000,  진교면,'15,10 - 14세,1998,445,221,224
'4885037000,  진교면,'20,15 - 19세,1998,683,363,320
'4885037000,  진교면,'25,20 - 24세,1998,725,403,322
'4885037000,  진교면,'30,25 - 29세,1998,651,347,304
'4885037000,  진교면,'35,30 - 34세,1998,513,283,230
'4885037000,  진교면,'40,35 - 39세,1998,557,309,248
'4885037000,  진교면,'45,40 - 44세,1998,477,236,241
'4885037000,  진교면,'50,45 - 49세,1998,400,211,189
'4885037000,  진교면,'55,50 - 54세,1998,332,155,177
'4885037000,  진교면,'60,55 - 59세,1998,492,208,284
'4885037000,  진교면,'65,60 - 64세,1998,468,192,276
'4885037000,  진교면,'70,65 - 69세,1998,445,170,275
'4885037000,  진교면,'75,70 - 74세,1998,299,128,171
'4885037000,  진교면,'80,75 - 79세,1998,179,66,113
'4885037000,  진교면,'85,80 - 84세,1998,86,29,57
'4885037000,  진교면,'90,85+ ,1998,51,14,37
'4885038000,  양보면,'00,계,1998,2790,1332,1458
'4885038000,  양보면,'05,0 - 4세,1998,73,42,31
'4885038000,  양보면,'10,5 - 9세,1998,80,44,36
'4885038000,  양보면,'15,10 - 14세,1998,138,65,73
'4885038000,  양보면,'20,15 - 19세,1998,229,117,112
'4885038000,  양보면,'25,20 - 24세,1998,278,159,119
'4885038000,  양보면,'30,25 - 29세,1998,191,117,74
'4885038000,  양보면,'35,30 - 34세,1998,106,63,43
'4885038000,  양보면,'40,35 - 39세,1998,132,74,58
'4885038000,  양보면,'45,40 - 44세,1998,144,77,67
'4885038000,  양보면,'50,45 - 49세,1998,148,70,78
'4885038000,  양보면,'55,50 - 54세,1998,144,62,82
'4885038000,  양보면,'60,55 - 59세,1998,223,104,119
'4885038000,  양보면,'65,60 - 64세,1998,260,97,163
'4885038000,  양보면,'70,65 - 69세,1998,242,84,158
'4885038000,  양보면,'75,70 - 74세,1998,191,90,101
'4885038000,  양보면,'80,75 - 79세,1998,105,40,65
'4885038000,  양보면,'85,80 - 84세,1998,75,17,58
'4885038000,  양보면,'90,85+ ,1998,31,10,21
'4885039000,  북천면,'00,계,1998,2508,1219,1289
'4885039000,  북천면,'05,0 - 4세,1998,75,34,41
'4885039000,  북천면,'10,5 - 9세,1998,73,42,31
'4885039000,  북천면,'15,10 - 14세,1998,88,46,42
'4885039000,  북천면,'20,15 - 19세,1998,183,101,82
'4885039000,  북천면,'25,20 - 24세,1998,261,128,133
'4885039000,  북천면,'30,25 - 29세,1998,213,147,66
'4885039000,  북천면,'35,30 - 34세,1998,113,76,37
'4885039000,  북천면,'40,35 - 39세,1998,104,62,42
'4885039000,  북천면,'45,40 - 44세,1998,120,54,66
'4885039000,  북천면,'50,45 - 49세,1998,121,61,60
'4885039000,  북천면,'55,50 - 54세,1998,157,69,88
'4885039000,  북천면,'60,55 - 59세,1998,219,93,126
'4885039000,  북천면,'65,60 - 64세,1998,234,90,144
'4885039000,  북천면,'70,65 - 69세,1998,214,92,122
'4885039000,  북천면,'75,70 - 74세,1998,168,65,103
'4885039000,  북천면,'80,75 - 79세,1998,89,34,55
'4885039000,  북천면,'85,80 - 84세,1998,43,18,25
'4885039000,  북천면,'90,85+ ,1998,33,7,26
'4885040000,  청암면,'00,계,1998,2327,1154,1173
'4885040000,  청암면,'05,0 - 4세,1998,103,56,47
'4885040000,  청암면,'10,5 - 9세,1998,99,53,46
'4885040000,  청암면,'15,10 - 14세,1998,117,63,54
'4885040000,  청암면,'20,15 - 19세,1998,216,106,110
'4885040000,  청암면,'25,20 - 24세,1998,237,125,112
'4885040000,  청암면,'30,25 - 29세,1998,160,99,61
'4885040000,  청암면,'35,30 - 34세,1998,117,79,38
'4885040000,  청암면,'40,35 - 39세,1998,130,71,59
'4885040000,  청암면,'45,40 - 44세,1998,152,78,74
'4885040000,  청암면,'50,45 - 49세,1998,118,65,53
'4885040000,  청암면,'55,50 - 54세,1998,127,60,67
'4885040000,  청암면,'60,55 - 59세,1998,175,75,100
'4885040000,  청암면,'65,60 - 64세,1998,173,68,105
'4885040000,  청암면,'70,65 - 69세,1998,166,65,101
'4885040000,  청암면,'75,70 - 74세,1998,103,40,63
'4885040000,  청암면,'80,75 - 79세,1998,77,32,45
'4885040000,  청암면,'85,80 - 84세,1998,35,12,23
'4885040000,  청암면,'90,85+ ,1998,22,7,15
'4885041000,  옥종면,'00,계,1998,4607,2276,2331
'4885041000,  옥종면,'05,0 - 4세,1998,143,83,60
'4885041000,  옥종면,'10,5 - 9세,1998,156,85,71
'4885041000,  옥종면,'15,10 - 14세,1998,225,124,101
'4885041000,  옥종면,'20,15 - 19세,1998,398,193,205
'4885041000,  옥종면,'25,20 - 24세,1998,473,272,201
'4885041000,  옥종면,'30,25 - 29세,1998,366,234,132
'4885041000,  옥종면,'35,30 - 34세,1998,202,121,81
'4885041000,  옥종면,'40,35 - 39세,1998,215,120,95
'4885041000,  옥종면,'45,40 - 44세,1998,238,118,120
'4885041000,  옥종면,'50,45 - 49세,1998,258,117,141
'4885041000,  옥종면,'55,50 - 54세,1998,257,121,136
'4885041000,  옥종면,'60,55 - 59세,1998,373,163,210
'4885041000,  옥종면,'65,60 - 64세,1998,448,179,269
'4885041000,  옥종면,'70,65 - 69세,1998,327,140,187
'4885041000,  옥종면,'75,70 - 74세,1998,237,106,131
'4885041000,  옥종면,'80,75 - 79세,1998,167,64,103
'4885041000,  옥종면,'85,80 - 84세,1998,79,27,52
'4885041000,  옥종면,'90,85+ ,1998,45,9,36
'4885042000,  금성면,'00,계,1998,4750,2418,2332
'4885042000,  금성면,'05,0 - 4세,1998,276,152,124
'4885042000,  금성면,'10,5 - 9세,1998,251,140,111
'4885042000,  금성면,'15,10 - 14세,1998,282,135,147
'4885042000,  금성면,'20,15 - 19세,1998,504,268,236
'4885042000,  금성면,'25,20 - 24세,1998,488,266,222
'4885042000,  금성면,'30,25 - 29세,1998,408,259,149
'4885042000,  금성면,'35,30 - 34세,1998,306,180,126
'4885042000,  금성면,'40,35 - 39세,1998,345,185,160
'4885042000,  금성면,'45,40 - 44세,1998,271,144,127
'4885042000,  금성면,'50,45 - 49세,1998,236,117,119
'4885042000,  금성면,'55,50 - 54세,1998,237,110,127
'4885042000,  금성면,'60,55 - 59세,1998,316,144,172
'4885042000,  금성면,'65,60 - 64세,1998,290,117,173
'4885042000,  금성면,'70,65 - 69세,1998,177,79,98
'4885042000,  금성면,'75,70 - 74세,1998,166,55,111
'4885042000,  금성면,'80,75 - 79세,1998,100,42,58
'4885042000,  금성면,'85,80 - 84세,1998,52,17,35
'4885042000,  금성면,'90,85+ ,1998,45,8,37
'48860, 산청군,'00,계,1998,43456,21281,22175
'48860, 산청군,'05,0 - 4세,1998,1889,1016,873
'48860, 산청군,'10,5 - 9세,1998,1684,879,805
'48860, 산청군,'15,10 - 14세,1998,2003,1035,968
'48860, 산청군,'20,15 - 19세,1998,3510,1814,1696
'48860, 산청군,'25,20 - 24세,1998,4304,2327,1977
'48860, 산청군,'30,25 - 29세,1998,3402,2070,1332
'48860, 산청군,'35,30 - 34세,1998,2369,1351,1018
'48860, 산청군,'40,35 - 39세,1998,2551,1369,1182
'48860, 산청군,'45,40 - 44세,1998,2371,1216,1155
'48860, 산청군,'50,45 - 49세,1998,2273,1126,1147
'48860, 산청군,'55,50 - 54세,1998,2486,1156,1330
'48860, 산청군,'60,55 - 59세,1998,3557,1487,2070
'48860, 산청군,'65,60 - 64세,1998,3725,1576,2149
'48860, 산청군,'70,65 - 69세,1998,2874,1188,1686
'48860, 산청군,'75,70 - 74세,1998,2006,811,1195
'48860, 산청군,'80,75 - 79세,1998,1318,529,789
'48860, 산청군,'85,80 - 84세,1998,671,230,441
'48860, 산청군,'90,85+ ,1998,463,101,362
'4886025000,  산청읍,'00,계,1998,8493,4186,4307
'4886025000,  산청읍,'05,0 - 4세,1998,534,295,239
'4886025000,  산청읍,'10,5 - 9세,1998,522,273,249
'4886025000,  산청읍,'15,10 - 14세,1998,441,233,208
'4886025000,  산청읍,'20,15 - 19세,1998,625,309,316
'4886025000,  산청읍,'25,20 - 24세,1998,726,382,344
'4886025000,  산청읍,'30,25 - 29세,1998,652,333,319
'4886025000,  산청읍,'35,30 - 34세,1998,611,306,305
'4886025000,  산청읍,'40,35 - 39세,1998,610,320,290
'4886025000,  산청읍,'45,40 - 44세,1998,522,281,241
'4886025000,  산청읍,'50,45 - 49세,1998,437,231,206
'4886025000,  산청읍,'55,50 - 54세,1998,462,226,236
'4886025000,  산청읍,'60,55 - 59세,1998,552,251,301
'4886025000,  산청읍,'65,60 - 64세,1998,549,230,319
'4886025000,  산청읍,'70,65 - 69세,1998,437,187,250
'4886025000,  산청읍,'75,70 - 74세,1998,350,153,197
'4886025000,  산청읍,'80,75 - 79세,1998,265,112,153
'4886025000,  산청읍,'85,80 - 84세,1998,133,48,85
'4886025000,  산청읍,'90,85+ ,1998,65,16,49
'4886031000,  차황면,'00,계,1998,2188,1061,1127
'4886031000,  차황면,'05,0 - 4세,1998,48,22,26
'4886031000,  차황면,'10,5 - 9세,1998,70,37,33
'4886031000,  차황면,'15,10 - 14세,1998,92,51,41
'4886031000,  차황면,'20,15 - 19세,1998,180,85,95
'4886031000,  차황면,'25,20 - 24세,1998,233,130,103
'4886031000,  차황면,'30,25 - 29세,1998,129,90,39
'4886031000,  차황면,'35,30 - 34세,1998,83,53,30
'4886031000,  차황면,'40,35 - 39세,1998,87,46,41
'4886031000,  차황면,'45,40 - 44세,1998,98,52,46
'4886031000,  차황면,'50,45 - 49세,1998,127,60,67
'4886031000,  차황면,'55,50 - 54세,1998,138,68,70
'4886031000,  차황면,'60,55 - 59세,1998,175,66,109
'4886031000,  차황면,'65,60 - 64세,1998,255,105,150
'4886031000,  차황면,'70,65 - 69세,1998,186,89,97
'4886031000,  차황면,'75,70 - 74세,1998,141,55,86
'4886031000,  차황면,'80,75 - 79세,1998,79,34,45
'4886031000,  차황면,'85,80 - 84세,1998,37,11,26
'4886031000,  차황면,'90,85+ ,1998,30,7,23
'4886032000,  오부면,'00,계,1998,1546,757,789
'4886032000,  오부면,'05,0 - 4세,1998,34,14,20
'4886032000,  오부면,'10,5 - 9세,1998,25,11,14
'4886032000,  오부면,'15,10 - 14세,1998,42,24,18
'4886032000,  오부면,'20,15 - 19세,1998,126,65,61
'4886032000,  오부면,'25,20 - 24세,1998,169,99,70
'4886032000,  오부면,'30,25 - 29세,1998,114,77,37
'4886032000,  오부면,'35,30 - 34세,1998,54,34,20
'4886032000,  오부면,'40,35 - 39세,1998,58,34,24
'4886032000,  오부면,'45,40 - 44세,1998,62,24,38
'4886032000,  오부면,'50,45 - 49세,1998,72,33,39
'4886032000,  오부면,'55,50 - 54세,1998,96,43,53
'4886032000,  오부면,'60,55 - 59세,1998,161,66,95
'4886032000,  오부면,'65,60 - 64세,1998,216,100,116
'4886032000,  오부면,'70,65 - 69세,1998,137,65,72
'4886032000,  오부면,'75,70 - 74세,1998,84,39,45
'4886032000,  오부면,'80,75 - 79세,1998,50,13,37
'4886032000,  오부면,'85,80 - 84세,1998,30,11,19
'4886032000,  오부면,'90,85+ ,1998,16,5,11
'4886033000,  생초면,'00,계,1998,3606,1699,1907
'4886033000,  생초면,'05,0 - 4세,1998,112,65,47
'4886033000,  생초면,'10,5 - 9세,1998,115,63,52
'4886033000,  생초면,'15,10 - 14세,1998,183,85,98
'4886033000,  생초면,'20,15 - 19세,1998,322,160,162
'4886033000,  생초면,'25,20 - 24세,1998,324,175,149
'4886033000,  생초면,'30,25 - 29세,1998,239,144,95
'4886033000,  생초면,'35,30 - 34세,1998,142,86,56
'4886033000,  생초면,'40,35 - 39세,1998,193,100,93
'4886033000,  생초면,'45,40 - 44세,1998,188,95,93
'4886033000,  생초면,'50,45 - 49세,1998,170,73,97
'4886033000,  생초면,'55,50 - 54세,1998,225,102,123
'4886033000,  생초면,'60,55 - 59세,1998,320,130,190
'4886033000,  생초면,'65,60 - 64세,1998,339,134,205
'4886033000,  생초면,'70,65 - 69세,1998,299,124,175
'4886033000,  생초면,'75,70 - 74세,1998,205,79,126
'4886033000,  생초면,'80,75 - 79세,1998,125,49,76
'4886033000,  생초면,'85,80 - 84세,1998,60,24,36
'4886033000,  생초면,'90,85+ ,1998,45,11,34
'4886034000,  금서면,'00,계,1998,3333,1610,1723
'4886034000,  금서면,'05,0 - 4세,1998,91,48,43
'4886034000,  금서면,'10,5 - 9세,1998,91,51,40
'4886034000,  금서면,'15,10 - 14세,1998,193,91,102
'4886034000,  금서면,'20,15 - 19세,1998,248,123,125
'4886034000,  금서면,'25,20 - 24세,1998,308,175,133
'4886034000,  금서면,'30,25 - 29세,1998,219,143,76
'4886034000,  금서면,'35,30 - 34세,1998,170,110,60
'4886034000,  금서면,'40,35 - 39세,1998,179,87,92
'4886034000,  금서면,'45,40 - 44세,1998,157,78,79
'4886034000,  금서면,'50,45 - 49세,1998,154,78,76
'4886034000,  금서면,'55,50 - 54세,1998,188,72,116
'4886034000,  금서면,'60,55 - 59세,1998,351,140,211
'4886034000,  금서면,'65,60 - 64세,1998,336,165,171
'4886034000,  금서면,'70,65 - 69세,1998,246,104,142
'4886034000,  금서면,'75,70 - 74세,1998,168,71,97
'4886034000,  금서면,'80,75 - 79세,1998,125,49,76
'4886034000,  금서면,'85,80 - 84세,1998,62,17,45
'4886034000,  금서면,'90,85+ ,1998,47,8,39
'4886035000,  삼장면,'00,계,1998,2139,1037,1102
'4886035000,  삼장면,'05,0 - 4세,1998,68,39,29
'4886035000,  삼장면,'10,5 - 9세,1998,49,24,25
'4886035000,  삼장면,'15,10 - 14세,1998,91,49,42
'4886035000,  삼장면,'20,15 - 19세,1998,183,100,83
'4886035000,  삼장면,'25,20 - 24세,1998,234,115,119
'4886035000,  삼장면,'30,25 - 29세,1998,168,106,62
'4886035000,  삼장면,'35,30 - 34세,1998,105,66,39
'4886035000,  삼장면,'40,35 - 39세,1998,107,57,50
'4886035000,  삼장면,'45,40 - 44세,1998,122,60,62
'4886035000,  삼장면,'50,45 - 49세,1998,134,70,64
'4886035000,  삼장면,'55,50 - 54세,1998,143,68,75
'4886035000,  삼장면,'60,55 - 59세,1998,218,79,139
'4886035000,  삼장면,'65,60 - 64세,1998,166,79,87
'4886035000,  삼장면,'70,65 - 69세,1998,110,46,64
'4886035000,  삼장면,'75,70 - 74세,1998,86,27,59
'4886035000,  삼장면,'80,75 - 79세,1998,70,26,44
'4886035000,  삼장면,'85,80 - 84세,1998,48,20,28
'4886035000,  삼장면,'90,85+ ,1998,37,6,31
'4886036000,  시천면,'00,계,1998,4629,2305,2324
'4886036000,  시천면,'05,0 - 4세,1998,266,146,120
'4886036000,  시천면,'10,5 - 9세,1998,192,112,80
'4886036000,  시천면,'15,10 - 14세,1998,206,105,101
'4886036000,  시천면,'20,15 - 19세,1998,387,189,198
'4886036000,  시천면,'25,20 - 24세,1998,514,272,242
'4886036000,  시천면,'30,25 - 29세,1998,404,251,153
'4886036000,  시천면,'35,30 - 34세,1998,308,167,141
'4886036000,  시천면,'40,35 - 39세,1998,291,162,129
'4886036000,  시천면,'45,40 - 44세,1998,271,132,139
'4886036000,  시천면,'50,45 - 49세,1998,220,112,108
'4886036000,  시천면,'55,50 - 54세,1998,261,120,141
'4886036000,  시천면,'60,55 - 59세,1998,351,149,202
'4886036000,  시천면,'65,60 - 64세,1998,314,143,171
'4886036000,  시천면,'70,65 - 69세,1998,243,98,145
'4886036000,  시천면,'75,70 - 74세,1998,180,64,116
'4886036000,  시천면,'80,75 - 79세,1998,125,52,73
'4886036000,  시천면,'85,80 - 84세,1998,47,20,27
'4886036000,  시천면,'90,85+ ,1998,49,11,38
'4886037000,  단성면,'00,계,1998,6750,3347,3403
'4886037000,  단성면,'05,0 - 4세,1998,243,123,120
'4886037000,  단성면,'10,5 - 9세,1998,226,115,111
'4886037000,  단성면,'15,10 - 14세,1998,281,143,138
'4886037000,  단성면,'20,15 - 19세,1998,605,333,272
'4886037000,  단성면,'25,20 - 24세,1998,721,377,344
'4886037000,  단성면,'30,25 - 29세,1998,562,372,190
'4886037000,  단성면,'35,30 - 34세,1998,308,175,133
'4886037000,  단성면,'40,35 - 39세,1998,371,202,169
'4886037000,  단성면,'45,40 - 44세,1998,371,191,180
'4886037000,  단성면,'50,45 - 49세,1998,365,173,192
'4886037000,  단성면,'55,50 - 54세,1998,415,205,210
'4886037000,  단성면,'60,55 - 59세,1998,560,255,305
'4886037000,  단성면,'65,60 - 64세,1998,575,234,341
'4886037000,  단성면,'70,65 - 69세,1998,466,182,284
'4886037000,  단성면,'75,70 - 74세,1998,313,138,175
'4886037000,  단성면,'80,75 - 79세,1998,194,86,108
'4886037000,  단성면,'85,80 - 84세,1998,112,31,81
'4886037000,  단성면,'90,85+ ,1998,62,12,50
'4886038000,  신안면,'00,계,1998,5768,2887,2881
'4886038000,  신안면,'05,0 - 4세,1998,342,185,157
'4886038000,  신안면,'10,5 - 9세,1998,264,122,142
'4886038000,  신안면,'15,10 - 14세,1998,275,153,122
'4886038000,  신안면,'20,15 - 19세,1998,445,232,213
'4886038000,  신안면,'25,20 - 24세,1998,535,304,231
'4886038000,  신안면,'30,25 - 29세,1998,508,295,213
'4886038000,  신안면,'35,30 - 34세,1998,393,238,155
'4886038000,  신안면,'40,35 - 39세,1998,399,220,179
'4886038000,  신안면,'45,40 - 44세,1998,328,173,155
'4886038000,  신안면,'50,45 - 49세,1998,321,160,161
'4886038000,  신안면,'55,50 - 54세,1998,264,128,136
'4886038000,  신안면,'60,55 - 59세,1998,408,167,241
'4886038000,  신안면,'65,60 - 64세,1998,473,198,275
'4886038000,  신안면,'70,65 - 69세,1998,364,139,225
'4886038000,  신안면,'75,70 - 74세,1998,216,88,128
'4886038000,  신안면,'80,75 - 79세,1998,125,47,78
'4886038000,  신안면,'85,80 - 84세,1998,66,23,43
'4886038000,  신안면,'90,85+ ,1998,42,15,27
'4886039000,  생비량면,'00,계,1998,1865,897,968
'4886039000,  생비량면,'05,0 - 4세,1998,58,30,28
'4886039000,  생비량면,'10,5 - 9세,1998,38,21,17
'4886039000,  생비량면,'15,10 - 14세,1998,60,32,28
'4886039000,  생비량면,'20,15 - 19세,1998,176,97,79
'4886039000,  생비량면,'25,20 - 24세,1998,215,127,88
'4886039000,  생비량면,'30,25 - 29세,1998,147,93,54
'4886039000,  생비량면,'35,30 - 34세,1998,66,41,25
'4886039000,  생비량면,'40,35 - 39세,1998,95,55,40
'4886039000,  생비량면,'45,40 - 44세,1998,109,55,54
'4886039000,  생비량면,'50,45 - 49세,1998,112,56,56
'4886039000,  생비량면,'55,50 - 54세,1998,114,44,70
'4886039000,  생비량면,'60,55 - 59세,1998,176,69,107
'4886039000,  생비량면,'65,60 - 64세,1998,178,74,104
'4886039000,  생비량면,'70,65 - 69세,1998,129,48,81
'4886039000,  생비량면,'75,70 - 74세,1998,99,32,67
'4886039000,  생비량면,'80,75 - 79세,1998,55,17,38
'4886039000,  생비량면,'85,80 - 84세,1998,18,4,14
'4886039000,  생비량면,'90,85+ ,1998,20,2,18
'4886040000,  신등면,'00,계,1998,3139,1495,1644
'4886040000,  신등면,'05,0 - 4세,1998,93,49,44
'4886040000,  신등면,'10,5 - 9세,1998,92,50,42
'4886040000,  신등면,'15,10 - 14세,1998,139,69,70
'4886040000,  신등면,'20,15 - 19세,1998,213,121,92
'4886040000,  신등면,'25,20 - 24세,1998,325,171,154
'4886040000,  신등면,'30,25 - 29세,1998,260,166,94
'4886040000,  신등면,'35,30 - 34세,1998,129,75,54
'4886040000,  신등면,'40,35 - 39세,1998,161,86,75
'4886040000,  신등면,'45,40 - 44세,1998,143,75,68
'4886040000,  신등면,'50,45 - 49세,1998,161,80,81
'4886040000,  신등면,'55,50 - 54세,1998,180,80,100
'4886040000,  신등면,'60,55 - 59세,1998,285,115,170
'4886040000,  신등면,'65,60 - 64세,1998,324,114,210
'4886040000,  신등면,'70,65 - 69세,1998,257,106,151
'4886040000,  신등면,'75,70 - 74세,1998,164,65,99
'4886040000,  신등면,'80,75 - 79세,1998,105,44,61
'4886040000,  신등면,'85,80 - 84세,1998,58,21,37
'4886040000,  신등면,'90,85+ ,1998,50,8,42
'48870, 함양군,'00,계,1998,48716,23730,24986
'48870, 함양군,'05,0 - 4세,1998,2275,1230,1045
'48870, 함양군,'10,5 - 9세,1998,2244,1186,1058
'48870, 함양군,'15,10 - 14세,1998,2727,1407,1320
'48870, 함양군,'20,15 - 19세,1998,4414,2201,2213
'48870, 함양군,'25,20 - 24세,1998,4415,2530,1885
'48870, 함양군,'30,25 - 29세,1998,3292,1967,1325
'48870, 함양군,'35,30 - 34세,1998,2586,1407,1179
'48870, 함양군,'40,35 - 39세,1998,2971,1518,1453
'48870, 함양군,'45,40 - 44세,1998,2841,1427,1414
'48870, 함양군,'50,45 - 49세,1998,2479,1164,1315
'48870, 함양군,'55,50 - 54세,1998,2627,1145,1482
'48870, 함양군,'60,55 - 59세,1998,3923,1652,2271
'48870, 함양군,'65,60 - 64세,1998,3920,1703,2217
'48870, 함양군,'70,65 - 69세,1998,3025,1189,1836
'48870, 함양군,'75,70 - 74세,1998,2256,976,1280
'48870, 함양군,'80,75 - 79세,1998,1448,598,850
'48870, 함양군,'85,80 - 84세,1998,759,298,461
'48870, 함양군,'90,85+ ,1998,514,132,382
'4887025000,  함양읍,'00,계,1998,19624,9603,10021
'4887025000,  함양읍,'05,0 - 4세,1998,1280,689,591
'4887025000,  함양읍,'10,5 - 9세,1998,1310,688,622
'4887025000,  함양읍,'15,10 - 14세,1998,1406,719,687
'4887025000,  함양읍,'20,15 - 19세,1998,1880,918,962
'4887025000,  함양읍,'25,20 - 24세,1998,1725,928,797
'4887025000,  함양읍,'30,25 - 29세,1998,1567,840,727
'4887025000,  함양읍,'35,30 - 34세,1998,1444,739,705
'4887025000,  함양읍,'40,35 - 39세,1998,1519,747,772
'4887025000,  함양읍,'45,40 - 44세,1998,1310,664,646
'4887025000,  함양읍,'50,45 - 49세,1998,1034,508,526
'4887025000,  함양읍,'55,50 - 54세,1998,915,425,490
'4887025000,  함양읍,'60,55 - 59세,1998,1169,506,663
'4887025000,  함양읍,'65,60 - 64세,1998,1071,477,594
'4887025000,  함양읍,'70,65 - 69세,1998,782,304,478
'4887025000,  함양읍,'75,70 - 74세,1998,547,225,322
'4887025000,  함양읍,'80,75 - 79세,1998,362,131,231
'4887025000,  함양읍,'85,80 - 84세,1998,177,61,116
'4887025000,  함양읍,'90,85+ ,1998,126,34,92
'4887031000,  마천면,'00,계,1998,2746,1358,1388
'4887031000,  마천면,'05,0 - 4세,1998,98,50,48
'4887031000,  마천면,'10,5 - 9세,1998,99,57,42
'4887031000,  마천면,'15,10 - 14세,1998,125,61,64
'4887031000,  마천면,'20,15 - 19세,1998,223,116,107
'4887031000,  마천면,'25,20 - 24세,1998,266,159,107
'4887031000,  마천면,'30,25 - 29세,1998,169,106,63
'4887031000,  마천면,'35,30 - 34세,1998,129,81,48
'4887031000,  마천면,'40,35 - 39세,1998,142,81,61
'4887031000,  마천면,'45,40 - 44세,1998,159,83,76
'4887031000,  마천면,'50,45 - 49세,1998,129,68,61
'4887031000,  마천면,'55,50 - 54세,1998,176,66,110
'4887031000,  마천면,'60,55 - 59세,1998,267,118,149
'4887031000,  마천면,'65,60 - 64세,1998,258,113,145
'4887031000,  마천면,'70,65 - 69세,1998,159,57,102
'4887031000,  마천면,'75,70 - 74세,1998,150,62,88
'4887031000,  마천면,'80,75 - 79세,1998,96,44,52
'4887031000,  마천면,'85,80 - 84세,1998,60,26,34
'4887031000,  마천면,'90,85+ ,1998,41,10,31
'4887032000,  휴천면,'00,계,1998,1978,982,996
'4887032000,  휴천면,'05,0 - 4세,1998,56,27,29
'4887032000,  휴천면,'10,5 - 9세,1998,42,19,23
'4887032000,  휴천면,'15,10 - 14세,1998,63,28,35
'4887032000,  휴천면,'20,15 - 19세,1998,150,83,67
'4887032000,  휴천면,'25,20 - 24세,1998,205,133,72
'4887032000,  휴천면,'30,25 - 29세,1998,138,95,43
'4887032000,  휴천면,'35,30 - 34세,1998,72,54,18
'4887032000,  휴천면,'40,35 - 39세,1998,102,57,45
'4887032000,  휴천면,'45,40 - 44세,1998,88,42,46
'4887032000,  휴천면,'50,45 - 49세,1998,88,50,38
'4887032000,  휴천면,'55,50 - 54세,1998,114,42,72
'4887032000,  휴천면,'60,55 - 59세,1998,233,93,140
'4887032000,  휴천면,'65,60 - 64세,1998,217,100,117
'4887032000,  휴천면,'70,65 - 69세,1998,161,69,92
'4887032000,  휴천면,'75,70 - 74세,1998,107,43,64
'4887032000,  휴천면,'80,75 - 79세,1998,73,25,48
'4887032000,  휴천면,'85,80 - 84세,1998,49,19,30
'4887032000,  휴천면,'90,85+ ,1998,20,3,17
'4887033000,  유림면,'00,계,1998,2553,1236,1317
'4887033000,  유림면,'05,0 - 4세,1998,77,48,29
'4887033000,  유림면,'10,5 - 9세,1998,66,36,30
'4887033000,  유림면,'15,10 - 14세,1998,103,50,53
'4887033000,  유림면,'20,15 - 19세,1998,193,94,99
'4887033000,  유림면,'25,20 - 24세,1998,222,136,86
'4887033000,  유림면,'30,25 - 29세,1998,145,102,43
'4887033000,  유림면,'35,30 - 34세,1998,79,45,34
'4887033000,  유림면,'40,35 - 39세,1998,116,65,51
'4887033000,  유림면,'45,40 - 44세,1998,100,48,52
'4887033000,  유림면,'50,45 - 49세,1998,111,47,64
'4887033000,  유림면,'55,50 - 54세,1998,157,74,83
'4887033000,  유림면,'60,55 - 59세,1998,266,118,148
'4887033000,  유림면,'65,60 - 64세,1998,289,125,164
'4887033000,  유림면,'70,65 - 69세,1998,212,73,139
'4887033000,  유림면,'75,70 - 74세,1998,193,83,110
'4887033000,  유림면,'80,75 - 79세,1998,115,54,61
'4887033000,  유림면,'85,80 - 84세,1998,62,26,36
'4887033000,  유림면,'90,85+ ,1998,47,12,35
'4887034000,  수동면,'00,계,1998,3707,1807,1900
'4887034000,  수동면,'05,0 - 4세,1998,153,76,77
'4887034000,  수동면,'10,5 - 9세,1998,160,81,79
'4887034000,  수동면,'15,10 - 14세,1998,173,85,88
'4887034000,  수동면,'20,15 - 19세,1998,351,195,156
'4887034000,  수동면,'25,20 - 24세,1998,342,201,141
'4887034000,  수동면,'30,25 - 29세,1998,243,138,105
'4887034000,  수동면,'35,30 - 34세,1998,156,89,67
'4887034000,  수동면,'40,35 - 39세,1998,209,104,105
'4887034000,  수동면,'45,40 - 44세,1998,205,107,98
'4887034000,  수동면,'50,45 - 49세,1998,189,87,102
'4887034000,  수동면,'55,50 - 54세,1998,217,94,123
'4887034000,  수동면,'60,55 - 59세,1998,296,116,180
'4887034000,  수동면,'65,60 - 64세,1998,334,144,190
'4887034000,  수동면,'70,65 - 69세,1998,258,100,158
'4887034000,  수동면,'75,70 - 74세,1998,197,91,106
'4887034000,  수동면,'80,75 - 79세,1998,119,52,67
'4887034000,  수동면,'85,80 - 84세,1998,55,22,33
'4887034000,  수동면,'90,85+ ,1998,50,25,25
'4887035000,  지곡면,'00,계,1998,2824,1361,1463
'4887035000,  지곡면,'05,0 - 4세,1998,80,42,38
'4887035000,  지곡면,'10,5 - 9세,1998,54,24,30
'4887035000,  지곡면,'15,10 - 14세,1998,102,62,40
'4887035000,  지곡면,'20,15 - 19세,1998,252,133,119
'4887035000,  지곡면,'25,20 - 24세,1998,273,152,121
'4887035000,  지곡면,'30,25 - 29세,1998,164,114,50
'4887035000,  지곡면,'35,30 - 34세,1998,83,52,31
'4887035000,  지곡면,'40,35 - 39세,1998,96,51,45
'4887035000,  지곡면,'45,40 - 44세,1998,128,62,66
'4887035000,  지곡면,'50,45 - 49세,1998,149,66,83
'4887035000,  지곡면,'55,50 - 54세,1998,190,71,119
'4887035000,  지곡면,'60,55 - 59세,1998,308,135,173
'4887035000,  지곡면,'65,60 - 64세,1998,262,110,152
'4887035000,  지곡면,'70,65 - 69세,1998,265,113,152
'4887035000,  지곡면,'75,70 - 74세,1998,174,74,100
'4887035000,  지곡면,'80,75 - 79세,1998,135,61,74
'4887035000,  지곡면,'85,80 - 84세,1998,70,31,39
'4887035000,  지곡면,'90,85+ ,1998,39,8,31
'4887036000,  안의면,'00,계,1998,6998,3414,3584
'4887036000,  안의면,'05,0 - 4세,1998,273,162,111
'4887036000,  안의면,'10,5 - 9세,1998,263,144,119
'4887036000,  안의면,'15,10 - 14세,1998,362,202,160
'4887036000,  안의면,'20,15 - 19세,1998,611,302,309
'4887036000,  안의면,'25,20 - 24세,1998,611,357,254
'4887036000,  안의면,'30,25 - 29세,1998,460,297,163
'4887036000,  안의면,'35,30 - 34세,1998,314,171,143
'4887036000,  안의면,'40,35 - 39세,1998,403,207,196
'4887036000,  안의면,'45,40 - 44세,1998,389,183,206
'4887036000,  안의면,'50,45 - 49세,1998,392,170,222
'4887036000,  안의면,'55,50 - 54세,1998,381,169,212
'4887036000,  안의면,'60,55 - 59세,1998,588,246,342
'4887036000,  안의면,'65,60 - 64세,1998,610,268,342
'4887036000,  안의면,'70,65 - 69세,1998,520,203,317
'4887036000,  안의면,'75,70 - 74세,1998,405,185,220
'4887036000,  안의면,'80,75 - 79세,1998,218,90,128
'4887036000,  안의면,'85,80 - 84세,1998,117,41,76
'4887036000,  안의면,'90,85+ ,1998,81,17,64
'4887037000,  서하면,'00,계,1998,1937,945,992
'4887037000,  서하면,'05,0 - 4세,1998,57,29,28
'4887037000,  서하면,'10,5 - 9세,1998,53,34,19
'4887037000,  서하면,'15,10 - 14세,1998,112,54,58
'4887037000,  서하면,'20,15 - 19세,1998,169,83,86
'4887037000,  서하면,'25,20 - 24세,1998,173,110,63
'4887037000,  서하면,'30,25 - 29세,1998,90,60,30
'4887037000,  서하면,'35,30 - 34세,1998,76,42,34
'4887037000,  서하면,'40,35 - 39세,1998,94,52,42
'4887037000,  서하면,'45,40 - 44세,1998,109,58,51
'4887037000,  서하면,'50,45 - 49세,1998,90,40,50
'4887037000,  서하면,'55,50 - 54세,1998,122,47,75
'4887037000,  서하면,'60,55 - 59세,1998,190,81,109
'4887037000,  서하면,'65,60 - 64세,1998,207,95,112
'4887037000,  서하면,'70,65 - 69세,1998,141,53,88
'4887037000,  서하면,'75,70 - 74세,1998,105,54,51
'4887037000,  서하면,'80,75 - 79세,1998,77,29,48
'4887037000,  서하면,'85,80 - 84세,1998,48,19,29
'4887037000,  서하면,'90,85+ ,1998,24,5,19
'4887038000,  서상면,'00,계,1998,2642,1244,1398
'4887038000,  서상면,'05,0 - 4세,1998,95,53,42
'4887038000,  서상면,'10,5 - 9세,1998,89,44,45
'4887038000,  서상면,'15,10 - 14세,1998,132,65,67
'4887038000,  서상면,'20,15 - 19세,1998,256,120,136
'4887038000,  서상면,'25,20 - 24세,1998,228,128,100
'4887038000,  서상면,'30,25 - 29세,1998,140,97,43
'4887038000,  서상면,'35,30 - 34세,1998,101,51,50
'4887038000,  서상면,'40,35 - 39세,1998,135,68,67
'4887038000,  서상면,'45,40 - 44세,1998,155,74,81
'4887038000,  서상면,'50,45 - 49세,1998,118,59,59
'4887038000,  서상면,'55,50 - 54세,1998,157,66,91
'4887038000,  서상면,'60,55 - 59세,1998,253,103,150
'4887038000,  서상면,'65,60 - 64세,1998,271,111,160
'4887038000,  서상면,'70,65 - 69세,1998,189,79,110
'4887038000,  서상면,'75,70 - 74세,1998,149,63,86
'4887038000,  서상면,'80,75 - 79세,1998,97,37,60
'4887038000,  서상면,'85,80 - 84세,1998,50,20,30
'4887038000,  서상면,'90,85+ ,1998,27,6,21
'4887039000,  백전면,'00,계,1998,1943,936,1007
'4887039000,  백전면,'05,0 - 4세,1998,54,28,26
'4887039000,  백전면,'10,5 - 9세,1998,65,32,33
'4887039000,  백전면,'15,10 - 14세,1998,72,38,34
'4887039000,  백전면,'20,15 - 19세,1998,185,93,92
'4887039000,  백전면,'25,20 - 24세,1998,203,118,85
'4887039000,  백전면,'30,25 - 29세,1998,75,49,26
'4887039000,  백전면,'35,30 - 34세,1998,59,39,20
'4887039000,  백전면,'40,35 - 39세,1998,83,46,37
'4887039000,  백전면,'45,40 - 44세,1998,108,57,51
'4887039000,  백전면,'50,45 - 49세,1998,100,39,61
'4887039000,  백전면,'55,50 - 54세,1998,113,56,57
'4887039000,  백전면,'60,55 - 59세,1998,180,74,106
'4887039000,  백전면,'65,60 - 64세,1998,213,85,128
'4887039000,  백전면,'70,65 - 69세,1998,171,69,102
'4887039000,  백전면,'75,70 - 74세,1998,124,55,69
'4887039000,  백전면,'80,75 - 79세,1998,77,35,42
'4887039000,  백전면,'85,80 - 84세,1998,31,16,15
'4887039000,  백전면,'90,85+ ,1998,30,7,23
'4887040000,  병곡면,'00,계,1998,1764,844,920
'4887040000,  병곡면,'05,0 - 4세,1998,52,26,26
'4887040000,  병곡면,'10,5 - 9세,1998,43,27,16
'4887040000,  병곡면,'15,10 - 14세,1998,77,43,34
'4887040000,  병곡면,'20,15 - 19세,1998,144,64,80
'4887040000,  병곡면,'25,20 - 24세,1998,167,108,59
'4887040000,  병곡면,'30,25 - 29세,1998,101,69,32
'4887040000,  병곡면,'35,30 - 34세,1998,73,44,29
'4887040000,  병곡면,'40,35 - 39세,1998,72,40,32
'4887040000,  병곡면,'45,40 - 44세,1998,90,49,41
'4887040000,  병곡면,'50,45 - 49세,1998,79,30,49
'4887040000,  병곡면,'55,50 - 54세,1998,85,35,50
'4887040000,  병곡면,'60,55 - 59세,1998,173,62,111
'4887040000,  병곡면,'65,60 - 64세,1998,188,75,113
'4887040000,  병곡면,'70,65 - 69세,1998,167,69,98
'4887040000,  병곡면,'75,70 - 74세,1998,105,41,64
'4887040000,  병곡면,'80,75 - 79세,1998,79,40,39
'4887040000,  병곡면,'85,80 - 84세,1998,40,17,23
'4887040000,  병곡면,'90,85+ ,1998,29,5,24
'48880, 거창군,'00,계,1998,72096,35383,36713
'48880, 거창군,'05,0 - 4세,1998,3819,2062,1757
'48880, 거창군,'10,5 - 9세,1998,4003,2201,1802
'48880, 거창군,'15,10 - 14세,1998,4490,2417,2073
'48880, 거창군,'20,15 - 19세,1998,6868,3526,3342
'48880, 거창군,'25,20 - 24세,1998,6297,3587,2710
'48880, 거창군,'30,25 - 29세,1998,5075,2871,2204
'48880, 거창군,'35,30 - 34세,1998,4388,2276,2112
'48880, 거창군,'40,35 - 39세,1998,5139,2553,2586
'48880, 거창군,'45,40 - 44세,1998,4678,2369,2309
'48880, 거창군,'50,45 - 49세,1998,3813,1848,1965
'48880, 거창군,'55,50 - 54세,1998,3663,1657,2006
'48880, 거창군,'60,55 - 59세,1998,4930,2147,2783
'48880, 거창군,'65,60 - 64세,1998,4825,2001,2824
'48880, 거창군,'70,65 - 69세,1998,3842,1525,2317
'48880, 거창군,'75,70 - 74세,1998,2774,1135,1639
'48880, 거창군,'80,75 - 79세,1998,1855,735,1120
'48880, 거창군,'85,80 - 84세,1998,1000,326,674
'48880, 거창군,'90,85+ ,1998,637,147,490
'4888025000,  거창읍,'00,계,1998,40319,19859,20460
'4888025000,  거창읍,'05,0 - 4세,1998,2764,1527,1237
'4888025000,  거창읍,'10,5 - 9세,1998,2984,1642,1342
'4888025000,  거창읍,'15,10 - 14세,1998,3093,1652,1441
'4888025000,  거창읍,'20,15 - 19세,1998,4127,2090,2037
'4888025000,  거창읍,'25,20 - 24세,1998,3369,1833,1536
'4888025000,  거창읍,'30,25 - 29세,1998,3176,1625,1551
'4888025000,  거창읍,'35,30 - 34세,1998,3072,1473,1599
'4888025000,  거창읍,'40,35 - 39세,1998,3567,1705,1862
'4888025000,  거창읍,'45,40 - 44세,1998,3095,1559,1536
'4888025000,  거창읍,'50,45 - 49세,1998,2223,1091,1132
'4888025000,  거창읍,'55,50 - 54세,1998,1865,872,993
'4888025000,  거창읍,'60,55 - 59세,1998,1950,894,1056
'4888025000,  거창읍,'65,60 - 64세,1998,1673,696,977
'4888025000,  거창읍,'70,65 - 69세,1998,1288,486,802
'4888025000,  거창읍,'75,70 - 74세,1998,915,339,576
'4888025000,  거창읍,'80,75 - 79세,1998,643,233,410
'4888025000,  거창읍,'85,80 - 84세,1998,314,94,220
'4888025000,  거창읍,'90,85+ ,1998,201,48,153
'4888031000,  주상면,'00,계,1998,2362,1161,1201
'4888031000,  주상면,'05,0 - 4세,1998,54,39,15
'4888031000,  주상면,'10,5 - 9세,1998,74,36,38
'4888031000,  주상면,'15,10 - 14세,1998,114,68,46
'4888031000,  주상면,'20,15 - 19세,1998,198,107,91
'4888031000,  주상면,'25,20 - 24세,1998,229,128,101
'4888031000,  주상면,'30,25 - 29세,1998,137,87,50
'4888031000,  주상면,'35,30 - 34세,1998,94,59,35
'4888031000,  주상면,'40,35 - 39세,1998,105,58,47
'4888031000,  주상면,'45,40 - 44세,1998,136,72,64
'4888031000,  주상면,'50,45 - 49세,1998,107,48,59
'4888031000,  주상면,'55,50 - 54세,1998,128,64,64
'4888031000,  주상면,'60,55 - 59세,1998,204,78,126
'4888031000,  주상면,'65,60 - 64세,1998,259,115,144
'4888031000,  주상면,'70,65 - 69세,1998,196,83,113
'4888031000,  주상면,'75,70 - 74세,1998,143,50,93
'4888031000,  주상면,'80,75 - 79세,1998,102,42,60
'4888031000,  주상면,'85,80 - 84세,1998,54,21,33
'4888031000,  주상면,'90,85+ ,1998,28,6,22
'4888032000,  웅양면,'00,계,1998,2770,1363,1407
'4888032000,  웅양면,'05,0 - 4세,1998,118,59,59
'4888032000,  웅양면,'10,5 - 9세,1998,92,51,41
'4888032000,  웅양면,'15,10 - 14세,1998,116,68,48
'4888032000,  웅양면,'20,15 - 19세,1998,227,108,119
'4888032000,  웅양면,'25,20 - 24세,1998,245,162,83
'4888032000,  웅양면,'30,25 - 29세,1998,169,107,62
'4888032000,  웅양면,'35,30 - 34세,1998,129,87,42
'4888032000,  웅양면,'40,35 - 39세,1998,129,70,59
'4888032000,  웅양면,'45,40 - 44세,1998,144,75,69
'4888032000,  웅양면,'50,45 - 49세,1998,123,62,61
'4888032000,  웅양면,'55,50 - 54세,1998,158,62,96
'4888032000,  웅양면,'60,55 - 59세,1998,267,99,168
'4888032000,  웅양면,'65,60 - 64세,1998,275,125,150
'4888032000,  웅양면,'70,65 - 69세,1998,224,100,124
'4888032000,  웅양면,'75,70 - 74세,1998,158,64,94
'4888032000,  웅양면,'80,75 - 79세,1998,104,42,62
'4888032000,  웅양면,'85,80 - 84세,1998,58,12,46
'4888032000,  웅양면,'90,85+ ,1998,34,10,24
'4888033000,  고제면,'00,계,1998,1911,927,984
'4888033000,  고제면,'05,0 - 4세,1998,76,34,42
'4888033000,  고제면,'10,5 - 9세,1998,67,31,36
'4888033000,  고제면,'15,10 - 14세,1998,73,38,35
'4888033000,  고제면,'20,15 - 19세,1998,163,87,76
'4888033000,  고제면,'25,20 - 24세,1998,167,89,78
'4888033000,  고제면,'30,25 - 29세,1998,100,68,32
'4888033000,  고제면,'35,30 - 34세,1998,92,56,36
'4888033000,  고제면,'40,35 - 39세,1998,94,57,37
'4888033000,  고제면,'45,40 - 44세,1998,87,34,53
'4888033000,  고제면,'50,45 - 49세,1998,114,58,56
'4888033000,  고제면,'55,50 - 54세,1998,98,44,54
'4888033000,  고제면,'60,55 - 59세,1998,183,87,96
'4888033000,  고제면,'65,60 - 64세,1998,174,62,112
'4888033000,  고제면,'70,65 - 69세,1998,164,65,99
'4888033000,  고제면,'75,70 - 74세,1998,124,67,57
'4888033000,  고제면,'80,75 - 79세,1998,74,32,42
'4888033000,  고제면,'85,80 - 84세,1998,38,13,25
'4888033000,  고제면,'90,85+ ,1998,23,5,18
'4888034000,  북상면,'00,계,1998,2061,1021,1040
'4888034000,  북상면,'05,0 - 4세,1998,52,27,25
'4888034000,  북상면,'10,5 - 9세,1998,72,42,30
'4888034000,  북상면,'15,10 - 14세,1998,78,38,40
'4888034000,  북상면,'20,15 - 19세,1998,147,80,67
'4888034000,  북상면,'25,20 - 24세,1998,211,139,72
'4888034000,  북상면,'30,25 - 29세,1998,126,83,43
'4888034000,  북상면,'35,30 - 34세,1998,78,49,29
'4888034000,  북상면,'40,35 - 39세,1998,94,52,42
'4888034000,  북상면,'45,40 - 44세,1998,96,51,45
'4888034000,  북상면,'50,45 - 49세,1998,84,42,42
'4888034000,  북상면,'55,50 - 54세,1998,129,47,82
'4888034000,  북상면,'60,55 - 59세,1998,235,116,119
'4888034000,  북상면,'65,60 - 64세,1998,214,75,139
'4888034000,  북상면,'70,65 - 69세,1998,156,60,96
'4888034000,  북상면,'75,70 - 74세,1998,125,54,71
'4888034000,  북상면,'80,75 - 79세,1998,78,35,43
'4888034000,  북상면,'85,80 - 84세,1998,49,22,27
'4888034000,  북상면,'90,85+ ,1998,37,9,28
'4888035000,  위천면,'00,계,1998,3104,1538,1566
'4888035000,  위천면,'05,0 - 4세,1998,132,68,64
'4888035000,  위천면,'10,5 - 9세,1998,131,71,60
'4888035000,  위천면,'15,10 - 14세,1998,155,77,78
'4888035000,  위천면,'20,15 - 19세,1998,277,139,138
'4888035000,  위천면,'25,20 - 24세,1998,279,178,101
'4888035000,  위천면,'30,25 - 29세,1998,222,140,82
'4888035000,  위천면,'35,30 - 34세,1998,149,100,49
'4888035000,  위천면,'40,35 - 39세,1998,158,72,86
'4888035000,  위천면,'45,40 - 44세,1998,174,98,76
'4888035000,  위천면,'50,45 - 49세,1998,143,61,82
'4888035000,  위천면,'55,50 - 54세,1998,169,78,91
'4888035000,  위천면,'60,55 - 59세,1998,248,108,140
'4888035000,  위천면,'65,60 - 64세,1998,259,107,152
'4888035000,  위천면,'70,65 - 69세,1998,222,87,135
'4888035000,  위천면,'75,70 - 74세,1998,176,75,101
'4888035000,  위천면,'80,75 - 79세,1998,109,44,65
'4888035000,  위천면,'85,80 - 84세,1998,66,23,43
'4888035000,  위천면,'90,85+ ,1998,35,12,23
'4888036000,  마리면,'00,계,1998,3019,1478,1541
'4888036000,  마리면,'05,0 - 4세,1998,114,67,47
'4888036000,  마리면,'10,5 - 9세,1998,99,53,46
'4888036000,  마리면,'15,10 - 14세,1998,134,79,55
'4888036000,  마리면,'20,15 - 19세,1998,247,138,109
'4888036000,  마리면,'25,20 - 24세,1998,267,161,106
'4888036000,  마리면,'30,25 - 29세,1998,185,127,58
'4888036000,  마리면,'35,30 - 34세,1998,112,64,48
'4888036000,  마리면,'40,35 - 39세,1998,162,90,72
'4888036000,  마리면,'45,40 - 44세,1998,133,72,61
'4888036000,  마리면,'50,45 - 49세,1998,142,66,76
'4888036000,  마리면,'55,50 - 54세,1998,167,67,100
'4888036000,  마리면,'60,55 - 59세,1998,261,94,167
'4888036000,  마리면,'65,60 - 64세,1998,329,135,194
'4888036000,  마리면,'70,65 - 69세,1998,284,128,156
'4888036000,  마리면,'75,70 - 74세,1998,153,54,99
'4888036000,  마리면,'80,75 - 79세,1998,135,59,76
'4888036000,  마리면,'85,80 - 84세,1998,59,20,39
'4888036000,  마리면,'90,85+ ,1998,36,4,32
'4888037000,  남상면,'00,계,1998,3761,1834,1927
'4888037000,  남상면,'05,0 - 4세,1998,137,64,73
'4888037000,  남상면,'10,5 - 9세,1998,91,49,42
'4888037000,  남상면,'15,10 - 14세,1998,167,91,76
'4888037000,  남상면,'20,15 - 19세,1998,345,178,167
'4888037000,  남상면,'25,20 - 24세,1998,392,230,162
'4888037000,  남상면,'30,25 - 29세,1998,229,157,72
'4888037000,  남상면,'35,30 - 34세,1998,143,83,60
'4888037000,  남상면,'40,35 - 39세,1998,177,95,82
'4888037000,  남상면,'45,40 - 44세,1998,188,94,94
'4888037000,  남상면,'50,45 - 49세,1998,209,105,104
'4888037000,  남상면,'55,50 - 54세,1998,201,88,113
'4888037000,  남상면,'60,55 - 59세,1998,365,159,206
'4888037000,  남상면,'65,60 - 64세,1998,360,144,216
'4888037000,  남상면,'70,65 - 69세,1998,274,107,167
'4888037000,  남상면,'75,70 - 74세,1998,234,110,124
'4888037000,  남상면,'80,75 - 79세,1998,115,40,75
'4888037000,  남상면,'85,80 - 84세,1998,75,25,50
'4888037000,  남상면,'90,85+ ,1998,59,15,44
'4888038000,  남하면,'00,계,1998,2428,1183,1245
'4888038000,  남하면,'05,0 - 4세,1998,79,44,35
'4888038000,  남하면,'10,5 - 9세,1998,42,20,22
'4888038000,  남하면,'15,10 - 14세,1998,100,57,43
'4888038000,  남하면,'20,15 - 19세,1998,200,93,107
'4888038000,  남하면,'25,20 - 24세,1998,200,123,77
'4888038000,  남하면,'30,25 - 29세,1998,172,105,67
'4888038000,  남하면,'35,30 - 34세,1998,95,65,30
'4888038000,  남하면,'40,35 - 39세,1998,129,75,54
'4888038000,  남하면,'45,40 - 44세,1998,99,50,49
'4888038000,  남하면,'50,45 - 49세,1998,126,60,66
'4888038000,  남하면,'55,50 - 54세,1998,142,60,82
'4888038000,  남하면,'60,55 - 59세,1998,237,106,131
'4888038000,  남하면,'65,60 - 64세,1998,259,110,149
'4888038000,  남하면,'70,65 - 69세,1998,191,74,117
'4888038000,  남하면,'75,70 - 74세,1998,142,58,84
'4888038000,  남하면,'80,75 - 79세,1998,111,57,54
'4888038000,  남하면,'85,80 - 84세,1998,67,19,48
'4888038000,  남하면,'90,85+ ,1998,37,7,30
'4888039000,  신원면,'00,계,1998,2549,1280,1269
'4888039000,  신원면,'05,0 - 4세,1998,63,38,25
'4888039000,  신원면,'10,5 - 9세,1998,87,43,44
'4888039000,  신원면,'15,10 - 14세,1998,97,57,40
'4888039000,  신원면,'20,15 - 19세,1998,250,144,106
'4888039000,  신원면,'25,20 - 24세,1998,231,161,70
'4888039000,  신원면,'30,25 - 29세,1998,114,84,30
'4888039000,  신원면,'35,30 - 34세,1998,94,61,33
'4888039000,  신원면,'40,35 - 39세,1998,103,57,46
'4888039000,  신원면,'45,40 - 44세,1998,131,63,68
'4888039000,  신원면,'50,45 - 49세,1998,161,80,81
'4888039000,  신원면,'55,50 - 54세,1998,170,87,83
'4888039000,  신원면,'60,55 - 59세,1998,285,134,151
'4888039000,  신원면,'65,60 - 64세,1998,230,84,146
'4888039000,  신원면,'70,65 - 69세,1998,170,60,110
'4888039000,  신원면,'75,70 - 74세,1998,148,63,85
'4888039000,  신원면,'80,75 - 79세,1998,104,36,68
'4888039000,  신원면,'85,80 - 84세,1998,51,18,33
'4888039000,  신원면,'90,85+ ,1998,60,10,50
'4888040000,  가조면,'00,계,1998,5742,2715,3027
'4888040000,  가조면,'05,0 - 4세,1998,180,73,107
'4888040000,  가조면,'10,5 - 9세,1998,215,132,83
'4888040000,  가조면,'15,10 - 14세,1998,292,149,143
'4888040000,  가조면,'20,15 - 19세,1998,529,282,247
'4888040000,  가조면,'25,20 - 24세,1998,527,282,245
'4888040000,  가조면,'30,25 - 29세,1998,331,206,125
'4888040000,  가조면,'35,30 - 34세,1998,252,128,124
'4888040000,  가조면,'40,35 - 39세,1998,323,161,162
'4888040000,  가조면,'45,40 - 44세,1998,308,163,145
'4888040000,  가조면,'50,45 - 49세,1998,287,132,155
'4888040000,  가조면,'55,50 - 54세,1998,327,141,186
'4888040000,  가조면,'60,55 - 59세,1998,493,193,300
'4888040000,  가조면,'65,60 - 64세,1998,545,232,313
'4888040000,  가조면,'70,65 - 69세,1998,453,179,274
'4888040000,  가조면,'75,70 - 74세,1998,315,145,170
'4888040000,  가조면,'80,75 - 79세,1998,190,68,122
'4888040000,  가조면,'85,80 - 84세,1998,118,40,78
'4888040000,  가조면,'90,85+ ,1998,57,9,48
'4888041000,  가북면,'00,계,1998,2070,1024,1046
'4888041000,  가북면,'05,0 - 4세,1998,50,22,28
'4888041000,  가북면,'10,5 - 9세,1998,49,31,18
'4888041000,  가북면,'15,10 - 14세,1998,71,43,28
'4888041000,  가북면,'20,15 - 19세,1998,158,80,78
'4888041000,  가북면,'25,20 - 24세,1998,180,101,79
'4888041000,  가북면,'30,25 - 29세,1998,114,82,32
'4888041000,  가북면,'35,30 - 34세,1998,78,51,27
'4888041000,  가북면,'40,35 - 39세,1998,98,61,37
'4888041000,  가북면,'45,40 - 44세,1998,87,38,49
'4888041000,  가북면,'50,45 - 49세,1998,94,43,51
'4888041000,  가북면,'55,50 - 54세,1998,109,47,62
'4888041000,  가북면,'60,55 - 59세,1998,202,79,123
'4888041000,  가북면,'65,60 - 64세,1998,248,116,132
'4888041000,  가북면,'70,65 - 69세,1998,220,96,124
'4888041000,  가북면,'75,70 - 74세,1998,141,56,85
'4888041000,  가북면,'80,75 - 79세,1998,90,47,43
'4888041000,  가북면,'85,80 - 84세,1998,51,19,32
'4888041000,  가북면,'90,85+ ,1998,30,12,18
'48890, 합천군,'00,계,1998,65016,31821,33195
'48890, 합천군,'05,0 - 4세,1998,2662,1428,1234
'48890, 합천군,'10,5 - 9세,1998,2744,1510,1234
'48890, 합천군,'15,10 - 14세,1998,3393,1777,1616
'48890, 합천군,'20,15 - 19세,1998,5448,2758,2690
'48890, 합천군,'25,20 - 24세,1998,5614,3221,2393
'48890, 합천군,'30,25 - 29세,1998,4473,2662,1811
'48890, 합천군,'35,30 - 34세,1998,3461,1973,1488
'48890, 합천군,'40,35 - 39세,1998,4106,2159,1947
'48890, 합천군,'45,40 - 44세,1998,3645,1935,1710
'48890, 합천군,'50,45 - 49세,1998,3417,1667,1750
'48890, 합천군,'55,50 - 54세,1998,3636,1618,2018
'48890, 합천군,'60,55 - 59세,1998,5549,2332,3217
'48890, 합천군,'65,60 - 64세,1998,5618,2350,3268
'48890, 합천군,'70,65 - 69세,1998,4571,1888,2683
'48890, 합천군,'75,70 - 74세,1998,2996,1277,1719
'48890, 합천군,'80,75 - 79세,1998,2110,817,1293
'48890, 합천군,'85,80 - 84세,1998,1001,324,677
'48890, 합천군,'90,85+ ,1998,572,125,447
'4889025000,  합천읍,'00,계,1998,13369,6602,6767
'4889025000,  합천읍,'05,0 - 4세,1998,963,543,420
'4889025000,  합천읍,'10,5 - 9세,1998,988,540,448
'4889025000,  합천읍,'15,10 - 14세,1998,1038,551,487
'4889025000,  합천읍,'20,15 - 19세,1998,1176,556,620
'4889025000,  합천읍,'25,20 - 24세,1998,1006,539,467
'4889025000,  합천읍,'30,25 - 29세,1998,1126,560,566
'4889025000,  합천읍,'35,30 - 34세,1998,1101,558,543
'4889025000,  합천읍,'40,35 - 39세,1998,1237,607,630
'4889025000,  합천읍,'45,40 - 44세,1998,896,490,406
'4889025000,  합천읍,'50,45 - 49세,1998,677,323,354
'4889025000,  합천읍,'55,50 - 54세,1998,559,275,284
'4889025000,  합천읍,'60,55 - 59세,1998,727,313,414
'4889025000,  합천읍,'65,60 - 64세,1998,647,273,374
'4889025000,  합천읍,'70,65 - 69세,1998,486,210,276
'4889025000,  합천읍,'75,70 - 74세,1998,305,121,184
'4889025000,  합천읍,'80,75 - 79세,1998,251,96,155
'4889025000,  합천읍,'85,80 - 84세,1998,118,33,85
'4889025000,  합천읍,'90,85+ ,1998,68,14,54
'4889031000,  봉산면,'00,계,1998,2202,1062,1140
'4889031000,  봉산면,'05,0 - 4세,1998,61,28,33
'4889031000,  봉산면,'10,5 - 9세,1998,52,28,24
'4889031000,  봉산면,'15,10 - 14세,1998,89,50,39
'4889031000,  봉산면,'20,15 - 19세,1998,162,76,86
'4889031000,  봉산면,'25,20 - 24세,1998,179,112,67
'4889031000,  봉산면,'30,25 - 29세,1998,128,85,43
'4889031000,  봉산면,'35,30 - 34세,1998,85,50,35
'4889031000,  봉산면,'40,35 - 39세,1998,116,69,47
'4889031000,  봉산면,'45,40 - 44세,1998,101,54,47
'4889031000,  봉산면,'50,45 - 49세,1998,106,59,47
'4889031000,  봉산면,'55,50 - 54세,1998,110,48,62
'4889031000,  봉산면,'60,55 - 59세,1998,234,94,140
'4889031000,  봉산면,'65,60 - 64세,1998,277,117,160
'4889031000,  봉산면,'70,65 - 69세,1998,202,76,126
'4889031000,  봉산면,'75,70 - 74세,1998,117,43,74
'4889031000,  봉산면,'80,75 - 79세,1998,99,44,55
'4889031000,  봉산면,'85,80 - 84세,1998,52,21,31
'4889031000,  봉산면,'90,85+ ,1998,32,8,24
'4889032000,  묘산면,'00,계,1998,2667,1253,1414
'4889032000,  묘산면,'05,0 - 4세,1998,58,29,29
'4889032000,  묘산면,'10,5 - 9세,1998,94,49,45
'4889032000,  묘산면,'15,10 - 14세,1998,128,72,56
'4889032000,  묘산면,'20,15 - 19세,1998,209,101,108
'4889032000,  묘산면,'25,20 - 24세,1998,222,115,107
'4889032000,  묘산면,'30,25 - 29세,1998,147,84,63
'4889032000,  묘산면,'35,30 - 34세,1998,96,61,35
'4889032000,  묘산면,'40,35 - 39세,1998,149,74,75
'4889032000,  묘산면,'45,40 - 44세,1998,134,70,64
'4889032000,  묘산면,'50,45 - 49세,1998,144,70,74
'4889032000,  묘산면,'55,50 - 54세,1998,170,66,104
'4889032000,  묘산면,'60,55 - 59세,1998,273,123,150
'4889032000,  묘산면,'65,60 - 64세,1998,264,110,154
'4889032000,  묘산면,'70,65 - 69세,1998,223,95,128
'4889032000,  묘산면,'75,70 - 74세,1998,141,71,70
'4889032000,  묘산면,'80,75 - 79세,1998,111,32,79
'4889032000,  묘산면,'85,80 - 84세,1998,66,22,44
'4889032000,  묘산면,'90,85+ ,1998,38,9,29
'4889033000,  가야면,'00,계,1998,6949,3613,3336
'4889033000,  가야면,'05,0 - 4세,1998,288,163,125
'4889033000,  가야면,'10,5 - 9세,1998,335,188,147
'4889033000,  가야면,'15,10 - 14세,1998,355,171,184
'4889033000,  가야면,'20,15 - 19세,1998,588,329,259
'4889033000,  가야면,'25,20 - 24세,1998,572,341,231
'4889033000,  가야면,'30,25 - 29세,1998,550,337,213
'4889033000,  가야면,'35,30 - 34세,1998,515,310,205
'4889033000,  가야면,'40,35 - 39세,1998,555,325,230
'4889033000,  가야면,'45,40 - 44세,1998,451,235,216
'4889033000,  가야면,'50,45 - 49세,1998,406,215,191
'4889033000,  가야면,'55,50 - 54세,1998,374,177,197
'4889033000,  가야면,'60,55 - 59세,1998,535,243,292
'4889033000,  가야면,'65,60 - 64세,1998,456,182,274
'4889033000,  가야면,'70,65 - 69세,1998,400,172,228
'4889033000,  가야면,'75,70 - 74세,1998,256,112,144
'4889033000,  가야면,'80,75 - 79세,1998,162,67,95
'4889033000,  가야면,'85,80 - 84세,1998,83,30,53
'4889033000,  가야면,'90,85+ ,1998,68,16,52
'4889034000,  야로면,'00,계,1998,3691,1837,1854
'4889034000,  야로면,'05,0 - 4세,1998,156,80,76
'4889034000,  야로면,'10,5 - 9세,1998,134,76,58
'4889034000,  야로면,'15,10 - 14세,1998,210,105,105
'4889034000,  야로면,'20,15 - 19세,1998,288,148,140
'4889034000,  야로면,'25,20 - 24세,1998,306,177,129
'4889034000,  야로면,'30,25 - 29세,1998,234,140,94
'4889034000,  야로면,'35,30 - 34세,1998,189,111,78
'4889034000,  야로면,'40,35 - 39세,1998,252,126,126
'4889034000,  야로면,'45,40 - 44세,1998,230,131,99
'4889034000,  야로면,'50,45 - 49세,1998,179,86,93
'4889034000,  야로면,'55,50 - 54세,1998,189,94,95
'4889034000,  야로면,'60,55 - 59세,1998,330,123,207
'4889034000,  야로면,'65,60 - 64세,1998,341,152,189
'4889034000,  야로면,'70,65 - 69세,1998,240,119,121
'4889034000,  야로면,'75,70 - 74세,1998,178,78,100
'4889034000,  야로면,'80,75 - 79세,1998,129,58,71
'4889034000,  야로면,'85,80 - 84세,1998,62,21,41
'4889034000,  야로면,'90,85+ ,1998,44,12,32
'4889035000,  율곡면,'00,계,1998,3604,1761,1843
'4889035000,  율곡면,'05,0 - 4세,1998,104,51,53
'4889035000,  율곡면,'10,5 - 9세,1998,90,50,40
'4889035000,  율곡면,'15,10 - 14세,1998,133,77,56
'4889035000,  율곡면,'20,15 - 19세,1998,326,164,162
'4889035000,  율곡면,'25,20 - 24세,1998,323,191,132
'4889035000,  율곡면,'30,25 - 29세,1998,231,153,78
'4889035000,  율곡면,'35,30 - 34세,1998,134,82,52
'4889035000,  율곡면,'40,35 - 39세,1998,163,99,64
'4889035000,  율곡면,'45,40 - 44세,1998,181,96,85
'4889035000,  율곡면,'50,45 - 49세,1998,214,93,121
'4889035000,  율곡면,'55,50 - 54세,1998,245,104,141
'4889035000,  율곡면,'60,55 - 59세,1998,338,148,190
'4889035000,  율곡면,'65,60 - 64세,1998,379,167,212
'4889035000,  율곡면,'70,65 - 69세,1998,315,139,176
'4889035000,  율곡면,'75,70 - 74세,1998,174,59,115
'4889035000,  율곡면,'80,75 - 79세,1998,155,59,96
'4889035000,  율곡면,'85,80 - 84세,1998,66,23,43
'4889035000,  율곡면,'90,85+ ,1998,33,6,27
'4889036000,  초계면,'00,계,1998,4187,2038,2149
'4889036000,  초계면,'05,0 - 4세,1998,185,87,98
'4889036000,  초계면,'10,5 - 9세,1998,206,117,89
'4889036000,  초계면,'15,10 - 14세,1998,263,150,113
'4889036000,  초계면,'20,15 - 19세,1998,385,184,201
'4889036000,  초계면,'25,20 - 24세,1998,335,194,141
'4889036000,  초계면,'30,25 - 29세,1998,253,145,108
'4889036000,  초계면,'35,30 - 34세,1998,224,114,110
'4889036000,  초계면,'40,35 - 39세,1998,254,129,125
'4889036000,  초계면,'45,40 - 44세,1998,242,133,109
'4889036000,  초계면,'50,45 - 49세,1998,249,114,135
'4889036000,  초계면,'55,50 - 54세,1998,230,118,112
'4889036000,  초계면,'60,55 - 59세,1998,328,137,191
'4889036000,  초계면,'65,60 - 64세,1998,318,129,189
'4889036000,  초계면,'70,65 - 69세,1998,314,133,181
'4889036000,  초계면,'75,70 - 74세,1998,202,84,118
'4889036000,  초계면,'80,75 - 79세,1998,110,46,64
'4889036000,  초계면,'85,80 - 84세,1998,65,18,47
'4889036000,  초계면,'90,85+ ,1998,24,6,18
'4889037000,  쌍책면,'00,계,1998,2131,1044,1087
'4889037000,  쌍책면,'05,0 - 4세,1998,47,22,25
'4889037000,  쌍책면,'10,5 - 9세,1998,56,33,23
'4889037000,  쌍책면,'15,10 - 14세,1998,99,51,48
'4889037000,  쌍책면,'20,15 - 19세,1998,182,83,99
'4889037000,  쌍책면,'25,20 - 24세,1998,197,126,71
'4889037000,  쌍책면,'30,25 - 29세,1998,122,76,46
'4889037000,  쌍책면,'35,30 - 34세,1998,75,45,30
'4889037000,  쌍책면,'40,35 - 39세,1998,106,63,43
'4889037000,  쌍책면,'45,40 - 44세,1998,110,53,57
'4889037000,  쌍책면,'50,45 - 49세,1998,120,57,63
'4889037000,  쌍책면,'55,50 - 54세,1998,125,59,66
'4889037000,  쌍책면,'60,55 - 59세,1998,208,100,108
'4889037000,  쌍책면,'65,60 - 64세,1998,203,75,128
'4889037000,  쌍책면,'70,65 - 69세,1998,182,69,113
'4889037000,  쌍책면,'75,70 - 74세,1998,139,70,69
'4889037000,  쌍책면,'80,75 - 79세,1998,102,44,58
'4889037000,  쌍책면,'85,80 - 84세,1998,34,12,22
'4889037000,  쌍책면,'90,85+ ,1998,24,6,18
'4889038000,  덕곡면,'00,계,1998,1311,643,668
'4889038000,  덕곡면,'05,0 - 4세,1998,35,13,22
'4889038000,  덕곡면,'10,5 - 9세,1998,31,18,13
'4889038000,  덕곡면,'15,10 - 14세,1998,47,27,20
'4889038000,  덕곡면,'20,15 - 19세,1998,96,56,40
'4889038000,  덕곡면,'25,20 - 24세,1998,99,57,42
'4889038000,  덕곡면,'30,25 - 29세,1998,83,56,27
'4889038000,  덕곡면,'35,30 - 34세,1998,39,28,11
'4889038000,  덕곡면,'40,35 - 39세,1998,52,31,21
'4889038000,  덕곡면,'45,40 - 44세,1998,61,32,29
'4889038000,  덕곡면,'50,45 - 49세,1998,68,30,38
'4889038000,  덕곡면,'55,50 - 54세,1998,77,34,43
'4889038000,  덕곡면,'60,55 - 59세,1998,123,51,72
'4889038000,  덕곡면,'65,60 - 64세,1998,161,68,93
'4889038000,  덕곡면,'70,65 - 69세,1998,109,52,57
'4889038000,  덕곡면,'75,70 - 74세,1998,111,48,63
'4889038000,  덕곡면,'80,75 - 79세,1998,58,21,37
'4889038000,  덕곡면,'85,80 - 84세,1998,43,17,26
'4889038000,  덕곡면,'90,85+ ,1998,18,4,14
'4889039000,  청덕면,'00,계,1998,2587,1251,1336
'4889039000,  청덕면,'05,0 - 4세,1998,51,28,23
'4889039000,  청덕면,'10,5 - 9세,1998,59,36,23
'4889039000,  청덕면,'15,10 - 14세,1998,107,59,48
'4889039000,  청덕면,'20,15 - 19세,1998,200,113,87
'4889039000,  청덕면,'25,20 - 24세,1998,205,123,82
'4889039000,  청덕면,'30,25 - 29세,1998,152,109,43
'4889039000,  청덕면,'35,30 - 34세,1998,80,51,29
'4889039000,  청덕면,'40,35 - 39세,1998,112,50,62
'4889039000,  청덕면,'45,40 - 44세,1998,129,74,55
'4889039000,  청덕면,'50,45 - 49세,1998,157,86,71
'4889039000,  청덕면,'55,50 - 54세,1998,154,55,99
'4889039000,  청덕면,'60,55 - 59세,1998,278,120,158
'4889039000,  청덕면,'65,60 - 64세,1998,278,111,167
'4889039000,  청덕면,'70,65 - 69세,1998,272,109,163
'4889039000,  청덕면,'75,70 - 74세,1998,165,70,95
'4889039000,  청덕면,'80,75 - 79세,1998,123,43,80
'4889039000,  청덕면,'85,80 - 84세,1998,37,10,27
'4889039000,  청덕면,'90,85+ ,1998,28,4,24
'4889040000,  적중면,'00,계,1998,2263,1043,1220
'4889040000,  적중면,'05,0 - 4세,1998,83,37,46
'4889040000,  적중면,'10,5 - 9세,1998,59,32,27
'4889040000,  적중면,'15,10 - 14세,1998,82,40,42
'4889040000,  적중면,'20,15 - 19세,1998,163,83,80
'4889040000,  적중면,'25,20 - 24세,1998,182,92,90
'4889040000,  적중면,'30,25 - 29세,1998,122,77,45
'4889040000,  적중면,'35,30 - 34세,1998,85,52,33
'4889040000,  적중면,'40,35 - 39세,1998,117,62,55
'4889040000,  적중면,'45,40 - 44세,1998,108,59,49
'4889040000,  적중면,'50,45 - 49세,1998,123,57,66
'4889040000,  적중면,'55,50 - 54세,1998,150,65,85
'4889040000,  적중면,'60,55 - 59세,1998,214,72,142
'4889040000,  적중면,'65,60 - 64세,1998,275,117,158
'4889040000,  적중면,'70,65 - 69세,1998,200,90,110
'4889040000,  적중면,'75,70 - 74세,1998,137,54,83
'4889040000,  적중면,'80,75 - 79세,1998,102,34,68
'4889040000,  적중면,'85,80 - 84세,1998,44,16,28
'4889040000,  적중면,'90,85+ ,1998,17,4,13
'4889041000,  대양면,'00,계,1998,2441,1181,1260
'4889041000,  대양면,'05,0 - 4세,1998,79,40,39
'4889041000,  대양면,'10,5 - 9세,1998,53,20,33
'4889041000,  대양면,'15,10 - 14세,1998,81,45,36
'4889041000,  대양면,'20,15 - 19세,1998,193,114,79
'4889041000,  대양면,'25,20 - 24세,1998,259,159,100
'4889041000,  대양면,'30,25 - 29세,1998,162,104,58
'4889041000,  대양면,'35,30 - 34세,1998,96,59,37
'4889041000,  대양면,'40,35 - 39세,1998,114,69,45
'4889041000,  대양면,'45,40 - 44세,1998,88,37,51
'4889041000,  대양면,'50,45 - 49세,1998,119,60,59
'4889041000,  대양면,'55,50 - 54세,1998,150,60,90
'4889041000,  대양면,'60,55 - 59세,1998,229,93,136
'4889041000,  대양면,'65,60 - 64세,1998,252,107,145
'4889041000,  대양면,'70,65 - 69세,1998,235,89,146
'4889041000,  대양면,'75,70 - 74세,1998,147,60,87
'4889041000,  대양면,'80,75 - 79세,1998,101,42,59
'4889041000,  대양면,'85,80 - 84세,1998,57,16,41
'4889041000,  대양면,'90,85+ ,1998,26,7,19
'4889042000,  쌍백면,'00,계,1998,3103,1491,1612
'4889042000,  쌍백면,'05,0 - 4세,1998,74,40,34
'4889042000,  쌍백면,'10,5 - 9세,1998,85,43,42
'4889042000,  쌍백면,'15,10 - 14세,1998,114,57,57
'4889042000,  쌍백면,'20,15 - 19세,1998,255,153,102
'4889042000,  쌍백면,'25,20 - 24세,1998,307,175,132
'4889042000,  쌍백면,'30,25 - 29세,1998,156,106,50
'4889042000,  쌍백면,'35,30 - 34세,1998,99,59,40
'4889042000,  쌍백면,'40,35 - 39세,1998,141,73,68
'4889042000,  쌍백면,'45,40 - 44세,1998,127,71,56
'4889042000,  쌍백면,'50,45 - 49세,1998,127,52,75
'4889042000,  쌍백면,'55,50 - 54세,1998,217,87,130
'4889042000,  쌍백면,'60,55 - 59세,1998,326,138,188
'4889042000,  쌍백면,'65,60 - 64세,1998,368,155,213
'4889042000,  쌍백면,'70,65 - 69세,1998,316,128,188
'4889042000,  쌍백면,'75,70 - 74세,1998,204,98,106
'4889042000,  쌍백면,'80,75 - 79세,1998,104,35,69
'4889042000,  쌍백면,'85,80 - 84세,1998,52,15,37
'4889042000,  쌍백면,'90,85+ ,1998,31,6,25
'4889043000,  삼가면,'00,계,1998,5656,2642,3014
'4889043000,  삼가면,'05,0 - 4세,1998,256,133,123
'4889043000,  삼가면,'10,5 - 9세,1998,237,127,110
'4889043000,  삼가면,'15,10 - 14세,1998,286,143,143
'4889043000,  삼가면,'20,15 - 19세,1998,500,224,276
'4889043000,  삼가면,'25,20 - 24세,1998,565,293,272
'4889043000,  삼가면,'30,25 - 29세,1998,427,251,176
'4889043000,  삼가면,'35,30 - 34세,1998,284,175,109
'4889043000,  삼가면,'40,35 - 39세,1998,302,153,149
'4889043000,  삼가면,'45,40 - 44세,1998,342,163,179
'4889043000,  삼가면,'50,45 - 49세,1998,285,147,138
'4889043000,  삼가면,'55,50 - 54세,1998,355,148,207
'4889043000,  삼가면,'60,55 - 59세,1998,445,175,270
'4889043000,  삼가면,'65,60 - 64세,1998,488,209,279
'4889043000,  삼가면,'70,65 - 69세,1998,355,104,251
'4889043000,  삼가면,'75,70 - 74세,1998,265,112,153
'4889043000,  삼가면,'80,75 - 79세,1998,160,56,104
'4889043000,  삼가면,'85,80 - 84세,1998,69,25,44
'4889043000,  삼가면,'90,85+ ,1998,35,4,31
'4889044000,  가회면,'00,계,1998,2567,1262,1305
'4889044000,  가회면,'05,0 - 4세,1998,64,42,22
'4889044000,  가회면,'10,5 - 9세,1998,85,53,32
'4889044000,  가회면,'15,10 - 14세,1998,92,37,55
'4889044000,  가회면,'20,15 - 19세,1998,191,101,90
'4889044000,  가회면,'25,20 - 24세,1998,228,133,95
'4889044000,  가회면,'30,25 - 29세,1998,174,118,56
'4889044000,  가회면,'35,30 - 34세,1998,111,70,41
'4889044000,  가회면,'40,35 - 39세,1998,130,68,62
'4889044000,  가회면,'45,40 - 44세,1998,114,62,52
'4889044000,  가회면,'50,45 - 49세,1998,133,73,60
'4889044000,  가회면,'55,50 - 54세,1998,169,73,96
'4889044000,  가회면,'60,55 - 59세,1998,296,116,180
'4889044000,  가회면,'65,60 - 64세,1998,251,94,157
'4889044000,  가회면,'70,65 - 69세,1998,219,90,129
'4889044000,  가회면,'75,70 - 74세,1998,143,66,77
'4889044000,  가회면,'80,75 - 79세,1998,102,47,55
'4889044000,  가회면,'85,80 - 84세,1998,38,12,26
'4889044000,  가회면,'90,85+ ,1998,27,7,20
'4889045000,  대병면,'00,계,1998,2863,1420,1443
'4889045000,  대병면,'05,0 - 4세,1998,81,53,28
'4889045000,  대병면,'10,5 - 9세,1998,88,44,44
'4889045000,  대병면,'15,10 - 14세,1998,122,67,55
'4889045000,  대병면,'20,15 - 19세,1998,221,120,101
'4889045000,  대병면,'25,20 - 24세,1998,274,180,94
'4889045000,  대병면,'30,25 - 29세,1998,189,112,77
'4889045000,  대병면,'35,30 - 34세,1998,130,75,55
'4889045000,  대병면,'40,35 - 39세,1998,138,72,66
'4889045000,  대병면,'45,40 - 44세,1998,159,82,77
'4889045000,  대병면,'50,45 - 49세,1998,151,71,80
'4889045000,  대병면,'55,50 - 54세,1998,150,67,83
'4889045000,  대병면,'60,55 - 59세,1998,289,119,170
'4889045000,  대병면,'65,60 - 64세,1998,300,131,169
'4889045000,  대병면,'70,65 - 69세,1998,224,98,126
'4889045000,  대병면,'75,70 - 74세,1998,154,63,91
'4889045000,  대병면,'80,75 - 79세,1998,99,45,54
'4889045000,  대병면,'85,80 - 84세,1998,66,16,50
'4889045000,  대병면,'90,85+ ,1998,28,5,23
'4889046000,  용주면,'00,계,1998,3425,1678,1747
'4889046000,  용주면,'05,0 - 4세,1998,77,39,38
'4889046000,  용주면,'10,5 - 9세,1998,92,56,36
'4889046000,  용주면,'15,10 - 14세,1998,147,75,72
'4889046000,  용주면,'20,15 - 19세,1998,313,153,160
'4889046000,  용주면,'25,20 - 24세,1998,355,214,141
'4889046000,  용주면,'30,25 - 29세,1998,217,149,68
'4889046000,  용주면,'35,30 - 34세,1998,118,73,45
'4889046000,  용주면,'40,35 - 39세,1998,168,89,79
'4889046000,  용주면,'45,40 - 44세,1998,172,93,79
'4889046000,  용주면,'50,45 - 49세,1998,159,74,85
'4889046000,  용주면,'55,50 - 54세,1998,212,88,124
'4889046000,  용주면,'60,55 - 59세,1998,376,167,209
'4889046000,  용주면,'65,60 - 64세,1998,360,153,207
'4889046000,  용주면,'70,65 - 69세,1998,279,115,164
'4889046000,  용주면,'75,70 - 74세,1998,158,68,90
'4889046000,  용주면,'80,75 - 79세,1998,142,48,94
'4889046000,  용주면,'85,80 - 84세,1998,49,17,32
'4889046000,  용주면,'90,85+ ,1998,31,7,24
'50,제주도,'00,계,1998,534008,264720,269288
'50,제주도,'05,0 - 4세,1998,42566,22324,20242
'50,제주도,'10,5 - 9세,1998,39597,20807,18790
'50,제주도,'15,10 - 14세,1998,35121,18195,16926
'50,제주도,'20,15 - 19세,1998,47059,24010,23049
'50,제주도,'25,20 - 24세,1998,46758,24665,22093
'50,제주도,'30,25 - 29세,1998,53589,27350,26239
'50,제주도,'35,30 - 34세,1998,48110,25220,22890
'50,제주도,'40,35 - 39세,1998,46869,24140,22729
'50,제주도,'45,40 - 44세,1998,38513,19927,18586
'50,제주도,'50,45 - 49세,1998,26309,13264,13045
'50,제주도,'55,50 - 54세,1998,25712,13018,12694
'50,제주도,'60,55 - 59세,1998,24234,11732,12502
'50,제주도,'65,60 - 64세,1998,20726,9114,11612
'50,제주도,'70,65 - 69세,1998,14987,5298,9689
'50,제주도,'75,70 - 74세,1998,7934,2442,5492
'50,제주도,'80,75 - 79세,1998,7763,1830,5933
'50,제주도,'85,80 - 84세,1998,4434,879,3555
'50,제주도,'90,85+ ,1998,3727,505,3222
'50110, 제주시,'00,계,1998,270424,133467,136957
'50110, 제주시,'05,0 - 4세,1998,23786,12515,11271
'50110, 제주시,'10,5 - 9세,1998,22646,11990,10656
'50110, 제주시,'15,10 - 14세,1998,19523,10206,9317
'50110, 제주시,'20,15 - 19세,1998,24300,12441,11859
'50110, 제주시,'25,20 - 24세,1998,22389,11571,10818
'50110, 제주시,'30,25 - 29세,1998,27100,12923,14177
'50110, 제주시,'35,30 - 34세,1998,26167,12972,13195
'50110, 제주시,'40,35 - 39세,1998,26232,12859,13373
'50110, 제주시,'45,40 - 44세,1998,21291,10620,10671
'50110, 제주시,'50,45 - 49세,1998,13706,6864,6842
'50110, 제주시,'55,50 - 54세,1998,12097,6146,5951
'50110, 제주시,'60,55 - 59세,1998,10104,4995,5109
'50110, 제주시,'65,60 - 64세,1998,7661,3515,4146
'50110, 제주시,'70,65 - 69세,1998,5108,1864,3244
'50110, 제주시,'75,70 - 74세,1998,2849,906,1943
'50110, 제주시,'80,75 - 79세,1998,2664,619,2045
'50110, 제주시,'85,80 - 84세,1998,1477,283,1194
'50110, 제주시,'90,85+ ,1998,1324,178,1146
'5011051000,  일도1동,'00,계,1998,4739,2348,2391
'5011051000,  일도1동,'05,0 - 4세,1998,268,124,144
'5011051000,  일도1동,'10,5 - 9세,1998,285,149,136
'5011051000,  일도1동,'15,10 - 14세,1998,314,176,138
'5011051000,  일도1동,'20,15 - 19세,1998,487,265,222
'5011051000,  일도1동,'25,20 - 24세,1998,446,228,218
'5011051000,  일도1동,'30,25 - 29세,1998,423,236,187
'5011051000,  일도1동,'35,30 - 34세,1998,328,173,155
'5011051000,  일도1동,'40,35 - 39세,1998,369,188,181
'5011051000,  일도1동,'45,40 - 44세,1998,419,199,220
'5011051000,  일도1동,'50,45 - 49세,1998,317,148,169
'5011051000,  일도1동,'55,50 - 54세,1998,309,152,157
'5011051000,  일도1동,'60,55 - 59세,1998,247,124,123
'5011051000,  일도1동,'65,60 - 64세,1998,163,74,89
'5011051000,  일도1동,'70,65 - 69세,1998,146,54,92
'5011051000,  일도1동,'75,70 - 74세,1998,96,29,67
'5011051000,  일도1동,'80,75 - 79세,1998,68,19,49
'5011051000,  일도1동,'85,80 - 84세,1998,31,8,23
'5011051000,  일도1동,'90,85+ ,1998,23,2,21
'5011052000,  일도2동,'00,계,1998,40136,19669,20467
'5011052000,  일도2동,'05,0 - 4세,1998,3603,1924,1679
'5011052000,  일도2동,'10,5 - 9세,1998,3835,1972,1863
'5011052000,  일도2동,'15,10 - 14세,1998,3276,1724,1552
'5011052000,  일도2동,'20,15 - 19세,1998,3620,1822,1798
'5011052000,  일도2동,'25,20 - 24세,1998,3140,1614,1526
'5011052000,  일도2동,'30,25 - 29세,1998,3563,1645,1918
'5011052000,  일도2동,'35,30 - 34세,1998,3753,1710,2043
'5011052000,  일도2동,'40,35 - 39세,1998,4343,2124,2219
'5011052000,  일도2동,'45,40 - 44세,1998,3403,1692,1711
'5011052000,  일도2동,'50,45 - 49세,1998,2006,1043,963
'5011052000,  일도2동,'55,50 - 54세,1998,1717,883,834
'5011052000,  일도2동,'60,55 - 59세,1998,1319,653,666
'5011052000,  일도2동,'65,60 - 64세,1998,944,442,502
'5011052000,  일도2동,'70,65 - 69세,1998,599,199,400
'5011052000,  일도2동,'75,70 - 74세,1998,381,110,271
'5011052000,  일도2동,'80,75 - 79세,1998,312,62,250
'5011052000,  일도2동,'85,80 - 84세,1998,172,30,142
'5011052000,  일도2동,'90,85+ ,1998,150,20,130
'5011053000,  이도1동,'00,계,1998,7909,3812,4097
'5011053000,  이도1동,'05,0 - 4세,1998,556,293,263
'5011053000,  이도1동,'10,5 - 9세,1998,631,329,302
'5011053000,  이도1동,'15,10 - 14세,1998,535,276,259
'5011053000,  이도1동,'20,15 - 19세,1998,655,342,313
'5011053000,  이도1동,'25,20 - 24세,1998,694,341,353
'5011053000,  이도1동,'30,25 - 29세,1998,751,369,382
'5011053000,  이도1동,'35,30 - 34세,1998,684,349,335
'5011053000,  이도1동,'40,35 - 39세,1998,724,324,400
'5011053000,  이도1동,'45,40 - 44세,1998,625,308,317
'5011053000,  이도1동,'50,45 - 49세,1998,424,195,229
'5011053000,  이도1동,'55,50 - 54세,1998,388,190,198
'5011053000,  이도1동,'60,55 - 59세,1998,389,167,222
'5011053000,  이도1동,'65,60 - 64세,1998,319,153,166
'5011053000,  이도1동,'70,65 - 69세,1998,211,77,134
'5011053000,  이도1동,'75,70 - 74세,1998,111,42,69
'5011053000,  이도1동,'80,75 - 79세,1998,118,35,83
'5011053000,  이도1동,'85,80 - 84세,1998,42,11,31
'5011053000,  이도1동,'90,85+ ,1998,52,11,41
'5011054000,  이도2동,'00,계,1998,39749,19423,20326
'5011054000,  이도2동,'05,0 - 4세,1998,3716,1917,1799
'5011054000,  이도2동,'10,5 - 9세,1998,3553,1881,1672
'5011054000,  이도2동,'15,10 - 14세,1998,3108,1614,1494
'5011054000,  이도2동,'20,15 - 19세,1998,3718,1858,1860
'5011054000,  이도2동,'25,20 - 24세,1998,3152,1620,1532
'5011054000,  이도2동,'30,25 - 29세,1998,3762,1679,2083
'5011054000,  이도2동,'35,30 - 34세,1998,3905,1898,2007
'5011054000,  이도2동,'40,35 - 39세,1998,4028,1920,2108
'5011054000,  이도2동,'45,40 - 44세,1998,3262,1639,1623
'5011054000,  이도2동,'50,45 - 49세,1998,2087,1053,1034
'5011054000,  이도2동,'55,50 - 54세,1998,1726,881,845
'5011054000,  이도2동,'60,55 - 59세,1998,1245,628,617
'5011054000,  이도2동,'65,60 - 64세,1998,867,379,488
'5011054000,  이도2동,'70,65 - 69세,1998,630,234,396
'5011054000,  이도2동,'75,70 - 74세,1998,341,99,242
'5011054000,  이도2동,'80,75 - 79세,1998,305,67,238
'5011054000,  이도2동,'85,80 - 84세,1998,179,34,145
'5011054000,  이도2동,'90,85+ ,1998,165,22,143
'5011055000,  삼도1동,'00,계,1998,14914,7260,7654
'5011055000,  삼도1동,'05,0 - 4세,1998,1248,653,595
'5011055000,  삼도1동,'10,5 - 9세,1998,1083,562,521
'5011055000,  삼도1동,'15,10 - 14세,1998,942,455,487
'5011055000,  삼도1동,'20,15 - 19세,1998,1383,732,651
'5011055000,  삼도1동,'25,20 - 24세,1998,1452,743,709
'5011055000,  삼도1동,'30,25 - 29세,1998,1668,786,882
'5011055000,  삼도1동,'35,30 - 34세,1998,1351,672,679
'5011055000,  삼도1동,'40,35 - 39세,1998,1165,568,597
'5011055000,  삼도1동,'45,40 - 44세,1998,1012,480,532
'5011055000,  삼도1동,'50,45 - 49세,1998,793,357,436
'5011055000,  삼도1동,'55,50 - 54세,1998,853,398,455
'5011055000,  삼도1동,'60,55 - 59세,1998,743,381,362
'5011055000,  삼도1동,'65,60 - 64세,1998,500,241,259
'5011055000,  삼도1동,'70,65 - 69세,1998,286,123,163
'5011055000,  삼도1동,'75,70 - 74세,1998,152,57,95
'5011055000,  삼도1동,'80,75 - 79세,1998,115,30,85
'5011055000,  삼도1동,'85,80 - 84세,1998,80,8,72
'5011055000,  삼도1동,'90,85+ ,1998,88,14,74
'5011056000,  삼도2동,'00,계,1998,10360,5152,5208
'5011056000,  삼도2동,'05,0 - 4세,1998,785,410,375
'5011056000,  삼도2동,'10,5 - 9세,1998,750,408,342
'5011056000,  삼도2동,'15,10 - 14세,1998,663,364,299
'5011056000,  삼도2동,'20,15 - 19세,1998,898,441,457
'5011056000,  삼도2동,'25,20 - 24세,1998,845,487,358
'5011056000,  삼도2동,'30,25 - 29세,1998,1034,531,503
'5011056000,  삼도2동,'35,30 - 34세,1998,965,493,472
'5011056000,  삼도2동,'40,35 - 39세,1998,971,475,496
'5011056000,  삼도2동,'45,40 - 44세,1998,770,376,394
'5011056000,  삼도2동,'50,45 - 49세,1998,555,278,277
'5011056000,  삼도2동,'55,50 - 54세,1998,503,234,269
'5011056000,  삼도2동,'60,55 - 59세,1998,456,222,234
'5011056000,  삼도2동,'65,60 - 64세,1998,392,176,216
'5011056000,  삼도2동,'70,65 - 69세,1998,315,126,189
'5011056000,  삼도2동,'75,70 - 74세,1998,169,66,103
'5011056000,  삼도2동,'80,75 - 79세,1998,147,42,105
'5011056000,  삼도2동,'85,80 - 84세,1998,85,16,69
'5011056000,  삼도2동,'90,85+ ,1998,57,7,50
'5011057000,  용담1동,'00,계,1998,9964,4801,5163
'5011057000,  용담1동,'05,0 - 4세,1998,757,398,359
'5011057000,  용담1동,'10,5 - 9세,1998,709,356,353
'5011057000,  용담1동,'15,10 - 14세,1998,630,325,305
'5011057000,  용담1동,'20,15 - 19세,1998,949,454,495
'5011057000,  용담1동,'25,20 - 24세,1998,1007,494,513
'5011057000,  용담1동,'30,25 - 29세,1998,1064,516,548
'5011057000,  용담1동,'35,30 - 34세,1998,846,432,414
'5011057000,  용담1동,'40,35 - 39세,1998,825,413,412
'5011057000,  용담1동,'45,40 - 44세,1998,729,341,388
'5011057000,  용담1동,'50,45 - 49세,1998,526,258,268
'5011057000,  용담1동,'55,50 - 54세,1998,538,276,262
'5011057000,  용담1동,'60,55 - 59세,1998,433,204,229
'5011057000,  용담1동,'65,60 - 64세,1998,350,161,189
'5011057000,  용담1동,'70,65 - 69세,1998,229,85,144
'5011057000,  용담1동,'75,70 - 74세,1998,136,44,92
'5011057000,  용담1동,'80,75 - 79세,1998,115,22,93
'5011057000,  용담1동,'85,80 - 84세,1998,71,13,58
'5011057000,  용담1동,'90,85+ ,1998,50,9,41
'5011058000,  용담2동,'00,계,1998,19169,9569,9600
'5011058000,  용담2동,'05,0 - 4세,1998,1566,800,766
'5011058000,  용담2동,'10,5 - 9세,1998,1484,796,688
'5011058000,  용담2동,'15,10 - 14세,1998,1336,678,658
'5011058000,  용담2동,'20,15 - 19세,1998,1820,962,858
'5011058000,  용담2동,'25,20 - 24세,1998,1801,932,869
'5011058000,  용담2동,'30,25 - 29세,1998,1949,970,979
'5011058000,  용담2동,'35,30 - 34세,1998,1678,868,810
'5011058000,  용담2동,'40,35 - 39세,1998,1664,831,833
'5011058000,  용담2동,'45,40 - 44세,1998,1489,751,738
'5011058000,  용담2동,'50,45 - 49세,1998,1004,518,486
'5011058000,  용담2동,'55,50 - 54세,1998,923,465,458
'5011058000,  용담2동,'60,55 - 59세,1998,791,410,381
'5011058000,  용담2동,'65,60 - 64세,1998,597,269,328
'5011058000,  용담2동,'70,65 - 69세,1998,419,144,275
'5011058000,  용담2동,'75,70 - 74세,1998,226,77,149
'5011058000,  용담2동,'80,75 - 79세,1998,222,62,160
'5011058000,  용담2동,'85,80 - 84세,1998,113,24,89
'5011058000,  용담2동,'90,85+ ,1998,87,12,75
'5011059000,  건입동,'00,계,1998,12468,6180,6288
'5011059000,  건입동,'05,0 - 4세,1998,895,464,431
'5011059000,  건입동,'10,5 - 9세,1998,922,493,429
'5011059000,  건입동,'15,10 - 14세,1998,854,430,424
'5011059000,  건입동,'20,15 - 19세,1998,1231,623,608
'5011059000,  건입동,'25,20 - 24세,1998,1107,608,499
'5011059000,  건입동,'30,25 - 29세,1998,1184,576,608
'5011059000,  건입동,'35,30 - 34세,1998,996,518,478
'5011059000,  건입동,'40,35 - 39세,1998,1146,548,598
'5011059000,  건입동,'45,40 - 44세,1998,1016,499,517
'5011059000,  건입동,'50,45 - 49세,1998,796,393,403
'5011059000,  건입동,'55,50 - 54세,1998,652,347,305
'5011059000,  건입동,'60,55 - 59세,1998,576,276,300
'5011059000,  건입동,'65,60 - 64세,1998,380,189,191
'5011059000,  건입동,'70,65 - 69세,1998,263,100,163
'5011059000,  건입동,'75,70 - 74세,1998,164,50,114
'5011059000,  건입동,'80,75 - 79세,1998,135,38,97
'5011059000,  건입동,'85,80 - 84세,1998,91,21,70
'5011059000,  건입동,'90,85+ ,1998,60,7,53
'5011060000,  화북동,'00,계,1998,19661,9834,9827
'5011060000,  화북동,'05,0 - 4세,1998,2102,1109,993
'5011060000,  화북동,'10,5 - 9세,1998,1953,1013,940
'5011060000,  화북동,'15,10 - 14세,1998,1407,738,669
'5011060000,  화북동,'20,15 - 19세,1998,1531,790,741
'5011060000,  화북동,'25,20 - 24세,1998,1370,696,674
'5011060000,  화북동,'30,25 - 29세,1998,2024,934,1090
'5011060000,  화북동,'35,30 - 34세,1998,2324,1176,1148
'5011060000,  화북동,'40,35 - 39세,1998,2122,1112,1010
'5011060000,  화북동,'45,40 - 44세,1998,1378,749,629
'5011060000,  화북동,'50,45 - 49세,1998,822,428,394
'5011060000,  화북동,'55,50 - 54세,1998,678,343,335
'5011060000,  화북동,'60,55 - 59세,1998,612,304,308
'5011060000,  화북동,'65,60 - 64세,1998,506,223,283
'5011060000,  화북동,'70,65 - 69세,1998,343,118,225
'5011060000,  화북동,'75,70 - 74세,1998,142,46,96
'5011060000,  화북동,'80,75 - 79세,1998,152,30,122
'5011060000,  화북동,'85,80 - 84세,1998,96,13,83
'5011060000,  화북동,'90,85+ ,1998,99,12,87
'5011061000,  삼양동,'00,계,1998,8173,4067,4106
'5011061000,  삼양동,'05,0 - 4세,1998,686,337,349
'5011061000,  삼양동,'10,5 - 9세,1998,597,327,270
'5011061000,  삼양동,'15,10 - 14세,1998,564,284,280
'5011061000,  삼양동,'20,15 - 19세,1998,755,404,351
'5011061000,  삼양동,'25,20 - 24세,1998,680,335,345
'5011061000,  삼양동,'30,25 - 29세,1998,883,450,433
'5011061000,  삼양동,'35,30 - 34세,1998,766,428,338
'5011061000,  삼양동,'40,35 - 39세,1998,696,372,324
'5011061000,  삼양동,'45,40 - 44세,1998,578,310,268
'5011061000,  삼양동,'50,45 - 49세,1998,341,179,162
'5011061000,  삼양동,'55,50 - 54세,1998,359,183,176
'5011061000,  삼양동,'60,55 - 59세,1998,383,179,204
'5011061000,  삼양동,'65,60 - 64세,1998,309,143,166
'5011061000,  삼양동,'70,65 - 69세,1998,194,58,136
'5011061000,  삼양동,'75,70 - 74세,1998,121,37,84
'5011061000,  삼양동,'80,75 - 79세,1998,133,25,108
'5011061000,  삼양동,'85,80 - 84세,1998,59,9,50
'5011061000,  삼양동,'90,85+ ,1998,69,7,62
'5011062000,  봉개동,'00,계,1998,2802,1425,1377
'5011062000,  봉개동,'05,0 - 4세,1998,246,131,115
'5011062000,  봉개동,'10,5 - 9세,1998,136,76,60
'5011062000,  봉개동,'15,10 - 14세,1998,144,71,73
'5011062000,  봉개동,'20,15 - 19세,1998,237,122,115
'5011062000,  봉개동,'25,20 - 24세,1998,256,147,109
'5011062000,  봉개동,'30,25 - 29세,1998,320,162,158
'5011062000,  봉개동,'35,30 - 34세,1998,263,156,107
'5011062000,  봉개동,'40,35 - 39세,1998,204,120,84
'5011062000,  봉개동,'45,40 - 44세,1998,170,89,81
'5011062000,  봉개동,'50,45 - 49세,1998,102,56,46
'5011062000,  봉개동,'55,50 - 54세,1998,115,60,55
'5011062000,  봉개동,'60,55 - 59세,1998,161,76,85
'5011062000,  봉개동,'65,60 - 64세,1998,160,77,83
'5011062000,  봉개동,'70,65 - 69세,1998,105,35,70
'5011062000,  봉개동,'75,70 - 74세,1998,64,21,43
'5011062000,  봉개동,'80,75 - 79세,1998,63,16,47
'5011062000,  봉개동,'85,80 - 84세,1998,29,7,22
'5011062000,  봉개동,'90,85+ ,1998,27,3,24
'5011063000,  아라동,'00,계,1998,11615,5787,5828
'5011063000,  아라동,'05,0 - 4세,1998,790,411,379
'5011063000,  아라동,'10,5 - 9세,1998,694,356,338
'5011063000,  아라동,'15,10 - 14세,1998,767,413,354
'5011063000,  아라동,'20,15 - 19세,1998,1264,660,604
'5011063000,  아라동,'25,20 - 24세,1998,1187,620,567
'5011063000,  아라동,'30,25 - 29세,1998,1186,657,529
'5011063000,  아라동,'35,30 - 34세,1998,879,480,399
'5011063000,  아라동,'40,35 - 39세,1998,894,422,472
'5011063000,  아라동,'45,40 - 44세,1998,886,438,448
'5011063000,  아라동,'50,45 - 49세,1998,629,302,327
'5011063000,  아라동,'55,50 - 54세,1998,604,293,311
'5011063000,  아라동,'60,55 - 59세,1998,599,287,312
'5011063000,  아라동,'65,60 - 64세,1998,465,214,251
'5011063000,  아라동,'70,65 - 69세,1998,301,103,198
'5011063000,  아라동,'75,70 - 74세,1998,154,49,105
'5011063000,  아라동,'80,75 - 79세,1998,172,55,117
'5011063000,  아라동,'85,80 - 84세,1998,83,18,65
'5011063000,  아라동,'90,85+ ,1998,61,9,52
'5011064000,  오라동,'00,계,1998,5336,2690,2646
'5011064000,  오라동,'05,0 - 4세,1998,452,238,214
'5011064000,  오라동,'10,5 - 9세,1998,327,186,141
'5011064000,  오라동,'15,10 - 14세,1998,317,155,162
'5011064000,  오라동,'20,15 - 19세,1998,435,233,202
'5011064000,  오라동,'25,20 - 24세,1998,557,285,272
'5011064000,  오라동,'30,25 - 29세,1998,606,317,289
'5011064000,  오라동,'35,30 - 34세,1998,522,288,234
'5011064000,  오라동,'40,35 - 39세,1998,421,217,204
'5011064000,  오라동,'45,40 - 44세,1998,350,177,173
'5011064000,  오라동,'50,45 - 49세,1998,238,118,120
'5011064000,  오라동,'55,50 - 54세,1998,254,136,118
'5011064000,  오라동,'60,55 - 59세,1998,260,123,137
'5011064000,  오라동,'65,60 - 64세,1998,222,110,112
'5011064000,  오라동,'70,65 - 69세,1998,135,50,85
'5011064000,  오라동,'75,70 - 74세,1998,64,22,42
'5011064000,  오라동,'80,75 - 79세,1998,72,15,57
'5011064000,  오라동,'85,80 - 84세,1998,55,12,43
'5011064000,  오라동,'90,85+ ,1998,49,8,41
'5011065000,  연동,'00,계,1998,30817,15058,15759
'5011065000,  연동,'05,0 - 4세,1998,2654,1374,1280
'5011065000,  연동,'10,5 - 9세,1998,2895,1590,1305
'5011065000,  연동,'15,10 - 14세,1998,2377,1265,1112
'5011065000,  연동,'20,15 - 19세,1998,2685,1354,1331
'5011065000,  연동,'25,20 - 24세,1998,2356,1219,1137
'5011065000,  연동,'30,25 - 29세,1998,3184,1454,1730
'5011065000,  연동,'35,30 - 34세,1998,3158,1456,1702
'5011065000,  연동,'40,35 - 39세,1998,3347,1521,1826
'5011065000,  연동,'45,40 - 44세,1998,2747,1305,1442
'5011065000,  연동,'50,45 - 49세,1998,1649,794,855
'5011065000,  연동,'55,50 - 54세,1998,1311,692,619
'5011065000,  연동,'60,55 - 59세,1998,853,455,398
'5011065000,  연동,'65,60 - 64세,1998,599,286,313
'5011065000,  연동,'70,65 - 69세,1998,379,153,226
'5011065000,  연동,'75,70 - 74세,1998,212,63,149
'5011065000,  연동,'80,75 - 79세,1998,209,45,164
'5011065000,  연동,'85,80 - 84세,1998,102,24,78
'5011065000,  연동,'90,85+ ,1998,100,8,92
'5011066000,  노형동,'00,계,1998,21089,10507,10582
'5011066000,  노형동,'05,0 - 4세,1998,2379,1311,1068
'5011066000,  노형동,'10,5 - 9세,1998,1984,1056,928
'5011066000,  노형동,'15,10 - 14세,1998,1575,842,733
'5011066000,  노형동,'20,15 - 19세,1998,1705,892,813
'5011066000,  노형동,'25,20 - 24세,1998,1382,691,691
'5011066000,  노형동,'30,25 - 29세,1998,2225,966,1259
'5011066000,  노형동,'35,30 - 34세,1998,2619,1260,1359
'5011066000,  노형동,'40,35 - 39세,1998,2288,1137,1151
'5011066000,  노형동,'45,40 - 44세,1998,1703,859,844
'5011066000,  노형동,'50,45 - 49세,1998,937,486,451
'5011066000,  노형동,'55,50 - 54세,1998,703,377,326
'5011066000,  노형동,'60,55 - 59세,1998,518,263,255
'5011066000,  노형동,'65,60 - 64세,1998,404,174,230
'5011066000,  노형동,'70,65 - 69세,1998,256,104,152
'5011066000,  노형동,'75,70 - 74세,1998,120,36,84
'5011066000,  노형동,'80,75 - 79세,1998,151,27,124
'5011066000,  노형동,'85,80 - 84세,1998,73,16,57
'5011066000,  노형동,'90,85+ ,1998,67,10,57
'5011067000,  외도동,'00,계,1998,5779,2895,2884
'5011067000,  외도동,'05,0 - 4세,1998,527,282,245
'5011067000,  외도동,'10,5 - 9세,1998,456,242,214
'5011067000,  외도동,'15,10 - 14세,1998,409,230,179
'5011067000,  외도동,'20,15 - 19세,1998,491,259,232
'5011067000,  외도동,'25,20 - 24세,1998,425,220,205
'5011067000,  외도동,'30,25 - 29세,1998,593,314,279
'5011067000,  외도동,'35,30 - 34세,1998,582,302,280
'5011067000,  외도동,'40,35 - 39세,1998,536,290,246
'5011067000,  외도동,'45,40 - 44세,1998,372,195,177
'5011067000,  외도동,'50,45 - 49세,1998,221,117,104
'5011067000,  외도동,'55,50 - 54세,1998,221,116,105
'5011067000,  외도동,'60,55 - 59세,1998,243,115,128
'5011067000,  외도동,'65,60 - 64세,1998,227,88,139
'5011067000,  외도동,'70,65 - 69세,1998,164,58,106
'5011067000,  외도동,'75,70 - 74세,1998,99,28,71
'5011067000,  외도동,'80,75 - 79세,1998,95,16,79
'5011067000,  외도동,'85,80 - 84세,1998,63,12,51
'5011067000,  외도동,'90,85+ ,1998,55,11,44
'5011068000,  이호동,'00,계,1998,3808,1985,1823
'5011068000,  이호동,'05,0 - 4세,1998,378,229,149
'5011068000,  이호동,'10,5 - 9세,1998,226,138,88
'5011068000,  이호동,'15,10 - 14세,1998,207,114,93
'5011068000,  이호동,'20,15 - 19세,1998,297,151,146
'5011068000,  이호동,'25,20 - 24세,1998,336,184,152
'5011068000,  이호동,'30,25 - 29세,1998,501,252,249
'5011068000,  이호동,'35,30 - 34세,1998,368,211,157
'5011068000,  이호동,'40,35 - 39세,1998,342,188,154
'5011068000,  이호동,'45,40 - 44세,1998,266,146,120
'5011068000,  이호동,'50,45 - 49세,1998,167,93,74
'5011068000,  이호동,'55,50 - 54세,1998,144,68,76
'5011068000,  이호동,'60,55 - 59세,1998,175,85,90
'5011068000,  이호동,'65,60 - 64세,1998,156,73,83
'5011068000,  이호동,'70,65 - 69세,1998,66,19,47
'5011068000,  이호동,'75,70 - 74세,1998,52,13,39
'5011068000,  이호동,'80,75 - 79세,1998,51,9,42
'5011068000,  이호동,'85,80 - 84세,1998,36,6,30
'5011068000,  이호동,'90,85+ ,1998,40,6,34
'5011069000,  도두동,'00,계,1998,1936,1005,931
'5011069000,  도두동,'05,0 - 4세,1998,178,110,68
'5011069000,  도두동,'10,5 - 9세,1998,126,60,66
'5011069000,  도두동,'15,10 - 14세,1998,98,52,46
'5011069000,  도두동,'20,15 - 19세,1998,139,77,62
'5011069000,  도두동,'25,20 - 24세,1998,196,107,89
'5011069000,  도두동,'30,25 - 29세,1998,180,109,71
'5011069000,  도두동,'35,30 - 34세,1998,180,102,78
'5011069000,  도두동,'40,35 - 39세,1998,147,89,58
'5011069000,  도두동,'45,40 - 44세,1998,116,67,49
'5011069000,  도두동,'50,45 - 49세,1998,92,48,44
'5011069000,  도두동,'55,50 - 54세,1998,99,52,47
'5011069000,  도두동,'60,55 - 59세,1998,101,43,58
'5011069000,  도두동,'65,60 - 64세,1998,101,43,58
'5011069000,  도두동,'70,65 - 69세,1998,67,24,43
'5011069000,  도두동,'75,70 - 74세,1998,45,17,28
'5011069000,  도두동,'80,75 - 79세,1998,29,4,25
'5011069000,  도두동,'85,80 - 84세,1998,17,1,16
'5011069000,  도두동,'90,85+ ,1998,25,0,25
'50130, 서귀포시,'00,계,1998,85041,42258,42783
'50130, 서귀포시,'05,0 - 4세,1998,6404,3308,3096
'50130, 서귀포시,'10,5 - 9세,1998,6079,3177,2902
'50130, 서귀포시,'15,10 - 14세,1998,5623,2870,2753
'50130, 서귀포시,'20,15 - 19세,1998,7623,3922,3701
'50130, 서귀포시,'25,20 - 24세,1998,7554,3960,3594
'50130, 서귀포시,'30,25 - 29세,1998,8391,4389,4002
'50130, 서귀포시,'35,30 - 34세,1998,7472,3901,3571
'50130, 서귀포시,'40,35 - 39세,1998,7504,3856,3648
'50130, 서귀포시,'45,40 - 44세,1998,6244,3194,3050
'50130, 서귀포시,'50,45 - 49세,1998,4496,2237,2259
'50130, 서귀포시,'55,50 - 54세,1998,4484,2225,2259
'50130, 서귀포시,'60,55 - 59세,1998,4047,1988,2059
'50130, 서귀포시,'65,60 - 64세,1998,3338,1478,1860
'50130, 서귀포시,'70,65 - 69세,1998,2311,842,1469
'50130, 서귀포시,'75,70 - 74세,1998,1197,410,787
'50130, 서귀포시,'80,75 - 79세,1998,1092,274,818
'50130, 서귀포시,'85,80 - 84세,1998,678,155,523
'50130, 서귀포시,'90,85+ ,1998,504,72,432
'5013051000,  송산동,'00,계,1998,6513,3325,3188
'5013051000,  송산동,'05,0 - 4세,1998,427,225,202
'5013051000,  송산동,'10,5 - 9세,1998,431,233,198
'5013051000,  송산동,'15,10 - 14세,1998,406,211,195
'5013051000,  송산동,'20,15 - 19세,1998,570,272,298
'5013051000,  송산동,'25,20 - 24세,1998,589,328,261
'5013051000,  송산동,'30,25 - 29세,1998,651,366,285
'5013051000,  송산동,'35,30 - 34세,1998,557,307,250
'5013051000,  송산동,'40,35 - 39세,1998,552,290,262
'5013051000,  송산동,'45,40 - 44세,1998,501,259,242
'5013051000,  송산동,'50,45 - 49세,1998,378,198,180
'5013051000,  송산동,'55,50 - 54세,1998,370,196,174
'5013051000,  송산동,'60,55 - 59세,1998,311,155,156
'5013051000,  송산동,'65,60 - 64세,1998,279,139,140
'5013051000,  송산동,'70,65 - 69세,1998,195,60,135
'5013051000,  송산동,'75,70 - 74세,1998,109,46,63
'5013051000,  송산동,'80,75 - 79세,1998,95,22,73
'5013051000,  송산동,'85,80 - 84세,1998,52,12,40
'5013051000,  송산동,'90,85+ ,1998,40,6,34
'5013052000,  정방동,'00,계,1998,4250,2086,2164
'5013052000,  정방동,'05,0 - 4세,1998,269,136,133
'5013052000,  정방동,'10,5 - 9세,1998,269,164,105
'5013052000,  정방동,'15,10 - 14세,1998,263,128,135
'5013052000,  정방동,'20,15 - 19세,1998,380,190,190
'5013052000,  정방동,'25,20 - 24세,1998,375,192,183
'5013052000,  정방동,'30,25 - 29세,1998,433,221,212
'5013052000,  정방동,'35,30 - 34세,1998,344,176,168
'5013052000,  정방동,'40,35 - 39세,1998,406,204,202
'5013052000,  정방동,'45,40 - 44세,1998,340,170,170
'5013052000,  정방동,'50,45 - 49세,1998,251,117,134
'5013052000,  정방동,'55,50 - 54세,1998,236,114,122
'5013052000,  정방동,'60,55 - 59세,1998,210,110,100
'5013052000,  정방동,'65,60 - 64세,1998,151,66,85
'5013052000,  정방동,'70,65 - 69세,1998,132,44,88
'5013052000,  정방동,'75,70 - 74세,1998,79,28,51
'5013052000,  정방동,'80,75 - 79세,1998,65,14,51
'5013052000,  정방동,'85,80 - 84세,1998,31,8,23
'5013052000,  정방동,'90,85+ ,1998,16,4,12
'5013053000,  중앙동,'00,계,1998,5954,2845,3109
'5013053000,  중앙동,'05,0 - 4세,1998,432,225,207
'5013053000,  중앙동,'10,5 - 9세,1998,559,295,264
'5013053000,  중앙동,'15,10 - 14세,1998,415,214,201
'5013053000,  중앙동,'20,15 - 19세,1998,541,236,305
'5013053000,  중앙동,'25,20 - 24세,1998,526,273,253
'5013053000,  중앙동,'30,25 - 29세,1998,535,280,255
'5013053000,  중앙동,'35,30 - 34세,1998,525,217,308
'5013053000,  중앙동,'40,35 - 39세,1998,545,254,291
'5013053000,  중앙동,'45,40 - 44세,1998,470,231,239
'5013053000,  중앙동,'50,45 - 49세,1998,318,143,175
'5013053000,  중앙동,'55,50 - 54세,1998,334,152,182
'5013053000,  중앙동,'60,55 - 59세,1998,285,137,148
'5013053000,  중앙동,'65,60 - 64세,1998,198,93,105
'5013053000,  중앙동,'70,65 - 69세,1998,116,49,67
'5013053000,  중앙동,'75,70 - 74세,1998,53,17,36
'5013053000,  중앙동,'80,75 - 79세,1998,40,13,27
'5013053000,  중앙동,'85,80 - 84세,1998,34,10,24
'5013053000,  중앙동,'90,85+ ,1998,28,6,22
'5013054000,  천지동,'00,계,1998,5254,2548,2706
'5013054000,  천지동,'05,0 - 4세,1998,351,187,164
'5013054000,  천지동,'10,5 - 9세,1998,331,182,149
'5013054000,  천지동,'15,10 - 14세,1998,346,167,179
'5013054000,  천지동,'20,15 - 19세,1998,487,242,245
'5013054000,  천지동,'25,20 - 24세,1998,498,244,254
'5013054000,  천지동,'30,25 - 29세,1998,561,282,279
'5013054000,  천지동,'35,30 - 34세,1998,447,228,219
'5013054000,  천지동,'40,35 - 39세,1998,463,232,231
'5013054000,  천지동,'45,40 - 44세,1998,361,171,190
'5013054000,  천지동,'50,45 - 49세,1998,284,133,151
'5013054000,  천지동,'55,50 - 54세,1998,298,133,165
'5013054000,  천지동,'60,55 - 59세,1998,292,157,135
'5013054000,  천지동,'65,60 - 64세,1998,214,84,130
'5013054000,  천지동,'70,65 - 69세,1998,128,53,75
'5013054000,  천지동,'75,70 - 74세,1998,77,31,46
'5013054000,  천지동,'80,75 - 79세,1998,62,10,52
'5013054000,  천지동,'85,80 - 84세,1998,35,11,24
'5013054000,  천지동,'90,85+ ,1998,19,1,18
'5013055000,  효돈동,'00,계,1998,6217,3081,3136
'5013055000,  효돈동,'05,0 - 4세,1998,475,230,245
'5013055000,  효돈동,'10,5 - 9세,1998,372,197,175
'5013055000,  효돈동,'15,10 - 14세,1998,382,206,176
'5013055000,  효돈동,'20,15 - 19세,1998,559,292,267
'5013055000,  효돈동,'25,20 - 24세,1998,599,315,284
'5013055000,  효돈동,'30,25 - 29세,1998,610,316,294
'5013055000,  효돈동,'35,30 - 34세,1998,493,261,232
'5013055000,  효돈동,'40,35 - 39세,1998,505,268,237
'5013055000,  효돈동,'45,40 - 44세,1998,376,191,185
'5013055000,  효돈동,'50,45 - 49세,1998,333,171,162
'5013055000,  효돈동,'55,50 - 54세,1998,353,171,182
'5013055000,  효돈동,'60,55 - 59세,1998,328,168,160
'5013055000,  효돈동,'65,60 - 64세,1998,291,136,155
'5013055000,  효돈동,'70,65 - 69세,1998,229,88,141
'5013055000,  효돈동,'75,70 - 74세,1998,87,31,56
'5013055000,  효돈동,'80,75 - 79세,1998,104,25,79
'5013055000,  효돈동,'85,80 - 84세,1998,74,9,65
'5013055000,  효돈동,'90,85+ ,1998,47,6,41
'5013056000,  영천동,'00,계,1998,5118,2596,2522
'5013056000,  영천동,'05,0 - 4세,1998,358,169,189
'5013056000,  영천동,'10,5 - 9세,1998,302,163,139
'5013056000,  영천동,'15,10 - 14세,1998,285,145,140
'5013056000,  영천동,'20,15 - 19세,1998,425,237,188
'5013056000,  영천동,'25,20 - 24세,1998,470,257,213
'5013056000,  영천동,'30,25 - 29세,1998,539,301,238
'5013056000,  영천동,'35,30 - 34세,1998,461,256,205
'5013056000,  영천동,'40,35 - 39세,1998,390,205,185
'5013056000,  영천동,'45,40 - 44세,1998,340,187,153
'5013056000,  영천동,'50,45 - 49세,1998,235,108,127
'5013056000,  영천동,'55,50 - 54세,1998,318,160,158
'5013056000,  영천동,'60,55 - 59세,1998,299,145,154
'5013056000,  영천동,'65,60 - 64세,1998,243,116,127
'5013056000,  영천동,'70,65 - 69세,1998,160,68,92
'5013056000,  영천동,'75,70 - 74세,1998,116,30,86
'5013056000,  영천동,'80,75 - 79세,1998,70,23,47
'5013056000,  영천동,'85,80 - 84세,1998,60,16,44
'5013056000,  영천동,'90,85+ ,1998,47,10,37
'5013057000,  동홍동,'00,계,1998,13495,6687,6808
'5013057000,  동홍동,'05,0 - 4세,1998,1126,574,552
'5013057000,  동홍동,'10,5 - 9세,1998,1026,538,488
'5013057000,  동홍동,'15,10 - 14세,1998,959,479,480
'5013057000,  동홍동,'20,15 - 19세,1998,1340,699,641
'5013057000,  동홍동,'25,20 - 24세,1998,1194,639,555
'5013057000,  동홍동,'30,25 - 29세,1998,1275,636,639
'5013057000,  동홍동,'35,30 - 34세,1998,1205,600,605
'5013057000,  동홍동,'40,35 - 39세,1998,1280,639,641
'5013057000,  동홍동,'45,40 - 44세,1998,1068,535,533
'5013057000,  동홍동,'50,45 - 49세,1998,768,367,401
'5013057000,  동홍동,'55,50 - 54세,1998,706,361,345
'5013057000,  동홍동,'60,55 - 59세,1998,550,276,274
'5013057000,  동홍동,'65,60 - 64세,1998,387,153,234
'5013057000,  동홍동,'70,65 - 69세,1998,255,86,169
'5013057000,  동홍동,'75,70 - 74세,1998,148,53,95
'5013057000,  동홍동,'80,75 - 79세,1998,112,35,77
'5013057000,  동홍동,'85,80 - 84세,1998,59,12,47
'5013057000,  동홍동,'90,85+ ,1998,37,5,32
'5013058000,  서홍동,'00,계,1998,8384,4239,4145
'5013058000,  서홍동,'05,0 - 4세,1998,720,390,330
'5013058000,  서홍동,'10,5 - 9세,1998,653,343,310
'5013058000,  서홍동,'15,10 - 14세,1998,594,301,293
'5013058000,  서홍동,'20,15 - 19세,1998,709,358,351
'5013058000,  서홍동,'25,20 - 24세,1998,754,393,361
'5013058000,  서홍동,'30,25 - 29세,1998,856,454,402
'5013058000,  서홍동,'35,30 - 34세,1998,776,389,387
'5013058000,  서홍동,'40,35 - 39세,1998,789,397,392
'5013058000,  서홍동,'45,40 - 44세,1998,621,322,299
'5013058000,  서홍동,'50,45 - 49세,1998,457,228,229
'5013058000,  서홍동,'55,50 - 54세,1998,446,231,215
'5013058000,  서홍동,'60,55 - 59세,1998,366,188,178
'5013058000,  서홍동,'65,60 - 64세,1998,230,106,124
'5013058000,  서홍동,'70,65 - 69세,1998,172,59,113
'5013058000,  서홍동,'75,70 - 74세,1998,87,31,56
'5013058000,  서홍동,'80,75 - 79세,1998,84,28,56
'5013058000,  서홍동,'85,80 - 84세,1998,35,13,22
'5013058000,  서홍동,'90,85+ ,1998,35,8,27
'5013059000,  대륜동,'00,계,1998,10537,5237,5300
'5013059000,  대륜동,'05,0 - 4세,1998,781,391,390
'5013059000,  대륜동,'10,5 - 9세,1998,762,378,384
'5013059000,  대륜동,'15,10 - 14세,1998,792,408,384
'5013059000,  대륜동,'20,15 - 19세,1998,1021,552,469
'5013059000,  대륜동,'25,20 - 24세,1998,880,463,417
'5013059000,  대륜동,'30,25 - 29세,1998,966,491,475
'5013059000,  대륜동,'35,30 - 34세,1998,919,481,438
'5013059000,  대륜동,'40,35 - 39세,1998,943,497,446
'5013059000,  대륜동,'45,40 - 44세,1998,876,442,434
'5013059000,  대륜동,'50,45 - 49세,1998,539,284,255
'5013059000,  대륜동,'55,50 - 54세,1998,521,255,266
'5013059000,  대륜동,'60,55 - 59세,1998,459,216,243
'5013059000,  대륜동,'65,60 - 64세,1998,383,174,209
'5013059000,  대륜동,'70,65 - 69세,1998,298,114,184
'5013059000,  대륜동,'75,70 - 74세,1998,113,32,81
'5013059000,  대륜동,'80,75 - 79세,1998,131,35,96
'5013059000,  대륜동,'85,80 - 84세,1998,78,20,58
'5013059000,  대륜동,'90,85+ ,1998,75,4,71
'5013060000,  대천동,'00,계,1998,7483,3682,3801
'5013060000,  대천동,'05,0 - 4세,1998,606,316,290
'5013060000,  대천동,'10,5 - 9세,1998,572,277,295
'5013060000,  대천동,'15,10 - 14세,1998,530,268,262
'5013060000,  대천동,'20,15 - 19세,1998,622,321,301
'5013060000,  대천동,'25,20 - 24세,1998,605,317,288
'5013060000,  대천동,'30,25 - 29세,1998,686,338,348
'5013060000,  대천동,'35,30 - 34세,1998,668,361,307
'5013060000,  대천동,'40,35 - 39세,1998,732,378,354
'5013060000,  대천동,'45,40 - 44세,1998,533,286,247
'5013060000,  대천동,'50,45 - 49세,1998,369,196,173
'5013060000,  대천동,'55,50 - 54세,1998,338,171,167
'5013060000,  대천동,'60,55 - 59세,1998,332,152,180
'5013060000,  대천동,'65,60 - 64세,1998,339,151,188
'5013060000,  대천동,'70,65 - 69세,1998,221,71,150
'5013060000,  대천동,'75,70 - 74세,1998,110,35,75
'5013060000,  대천동,'80,75 - 79세,1998,102,20,82
'5013060000,  대천동,'85,80 - 84세,1998,66,15,51
'5013060000,  대천동,'90,85+ ,1998,52,9,43
'5013061000,  중문동,'00,계,1998,8058,4053,4005
'5013061000,  중문동,'05,0 - 4세,1998,596,323,273
'5013061000,  중문동,'10,5 - 9세,1998,554,282,272
'5013061000,  중문동,'15,10 - 14세,1998,457,240,217
'5013061000,  중문동,'20,15 - 19세,1998,669,367,302
'5013061000,  중문동,'25,20 - 24세,1998,716,376,340
'5013061000,  중문동,'30,25 - 29세,1998,850,458,392
'5013061000,  중문동,'35,30 - 34세,1998,749,425,324
'5013061000,  중문동,'40,35 - 39세,1998,611,334,277
'5013061000,  중문동,'45,40 - 44세,1998,539,280,259
'5013061000,  중문동,'50,45 - 49세,1998,416,218,198
'5013061000,  중문동,'55,50 - 54세,1998,397,201,196
'5013061000,  중문동,'60,55 - 59세,1998,413,193,220
'5013061000,  중문동,'65,60 - 64세,1998,404,163,241
'5013061000,  중문동,'70,65 - 69세,1998,241,88,153
'5013061000,  중문동,'75,70 - 74세,1998,147,52,95
'5013061000,  중문동,'80,75 - 79세,1998,130,28,102
'5013061000,  중문동,'85,80 - 84세,1998,104,19,85
'5013061000,  중문동,'90,85+ ,1998,65,6,59
'5013062000,  예래동,'00,계,1998,3778,1879,1899
'5013062000,  예래동,'05,0 - 4세,1998,263,142,121
'5013062000,  예래동,'10,5 - 9세,1998,248,125,123
'5013062000,  예래동,'15,10 - 14세,1998,194,103,91
'5013062000,  예래동,'20,15 - 19세,1998,300,156,144
'5013062000,  예래동,'25,20 - 24세,1998,348,163,185
'5013062000,  예래동,'30,25 - 29세,1998,429,246,183
'5013062000,  예래동,'35,30 - 34세,1998,328,200,128
'5013062000,  예래동,'40,35 - 39세,1998,288,158,130
'5013062000,  예래동,'45,40 - 44세,1998,219,120,99
'5013062000,  예래동,'50,45 - 49세,1998,148,74,74
'5013062000,  예래동,'55,50 - 54세,1998,167,80,87
'5013062000,  예래동,'60,55 - 59세,1998,202,91,111
'5013062000,  예래동,'65,60 - 64세,1998,219,97,122
'5013062000,  예래동,'70,65 - 69세,1998,164,62,102
'5013062000,  예래동,'75,70 - 74세,1998,71,24,47
'5013062000,  예래동,'80,75 - 79세,1998,97,21,76
'5013062000,  예래동,'85,80 - 84세,1998,50,10,40
'5013062000,  예래동,'90,85+ ,1998,43,7,36
'50910, 북제주군,'00,계,1998,100422,50020,50402
'50910, 북제주군,'05,0 - 4세,1998,7002,3707,3295
'50910, 북제주군,'10,5 - 9세,1998,6016,3115,2901
'50910, 북제주군,'15,10 - 14세,1998,5382,2763,2619
'50910, 북제주군,'20,15 - 19세,1998,8289,4233,4056
'50910, 북제주군,'25,20 - 24세,1998,9477,5162,4315
'50910, 북제주군,'30,25 - 29세,1998,10490,5835,4655
'50910, 북제주군,'35,30 - 34세,1998,8251,4787,3464
'50910, 북제주군,'40,35 - 39세,1998,7195,4121,3074
'50910, 북제주군,'45,40 - 44세,1998,6075,3397,2678
'50910, 북제주군,'50,45 - 49세,1998,4417,2265,2152
'50910, 북제주군,'55,50 - 54세,1998,5029,2556,2473
'50910, 북제주군,'60,55 - 59세,1998,5558,2617,2941
'50910, 북제주군,'65,60 - 64세,1998,5499,2325,3174
'50910, 북제주군,'70,65 - 69세,1998,4448,1516,2932
'50910, 북제주군,'75,70 - 74세,1998,2293,648,1645
'50910, 북제주군,'80,75 - 79세,1998,2451,562,1889
'50910, 북제주군,'85,80 - 84세,1998,1367,256,1111
'50910, 북제주군,'90,85+ ,1998,1183,155,1028
'5091025000,  한림읍,'00,계,1998,21223,10594,10629
'5091025000,  한림읍,'05,0 - 4세,1998,1505,810,695
'5091025000,  한림읍,'10,5 - 9세,1998,1311,704,607
'5091025000,  한림읍,'15,10 - 14세,1998,1199,648,551
'5091025000,  한림읍,'20,15 - 19세,1998,1728,878,850
'5091025000,  한림읍,'25,20 - 24세,1998,1886,1028,858
'5091025000,  한림읍,'30,25 - 29세,1998,2249,1263,986
'5091025000,  한림읍,'35,30 - 34세,1998,1740,985,755
'5091025000,  한림읍,'40,35 - 39세,1998,1592,869,723
'5091025000,  한림읍,'45,40 - 44세,1998,1347,757,590
'5091025000,  한림읍,'50,45 - 49세,1998,949,465,484
'5091025000,  한림읍,'55,50 - 54세,1998,1080,557,523
'5091025000,  한림읍,'60,55 - 59세,1998,1138,533,605
'5091025000,  한림읍,'65,60 - 64세,1998,1091,437,654
'5091025000,  한림읍,'70,65 - 69세,1998,876,297,579
'5091025000,  한림읍,'75,70 - 74세,1998,425,134,291
'5091025000,  한림읍,'80,75 - 79세,1998,514,128,386
'5091025000,  한림읍,'85,80 - 84세,1998,317,67,250
'5091025000,  한림읍,'90,85+ ,1998,276,34,242
'5091025300,  애월읍,'00,계,1998,25393,12804,12589
'5091025300,  애월읍,'05,0 - 4세,1998,2015,1088,927
'5091025300,  애월읍,'10,5 - 9세,1998,1542,761,781
'5091025300,  애월읍,'15,10 - 14세,1998,1204,641,563
'5091025300,  애월읍,'20,15 - 19세,1998,1873,972,901
'5091025300,  애월읍,'25,20 - 24세,1998,2365,1308,1057
'5091025300,  애월읍,'30,25 - 29세,1998,2846,1545,1301
'5091025300,  애월읍,'35,30 - 34세,1998,2326,1314,1012
'5091025300,  애월읍,'40,35 - 39세,1998,1821,1057,764
'5091025300,  애월읍,'45,40 - 44세,1998,1466,840,626
'5091025300,  애월읍,'50,45 - 49세,1998,1087,578,509
'5091025300,  애월읍,'55,50 - 54세,1998,1225,626,599
'5091025300,  애월읍,'60,55 - 59세,1998,1382,655,727
'5091025300,  애월읍,'65,60 - 64세,1998,1302,596,706
'5091025300,  애월읍,'70,65 - 69세,1998,1075,378,697
'5091025300,  애월읍,'75,70 - 74세,1998,615,175,440
'5091025300,  애월읍,'80,75 - 79세,1998,620,154,466
'5091025300,  애월읍,'85,80 - 84세,1998,327,73,254
'5091025300,  애월읍,'90,85+ ,1998,302,43,259
'5091025600,  구좌읍,'00,계,1998,18006,8814,9192
'5091025600,  구좌읍,'05,0 - 4세,1998,1126,570,556
'5091025600,  구좌읍,'10,5 - 9세,1998,985,523,462
'5091025600,  구좌읍,'15,10 - 14세,1998,957,482,475
'5091025600,  구좌읍,'20,15 - 19세,1998,1557,792,765
'5091025600,  구좌읍,'25,20 - 24세,1998,1796,948,848
'5091025600,  구좌읍,'30,25 - 29세,1998,1824,1029,795
'5091025600,  구좌읍,'35,30 - 34세,1998,1325,794,531
'5091025600,  구좌읍,'40,35 - 39세,1998,1219,723,496
'5091025600,  구좌읍,'45,40 - 44세,1998,1048,567,481
'5091025600,  구좌읍,'50,45 - 49세,1998,810,413,397
'5091025600,  구좌읍,'55,50 - 54세,1998,928,488,440
'5091025600,  구좌읍,'60,55 - 59세,1998,1019,470,549
'5091025600,  구좌읍,'65,60 - 64세,1998,1071,419,652
'5091025600,  구좌읍,'70,65 - 69세,1998,901,308,593
'5091025600,  구좌읍,'75,70 - 74세,1998,478,116,362
'5091025600,  구좌읍,'80,75 - 79세,1998,474,101,373
'5091025600,  구좌읍,'85,80 - 84세,1998,247,46,201
'5091025600,  구좌읍,'90,85+ ,1998,241,25,216
'5091025900,  조천읍,'00,계,1998,20115,10003,10112
'5091025900,  조천읍,'05,0 - 4세,1998,1510,795,715
'5091025900,  조천읍,'10,5 - 9세,1998,1391,719,672
'5091025900,  조천읍,'15,10 - 14세,1998,1221,598,623
'5091025900,  조천읍,'20,15 - 19세,1998,1754,890,864
'5091025900,  조천읍,'25,20 - 24세,1998,1795,939,856
'5091025900,  조천읍,'30,25 - 29세,1998,2121,1130,991
'5091025900,  조천읍,'35,30 - 34세,1998,1741,994,747
'5091025900,  조천읍,'40,35 - 39세,1998,1575,867,708
'5091025900,  조천읍,'45,40 - 44세,1998,1278,721,557
'5091025900,  조천읍,'50,45 - 49세,1998,833,414,419
'5091025900,  조천읍,'55,50 - 54세,1998,996,487,509
'5091025900,  조천읍,'60,55 - 59세,1998,1052,505,547
'5091025900,  조천읍,'65,60 - 64세,1998,991,442,549
'5091025900,  조천읍,'70,65 - 69세,1998,723,263,460
'5091025900,  조천읍,'75,70 - 74세,1998,361,94,267
'5091025900,  조천읍,'80,75 - 79세,1998,349,71,278
'5091025900,  조천읍,'85,80 - 84세,1998,226,38,188
'5091025900,  조천읍,'90,85+ ,1998,198,36,162
'5091031000,  한경면,'00,계,1998,10306,5061,5245
'5091031000,  한경면,'05,0 - 4세,1998,556,286,270
'5091031000,  한경면,'10,5 - 9세,1998,530,282,248
'5091031000,  한경면,'15,10 - 14세,1998,526,263,263
'5091031000,  한경면,'20,15 - 19세,1998,851,425,426
'5091031000,  한경면,'25,20 - 24세,1998,1026,583,443
'5091031000,  한경면,'30,25 - 29세,1998,996,577,419
'5091031000,  한경면,'35,30 - 34세,1998,727,444,283
'5091031000,  한경면,'40,35 - 39세,1998,641,385,256
'5091031000,  한경면,'45,40 - 44세,1998,615,340,275
'5091031000,  한경면,'50,45 - 49세,1998,467,252,215
'5091031000,  한경면,'55,50 - 54세,1998,498,245,253
'5091031000,  한경면,'60,55 - 59세,1998,640,307,333
'5091031000,  한경면,'65,60 - 64세,1998,709,288,421
'5091031000,  한경면,'70,65 - 69세,1998,613,190,423
'5091031000,  한경면,'75,70 - 74세,1998,233,80,153
'5091031000,  한경면,'80,75 - 79세,1998,364,73,291
'5091031000,  한경면,'85,80 - 84세,1998,190,26,164
'5091031000,  한경면,'90,85+ ,1998,124,15,109
'5091032000,  추자면,'00,계,1998,3502,1852,1650
'5091032000,  추자면,'05,0 - 4세,1998,193,105,88
'5091032000,  추자면,'10,5 - 9세,1998,174,85,89
'5091032000,  추자면,'15,10 - 14세,1998,181,86,95
'5091032000,  추자면,'20,15 - 19세,1998,351,184,167
'5091032000,  추자면,'25,20 - 24세,1998,380,226,154
'5091032000,  추자면,'30,25 - 29세,1998,295,196,99
'5091032000,  추자면,'35,30 - 34세,1998,286,193,93
'5091032000,  추자면,'40,35 - 39세,1998,245,157,88
'5091032000,  추자면,'45,40 - 44세,1998,229,122,107
'5091032000,  추자면,'50,45 - 49세,1998,187,97,90
'5091032000,  추자면,'55,50 - 54세,1998,191,99,92
'5091032000,  추자면,'60,55 - 59세,1998,212,100,112
'5091032000,  추자면,'65,60 - 64세,1998,204,89,115
'5091032000,  추자면,'70,65 - 69세,1998,141,50,91
'5091032000,  추자면,'75,70 - 74세,1998,105,31,74
'5091032000,  추자면,'80,75 - 79세,1998,78,28,50
'5091032000,  추자면,'85,80 - 84세,1998,31,4,27
'5091032000,  추자면,'90,85+ ,1998,19,0,19
'5091033000,  우도면,'00,계,1998,1877,892,985
'5091033000,  우도면,'05,0 - 4세,1998,97,53,44
'5091033000,  우도면,'10,5 - 9세,1998,83,41,42
'5091033000,  우도면,'15,10 - 14세,1998,94,45,49
'5091033000,  우도면,'20,15 - 19세,1998,175,92,83
'5091033000,  우도면,'25,20 - 24세,1998,229,130,99
'5091033000,  우도면,'30,25 - 29세,1998,159,95,64
'5091033000,  우도면,'35,30 - 34세,1998,106,63,43
'5091033000,  우도면,'40,35 - 39세,1998,102,63,39
'5091033000,  우도면,'45,40 - 44세,1998,92,50,42
'5091033000,  우도면,'50,45 - 49세,1998,84,46,38
'5091033000,  우도면,'55,50 - 54세,1998,111,54,57
'5091033000,  우도면,'60,55 - 59세,1998,115,47,68
'5091033000,  우도면,'65,60 - 64세,1998,131,54,77
'5091033000,  우도면,'70,65 - 69세,1998,119,30,89
'5091033000,  우도면,'75,70 - 74세,1998,76,18,58
'5091033000,  우도면,'80,75 - 79세,1998,52,7,45
'5091033000,  우도면,'85,80 - 84세,1998,29,2,27
'5091033000,  우도면,'90,85+ ,1998,23,2,21
'50920, 남제주군,'00,계,1998,78121,38975,39146
'50920, 남제주군,'05,0 - 4세,1998,5374,2794,2580
'50920, 남제주군,'10,5 - 9세,1998,4856,2525,2331
'50920, 남제주군,'15,10 - 14세,1998,4593,2356,2237
'50920, 남제주군,'20,15 - 19세,1998,6847,3414,3433
'50920, 남제주군,'25,20 - 24세,1998,7338,3972,3366
'50920, 남제주군,'30,25 - 29세,1998,7608,4203,3405
'50920, 남제주군,'35,30 - 34세,1998,6220,3560,2660
'50920, 남제주군,'40,35 - 39세,1998,5938,3304,2634
'50920, 남제주군,'45,40 - 44세,1998,4903,2716,2187
'50920, 남제주군,'50,45 - 49세,1998,3690,1898,1792
'50920, 남제주군,'55,50 - 54세,1998,4102,2091,2011
'50920, 남제주군,'60,55 - 59세,1998,4525,2132,2393
'50920, 남제주군,'65,60 - 64세,1998,4228,1796,2432
'50920, 남제주군,'70,65 - 69세,1998,3120,1076,2044
'50920, 남제주군,'75,70 - 74세,1998,1595,478,1117
'50920, 남제주군,'80,75 - 79세,1998,1556,375,1181
'50920, 남제주군,'85,80 - 84세,1998,912,185,727
'50920, 남제주군,'90,85+ ,1998,716,100,616
'5092025000,  대정읍,'00,계,1998,19318,9605,9713
'5092025000,  대정읍,'05,0 - 4세,1998,1246,648,598
'5092025000,  대정읍,'10,5 - 9세,1998,1188,614,574
'5092025000,  대정읍,'15,10 - 14세,1998,1071,557,514
'5092025000,  대정읍,'20,15 - 19세,1998,1668,837,831
'5092025000,  대정읍,'25,20 - 24세,1998,1933,1044,889
'5092025000,  대정읍,'30,25 - 29세,1998,1868,1036,832
'5092025000,  대정읍,'35,30 - 34세,1998,1462,812,650
'5092025000,  대정읍,'40,35 - 39세,1998,1451,818,633
'5092025000,  대정읍,'45,40 - 44세,1998,1160,643,517
'5092025000,  대정읍,'50,45 - 49세,1998,922,460,462
'5092025000,  대정읍,'55,50 - 54세,1998,1083,552,531
'5092025000,  대정읍,'60,55 - 59세,1998,1113,520,593
'5092025000,  대정읍,'65,60 - 64세,1998,1070,481,589
'5092025000,  대정읍,'70,65 - 69세,1998,818,274,544
'5092025000,  대정읍,'75,70 - 74세,1998,394,113,281
'5092025000,  대정읍,'80,75 - 79세,1998,451,121,330
'5092025000,  대정읍,'85,80 - 84세,1998,226,47,179
'5092025000,  대정읍,'90,85+ ,1998,194,28,166
'5092025300,  남원읍,'00,계,1998,20758,10431,10327
'5092025300,  남원읍,'05,0 - 4세,1998,1501,770,731
'5092025300,  남원읍,'10,5 - 9세,1998,1313,669,644
'5092025300,  남원읍,'15,10 - 14세,1998,1272,641,631
'5092025300,  남원읍,'20,15 - 19세,1998,1915,948,967
'5092025300,  남원읍,'25,20 - 24세,1998,1909,1027,882
'5092025300,  남원읍,'30,25 - 29세,1998,2089,1146,943
'5092025300,  남원읍,'35,30 - 34세,1998,1698,986,712
'5092025300,  남원읍,'40,35 - 39세,1998,1634,918,716
'5092025300,  남원읍,'45,40 - 44세,1998,1303,710,593
'5092025300,  남원읍,'50,45 - 49세,1998,940,473,467
'5092025300,  남원읍,'55,50 - 54세,1998,1039,533,506
'5092025300,  남원읍,'60,55 - 59세,1998,1246,599,647
'5092025300,  남원읍,'65,60 - 64세,1998,1067,451,616
'5092025300,  남원읍,'70,65 - 69세,1998,765,296,469
'5092025300,  남원읍,'75,70 - 74세,1998,372,109,263
'5092025300,  남원읍,'80,75 - 79세,1998,322,83,239
'5092025300,  남원읍,'85,80 - 84세,1998,218,46,172
'5092025300,  남원읍,'90,85+ ,1998,155,26,129
'5092025900,  성산읍,'00,계,1998,16058,8012,8046
'5092025900,  성산읍,'05,0 - 4세,1998,1043,538,505
'5092025900,  성산읍,'10,5 - 9세,1998,998,535,463
'5092025900,  성산읍,'15,10 - 14세,1998,986,498,488
'5092025900,  성산읍,'20,15 - 19세,1998,1399,734,665
'5092025900,  성산읍,'25,20 - 24세,1998,1481,804,677
'5092025900,  성산읍,'30,25 - 29세,1998,1468,835,633
'5092025900,  성산읍,'35,30 - 34세,1998,1185,660,525
'5092025900,  성산읍,'40,35 - 39세,1998,1208,663,545
'5092025900,  성산읍,'45,40 - 44세,1998,1070,604,466
'5092025900,  성산읍,'50,45 - 49세,1998,794,431,363
'5092025900,  성산읍,'55,50 - 54세,1998,841,411,430
'5092025900,  성산읍,'60,55 - 59세,1998,938,440,498
'5092025900,  성산읍,'65,60 - 64세,1998,853,363,490
'5092025900,  성산읍,'70,65 - 69세,1998,725,233,492
'5092025900,  성산읍,'75,70 - 74세,1998,356,121,235
'5092025900,  성산읍,'80,75 - 79세,1998,360,77,283
'5092025900,  성산읍,'85,80 - 84세,1998,196,45,151
'5092025900,  성산읍,'90,85+ ,1998,157,20,137
'5092031000,  안덕면,'00,계,1998,10775,5369,5406
'5092031000,  안덕면,'05,0 - 4세,1998,788,420,368
'5092031000,  안덕면,'10,5 - 9세,1998,645,352,293
'5092031000,  안덕면,'15,10 - 14세,1998,606,314,292
'5092031000,  안덕면,'20,15 - 19세,1998,880,421,459
'5092031000,  안덕면,'25,20 - 24세,1998,998,535,463
'5092031000,  안덕면,'30,25 - 29세,1998,1059,573,486
'5092031000,  안덕면,'35,30 - 34세,1998,912,558,354
'5092031000,  안덕면,'40,35 - 39세,1998,752,426,326
'5092031000,  안덕면,'45,40 - 44세,1998,656,371,285
'5092031000,  안덕면,'50,45 - 49세,1998,490,255,235
'5092031000,  안덕면,'55,50 - 54세,1998,541,276,265
'5092031000,  안덕면,'60,55 - 59세,1998,597,274,323
'5092031000,  안덕면,'65,60 - 64세,1998,639,260,379
'5092031000,  안덕면,'70,65 - 69세,1998,439,157,282
'5092031000,  안덕면,'75,70 - 74세,1998,229,73,156
'5092031000,  안덕면,'80,75 - 79세,1998,273,59,214
'5092031000,  안덕면,'85,80 - 84세,1998,162,28,134
'5092031000,  안덕면,'90,85+ ,1998,109,17,92
'5092032000,  표선면,'00,계,1998,11212,5558,5654
'5092032000,  표선면,'05,0 - 4세,1998,796,418,378
'5092032000,  표선면,'10,5 - 9세,1998,712,355,357
'5092032000,  표선면,'15,10 - 14세,1998,658,346,312
'5092032000,  표선면,'20,15 - 19세,1998,985,474,511
'5092032000,  표선면,'25,20 - 24세,1998,1017,562,455
'5092032000,  표선면,'30,25 - 29세,1998,1124,613,511
'5092032000,  표선면,'35,30 - 34세,1998,963,544,419
'5092032000,  표선면,'40,35 - 39세,1998,893,479,414
'5092032000,  표선면,'45,40 - 44세,1998,714,388,326
'5092032000,  표선면,'50,45 - 49세,1998,544,279,265
'5092032000,  표선면,'55,50 - 54세,1998,598,319,279
'5092032000,  표선면,'60,55 - 59세,1998,631,299,332
'5092032000,  표선면,'65,60 - 64세,1998,599,241,358
'5092032000,  표선면,'70,65 - 69세,1998,373,116,257
'5092032000,  표선면,'75,70 - 74세,1998,244,62,182
'5092032000,  표선면,'80,75 - 79세,1998,150,35,115
'5092032000,  표선면,'85,80 - 84세,1998,110,19,91
'5092032000,  표선면,'90,85+ ,1998,101,9,92
